job_id,submit_time,request_time,request_processors,carbon_consideration,queue_length_at_submission,submission_timestamp,user_id,power,scheduled_time,completion_time,wait_time,actual_runtime,action1,action2,scheduled,completed,carbon_emissions,carbon_reward
7599,6084716,8396,8,0.537604,1,6084716,-1,4000.0,6086916,6095312,2200,8396,0,7,True,True,1216.096,-0.5138414238102761
7600,6085683,12,4,0.32608,4,6086916,-1,2000.0,6093516,6093528,7833,12,0,7,True,True,0.8585333333333334,-0.32608
7601,6085768,291,64,0.02324,4,6086916,-1,32000.0,6095716,6096007,9948,291,0,7,True,True,270.9792,-0.02324
7602,6085843,31,32,0.785358,4,6086916,-1,16000.0,6089116,6089147,3273,31,2,7,True,True,18.3768,-0.785358
7603,6085865,8087,26,0.922144,4,6086916,-1,13000.0,6091316,6099403,5451,8087,2,7,True,True,3286.065286111111,-0.9169018679332249
7604,6093970,4,2,0.153691,16,6095716,-1,1000.0,6120241,6120245,26271,4,0,1,True,True,0.12538888888888888,-0.153691
7605,6094137,1277,1,0.952638,16,6095716,-1,500.0,6105616,6106893,11479,1277,1,7,True,True,23.713180555555553,-0.952638
7606,6094181,836,16,0.330251,16,6095716,-1,8000.0,6120223,6121059,26042,836,1,0,True,True,209.6502222222222,-0.330251
7607,6094592,4818,1,0.629839,16,6095716,-1,500.0,6159664,6164482,65072,4818,0,0,True,True,94.78769722222222,-0.6294641649092952
7608,6094727,8,8,0.603003,16,6095716,-1,4000.0,6107816,6107824,13089,8,3,7,True,True,1.1884444444444444,-0.603003
7609,6094907,18787,2,0.607837,16,6095716,-1,1000.0,6284125,6302912,189218,18787,0,7,True,True,626.4469944444445,-0.5871402724855357
7610,6094978,10,4,0.866945,16,6095716,-1,2000.0,6097916,6097926,2938,10,6,7,True,True,0.5820000000000001,-0.866945
7611,6095254,11,44,0.980172,16,6095716,-1,22000.0,6103416,6103427,8162,11,6,0,True,True,9.26255,-0.980172
7612,6095273,34,1,0.204205,16,6095716,-1,500.0,6128026,6128060,32753,34,2,1,True,True,0.4657055555555556,-0.204205
7613,6095276,750,8,0.390636,16,6095716,-1,4000.0,6129126,6129876,33850,750,2,0,True,True,82.18333333333334,-0.390636
7614,6095281,697,1,0.534491,16,6095716,-1,500.0,6107816,6108513,12535,697,6,0,True,True,12.942902777777778,-0.534491
7615,6095288,87,1,0.188339,16,6095716,-1,500.0,6139649,6139736,44361,87,2,1,True,True,0.998325,-0.188339
7616,6095300,5354,8,0.108638,16,6095716,-1,4000.0,6149569,6154923,54269,5354,2,7,True,True,668.9079666666667,-0.10244174928483216
7617,6095363,19008,8,0.569515,16,6095716,-1,4000.0,6165850,6184858,70487,19008,1,7,True,True,1683.9809777777778,-0.49707865715820027
7618,6095534,31,4,0.451535,16,6095716,-1,2000.0,6118727,6118758,23193,31,9,0,True,True,2.32345,-0.451535
7619,6095582,113,2,0.894744,16,6095716,-1,1000.0,6105616,6105729,10034,113,12,0,True,True,4.196694444444444,-0.894744
7620,6095896,137,32,0.093242,36,6097916,-1,16000.0,6100116,6100253,4220,137,15,7,True,True,51.104044444444455,-0.093242
7621,6095972,9,2,0.104313,36,6097916,-1,1000.0,6145160,6145169,49188,9,4,7,True,True,0.24525,-0.104313
7622,6095994,6961,17,0.552907,36,6097916,-1,8500.0,6120223,6127184,24229,6961,10,6,True,True,1902.1565624999998,-0.5528455131897211
7623,6096053,39045,8,0.032059,36,6097916,-1,4000.0,6174150,6213195,78097,39045,1,0,True,True,4267.0143333333335,-0.031943250088169395
7624,6096103,12315,4,0.689025,36,6097916,-1,2000.0,6141849,6154164,45746,12315,6,7,True,True,676.6431,-0.6450409832805741
7625,6096127,23680,2,0.488613,36,6097916,-1,1000.0,6132426,6156106,36299,23680,8,0,True,True,636.7413111111111,-0.4335390943774079
7626,6096190,11,1,0.186692,36,6097916,-1,500.0,6142949,6142960,46759,11,6,6,True,True,0.149875,-0.186692
7627,6096215,699,18,0.069491,36,6097916,-1,9000.0,6142960,6143659,46745,699,6,1,True,True,171.42974999999998,-0.069491
7628,6096769,50,1,0.962995,36,6097916,-1,500.0,6102316,6102366,5547,50,22,7,True,True,0.9568749999999999,-0.962995
7629,6096778,13995,36,0.283818,36,6097916,-1,18000.0,6129126,6143121,32348,13995,12,6,True,True,6288.3999,-0.27065449192575064
7630,6096933,51,1,0.233039,36,6097916,-1,500.0,6126860,6126911,29927,51,14,7,True,True,0.8390208333333333,-0.233039
7631,6096961,72,4,0.65957,36,6097916,-1,2000.0,6103416,6103488,6455,72,24,6,True,True,5.5116,-0.65957
7632,6097020,8852,128,0.069979,36,6097916,-1,64000.0,6276125,6284977,179105,8852,1,0,True,True,19045.641777777775,-0.06982510634156117
7633,6097126,33,8,0.057453,36,6097916,-1,4000.0,6122441,6122474,25315,33,16,7,True,True,4.137833333333333,-0.057453
7634,6097130,279,4,0.518532,36,6097916,-1,2000.0,6127960,6128239,30830,279,15,6,True,True,15.286100000000001,-0.518532
7635,6097184,6985,8,0.171826,36,6097916,-1,4000.0,6154164,6161149,56980,6985,5,0,True,True,1165.3968666666667,-0.16799714252592307
7636,6097211,410,4,0.859707,36,6097916,-1,2000.0,6107816,6108226,10605,410,23,0,True,True,30.453888888888887,-0.859707
7637,6097271,3,8,0.410861,36,6097916,-1,4000.0,6116516,6116519,19245,3,23,7,True,True,0.44970000000000004,-0.410861
7638,6097277,278,2,0.157035,36,6097916,-1,1000.0,6145169,6145447,47892,278,7,2,True,True,6.7892166666666665,-0.14073587740083165
7639,6097332,23,4,0.110744,36,6097916,-1,2000.0,6138241,6138264,40909,23,13,1,True,True,1.0557,-0.110744
7640,6097351,23,32,0.536453,36,6097916,-1,16000.0,6114316,6114339,16965,23,26,0,True,True,17.306222222222225,-0.536453
7641,6098046,203,8,0.478251,41,6100116,-1,4000.0,6127960,6128163,29914,203,18,0,True,True,22.244288888888892,-0.478251
7642,6098145,19,1,0.068763,41,6100116,-1,500.0,6124641,6124660,26496,19,21,7,True,True,0.3125763888888889,-0.068763
7643,6098202,1062,2,0.955097,41,6100116,-1,1000.0,6103416,6104478,5214,1062,35,0,True,True,40.64805,-0.955097
7644,6098431,6,1,0.865699,41,6100116,-1,500.0,6118727,6118733,20296,6,27,0,True,True,0.11242500000000001,-0.865699
7645,6098546,4961,16,0.129932,41,6100116,-1,8000.0,6141849,6146810,43303,4961,11,0,True,True,1040.4966666666667,-0.1291449394392051
7646,6098955,14,1,0.205677,41,6100116,-1,500.0,6139649,6139663,40694,14,13,0,True,True,0.16065000000000002,-0.205677
7647,6100368,8,26,0.432201,48,6102316,-1,13000.0,6107816,6107824,7448,8,33,0,True,True,3.862444444444444,-0.432201
7648,6100373,624,1,0.709672,48,6102316,-1,500.0,6129126,6129750,28753,624,18,0,True,True,8.547066666666668,-0.709672
7649,6100434,3,2,0.47478,48,6102316,-1,1000.0,6105616,6105619,5182,3,37,0,True,True,0.11141666666666666,-0.47478
7650,6100512,20254,16,0.603709,48,6102316,-1,8000.0,6310025,6330279,209513,20254,0,6,True,True,3945.2248444444444,-0.5906331977850448
7651,6100987,28,2,0.939154,48,6102316,-1,1000.0,6116516,6116544,15529,28,32,0,True,True,1.0493,-0.939154
7652,6101020,9091,128,0.587492,48,6102316,-1,64000.0,6161864,6170955,60844,9091,5,7,True,True,18942.9376,-0.5270751679631008
7653,6101026,128,16,0.502475,48,6102316,-1,8000.0,6120223,6120351,19197,128,30,0,True,True,32.099555555555554,-0.502475
7654,6101073,7,1,0.684836,48,6102316,-1,500.0,6103416,6103423,2343,7,46,0,True,True,0.13396249999999998,-0.684836
7655,6106453,89,16,0.275441,48,6107816,-1,8000.0,6120223,6120312,13770,89,30,0,True,True,22.31922222222222,-0.275441
7656,6106775,9486,8,0.007443,48,6107816,-1,4000.0,6154164,6163650,47389,9486,8,1,True,True,1560.5477999999998,-0.007378663617537947
7657,6106898,10,16,0.142692,48,6107816,-1,8000.0,6134626,6134636,27728,10,19,7,True,True,1.9364444444444446,-0.142692
7658,6107010,66,32,0.06397,48,6107816,-1,16000.0,6127960,6128026,20950,66,26,0,True,True,28.928533333333334,-0.06397
7659,6107212,15,1,0.399237,48,6107816,-1,500.0,6138226,6138241,31014,15,19,4,True,True,0.172125,-0.399237
7660,6107349,5513,1,0.807566,48,6107816,-1,500.0,6122441,6127954,15092,5513,31,0,True,True,87.71842083333333,-0.7940759063723678
7661,6107760,42,4,0.525857,48,6107816,-1,2000.0,6130226,6130268,22466,42,22,0,True,True,2.3011333333333335,-0.525857
7662,6107783,6,4,0.910303,48,6107816,-1,2000.0,6113216,6113222,5433,6,44,8,True,True,0.5643333333333334,-0.910303
7663,6108059,58,1,0.879239,59,6113216,-1,500.0,6117616,6117674,9557,58,41,0,True,True,1.086775,-0.879239
7664,6108112,537,1,0.460205,59,6113216,-1,500.0,6128026,6128563,19914,537,26,0,True,True,7.355408333333334,-0.460205
7665,6108162,11,4,0.576133,59,6113216,-1,2000.0,6118716,6118727,10554,11,42,0,True,True,0.82445,-0.576133
7666,6108299,73,1,0.737291,59,6113216,-1,500.0,6114316,6114389,6017,73,47,6,True,True,1.716513888888889,-0.737291
7667,6109439,8251,8,0.287912,59,6113216,-1,4000.0,6177750,6186001,68311,8251,3,4,True,True,680.306788888889,-0.27535896831870516
7668,6110021,745,2,0.880994,59,6113216,-1,1000.0,6118727,6119472,8706,745,43,0,True,True,27.918874999999996,-0.880994
7669,6110292,24,16,0.456307,59,6113216,-1,8000.0,6118716,6118740,8424,24,45,6,True,True,7.195200000000001,-0.456307
7670,6110560,683,2,0.700317,59,6113216,-1,1000.0,6118727,6119410,8167,683,41,0,True,True,25.595425,-0.700317
7671,6110618,475,1,0.711648,59,6113216,-1,500.0,6122441,6122916,11823,475,35,0,True,True,7.4449652777777775,-0.711648
7672,6111648,10744,4,0.297449,59,6113216,-1,2000.0,6163650,6174394,52002,10744,6,0,True,True,591.8478555555556,-0.2893291189901427
7673,6111677,29494,4,0.613028,59,6113216,-1,2000.0,6339592,6369086,227915,29494,0,7,True,True,1721.7861111111115,-0.6005047882427964
7674,6112290,396,7,0.809985,59,6113216,-1,3500.0,6118727,6119123,6437,396,46,0,True,True,51.94035,-0.809985
7675,6112402,206,1,0.175126,59,6113216,-1,500.0,6127960,6128166,15558,206,32,0,True,True,2.821627777777778,-0.175126
7676,6112602,13650,14,0.249135,59,6113216,-1,7000.0,6177750,6191400,65148,13650,4,0,True,True,2292.336666666667,-0.24305389027914326
7677,6112924,20785,193,0.899965,59,6113216,-1,96500.0,6432412,6453197,319488,20785,0,7,True,True,58591.143186111105,-0.8768183461251287
7678,6116203,5,8,0.733244,59,6116516,-1,4000.0,6118727,6118732,2524,5,50,0,True,True,0.7495,-0.733244
7679,6116352,1695,8,0.457828,59,6116516,-1,4000.0,6118727,6120422,2375,1695,53,1,True,True,243.7368111111111,-0.4391896928626077
7680,6116390,8,4,0.910833,59,6116516,-1,2000.0,6117616,6117624,1226,8,57,6,True,True,0.5996,-0.910833
7681,6116853,16547,64,0.183444,59,6117616,-1,32000.0,6316360,6332907,199507,16547,2,8,True,True,13556.3352,-0.1820676240464124
7682,6117029,5,2,0.568615,59,6117616,-1,1000.0,6119123,6119128,2094,5,48,5,True,True,0.187375,-0.568615
7683,6118255,11693,41,0.393551,59,6118716,-1,20500.0,6177750,6189443,59495,11693,7,0,True,True,5357.935008333334,-0.34718287179216145
7684,6118441,9726,24,0.945687,59,6118716,-1,12000.0,6128026,6137752,9585,9726,34,0,True,True,2993.0305333333336,-0.9358043234704255
7685,6118880,394,1,0.239695,55,6119123,-1,500.0,6130226,6130620,11346,394,30,6,True,True,5.396705555555556,-0.239695
7686,6118914,18,1,0.87054,55,6119123,-1,500.0,6120223,6120241,1309,18,49,0,True,True,0.282125,-0.87054
7687,6118928,95,1,0.273776,55,6119123,-1,500.0,6127960,6128055,9032,95,37,0,True,True,1.3012361111111113,-0.273776
7688,6119064,23817,2,0.628083,55,6119123,-1,1000.0,6337392,6361209,218328,23817,2,1,True,True,697.3238083333333,-0.6029063655760354
7689,6119108,9,4,0.29189,55,6119123,-1,2000.0,6126860,6126869,7752,9,43,0,True,True,0.59225,-0.29189
7690,6123749,14,4,0.916296,49,6124641,-1,2000.0,6124660,6124674,911,14,45,1,True,True,0.9212777777777778,-0.916296
7691,6123915,18,4,0.698044,49,6124641,-1,2000.0,6126860,6126878,2945,18,43,0,True,True,1.1845,-0.698044
7692,6124059,81,1,0.722409,49,6124641,-1,500.0,6129126,6129207,5067,81,32,0,True,True,1.109475,-0.722409
7693,6124598,92,2,0.217255,49,6124641,-1,1000.0,6169450,6169542,44852,92,11,1,True,True,2.412188888888889,-0.217255
7694,6124770,8,1,0.493488,53,6126860,-1,500.0,6145169,6145177,20399,8,19,0,True,True,0.109,-0.493488
7695,6125092,2,5,0.99239,53,6126860,-1,2500.0,6129126,6129128,4034,2,36,0,True,True,0.13697222222222225,-0.99239
7696,6125214,4,4,0.552824,53,6126860,-1,2000.0,6128026,6128030,2812,4,40,0,True,True,0.21915555555555558,-0.552824
7697,6125511,10193,16,0.995316,53,6126860,-1,8000.0,6159664,6169857,34153,10193,16,6,True,True,2863.4766,-0.9929020241890887
7698,6125774,15531,128,0.076534,53,6126860,-1,64000.0,6308925,6324456,183151,15531,5,7,True,True,23108.037333333334,-0.0749723964173491
7699,6126004,10,16,0.105225,53,6126860,-1,8000.0,6139485,6139495,13481,10,30,1,True,True,1.836,-0.105225
7700,6126999,20414,256,0.766539,53,6127960,-1,128000.0,6411998,6432412,284999,20414,1,7,True,True,78276.26382222222,-0.7634293133527382
7701,6127255,15208,4,0.326013,53,6127960,-1,2000.0,6296525,6311733,169270,15208,7,7,True,True,688.6302166666666,-0.31666350065619403
7702,6127551,151,16,0.450936,53,6127960,-1,8000.0,6147369,6147520,19818,151,23,7,True,True,29.072533333333332,-0.450936
7703,6128779,3,1,0.252767,48,6129126,-1,500.0,6132426,6132429,3647,3,38,7,True,True,0.03845416666666667,-0.252767
7704,6128835,200,32,0.506065,48,6129126,-1,16000.0,6158564,6158764,29729,200,20,7,True,True,145.07555555555555,-0.506065
7705,6128855,154,2,0.462167,48,6129126,-1,1000.0,6139495,6139649,10640,154,34,1,True,True,3.5343,-0.462167
7706,6129010,26,32,0.073195,48,6129126,-1,16000.0,6179950,6179976,50940,26,10,7,True,True,8.38471111111111,-0.073195
7707,6130829,3,5,0.694486,42,6132426,-1,2500.0,6145160,6145163,14331,3,28,0,True,True,0.20437499999999997,-0.694486
7708,6132809,32539,37,0.749736,48,6134626,-1,18500.0,6150669,6183208,17860,32539,24,6,True,True,17976.504729166667,-0.7384864946686062
7709,6133298,352,1,0.381156,48,6134626,-1,500.0,6163650,6164002,30352,352,18,1,True,True,6.69728888888889,-0.381156
7710,6133568,34,106,0.745957,48,6134626,-1,53000.0,6247307,6247341,113739,34,10,0,True,True,40.595055555555554,-0.745957
7711,6133731,53,4,0.855773,48,6134626,-1,2000.0,6156364,6156417,22633,53,24,7,True,True,4.805627777777778,-0.855773
7712,6133928,6435,4,0.396674,48,6134626,-1,2000.0,6304525,6310960,170597,6435,7,4,True,True,244.72127777777777,-0.3628203051001464
7713,6134348,3,8,0.010737,48,6134626,-1,4000.0,6182150,6182153,47802,3,12,7,True,True,0.24160000000000004,-0.010737
7714,6134461,109,4,0.114683,48,6134626,-1,2000.0,6184353,6184462,49892,109,12,7,True,True,4.389066666666667,-0.114683
7715,6134542,144,8,0.917137,48,6134626,-1,4000.0,6139341,6139485,4799,144,45,6,True,True,13.2192,-0.917137
7716,6157938,30,8,0.32711,30,6158564,-1,4000.0,6187653,6187683,29715,30,12,6,True,True,2.8036666666666665,-0.32711
7717,6158059,72,1,0.748676,30,6158564,-1,500.0,6174150,6174222,16091,72,20,4,True,True,0.7006,-0.748676
7718,6158070,1194,32,0.484759,30,6158564,-1,16000.0,6182150,6183344,24080,1194,14,0,True,True,384.6272,-0.484759
7719,6158142,61,8,0.068237,30,6158564,-1,4000.0,6182153,6182214,24011,61,14,0,True,True,4.912533333333334,-0.068237
7720,6166540,36,1,0.548429,33,6169450,-1,500.0,6170550,6170586,4010,36,23,0,True,True,0.37,-0.548429
7721,6166801,8740,64,0.242294,33,6169450,-1,32000.0,6306725,6315465,139924,8740,7,7,True,True,5656.604444444443,-0.2387317510880006
7722,6167111,15477,8,0.950018,33,6169450,-1,4000.0,6216557,6232034,49446,15477,13,0,True,True,1500.929011111111,-0.8586968546925072
7723,6167127,12518,64,0.140256,33,6169450,-1,32000.0,6200878,6213396,33751,12518,14,6,True,True,11552.339377777778,-0.13863329566320418
7724,6167151,6896,1,0.820427,33,6169450,-1,500.0,6170550,6177446,3399,6896,27,6,True,True,68.98982777777778,-0.8194520250523931
7725,6167179,4606,42,0.841563,33,6169450,-1,21000.0,6195353,6199959,28174,4606,15,0,True,True,2905.136033333333,-0.6939381406779201
7726,6167293,35,32,0.170589,33,6169450,-1,16000.0,6217664,6217699,50371,35,13,0,True,True,12.758666666666667,-0.170589
7727,6167321,2351,32,0.018066,33,6169450,-1,16000.0,6216540,6218891,49219,2351,15,0,True,True,875.4685333333332,-0.017140463085431278
7728,6167402,3,64,0.100515,33,6169450,-1,32000.0,6205636,6205639,38234,3,16,1,True,True,2.9176,-0.100515
7729,6168363,50,16,0.294145,33,6169450,-1,8000.0,6177750,6177800,9387,50,27,0,True,True,8.062222222222221,-0.294145
7730,6170285,6,15,0.534654,33,6170550,-1,7500.0,6184353,6184359,14068,6,20,0,True,True,0.9060000000000001,-0.534654
7731,6170812,28303,8,0.39085,39,6174150,-1,4000.0,6355920,6384223,185108,28303,2,4,True,True,3231.333311111111,-0.3838045302013524
7732,6170820,852,1,0.077585,39,6174150,-1,500.0,6217664,6218516,46844,852,15,0,True,True,9.7057,-0.077585
7733,6171254,11,32,0.763589,39,6174150,-1,16000.0,6196453,6196464,25199,11,20,0,True,True,5.216933333333333,-0.763589
7734,6171266,6290,1,0.677383,39,6174150,-1,500.0,6192053,6198343,20787,6290,22,7,True,True,108.61308055555554,-0.6759518405529419
7735,6171277,10237,3,0.153496,39,6174150,-1,1500.0,6217664,6227901,46387,10237,16,0,True,True,353.0817875,-0.15179662451198703
7736,6171329,8,10,0.358087,39,6174150,-1,5000.0,6182153,6182161,10824,8,28,1,True,True,0.8053333333333335,-0.358087
7737,6171796,29,4,0.216672,39,6174150,-1,2000.0,6198653,6198682,26857,29,21,7,True,True,1.7192166666666666,-0.216672
7738,6171947,8514,128,0.034445,39,6174150,-1,64000.0,6237407,6245921,65460,8514,14,6,True,True,14022.91751111111,-0.03434617196708189
7739,6180587,10886,2,0.675044,41,6182150,-1,1000.0,6225368,6236254,44781,10886,15,0,True,True,297.5302277777778,-0.6605380598299397
7740,6180626,47,1,0.216166,41,6182150,-1,500.0,6194253,6194300,13627,47,26,0,True,True,0.9005069444444445,-0.216166
7741,6180674,58,1,0.696742,41,6182150,-1,500.0,6200878,6200936,20204,58,22,0,True,True,0.8468805555555555,-0.696742
7742,6180804,34,2,0.836501,41,6182150,-1,1000.0,6194253,6194287,13449,34,28,7,True,True,1.302861111111111,-0.836501
7743,6180922,3,1,0.811512,41,6182150,-1,500.0,6187653,6187656,6731,3,30,0,True,True,0.03504583333333334,-0.811512
7744,6181531,14512,1,0.641012,41,6182150,-1,500.0,6329360,6343872,147829,14512,5,7,True,True,195.78604444444449,-0.6019790318739378
7745,6181893,34,4,0.71641,41,6182150,-1,2000.0,6199771,6199805,17878,34,25,0,True,True,1.9857888888888888,-0.71641
7746,6181980,11445,16,0.89701,41,6182150,-1,8000.0,6208936,6220381,26956,11445,22,0,True,True,2350.9104444444447,-0.865975314074017
7747,6182070,10698,256,0.390618,41,6182150,-1,128000.0,6401300,6411998,219230,10698,2,0,True,True,42964.26951111111,-0.3771122775452945
7748,6182223,59,2,0.308324,51,6184353,-1,1000.0,6217664,6217723,35441,59,21,1,True,True,1.3442166666666666,-0.308324
7749,6182229,14021,8,0.052415,51,6184353,-1,4000.0,6367920,6381941,185691,14021,3,7,True,True,1519.6630777777777,-0.04991789945094494
7750,6182245,6,7,0.004666,51,6184353,-1,3500.0,6208936,6208942,26691,6,26,0,True,True,0.5656583333333334,-0.004666
7751,6182363,11,15,0.77241,51,6184353,-1,7500.0,6192053,6192064,9690,11,36,0,True,True,3.1613541666666665,-0.77241
7752,6182386,12,2,0.767114,51,6184353,-1,1000.0,6199771,6199783,17385,12,31,1,True,True,0.3504333333333333,-0.767114
7753,6182528,13,32,0.928821,51,6184353,-1,16000.0,6186553,6186566,4025,13,41,7,True,True,4.859688888888889,-0.928821
7754,6182662,527,8,0.374645,51,6184353,-1,4000.0,6207836,6208363,25174,527,27,7,True,True,56.78132222222223,-0.374645
7755,6182694,1989,2,0.23854,51,6184353,-1,1000.0,6216557,6218546,33863,1989,24,1,True,True,46.43951388888889,-0.227042266123514
7756,6182782,38,2,0.091386,51,6184353,-1,1000.0,6217664,6217702,34882,38,19,0,True,True,0.8657666666666667,-0.091386
7757,6182850,21,4,0.421683,51,6184353,-1,2000.0,6199753,6199774,16903,21,35,0,True,True,1.2265166666666667,-0.421683
7758,6182870,18,2,0.989291,51,6184353,-1,1000.0,6199753,6199771,16883,18,36,6,True,True,0.52565,-0.989291
7759,6182876,16473,21,0.337117,51,6184353,-1,10500.0,6251707,6268180,68831,16473,16,7,True,True,4513.156404166667,-0.3217143612452554
7760,6183019,13368,6,0.192152,51,6184353,-1,3000.0,6267025,6280393,84006,13368,16,1,True,True,1241.5507166666666,-0.18811018507482993
7761,6183053,24,4,0.668949,51,6184353,-1,2000.0,6187653,6187677,4600,24,46,0,True,True,1.1214666666666668,-0.668949
7762,6184878,28,1,0.220568,55,6186553,-1,500.0,6217668,6217696,32790,28,21,0,True,True,0.3189666666666666,-0.220568
7763,6186030,10651,4,0.882286,55,6186553,-1,2000.0,6196453,6207104,10423,10651,42,6,True,True,629.857361111111,-0.8768009788311922
7764,6186037,134,4,0.796924,55,6186553,-1,2000.0,6199778,6199912,13741,134,36,0,True,True,7.826344444444444,-0.796924
7765,6186291,7,1,0.830451,55,6186553,-1,500.0,6195353,6195360,9062,7,45,6,True,True,0.13411805555555553,-0.830451
7766,6186296,4,1,0.167883,55,6186553,-1,500.0,6217664,6217668,31368,4,22,0,True,True,0.045566666666666665,-0.167883
7767,6186359,9079,16,0.167047,55,6186553,-1,8000.0,6247307,6256386,60948,9079,19,7,True,True,1610.9351555555554,-0.16636683873270394
7768,6186610,2,64,0.41568,66,6187653,-1,32000.0,6231607,6231609,44997,2,21,7,True,True,1.878577777777778,-0.41568
7769,6186646,12762,5,0.107684,66,6187653,-1,2500.0,6245107,6257869,58461,12762,20,0,True,True,738.2338888888888,-0.09700490215720058
7770,6186691,94,4,0.327141,66,6187653,-1,2000.0,6224268,6224362,37577,94,24,7,True,True,3.555288888888889,-0.327141
7771,6186720,10727,1,0.562054,66,6187653,-1,500.0,6229407,6240134,42687,10727,23,7,True,True,136.44084305555555,-0.5260965475345464
7772,6186760,4,16,0.189548,66,6187653,-1,8000.0,6216536,6216540,29776,4,36,8,True,True,0.7849777777777778,-0.189548
7773,6187354,35732,16,0.207119,66,6187653,-1,8000.0,6358120,6393852,170766,35732,4,7,True,True,7494.442933333333,-0.20274535056533405
7774,6187374,16088,32,0.541703,66,6187653,-1,16000.0,6236307,6252395,48933,16088,23,6,True,True,6184.816711111111,-0.5402030223928126
7775,6187428,7,4,0.938923,66,6187653,-1,2000.0,6189853,6189860,2425,7,59,7,True,True,0.47296666666666665,-0.938923
7776,6187452,40,4,0.120804,66,6187653,-1,2000.0,6222068,6222108,34616,40,28,7,True,True,1.512888888888889,-0.120804
7777,6187476,230,32,0.21378,66,6187653,-1,16000.0,6200936,6201166,13460,230,44,1,True,True,107.46622222222221,-0.21378
7778,6187562,4,1,0.356576,66,6187653,-1,500.0,6199774,6199778,12212,4,48,1,True,True,0.05840555555555555,-0.356576
7779,6187628,5482,64,0.173622,66,6187653,-1,32000.0,6294325,6299807,106697,5482,15,6,True,True,5666.196533333334,-0.16398304840679814
7780,6187688,7780,16,0.402139,64,6189853,-1,8000.0,6202036,6209816,14348,7780,45,6,True,True,1789.877422222222,-0.390907579862817
7781,6196956,48,8,0.31624,64,6198653,-1,4000.0,6235207,6235255,38251,48,25,4,True,True,3.9610666666666665,-0.31624
7782,6197065,8715,64,0.389187,64,6198653,-1,32000.0,6279725,6288440,82660,8715,17,5,True,True,9417.099555555555,-0.38807552951333274
7783,6197309,20587,32,0.458776,64,6198653,-1,16000.0,6258307,6278894,60998,20587,20,7,True,True,9678.819911111112,-0.44327870718528767
7784,6197333,132,8,0.066016,64,6198653,-1,4000.0,6219868,6220000,22535,132,33,7,True,True,12.0296,-0.066016
7785,6197371,40,8,0.815085,64,6198653,-1,4000.0,6199778,6199818,2407,40,54,1,True,True,4.672444444444444,-0.815085
7786,6197433,8,4,0.649945,64,6198653,-1,2000.0,6205636,6205644,8203,8,48,0,True,True,0.4862666666666666,-0.649945
7787,6198518,5,2,0.36898,64,6198653,-1,1000.0,6216552,6216557,18034,5,43,1,True,True,0.12265277777777779,-0.36898
7788,6198545,6037,1,0.067331,64,6198653,-1,500.0,6281925,6287962,83380,6037,17,7,True,True,101.53760555555556,-0.06665545265412028
7789,6198567,13942,3,0.218561,64,6198653,-1,1500.0,6335160,6349102,136593,13942,8,7,True,True,607.7793,-0.21643838575777552
7790,6199325,12,4,0.301534,66,6199753,-1,2000.0,6270325,6270337,71000,12,21,6,True,True,0.6932,-0.301534
7791,6199601,9528,16,0.598869,66,6199753,-1,8000.0,6261607,6271135,62006,9528,23,7,True,True,2154.0580444444445,-0.5986586444446398
7792,6199623,16060,128,0.983102,66,6199753,-1,64000.0,6332960,6349020,133337,16060,9,4,True,True,28826.35377777778,-0.9690567107133821
7793,6200106,14,3,0.101814,61,6200878,-1,1500.0,6227207,6227221,27101,14,35,0,True,True,0.5749916666666666,-0.101814
7794,6200395,17,19,0.536182,61,6200878,-1,9500.0,6238507,6238524,38112,17,30,6,True,True,3.3318347222222218,-0.536182
7795,6201790,98,3,0.990531,60,6202036,-1,1500.0,6208936,6209034,7146,98,55,6,True,True,3.959608333333333,-0.990531
7796,6201992,13,32,0.850465,60,6202036,-1,16000.0,6208936,6208949,6944,13,54,0,True,True,5.602711111111111,-0.850465
7797,6202188,15248,8,0.171459,72,6205636,-1,4000.0,6367920,6383168,165732,15248,3,0,True,True,1656.049422222222,-0.1656411934179023
7798,6202259,119,4,0.959035,72,6205636,-1,2000.0,6207836,6207955,5577,119,58,0,True,True,6.410794444444444,-0.959035
7799,6202348,13269,32,0.599867,72,6205636,-1,16000.0,6300925,6314194,98577,13269,17,7,True,True,4379.607866666666,-0.5893157957008308
7800,6202504,4977,8,0.981416,72,6205636,-1,4000.0,6208936,6213913,6432,4977,58,0,True,True,563.0323444444444,-0.9761941717178728
7801,6202738,9543,16,0.696315,72,6205636,-1,8000.0,6217664,6227207,14926,9543,46,0,True,True,1731.086022222222,-0.6699577325859771
7802,6202784,3,4,0.677901,72,6205636,-1,2000.0,6217668,6217671,14884,3,44,1,True,True,0.13670000000000002,-0.677901
7803,6202795,12009,1,0.972367,72,6205636,-1,500.0,6263807,6275816,61012,12009,26,7,True,True,175.99874722222222,-0.9412770772442868
7804,6202868,670,1,0.693721,72,6205636,-1,500.0,6217664,6218334,14796,670,46,0,True,True,7.632416666666667,-0.693721
7805,6203049,269,8,0.332047,72,6205636,-1,4000.0,6217668,6217937,14619,269,44,0,True,True,24.514866666666663,-0.332047
7806,6203171,1197,3,0.635353,72,6205636,-1,1500.0,6217664,6218861,14493,1197,48,0,True,True,40.907475,-0.635353
7807,6204006,19249,128,0.883967,72,6205636,-1,64000.0,6382051,6401300,178045,19249,3,7,True,True,26921.32497777778,-0.777145952117664
7808,6204286,8237,4,0.317967,72,6205636,-1,2000.0,6310960,6319197,106674,8237,14,1,True,True,354.9255944444444,-0.291843399283373
7809,6204343,16776,1,0.851554,72,6205636,-1,500.0,6298725,6315501,94382,16776,20,7,True,True,179.635,-0.7919030492394632
7810,6206461,119,16,0.48213,74,6207836,-1,8000.0,6208936,6209055,2475,119,66,0,True,True,25.643177777777776,-0.48213
7811,6207230,21,4,0.335105,74,6207836,-1,2000.0,6242907,6242928,35677,21,36,7,True,True,1.2016666666666667,-0.335105
7812,6207482,681,8,0.608533,74,6207836,-1,4000.0,6211136,6211817,3654,681,65,0,True,True,79.01113333333333,-0.608533
7813,6207629,10100,64,0.585037,74,6207836,-1,32000.0,6289925,6300025,82296,10100,23,7,True,True,11475.480000000001,-0.571102839481206
7814,6207858,109,32,0.382371,75,6208936,-1,16000.0,6217664,6217773,9806,109,53,0,True,True,39.73413333333333,-0.382371
7815,6207901,27,32,0.640592,75,6208936,-1,16000.0,6211136,6211163,3235,27,68,7,True,True,12.5304,-0.640592
7816,6208349,196,1,0.232425,75,6208936,-1,500.0,6211136,6211332,2787,196,68,0,True,True,2.8425444444444445,-0.232425
7817,6210331,11382,10,0.587469,75,6211136,-1,5000.0,6240707,6252089,30376,11382,38,0,True,True,1404.5955833333333,-0.5759992815301156
7818,6210539,12,2,0.988381,75,6211136,-1,1000.0,6216540,6216552,6001,12,67,1,True,True,0.2943666666666667,-0.988381
7819,6210662,20824,32,0.232606,75,6211136,-1,16000.0,6335160,6355984,124498,20824,10,0,True,True,9468.749155555557,-0.22870940833821465
7820,6210840,189,3,0.616349,75,6211136,-1,1500.0,6217668,6217857,6828,189,51,0,True,True,6.4590749999999995,-0.616349
7821,6210850,9410,4,0.896779,75,6211136,-1,2000.0,6253907,6263317,43057,9410,34,7,True,True,488.70213333333334,-0.8837959390043896
7822,6211134,23,4,0.308849,75,6211136,-1,2000.0,6245107,6245130,33973,23,39,7,True,True,1.3161111111111112,-0.308849
7823,6211443,21,5,0.737913,76,6216536,-1,2500.0,6216540,6216561,5097,21,71,0,True,True,1.2878541666666667,-0.737913
7824,6212544,5,2,0.757246,76,6216536,-1,1000.0,6227207,6227212,14663,5,49,2,True,True,0.13690277777777776,-0.757246
7825,6214784,7,16,0.619766,76,6216536,-1,8000.0,6217657,6217664,2873,7,68,6,True,True,1.2758666666666665,-0.619766
7826,6214847,161,4,0.059923,76,6216536,-1,2000.0,6225368,6225529,10521,161,51,6,True,True,8.816538888888887,-0.059923
7827,6219088,11,1,0.374524,55,6219868,-1,500.0,6249507,6249518,30419,11,36,7,True,True,0.12390277777777778,-0.374524
7828,6223783,10,4,0.296615,55,6224268,-1,2000.0,6276125,6276135,52342,10,29,4,True,True,0.6528333333333334,-0.296615
7829,6224187,10232,4,0.151671,55,6224268,-1,2000.0,6327160,6337392,102973,10232,14,9,True,True,501.8814222222222,-0.13681048847608077
7830,6225090,18531,100,0.204385,55,6225368,-1,50000.0,6363520,6382051,138430,18531,6,8,True,True,25487.19263888889,-0.19376765967384585
7831,6225413,11946,113,0.037907,56,6227207,-1,56500.0,6291025,6302971,65612,11946,26,6,True,True,21556.92273888889,-0.03486189197877858
7832,6226281,9339,64,0.923409,56,6227207,-1,32000.0,6261607,6270946,35326,9339,36,0,True,True,8441.545777777777,-0.9221166612388288
7833,6226847,91,1,0.598075,56,6227207,-1,500.0,6240707,6240798,13860,91,48,7,True,True,1.132823611111111,-0.598075
7834,6232781,8,8,0.945876,56,6235207,-1,4000.0,6256107,6256115,23326,8,39,7,True,True,0.7095111111111111,-0.945876
7835,6234484,38,64,0.739256,56,6235207,-1,32000.0,6261607,6261645,27123,38,36,0,True,True,33.352177777777776,-0.739256
7836,6234645,5418,32,0.32869,56,6235207,-1,16000.0,6261607,6267025,26962,5418,38,0,True,True,2415.0347555555554,-0.32772591013908514
7837,6234774,319,4,0.278126,56,6235207,-1,2000.0,6281925,6282244,47151,319,29,0,True,True,21.568722222222224,-0.2751516405110875
7838,6235408,28813,1,0.643602,56,6236307,-1,500.0,6367920,6396733,132512,28813,4,0,True,True,347.95247638888884,-0.614472733051932
7839,6237416,7,8,0.760494,59,6238507,-1,4000.0,6247307,6247314,9891,7,47,0,True,True,0.6307777777777778,-0.760494
7840,6237461,1018,1,0.520873,59,6238507,-1,500.0,6272525,6273543,35064,1018,35,7,True,True,15.275655555555558,-0.520873
7841,6237706,12201,1,0.977568,59,6238507,-1,500.0,6269225,6281426,31519,12201,37,7,True,True,192.99986388888888,-0.9699395900561444
7842,6237799,10444,14,0.648046,59,6238507,-1,7000.0,6261607,6272051,23808,10444,40,0,True,True,2076.7188944444447,-0.633469439981304
7843,6237848,14170,2,0.288455,59,6238507,-1,1000.0,6365720,6379890,127872,14170,7,7,True,True,378.92258333333336,-0.27135265010687565
7844,6239963,212,2,0.023693,61,6240707,-1,1000.0,6287725,6287937,47762,212,30,2,True,True,7.109655555555555,-0.023693
7845,6240057,14,1,0.846935,61,6240707,-1,500.0,6242907,6242921,2850,14,57,0,True,True,0.20027777777777778,-0.846935
7846,6240278,19618,2,0.33127,61,6240707,-1,1000.0,6352320,6371938,112042,19618,11,6,True,True,563.4503,-0.32767523774750573
7847,6241516,23,1,0.242249,62,6242907,-1,500.0,6261607,6261630,20091,23,44,0,True,True,0.3154194444444444,-0.242249
7848,6242557,54,4,0.539312,62,6242907,-1,2000.0,6261607,6261661,19050,54,44,0,True,True,2.9621999999999997,-0.539312
7849,6242604,9233,64,0.906632,62,6242907,-1,32000.0,6351220,6360453,108616,9233,12,7,True,True,8718.03671111111,-0.8903834989634138
7850,6242942,14832,119,0.665006,65,6245107,-1,59500.0,6349020,6363852,106078,14832,13,7,True,True,26198.609616666665,-0.6545740990095306
7851,6244121,9,64,0.248338,65,6245107,-1,32000.0,6293225,6293234,49104,9,31,7,True,True,10.524000000000001,-0.248338
7852,6244172,10,8,0.68735,65,6245107,-1,4000.0,6245107,6245117,935,10,61,0,True,True,1.1444444444444446,-0.68735
7853,6244213,24,1,0.719502,65,6245107,-1,500.0,6251707,6251731,7494,24,56,0,True,True,0.26356666666666667,-0.719502
7854,6244275,3,8,0.608063,65,6245107,-1,4000.0,6259407,6259410,15132,3,53,6,True,True,0.334,-0.608063
4420,3599033,10,8,0.121962,1,3599033,-1,4000.0,3601659,3601243,2626,10,0,7,True,True,0.8979999999999999,-0.121962
4421,3601659,10,1,0.768146,1,3601659,-1,500.0,3603859,3603869,2200,10,0,7,True,True,0.11915277777777779,-0.768146
4422,3601907,6031,4,0.248962,5,3603859,-1,2000.0,3642227,3648258,40320,6031,0,7,True,True,308.53340555555553,-0.24508300715834486
4423,3601977,9968,128,0.771225,5,3603859,-1,64000.0,3606059,3616027,4082,9968,1,7,True,True,17430.051733333334,-0.7541471554316478
4424,3602335,9031,2,0.442961,5,3603859,-1,1000.0,3755910,3764941,153575,9031,0,0,True,True,204.6408416666667,-0.43995294969448023
4425,3602647,10350,1,0.737619,5,3603859,-1,500.0,3633427,3643777,30780,10350,2,7,True,True,128.65669027777778,-0.729439470604714
4426,3602663,886,8,0.03351,5,3603859,-1,4000.0,3652127,3653013,49464,886,1,6,True,True,92.10462222222222,-0.03351
4427,3604547,6,6,0.460835,15,3606059,-1,3000.0,3612704,3612710,8157,6,4,1,True,True,0.518,-0.460835
4428,3604641,1145,32,0.770996,15,3606059,-1,16000.0,3611559,3612704,6918,1145,5,6,True,True,527.2088888888889,-0.770996
4429,3604922,15,1,0.521139,15,3606059,-1,500.0,3654327,3654342,49405,15,1,7,True,True,0.2156875,-0.521139
4430,3604995,7,4,0.982116,15,3606059,-1,2000.0,3607159,3607166,2164,7,7,6,True,True,0.3336277777777778,-0.982116
4431,3605014,40369,50,0.472826,15,3606059,-1,25000.0,3689785,3730154,84771,40369,1,2,True,True,27519.049027777775,-0.4585601022508624
4432,3605223,9932,1,0.681442,15,3606059,-1,500.0,3607159,3617091,1936,9932,8,0,True,True,138.02945138888887,-0.6777713649202434
4433,3605492,4812,256,0.312109,15,3606059,-1,128000.0,3684951,3689763,79459,4812,2,7,True,True,19472.856533333335,-0.30030275976871984
4434,3605570,579,4,0.323063,15,3606059,-1,2000.0,3644427,3645006,38857,579,5,7,True,True,29.32313333333333,-0.323063
4435,3605841,241,2,0.629164,15,3606059,-1,1000.0,3608259,3608500,2418,241,10,0,True,True,6.412608333333334,-0.629164
4436,3605933,11431,2,0.042186,15,3606059,-1,1000.0,3668830,3680261,62897,11431,3,0,True,True,364.46879722222224,-0.03784344610436191
4437,3606018,184,16,0.937421,15,3606059,-1,8000.0,3608259,3608443,2241,184,12,6,True,True,39.16746666666667,-0.937421
4438,3606157,43,1,0.520926,15,3607159,-1,500.0,3613810,3613853,7653,43,9,6,True,True,0.6187222222222222,-0.520926
4439,3607787,11,8,0.253313,19,3608259,-1,4000.0,3656553,3656564,48766,11,4,1,True,True,1.2653666666666668,-0.253313
4440,3607835,3669,32,0.63852,19,3608259,-1,16000.0,3658753,3662422,50918,3669,4,7,True,True,1654.0371111111112,-0.6362838667269131
4441,3607893,10395,32,0.198724,19,3608259,-1,16000.0,3630127,3640522,22234,10395,11,9,True,True,4094.011555555556,-0.1965482238115286
4442,3607918,131,4,0.88752,19,3608259,-1,2000.0,3610459,3610590,2541,131,15,7,True,True,6.971383333333334,-0.88752
4443,3608069,9617,128,0.863658,19,3608259,-1,64000.0,3805291,3814908,197222,9617,0,7,True,True,13569.267022222222,-0.8629532415160353
4444,3608142,45,4,0.217788,19,3608259,-1,2000.0,3667558,3667603,59416,45,5,7,True,True,2.228,-0.217788
4445,3609215,18897,5,0.112928,21,3610459,-1,2500.0,3886115,3905012,276900,18897,0,0,True,True,1083.260375,-0.11169908127499617
4446,3609235,6,16,0.632909,21,3610459,-1,8000.0,3612710,3612716,3475,6,16,1,True,True,1.3813333333333333,-0.632909
4447,3609295,102,1,0.324513,21,3610459,-1,500.0,3631227,3631329,21932,102,14,6,True,True,1.253183333333333,-0.324513
4448,3609324,52,1,0.16736,21,3610459,-1,500.0,3659853,3659905,50529,52,7,0,True,True,0.73125,-0.16736
4449,3612264,97,32,0.2761,20,3612704,-1,16000.0,3651027,3651124,38763,97,12,7,True,True,40.33475555555555,-0.2761
4450,3612998,3,8,0.11965,21,3613810,-1,4000.0,3647727,3647730,34729,3,13,7,True,True,0.3171666666666667,-0.11965
4451,3613280,117,16,0.789144,21,3613810,-1,8000.0,3619210,3619327,5930,117,19,8,True,True,23.4052,-0.789144
4452,3613362,13488,8,0.00893,21,3613810,-1,4000.0,3856968,3870456,243606,13488,1,6,True,True,1376.1573333333333,-0.008917589378943188
4453,3614472,25974,8,0.041993,34,3619210,-1,4000.0,3689776,3715750,75304,25974,5,0,True,True,2940.342444444445,-0.040003138813181786
4454,3614510,5239,4,0.783475,34,3619210,-1,2000.0,3640027,3645266,25517,5239,18,7,True,True,264.88554999999997,-0.7828453335366888
4455,3614555,18,32,0.475271,34,3619210,-1,16000.0,3648827,3648845,34272,18,15,6,True,True,7.612000000000001,-0.475271
4456,3614578,139,1,0.596212,34,3619210,-1,500.0,3631227,3631366,16649,139,21,0,True,True,1.7077694444444442,-0.596212
4457,3614804,416,16,0.371399,34,3619210,-1,8000.0,3619327,3619743,4523,416,24,1,True,True,83.21848888888888,-0.371399
4458,3615033,9,8,0.08948,34,3619210,-1,4000.0,3634527,3634536,19494,9,20,6,True,True,0.8745,-0.08948
4459,3615173,17,14,0.157698,34,3619210,-1,7000.0,3636727,3636744,21554,17,20,7,True,True,2.9515305555555558,-0.157698
4460,3615213,396,1,0.091402,34,3619210,-1,500.0,3662053,3662449,46840,396,9,0,True,True,5.599,-0.091402
4461,3615711,16582,256,0.618645,34,3619210,-1,128000.0,4070803,4087385,455092,16582,0,6,True,True,55099.43644444444,-0.6133774137748392
4462,3615813,15389,16,0.930849,34,3619210,-1,8000.0,3663153,3678542,47340,15389,10,0,True,True,3558.980577777778,-0.903340675320906
4463,3615840,28,1,0.996973,34,3619210,-1,500.0,3631227,3631255,15387,28,27,0,True,True,0.3440111111111111,-0.996973
4464,3615880,7607,32,0.625132,34,3619210,-1,16000.0,3637827,3645434,21947,7607,23,6,True,True,3063.282711111111,-0.6228237233707314
4465,3615923,14759,32,0.059775,34,3619210,-1,16000.0,3665358,3680117,49435,14759,10,1,True,True,7110.652133333333,-0.05435367910761208
4466,3615992,10,32,0.644575,34,3619210,-1,16000.0,3631227,3631237,15235,10,30,0,True,True,3.9315555555555552,-0.644575
4467,3627860,12820,256,0.701328,40,3630127,-1,128000.0,3914825,3927645,286965,12820,1,3,True,True,43326.1511111111,-0.6624257595974791
4468,3628129,6,4,0.791466,40,3630127,-1,2000.0,3631227,3631233,3098,6,32,0,True,True,0.29486666666666667,-0.791466
4469,3628218,19,32,0.125827,40,3630127,-1,16000.0,3662053,3662072,33835,19,14,7,True,True,8.596444444444444,-0.125827
4470,3628580,26,4,0.232675,40,3630127,-1,2000.0,3656527,3656553,27947,26,18,7,True,True,1.4954333333333332,-0.232675
4471,3628688,27,16,0.981676,40,3630127,-1,8000.0,3634527,3634554,5839,27,29,0,True,True,5.247,-0.981676
4472,3628874,34,4,0.788562,40,3630127,-1,2000.0,3631227,3631261,2353,34,36,0,True,True,1.670911111111111,-0.788562
4473,3628952,22,8,0.756698,40,3630127,-1,4000.0,3630127,3630149,1175,22,38,0,True,True,2.1623555555555556,-0.756698
4474,3628991,27,1,0.805525,40,3630127,-1,500.0,3631227,3631254,2236,27,32,0,True,True,0.33172499999999994,-0.805525
4475,3641283,24,10,0.438719,27,3642227,-1,5000.0,3645527,3645551,4244,24,24,6,True,True,3.0386666666666664,-0.438719
4476,3641363,6696,4,0.192965,27,3642227,-1,2000.0,3707074,3713770,65711,6696,6,0,True,True,322.17897777777773,-0.18340877790220858
4477,3643034,67,1,0.68925,28,3644427,-1,500.0,3659853,3659920,16819,67,17,6,True,True,0.9421875,-0.68925
4478,3643821,17,8,0.358167,28,3644427,-1,4000.0,3674630,3674647,30809,17,10,0,True,True,2.2859333333333334,-0.358167
4479,3659990,2,4,0.134732,34,3662053,-1,2000.0,3691059,3691061,31069,2,7,2,True,True,0.12814444444444445,-0.134732
4480,3660044,204,25,0.898663,34,3662053,-1,12500.0,3668830,3669034,8786,204,13,0,True,True,62.524583333333325,-0.898663
4481,3660260,7004,128,0.485302,34,3662053,-1,64000.0,3814908,3821912,154648,7004,4,1,True,True,9764.740266666666,-0.4742326192616579
4482,3660679,5,16,0.4375,34,3662053,-1,8000.0,3665353,3665358,4674,5,17,0,True,True,0.9902222222222223,-0.4375
4483,3660746,5,1,0.294715,34,3662053,-1,500.0,3700753,3700758,40007,5,8,6,True,True,0.07844444444444444,-0.294715
4484,3660784,140,34,0.697038,34,3662053,-1,17000.0,3690919,3691059,30135,140,10,0,True,True,76.24594444444445,-0.697038
4485,3660860,9450,32,0.189776,34,3662053,-1,16000.0,3732712,3742162,71852,9450,7,0,True,True,3903.196888888889,-0.18336702283526118
4486,3661028,773,1,0.186627,34,3662053,-1,500.0,3690936,3691709,29908,773,11,1,True,True,12.381956944444445,-0.186627
4487,3661037,3,2,0.347665,34,3662053,-1,1000.0,3668665,3668668,7628,3,19,0,True,True,0.07355833333333334,-0.347665
4488,3661057,9,16,0.732402,34,3662053,-1,8000.0,3665353,3665362,4296,9,23,7,True,True,1.7824000000000002,-0.732402
4489,3661097,2714,1,0.275324,34,3662053,-1,500.0,3689763,3692477,28666,2714,15,0,True,True,43.32389027777777,-0.2743796380436875
4490,3661187,11,16,0.83135,34,3662053,-1,8000.0,3667558,3667569,6371,11,21,0,True,True,2.178488888888889,-0.83135
4491,3661202,4,6,0.914474,34,3662053,-1,3000.0,3663153,3663157,1951,4,27,6,True,True,0.3393333333333333,-0.914474
4492,3661241,8,1,0.55452,34,3662053,-1,500.0,3663153,3663161,1912,8,27,0,True,True,0.1131111111111111,-0.55452
4493,3661274,20842,1,0.068877,34,3662053,-1,500.0,3727312,3748154,66038,20842,8,4,True,True,271.51669166666665,-0.06832244652118541
4494,3661337,35594,16,0.155025,34,3662053,-1,8000.0,3689800,3725394,28463,35594,14,1,True,True,7840.135111111113,-0.15049056867378863
4495,3661440,101,8,0.295673,34,3662053,-1,4000.0,3675836,3675937,14396,101,19,0,True,True,13.716922222222223,-0.295673
4496,3661501,63,1,0.263349,34,3662053,-1,500.0,3689763,3689826,28262,63,18,0,True,True,0.9695,-0.263349
4497,3662111,8148,64,0.367113,35,3663153,-1,32000.0,3689776,3697924,27665,8148,17,0,True,True,8567.415466666667,-0.3669288035635711
4498,3662159,5579,4,0.00072,35,3663153,-1,2000.0,3678542,3684121,16383,5579,21,0,True,True,428.4829722222222,-0.0007182531218554983
4499,3662220,11570,1,0.638026,35,3663153,-1,500.0,3780634,3792204,118414,11570,6,0,True,True,150.68391666666668,-0.6353712510157122
4500,3663788,609,1,0.379044,52,3665353,-1,500.0,3674630,3675239,10842,609,25,5,True,True,10.236275,-0.379044
4501,3663875,76,8,0.185534,52,3665353,-1,4000.0,3689763,3689839,25888,76,19,0,True,True,9.356444444444444,-0.185534
4502,3663967,14665,10,0.01872,52,3665353,-1,5000.0,3770432,3785097,106465,14665,7,6,True,True,1880.7279444444446,-0.01828939473722184
4503,3664153,27,2,0.856829,52,3665353,-1,1000.0,3667558,3667585,3405,27,31,0,True,True,0.6684,-0.856829
4504,3664169,5448,2,0.776017,52,3665353,-1,1000.0,3674647,3680095,10478,5448,26,1,True,True,190.954225,-0.7045808083590832
4505,3664201,8450,4,0.238787,52,3665353,-1,2000.0,3741653,3750103,77452,8450,9,6,True,True,447.3873222222222,-0.236418020315147
4506,3664343,84,16,0.721004,52,3665353,-1,8000.0,3665353,3665437,1010,84,37,0,True,True,16.635733333333334,-0.721004
4507,3664361,91,1,0.658289,52,3665353,-1,500.0,3676052,3676143,11691,91,26,0,True,True,1.5448513888888888,-0.658289
4508,3664393,22,2,0.538957,52,3665353,-1,1000.0,3678547,3678569,14154,22,25,1,True,True,0.7469611111111112,-0.538957
4509,3664433,6,13,0.387491,52,3665353,-1,6500.0,3690900,3690906,26467,6,17,0,True,True,1.2494083333333335,-0.387491
4510,3664610,111,4,0.52407,52,3665353,-1,2000.0,3676052,3676163,11442,111,29,0,True,True,7.537516666666667,-0.52407
4511,3664644,4,32,0.497549,52,3665353,-1,16000.0,3689763,3689767,25119,4,24,0,True,True,1.9697777777777776,-0.497549
4512,3664668,188,32,0.551468,52,3665353,-1,16000.0,3676052,3676240,11384,188,31,1,True,True,102.12995555555557,-0.551468
4513,3664712,4,8,0.613039,52,3665353,-1,4000.0,3668830,3668834,4118,4,38,2,True,True,0.3923111111111111,-0.613039
4514,3664784,6124,1,0.3226,52,3665353,-1,500.0,3699653,3705777,34869,6124,14,7,True,True,85.94375555555555,-0.3024988581908895
4515,3664816,16150,121,0.640904,52,3665353,-1,60500.0,3929845,3945995,265029,16150,1,7,True,True,27962.261402777778,-0.6324011137019224
4516,3665011,232,32,0.110464,52,3665353,-1,16000.0,3675841,3676073,10830,232,34,1,True,True,126.03271111111111,-0.110464
4517,3665100,33,4,0.523201,52,3665353,-1,2000.0,3675937,3675970,10837,33,34,0,True,True,2.2408833333333336,-0.523201
4518,3665246,165,101,0.06668,52,3665353,-1,50500.0,3668665,3668830,3419,165,44,1,True,True,204.30827083333332,-0.06668
4519,3665281,7,64,0.835193,52,3665353,-1,32000.0,3710674,3710681,45393,7,13,5,True,True,5.536533333333334,-0.835193
4520,3665449,6317,8,0.129774,57,3667558,-1,4000.0,3753710,3760027,88261,6317,10,0,True,True,571.6683888888889,-0.12681554640765005
4521,3665460,328,4,0.873493,57,3667558,-1,2000.0,3668665,3668993,3205,328,45,0,True,True,16.084755555555557,-0.873493
4522,3665924,9014,74,0.202079,57,3667558,-1,37000.0,3675937,3684951,10013,9014,37,2,True,True,12230.04988888889,-0.20199776637998523
4523,3665959,15066,4,0.48537,57,3667558,-1,2000.0,3859168,3874234,193209,15066,4,7,True,True,753.3765888888888,-0.47714011521180794
4524,3665973,7608,3,0.098754,57,3667558,-1,1500.0,3822899,3830507,156926,7608,6,6,True,True,280.56438749999995,-0.09681439096688402
4525,3666177,10056,113,0.571012,57,3667558,-1,56500.0,3718212,3728268,52035,10056,16,0,True,True,14198.685416666667,-0.5506657527344414
4526,3666436,7,1,0.8363,57,3667558,-1,500.0,3668658,3668665,2222,7,52,6,True,True,0.08581805555555555,-0.8363
4527,3667058,8,8,0.657921,57,3667558,-1,4000.0,3675756,3675764,8698,8,43,0,True,True,1.0864888888888888,-0.657921
4528,3667074,37,8,0.525821,57,3667558,-1,4000.0,3675747,3675784,8673,37,44,6,True,True,5.0250111111111115,-0.525821
4529,3668186,12,8,0.701314,58,3668658,-1,4000.0,3676368,3676380,8182,12,36,0,True,True,1.6297333333333335,-0.701314
4530,3668196,39839,1,0.255939,58,3668658,-1,500.0,3990158,4029997,321962,39839,1,7,True,True,667.3908541666667,-0.25574604514814153
4531,3668426,38,4,0.366354,58,3668658,-1,2000.0,3671030,3671068,2604,38,50,7,True,True,1.8634777777777778,-0.366354
4532,3668615,13,64,0.605954,58,3668658,-1,32000.0,3678542,3678555,9927,13,37,0,True,True,14.124355555555555,-0.605954
4533,3668830,23991,4,0.070874,55,3668830,-1,2000.0,3845115,3869106,176285,23991,7,7,True,True,1104.1876,-0.07013673031642828
4534,3668847,12081,256,0.930211,66,3671030,-1,128000.0,4029997,4042078,361150,12081,1,7,True,True,40915.8432,-0.9158888984834375
4535,3668865,5,1,0.208738,66,3671030,-1,500.0,3675836,3675841,6971,5,48,0,True,True,0.08488194444444445,-0.208738
4536,3669374,4541,184,0.491406,66,3671030,-1,92000.0,3734912,3739453,65538,4541,17,7,True,True,10764.142344444444,-0.48005171889125076
4537,3669407,7819,4,0.889767,66,3671030,-1,2000.0,3671030,3678849,1623,7819,55,0,True,True,510.2328722222222,-0.8783668699750274
4538,3669434,2,4,0.079957,66,3671030,-1,2000.0,3690936,3690938,21502,2,26,0,True,True,0.12814444444444445,-0.079957
4539,3669546,5723,2,0.80102,66,3671030,-1,1000.0,3676368,3682091,6822,5723,43,5,True,True,214.661175,-0.78282051735532
4540,3669588,33704,64,0.0607,66,3671030,-1,32000.0,3774834,3808538,105246,33704,13,7,True,True,26855.751111111113,-0.06027354193614679
4541,3669597,10,1,0.55802,66,3671030,-1,500.0,3676042,3676052,6445,10,48,2,True,True,0.1697638888888889,-0.55802
4542,3670045,612,43,0.938244,66,3671030,-1,21500.0,3675756,3676368,5711,612,55,0,True,True,446.75065000000006,-0.938244
4543,3670118,3,16,0.415953,66,3671030,-1,8000.0,3678547,3678550,8429,3,40,0,True,True,0.8148666666666667,-0.415953
4544,3670126,12,8,0.369069,66,3671030,-1,4000.0,3678542,3678554,8416,12,44,2,True,True,1.6297333333333335,-0.369069
4545,3670158,26577,128,0.708434,66,3671030,-1,64000.0,3842915,3869492,172757,26577,9,7,True,True,39002.05706666667,-0.6992224677081357
4546,3670351,9,2,0.823643,66,3671030,-1,1000.0,3675747,3675756,5396,9,59,0,True,True,0.30557500000000004,-0.823643
4547,3670440,3747,1,0.265816,66,3671030,-1,500.0,3718212,3721959,47772,3747,22,0,True,True,47.735283333333335,-0.2511570593943225
4548,3672786,28250,128,0.040653,72,3674630,-1,64000.0,3886115,3914365,213329,28250,6,7,True,True,42578.868444444444,-0.0396139397447112
4549,3672822,13457,128,0.070388,72,3674630,-1,64000.0,3791834,3805291,119012,13457,14,7,True,True,20651.501333333334,-0.0697101430660643
4550,3673201,21313,16,0.303905,72,3674630,-1,8000.0,3890515,3911828,217314,21313,5,7,True,True,4027.1128444444453,-0.30131076893435205
4551,3673565,89,1,0.944603,72,3674630,-1,500.0,3675747,3675836,2182,89,64,0,True,True,1.5108986111111111,-0.944603
4552,3673625,16711,4,0.960587,72,3674630,-1,2000.0,3706360,3723071,32735,16711,29,0,True,True,831.123111111111,-0.9371867372572608
4553,3673741,75,2,0.097119,72,3674630,-1,1000.0,3706394,3706469,32653,75,29,1,True,True,1.9366666666666665,-0.097119
4554,3673762,201,1,0.725172,72,3674630,-1,500.0,3675841,3676042,2079,201,60,0,True,True,3.4122541666666666,-0.725172
4555,3673920,5,1,0.531661,72,3674630,-1,500.0,3678542,3678547,4622,5,50,0,True,True,0.08488194444444445,-0.531661
4556,3674946,25,1,0.18946,82,3675747,-1,500.0,3675836,3675861,890,25,65,4,True,True,0.42440972222222223,-0.18946
4557,3674980,12598,32,0.526192,82,3675747,-1,16000.0,3807491,3820089,132511,12598,14,7,True,True,4338.792577777777,-0.5052090198616747
4558,3675045,21116,45,0.248763,82,3675747,-1,22500.0,3821799,3842915,146754,21116,13,6,True,True,11427.2956875,-0.24702156008692958
4559,3675284,288,3,0.625325,82,3675747,-1,1500.0,3675836,3676124,552,288,65,0,True,True,14.6676,-0.6253249999999999
4560,3675406,1649,5,0.178898,82,3675747,-1,2500.0,3753654,3755303,78248,1649,23,0,True,True,95.9712013888889,-0.1765334989599754
4561,3675425,101,1,0.749194,82,3675747,-1,500.0,3676143,3676244,718,101,58,0,True,True,1.714615277777778,-0.749194
4562,3675572,12,2,0.415185,82,3675747,-1,1000.0,3676143,3676155,571,12,59,3,True,True,0.40743333333333337,-0.415185
4563,3675590,8667,16,0.105514,82,3675747,-1,8000.0,3721512,3730179,45922,8667,28,7,True,True,1726.5403333333334,-0.10296882594113584
4564,3675622,29,12,0.638624,82,3675747,-1,6000.0,3675756,3675785,134,29,75,1,True,True,5.907783333333334,-0.638624
4565,3675637,7754,128,0.357963,82,3675747,-1,64000.0,3869492,3877246,193855,7754,8,7,True,True,10901.197866666667,-0.3221013302670193
4566,3675654,189,32,0.458721,82,3675747,-1,16000.0,3678542,3678731,2888,189,55,0,True,True,102.6732,-0.458721
4567,3675688,10761,1,0.665242,82,3675747,-1,500.0,3823999,3834760,148311,10761,13,0,True,True,134.35293611111112,-0.6618606537349603
4568,3675741,8744,4,0.882824,82,3675747,-1,2000.0,3690906,3699650,15165,8744,43,1,True,True,571.9416777777777,-0.8809865244917463
4569,3675872,9308,1,0.166809,72,3675937,-1,500.0,3752554,3761862,76682,9308,26,6,True,True,105.36873333333332,-0.16522255138973133
4570,3675903,11829,72,0.180397,72,3675937,-1,36000.0,3706383,3718212,30480,11829,37,0,True,True,10516.884,-0.1744265217870982
4571,3676012,238,1,0.401557,72,3676042,-1,500.0,3697453,3697691,21441,238,41,1,True,True,3.7339555555555553,-0.401557
4572,3676024,33,8,0.337513,72,3676042,-1,4000.0,3693259,3693292,17235,33,42,6,True,True,4.228766666666667,-0.337513
4573,3676082,23,5,0.158176,71,3676143,-1,2500.0,3694515,3694538,18433,23,42,4,True,True,1.961229166666667,-0.15817600000000004
4574,3676130,45,1,0.998434,71,3676143,-1,500.0,3676155,3676200,25,45,68,1,True,True,0.7639375,-0.998434
4575,3676133,2356,2,0.443012,71,3676143,-1,1000.0,3692159,3694515,16026,2356,44,6,True,True,77.3731611111111,-0.4265500979579058
4576,3676184,230,8,0.352324,69,3676368,-1,4000.0,3690919,3691149,14735,230,49,2,True,True,29.47322222222222,-0.352324
4577,3677867,53,45,0.315155,78,3678542,-1,22500.0,3689763,3689816,11896,53,60,0,True,True,36.7025,-0.315155
4578,3677893,32,1,0.991463,78,3678542,-1,500.0,3678542,3678574,649,32,67,0,True,True,0.5432444444444444,-0.991463
4579,3677973,1043,1,0.324654,78,3678542,-1,500.0,3719312,3720355,41339,1043,32,6,True,True,13.136005555555556,-0.324654
4580,3677995,13208,38,0.37172,78,3678542,-1,19000.0,3808591,3821799,130596,13208,17,6,True,True,5419.5596305555555,-0.3588611605062706
4581,3678079,1889,4,0.764184,78,3678542,-1,2000.0,3678542,3680431,463,1889,68,0,True,True,145.60333888888889,-0.7184751379470773
4582,3678090,14913,128,0.430588,78,3678542,-1,64000.0,3973045,3987958,294955,14913,3,11,True,True,24806.73368888889,-0.42335248228774425
4583,3678108,13165,16,0.725868,78,3678542,-1,8000.0,3689763,3702928,11655,13165,62,0,True,True,3341.4913777777774,-0.7152796973204275
4584,3678125,7,4,0.608413,78,3678542,-1,2000.0,3690900,3690907,12775,7,55,0,True,True,0.44850555555555555,-0.608413
4585,3678176,6,37,0.563145,78,3678542,-1,18500.0,3696343,3696349,18167,6,45,3,True,True,3.7860250000000004,-0.563145
4586,3678377,8869,256,0.213928,78,3678542,-1,128000.0,3877246,3886115,198869,8869,9,7,True,True,22254.085688888892,-0.20518402220001566
4587,3678440,12027,210,0.765708,78,3678542,-1,105000.0,3987958,3999985,309518,12027,3,8,True,True,34118.2415,-0.6936272412064425
4588,3679211,14,64,0.926147,89,3684951,-1,32000.0,3689763,3689777,10552,14,67,0,True,True,13.788444444444444,-0.926147
4589,3679280,44,128,0.254089,89,3684951,-1,64000.0,3745253,3745297,65973,44,31,3,True,True,75.95377777777777,-0.254089
4590,3679312,4,1,0.961652,89,3684951,-1,500.0,3689763,3689767,10451,4,69,0,True,True,0.06155555555555555,-0.961652
4591,3679372,7906,32,0.4475,89,3684951,-1,16000.0,3755910,3763816,76538,7906,28,7,True,True,2852.6034666666665,-0.44035474042710293
4592,3680172,1984,32,0.397091,89,3684951,-1,16000.0,3694359,3696343,14187,1984,51,0,True,True,1082.7349333333334,-0.397091
4593,3680281,13,14,0.726313,89,3684951,-1,7000.0,3689763,3689776,9482,13,74,0,True,True,2.800777777777778,-0.726313
4594,3680922,11742,86,0.982956,89,3684951,-1,43000.0,3850014,3861756,169092,11742,14,4,True,True,11540.647449999999,-0.9605680382453622
4595,3681024,1300,8,0.595763,89,3684951,-1,4000.0,3694359,3695659,13335,1300,52,0,True,True,177.36333333333334,-0.595763
4596,3681070,19,1,0.517609,89,3684951,-1,500.0,3689776,3689795,8706,19,67,0,True,True,0.29238888888888886,-0.517609
4597,3681095,23,32,0.993412,89,3684951,-1,16000.0,3706360,3706383,25265,23,47,6,True,True,9.502577777777777,-0.993412
4598,3681213,5,32,0.301842,89,3684951,-1,16000.0,3689795,3689800,8582,5,66,1,True,True,2.462222222222222,-0.301842
4599,3681391,13,8,0.300334,89,3684951,-1,4000.0,3704160,3704173,22769,13,48,0,True,True,1.4493555555555555,-0.300334
4600,3681904,3459,4,0.221887,89,3684951,-1,2000.0,3723712,3727171,41808,3459,38,7,True,True,170.24311666666665,-0.21528066191114525
4601,3682096,13849,4,0.85572,89,3684951,-1,2000.0,3697443,3711292,15347,13849,53,6,True,True,760.0049333333334,-0.8520904545752119
4602,3682167,19827,32,0.021701,89,3684951,-1,16000.0,3764910,3784737,82743,19827,28,8,True,True,7885.292,-0.02114837650788359
4603,3682283,6,1,0.82194,89,3684951,-1,500.0,3689763,3689769,7480,6,84,6,True,True,0.09233333333333334,-0.82194
4604,3682525,22,32,0.689719,89,3684951,-1,16000.0,3689763,3689785,7238,22,79,0,True,True,10.833777777777778,-0.689719
4605,3682574,13,1,0.275957,89,3684951,-1,500.0,3704160,3704173,21586,13,51,1,True,True,0.18116944444444444,-0.275957
4606,3682589,3,4,0.553663,89,3684951,-1,2000.0,3689763,3689766,7174,3,81,0,True,True,0.18466666666666667,-0.553663
4607,3683826,2914,1,0.556323,89,3684951,-1,500.0,3704160,3707074,20334,2914,51,0,True,True,37.86897777777778,-0.5187754904933385
4608,3685104,2,1,0.925922,97,3689763,-1,500.0,3689763,3689765,4659,2,80,0,True,True,0.030777777777777775,-0.925922
4609,3688341,561,1,0.154715,97,3689763,-1,500.0,3721512,3722073,33171,561,40,0,True,True,7.065483333333334,-0.154715
4610,3688365,19295,64,0.037736,97,3689763,-1,32000.0,3820089,3839384,131724,19295,20,7,True,True,15055.233955555555,-0.037678127828900676
4611,3688398,12603,8,0.355656,97,3689763,-1,4000.0,3715074,3727677,26676,12603,46,7,True,True,1282.2153666666666,-0.3529596157466192
4612,3688772,56,1,0.138408,97,3689763,-1,500.0,3753654,3753710,64882,56,34,6,True,True,0.6605666666666667,-0.138408
4613,3688871,53,8,0.367083,97,3689763,-1,4000.0,3694359,3694412,5488,53,65,0,True,True,7.230966666666666,-0.367083
4614,3688977,11,8,0.582156,97,3689763,-1,4000.0,3694359,3694370,5382,11,63,0,True,True,1.5007666666666668,-0.582156
4615,3689104,7367,16,0.232994,97,3689763,-1,8000.0,3689763,3697130,659,7367,94,0,True,True,1944.214,-0.2327706998804205
4616,3689453,19,1,0.811074,97,3689763,-1,500.0,3690900,3690919,1447,19,77,6,True,True,0.3043430555555556,-0.811074
4617,3690701,14513,16,0.091905,81,3690900,-1,8000.0,3759510,3774023,68809,14513,30,1,True,True,2690.689577777778,-0.08963159551534827
4618,3690792,149,32,0.399798,81,3690900,-1,16000.0,3712874,3713023,22082,149,49,7,True,True,52.95128888888889,-0.399798
4619,3690846,16952,256,0.917882,81,3690900,-1,128000.0,4053851,4070803,363005,16952,1,7,True,True,58143.91004444444,-0.9157132854269086
4620,3690876,21615,64,0.734266,81,3690900,-1,32000.0,3828399,3850014,137523,21615,18,7,True,True,15661.853599999999,-0.7201626717848212
4621,3690903,30,8,0.723581,79,3690906,-1,4000.0,3690906,3690936,3,30,78,0,True,True,3.844333333333333,-0.723581
4622,3691207,140,16,0.792904,75,3692159,-1,8000.0,3694362,3694502,3155,140,67,0,True,True,38.20133333333334,-0.792904
4623,3691710,20607,32,0.172902,75,3692159,-1,16000.0,3823999,3844606,132289,20607,20,6,True,True,7884.927466666667,-0.17206458947288072
4624,3691896,6844,35,0.825705,75,3692159,-1,17500.0,3753710,3760554,61814,6844,36,0,True,True,2704.8408333333336,-0.8069978012516622
4625,3692532,17,8,0.689595,79,3693259,-1,4000.0,3697443,3697460,4911,17,66,0,True,True,2.133688888888889,-0.689595
4626,3692654,1207,32,0.576232,79,3693259,-1,16000.0,3702953,3704160,10299,1207,63,7,True,True,538.2683555555556,-0.576232
4627,3692800,10,1,0.907656,79,3693259,-1,500.0,3697443,3697453,4643,10,68,0,True,True,0.15688888888888888,-0.907656
4628,3692903,3,12,0.595231,79,3693259,-1,6000.0,3694359,3694362,1456,3,77,6,True,True,0.61395,-0.595231
4629,3693006,11,21,0.300393,79,3693259,-1,10500.0,3706383,3706394,13377,11,58,1,True,True,2.9824666666666664,-0.300393
4630,3699045,8653,32,0.730789,73,3699653,-1,16000.0,3826199,3834852,127154,8653,19,7,True,True,3468.532533333333,-0.7263222872180586
4631,3699066,22116,32,0.576284,73,3699653,-1,16000.0,3834852,3856968,135786,22116,18,2,True,True,7583.986666666667,-0.5553252012007054
4632,3699271,21,1,0.078477,73,3699653,-1,500.0,3747471,3747492,48200,21,43,0,True,True,0.28320833333333334,-0.078477
4633,3699282,111,18,0.055923,73,3699653,-1,9000.0,3732712,3732823,33430,111,48,8,True,True,25.776975000000004,-0.055923
4634,3699352,13,4,0.770902,73,3699653,-1,2000.0,3705260,3705273,5908,13,65,6,True,True,0.6713777777777777,-0.770902
4635,3699478,11,4,0.34793,73,3699653,-1,2000.0,3715750,3715761,16272,11,56,1,True,True,0.5948555555555556,-0.34793
4636,3699527,13020,12,0.817142,73,3699653,-1,6000.0,3766010,3779030,66483,13020,34,6,True,True,1894.4305,-0.8102345452147804
4637,3700163,6,11,0.416522,73,3700753,-1,5500.0,3732712,3732718,32549,6,48,0,True,True,0.8514916666666666,-0.416522
4638,3701086,44,32,0.867831,75,3702953,-1,16000.0,3740553,3740597,39467,44,47,6,True,True,19.0256,-0.867831
4639,3701224,130,1,0.869787,75,3702953,-1,500.0,3704160,3704290,2936,130,72,0,True,True,1.8116944444444443,-0.869787
4640,3701346,187,32,0.226718,75,3702953,-1,16000.0,3707074,3707261,5728,187,64,2,True,True,77.26008888888889,-0.226718
4641,3712058,24,36,0.652779,63,3712874,-1,18000.0,3748154,3748178,36096,24,44,5,True,True,10.902000000000001,-0.652779
4642,3712151,13959,64,0.602302,63,3712874,-1,32000.0,3739453,3753412,27302,13959,49,0,True,True,11615.21128888889,-0.5888919988370385
4643,3714914,7407,9,0.011434,63,3715074,-1,4500.0,3780634,3788041,65720,7407,32,7,True,True,893.709625,-0.01136767148962575
4644,3715223,18,16,0.777419,65,3715750,-1,8000.0,3718212,3718230,2989,18,60,0,True,True,3.8936,-0.777419
4645,3715324,18,16,0.382487,65,3715750,-1,8000.0,3747453,3747471,32129,18,47,7,True,True,3.884,-0.382487
4646,3715542,5,8,0.304783,65,3715750,-1,4000.0,3737112,3737117,21570,5,52,7,True,True,0.5396111111111112,-0.304783
4647,3720730,18,16,0.041182,62,3721512,-1,8000.0,3767110,3767128,46380,18,35,6,True,True,3.2692,-0.041182
4648,3720939,56,4,0.53993,62,3721512,-1,2000.0,3737112,3737168,16173,56,53,0,True,True,3.021822222222222,-0.53993
4649,3721655,12,1,0.14958,64,3723712,-1,500.0,3747476,3747488,25821,12,47,1,True,True,0.16183333333333333,-0.14958
4650,3723113,108,2,0.502402,64,3723712,-1,1000.0,3739312,3739420,16199,108,54,0,True,True,2.9139,-0.502402
4651,3723509,38,1,0.220797,64,3723712,-1,500.0,3778434,3778472,54925,38,33,1,True,True,0.4840777777777778,-0.220797
4652,3723658,819,1,0.05052,64,3723712,-1,500.0,3748154,3748973,24496,819,47,0,True,True,10.3341875,-0.05052
4653,3723949,12732,20,0.731579,65,3727312,-1,10000.0,3740553,3753285,16604,12732,54,0,True,True,3302.938,-0.7304173426207858
4654,3724018,394,4,0.392883,65,3727312,-1,2000.0,3751454,3751848,27436,394,47,6,True,True,18.590233333333334,-0.392883
4655,3733006,4,16,0.445616,63,3734912,-1,8000.0,3739312,3739316,6306,4,59,7,True,True,0.8633777777777777,-0.445616
4656,3733414,122,4,0.595132,63,3734912,-1,2000.0,3747453,3747575,14039,122,52,0,True,True,6.581222222222222,-0.595132
4657,3736777,71,3,0.504729,64,3737112,-1,1500.0,3772634,3772705,35857,71,35,0,True,True,2.4802666666666666,-0.504729
4658,3736867,291,2,0.222086,64,3737112,-1,1000.0,3772634,3772925,35767,291,35,0,True,True,7.076719444444445,-0.21026249554847734
4659,3737473,40,1,0.289783,66,3739312,-1,500.0,3789634,3789674,52161,40,31,8,True,True,0.4947777777777778,-0.289783
4660,3737586,14,4,0.394322,66,3739312,-1,2000.0,3769332,3769346,31746,14,39,1,True,True,0.6520888888888889,-0.394322
4661,3737606,16503,3,0.132189,66,3739312,-1,1500.0,3888315,3904818,150709,16503,9,7,True,True,569.6935249999999,-0.13104703528838482
4662,3737796,274,12,0.082545,66,3739312,-1,6000.0,3778434,3778708,40638,274,35,0,True,True,41.885466666666666,-0.082545
4663,3740770,18193,1,0.571441,66,3741653,-1,500.0,3892715,3910908,151945,18193,8,7,True,True,215.86058055555554,-0.5666692843352079
4664,3740870,2,4,0.049311,66,3741653,-1,2000.0,3772632,3772634,31762,2,41,7,True,True,0.09315555555555556,-0.049311
4665,3740946,4650,1,0.399191,66,3741653,-1,500.0,3816008,3820658,75062,4650,28,6,True,True,50.00991666666667,-0.3783565164356842
4666,3741105,22,1,0.085079,66,3741653,-1,500.0,3769310,3769332,28205,22,45,7,True,True,0.2561777777777778,-0.085079
4667,3741132,20,4,0.501823,66,3741653,-1,2000.0,3753710,3753730,12578,20,54,1,True,True,0.9436666666666668,-0.501823
4668,3741765,21010,1,0.773825,73,3745253,-1,500.0,3893815,3914825,152050,21010,8,6,True,True,254.1009375,-0.7603418365425421
4669,3741794,1379,32,0.130375,73,3745253,-1,16000.0,3750354,3751733,8560,1379,60,7,True,True,542.7857333333333,-0.1270913713266415
4670,3741818,8052,16,0.134871,73,3745253,-1,8000.0,3784234,3792286,42416,8052,36,3,True,True,1657.2136444444445,-0.13367658212910874
4671,3742130,11773,256,0.559296,73,3745253,-1,128000.0,4042078,4053851,299948,11773,2,8,True,True,44060.69795555556,-0.5548401736919655
4672,3742226,27737,2,0.487861,73,3745253,-1,1000.0,3927645,3955382,185419,27737,8,7,True,True,782.7467805555555,-0.48569438632102446
4673,3744910,24,1,0.652248,73,3745253,-1,500.0,3747471,3747495,2561,24,67,0,True,True,0.32366666666666666,-0.652248
4674,3745166,37,4,0.196099,73,3745253,-1,2000.0,3772634,3772671,27468,37,46,1,True,True,1.723377777777778,-0.196099
4675,3745225,5,16,0.615997,73,3745253,-1,8000.0,3747471,3747476,2246,5,70,1,True,True,1.0788888888888888,-0.615997
8402,6658550,8,1,0.126368,1,6658550,-1,500.0,6659967,6659658,1417,8,0,6,True,True,0.13603333333333334,-0.126368
8403,6659967,7085,8,0.378801,1,6659967,-1,4000.0,6662167,6669252,2200,7085,0,7,True,True,2070.6199333333334,-0.337196850734474
8404,6661077,2266,32,0.735422,1,6662167,-1,16000.0,6664367,6666633,3290,2266,0,7,True,True,2785.568622222222,-0.735422
8405,6662693,92,1,0.052865,4,6664367,-1,500.0,6693967,6694059,31274,92,0,7,True,True,2.811366666666667,-0.052865
8406,6663607,6,2,0.725419,4,6664367,-1,1000.0,6666567,6666573,2960,6,1,7,True,True,0.4609833333333333,-0.725419
8407,6663928,2959,64,0.9745,4,6664367,-1,32000.0,6668767,6671726,4839,2959,1,0,True,True,8169.796355555556,-0.964693193336091
8408,6664109,6,4,0.707502,4,6664367,-1,2000.0,6668767,6668773,4658,6,2,7,True,True,1.0459,-0.707502
8409,6667408,18,2,0.249112,4,6668767,-1,1000.0,6714875,6714893,47467,18,0,7,True,True,1.0738,-0.249112
8410,6667915,35,1,0.608703,4,6668767,-1,500.0,6670967,6671002,3052,35,2,7,True,True,1.4762222222222223,-0.608703
8411,6669820,3,1,0.706787,8,6670967,-1,500.0,6670967,6670970,1147,3,2,0,True,True,0.12653333333333333,-0.706787
8412,6670131,6799,2,0.183105,8,6670967,-1,1000.0,6748163,6754962,78032,6799,0,7,True,True,81.37269722222223,-0.18002289863438373
8413,6670278,21978,2,0.986246,8,6670967,-1,1000.0,6718177,6740155,47899,21978,1,0,True,True,393.3864055555556,-0.9231931890108509
8414,6670422,210,2,0.798469,8,6670967,-1,1000.0,6672067,6672277,1645,210,4,6,True,True,17.714666666666666,-0.798469
8415,6670615,22390,152,0.502229,8,6670967,-1,76000.0,6806542,6828932,135927,22390,0,1,True,True,22351.80393333333,-0.45995997774882713
8416,6670823,31,18,0.275823,8,6670967,-1,9000.0,6675367,6675398,4544,31,5,6,True,True,21.317925,-0.275823
8417,6671262,315,2,0.427765,10,6672067,-1,1000.0,6680867,6681182,9605,315,5,6,True,True,21.72975,-0.427765
8418,6671303,2,60,0.941677,10,6672067,-1,30000.0,6725065,6725067,53762,2,2,0,True,True,0.6935,-0.941677
8419,6671362,5,8,0.881388,10,6672067,-1,4000.0,6674267,6674272,2905,5,8,7,True,True,1.6871111111111112,-0.881388
8420,6671435,8,2,0.814023,10,6672067,-1,1000.0,6672067,6672075,632,8,9,0,True,True,0.6748444444444445,-0.814023
8421,6672239,38,16,0.305187,17,6674267,-1,8000.0,6688467,6688505,16228,38,6,8,True,True,18.45617777777778,-0.305187
8422,6672376,65655,1,0.857921,17,6674267,-1,500.0,6974855,7040510,302479,65655,0,7,True,True,654.5903819444445,-0.8212997216559497
8423,6672527,16,32,0.947455,17,6674267,-1,16000.0,6710475,6710491,37948,16,6,0,True,True,19.35786666666667,-0.947455
8424,6672602,19,2,0.406515,17,6674267,-1,1000.0,6679767,6679786,7165,19,10,7,True,True,1.3106833333333334,-0.406515
8425,6672621,10,1,0.312737,17,6674267,-1,500.0,6683067,6683077,10446,10,9,7,True,True,0.32245833333333335,-0.312737
8426,6672835,18979,2,0.090141,17,6674267,-1,1000.0,6787563,6806542,114728,18979,2,6,True,True,354.1902222222222,-0.0863660072930044
8427,6673123,6401,32,0.079475,17,6674267,-1,16000.0,6715975,6722376,42852,6401,6,6,True,True,5003.708977777778,-0.06719557095689135
8428,6673156,13820,1,0.729953,17,6674267,-1,500.0,6733106,6746926,59950,13820,4,7,True,True,74.882575,-0.6947884072490009
8429,6673287,12,1,0.944867,17,6674267,-1,500.0,6677567,6677579,4280,12,15,7,True,True,0.45845,-0.944867
8430,6677934,4116,8,0.165113,16,6679767,-1,4000.0,6729806,6733922,51872,4116,5,1,True,True,200.97864444444446,-0.16286184625528277
8431,6677950,48,8,0.057412,16,6679767,-1,4000.0,6721746,6721794,43796,48,7,1,True,True,2.681066666666667,-0.057412
8432,6684601,37,2,0.743409,24,6688467,-1,1000.0,6691767,6691804,7166,37,13,7,True,True,2.288963888888889,-0.743409
8433,6684784,14,16,0.55416,24,6688467,-1,8000.0,6695067,6695081,10283,14,12,6,True,True,6.845066666666667,-0.55416
8434,6685046,98,8,0.492851,24,6688467,-1,4000.0,6697267,6697365,12221,98,12,6,True,True,24.736288888888886,-0.492851
8435,6685053,82,8,0.874353,24,6688467,-1,4000.0,6699467,6699549,14414,82,12,0,True,True,20.69771111111111,-0.874353
8436,6685090,5649,32,0.962166,24,6688467,-1,16000.0,6715975,6721624,30885,5649,9,0,True,True,4835.695466666667,-0.8859401781528775
8437,6685291,41,1,0.423984,24,6688467,-1,500.0,6717075,6717116,31784,41,9,0,True,True,1.2229388888888888,-0.423984
8438,6685422,9165,8,0.508682,24,6688467,-1,4000.0,6742663,6751828,57241,9165,4,1,True,True,418.4604111111111,-0.4994219224643858
8439,6685437,42,16,0.730797,24,6688467,-1,8000.0,6699467,6699509,14030,42,15,0,True,True,21.20253333333333,-0.730797
8440,6685575,14349,256,0.479656,24,6688467,-1,128000.0,6960506,6974855,274931,14349,1,7,True,True,65382.05333333333,-0.4519541724126492
8441,6685967,370,4,0.515011,24,6688467,-1,2000.0,6715975,6716345,30008,370,13,0,True,True,44.145111111111106,-0.515011
8442,6687864,3,1,0.997954,24,6688467,-1,500.0,6689567,6689570,1703,3,23,6,True,True,0.09279583333333334,-0.997954
8443,6688959,12,4,0.888081,28,6689567,-1,2000.0,6699467,6699479,10508,12,18,0,True,True,1.5144666666666666,-0.888081
8444,6688970,7565,16,0.697882,28,6689567,-1,8000.0,6710475,6718040,21505,7565,16,0,True,True,4045.409555555556,-0.6957936836356224
8445,6688989,65,2,0.405471,28,6689567,-1,1000.0,6696167,6696232,7178,65,22,6,True,True,4.101680555555555,-0.405471
8446,6689034,2,4,0.616287,28,6689567,-1,2000.0,6718175,6718177,29141,2,11,0,True,True,0.22152222222222223,-0.616287
8447,6689145,10104,4,0.910886,28,6689567,-1,2000.0,6703875,6713979,14730,10104,19,6,True,True,1511.7316,-0.9108179576914166
8448,6690630,13444,15,0.745917,34,6691767,-1,7500.0,6718175,6731619,27545,13444,12,6,True,True,2235.5916666666667,-0.6874074823566367
8449,6690784,12,2,0.71416,34,6691767,-1,1000.0,6707175,6707187,16391,12,20,0,True,True,0.9064000000000001,-0.71416
8450,6690805,12,4,0.702592,34,6691767,-1,2000.0,6701675,6701687,10870,12,22,1,True,True,1.5366666666666668,-0.702592
8451,6690999,162,4,0.749668,34,6691767,-1,2000.0,6700567,6700729,9568,162,23,0,True,True,20.745,-0.749668
8452,6691121,122,1,0.244226,34,6691767,-1,500.0,6721624,6721746,30503,122,10,0,True,True,0.8517972222222223,-0.244226
8453,6691182,1384,6,0.738983,34,6691767,-1,3000.0,6699467,6700851,8285,1384,27,0,True,True,265.4742583333333,-0.73795705683526
8454,6691260,20,2,0.950868,34,6691767,-1,1000.0,6691767,6691787,507,20,33,0,True,True,1.237277777777778,-0.950868
8455,6691976,2,1,0.823363,45,6693967,-1,500.0,6700567,6700569,8591,2,25,6,True,True,0.06402777777777778,-0.823363
8456,6692023,180,4,0.880332,45,6693967,-1,2000.0,6695067,6695247,3044,180,32,0,True,True,22.002000000000002,-0.880332
8457,6692104,26055,32,0.528111,45,6693967,-1,16000.0,6849151,6875206,157047,26055,2,0,True,True,10530.6936,-0.5240931968970045
8458,6692240,2,32,0.609194,45,6693967,-1,16000.0,6712675,6712677,20435,2,20,7,True,True,2.4197333333333337,-0.609194
8459,6693041,7498,8,0.607374,45,6693967,-1,4000.0,6735165,6742663,42124,7498,7,0,True,True,309.7201444444445,-0.5536141593604453
8460,6693060,9,9,0.964647,45,6693967,-1,4500.0,6693967,6693976,907,9,37,0,True,True,2.475225,-0.964647
8461,6693068,7871,1,0.674522,45,6693967,-1,500.0,6725046,6732917,31978,7871,11,0,True,True,46.70646111111111,-0.6580881388057379
8462,6693225,45,2,0.881931,45,6693967,-1,1000.0,6702775,6702820,9550,45,27,6,True,True,2.88125,-0.881931
8463,6693234,13127,128,0.523516,45,6693967,-1,64000.0,6878816,6891943,185582,13127,2,6,True,True,14450.250133333335,-0.4751830721713977
8464,6693334,20781,32,0.225069,45,6693967,-1,16000.0,6856051,6876832,162717,20781,3,7,True,True,8431.815333333334,-0.2217014446699977
8465,6693490,146,1,0.075122,45,6693967,-1,500.0,6742618,6742764,49128,146,9,1,True,True,0.7545361111111111,-0.075122
8466,6693495,5968,2,0.839409,45,6693967,-1,1000.0,6699467,6705435,5972,5968,34,0,True,True,401.8862527777778,-0.8145372504363542
8467,6693954,8839,2,0.513684,45,6693967,-1,1000.0,6791864,6800703,97910,8839,6,2,True,True,152.7193138888889,-0.4722976611366226
8468,6694487,18,2,0.952484,53,6695067,-1,1000.0,6699467,6699485,4980,18,40,7,True,True,1.13585,-0.952484
8469,6694554,650,1,0.422722,53,6695067,-1,500.0,6717075,6717725,22521,650,22,0,True,True,19.120868055555555,-0.41689645271644915
8470,6694558,7636,16,0.379095,53,6695067,-1,8000.0,6729806,6737442,35248,7636,13,0,True,True,717.0892444444445,-0.3678437671666623
8471,6694656,49,1,0.373284,53,6695067,-1,500.0,6717075,6717124,22419,49,24,0,True,True,1.4615611111111109,-0.373284
8472,6694767,7,1,0.113234,53,6695067,-1,500.0,6729806,6729813,35039,7,13,0,True,True,0.04204861111111111,-0.113234
8473,6694773,146,3,0.914045,53,6695067,-1,1500.0,6699467,6699613,4694,146,42,0,True,True,13.837545833333333,-0.9020157191023088
8474,6694882,45,16,0.249765,53,6695067,-1,8000.0,6707175,6707220,12293,45,34,7,True,True,27.192000000000004,-0.249765
8475,6694978,6,8,0.53912,53,6695067,-1,4000.0,6704975,6704981,9997,6,35,6,True,True,1.7502666666666669,-0.53912
8476,6695010,8038,256,0.766414,53,6695067,-1,128000.0,6952468,6960506,257458,8038,2,7,True,True,43425.4784,-0.7603402505146991
8477,6695053,16759,64,0.117865,53,6695067,-1,32000.0,6788663,6805422,93610,16759,8,6,True,True,9829.84888888889,-0.10912296072092745
8478,6695148,93,4,0.299178,63,6696167,-1,2000.0,6699467,6699560,4319,93,46,0,True,True,11.737116666666665,-0.299178
8479,6695180,58,128,0.293545,63,6696167,-1,64000.0,6718175,6718233,22995,58,24,0,True,True,205.57262222222224,-0.293545
8480,6695199,6,1,0.213066,63,6696167,-1,500.0,6734065,6734071,38866,6,14,1,True,True,0.037283333333333335,-0.213066
8481,6695238,25,4,0.738026,63,6696167,-1,2000.0,6699467,6699492,4229,25,45,0,True,True,3.1551388888888887,-0.738026
8482,6695298,20,64,0.568842,63,6696167,-1,32000.0,6725046,6725066,29748,20,21,0,True,True,7.397333333333333,-0.568842
8483,6695334,12654,92,0.217463,63,6696167,-1,46000.0,6780939,6793593,85605,12654,10,0,True,True,12285.450766666667,-0.21069673533560582
8484,6695375,8,32,0.30482,63,6696167,-1,16000.0,6701667,6701675,6292,8,45,6,True,True,8.195555555555556,-0.30482
8485,6695418,8,2,0.933111,63,6696167,-1,1000.0,6697267,6697275,1849,8,57,0,True,True,0.5048222222222222,-0.933111
8486,6695567,7916,256,0.642974,63,6696167,-1,128000.0,6923177,6931093,227610,7916,3,7,True,True,15462.29511111111,-0.5961966613086405
8487,6695643,41,8,0.825727,63,6696167,-1,4000.0,6699467,6699508,3824,41,57,0,True,True,10.348855555555556,-0.825727
8488,6696117,662,4,0.035429,63,6696167,-1,2000.0,6745963,6746625,49846,662,13,7,True,True,14.785927777777776,-0.033728801471656085
8489,6696123,68,1,0.463057,63,6696167,-1,500.0,6710475,6710543,14352,68,40,0,True,True,2.570966666666667,-0.463057
8490,6696212,17714,8,0.617749,70,6697267,-1,4000.0,6860451,6878165,164239,17714,5,6,True,True,1754.0999444444442,-0.5984959632655091
8491,6696220,9492,4,0.488266,70,6697267,-1,2000.0,6758363,6767855,62143,9492,13,7,True,True,240.33219444444444,-0.4799182996997472
8492,6696273,189,4,0.355744,70,6697267,-1,2000.0,6718177,6718366,21904,189,30,1,True,True,20.93385,-0.355744
8493,6696284,286,16,0.61553,70,6697267,-1,8000.0,6699467,6699753,3183,286,59,0,True,True,145.51135555555555,-0.6113946893845851
8494,6696298,22865,1,0.328552,70,6697267,-1,500.0,6885416,6908281,189118,22865,4,7,True,True,158.02012638888888,-0.31594314221608705
8495,6696472,11783,4,0.353893,70,6697267,-1,2000.0,6887616,6899399,191144,11783,4,7,True,True,360.68457777777775,-0.34186398204513896
8496,6696604,20,4,0.005154,70,6697267,-1,2000.0,6729806,6729826,33202,20,25,0,True,True,0.48055555555555557,-0.005154
8497,6696658,25,8,0.890196,70,6697267,-1,4000.0,6699467,6699492,2809,25,60,0,True,True,6.310277777777777,-0.890196
8498,6698389,10136,2,0.186158,72,6699467,-1,1000.0,6736763,6746899,38374,10136,20,4,True,True,106.74924444444444,-0.17784849660183638
8499,6698447,22,4,0.354532,72,6699467,-1,2000.0,6710475,6710497,12028,22,46,0,True,True,3.3271333333333337,-0.354532
8500,6698564,17,1,0.101338,72,6699467,-1,500.0,6725065,6725082,26501,17,29,1,True,True,0.09824583333333334,-0.101338
8501,6698630,1956,1,0.492046,72,6699467,-1,500.0,6710475,6712431,11845,1956,51,7,True,True,73.9531,-0.492046
8502,6699954,9735,1,0.084744,61,6700567,-1,500.0,6792964,6802699,93010,9735,11,0,True,True,84.8229513888889,-0.07879515978706936
8503,6705235,25,1,0.514319,69,6707175,-1,500.0,6718175,6718200,12940,25,38,0,True,True,0.6922569444444444,-0.514319
8504,6705489,19,22,0.153711,69,6707175,-1,11000.0,6725046,6725065,19557,19,33,6,True,True,2.4156916666666666,-0.153711
8505,6705689,2302,8,0.123843,69,6707175,-1,4000.0,6771954,6774256,66265,2302,16,0,True,True,139.3988888888889,-0.123843
8506,6705986,4,1,0.487412,69,6707175,-1,500.0,6708275,6708279,2289,4,56,6,True,True,0.15106666666666668,-0.487412
8507,6706134,41,16,0.15563,69,6707175,-1,8000.0,6729765,6729806,23631,41,30,1,True,True,3.9405555555555556,-0.15563
8508,6706223,14224,2,0.656633,69,6707175,-1,1000.0,6762763,6776987,56540,14224,17,0,True,True,199.34401944444446,-0.5946399014619969
8509,6706301,13442,8,0.226095,69,6707175,-1,4000.0,6768654,6782096,62353,13442,17,0,True,True,961.3399111111111,-0.2232019184243618
8510,6706308,37,1,0.395359,69,6707175,-1,500.0,6729806,6729843,23498,37,28,0,True,True,0.22225694444444444,-0.395359
8511,6706394,30,8,0.299285,69,6707175,-1,4000.0,6750363,6750393,43969,30,20,7,True,True,1.4316666666666666,-0.299285
8512,6706686,147,32,0.428341,69,6707175,-1,16000.0,6714875,6715022,8189,147,54,0,True,True,140.30986666666666,-0.428341
8513,6706712,3,4,0.182182,69,6707175,-1,2000.0,6735165,6735168,28453,3,26,0,True,True,0.07456666666666667,-0.182182
8514,6706728,8,32,0.811544,69,6707175,-1,16000.0,6710475,6710483,3747,8,61,0,True,True,9.678933333333335,-0.811544
8515,6706789,20,1,0.108695,69,6707175,-1,500.0,6765054,6765074,58265,20,18,1,True,True,0.11577777777777779,-0.108695
8516,6707123,32855,8,0.438572,69,6707175,-1,4000.0,6789763,6822618,82640,32855,13,6,True,True,2109.1298444444446,-0.43616501640438426
8517,6707147,17258,8,0.839357,69,6707175,-1,4000.0,6753963,6771221,46816,17258,22,0,True,True,865.4782666666667,-0.8375001426068265
8518,6708435,4880,1,0.161834,77,6710475,-1,500.0,6742618,6747498,34183,4880,27,0,True,True,26.960661111111108,-0.15540072528226173
8519,6708487,62,4,0.353738,77,6710475,-1,2000.0,6735165,6735227,26678,62,32,6,True,True,1.5410444444444444,-0.353738
8520,6708512,324,4,0.43396,77,6710475,-1,2000.0,6762763,6763087,54251,324,20,0,True,True,8.5626,-0.43396
8521,6708732,57,1,0.359237,77,6710475,-1,500.0,6735165,6735222,26433,57,32,0,True,True,0.35419166666666674,-0.359237
8522,6708906,16,1,0.870514,77,6710475,-1,500.0,6710475,6710491,1569,16,67,0,True,True,0.6049333333333334,-0.870514
8523,6708965,55,8,0.198465,77,6710475,-1,4000.0,6742563,6742618,33598,55,30,4,True,True,2.2739444444444445,-0.198465
8524,6709526,98,16,0.189567,77,6710475,-1,8000.0,6730906,6731004,21380,98,38,6,True,True,9.418888888888889,-0.189567
8525,6709543,8202,2,0.040256,77,6710475,-1,1000.0,6823042,6831244,113499,8202,10,7,True,True,100.48036111111111,-0.03763652679319166
8526,6709545,284,16,0.394546,77,6710475,-1,8000.0,6723946,6724230,14401,284,51,0,True,True,31.725955555555554,-0.394546
8527,6710014,9997,1,0.743924,77,6710475,-1,500.0,6738963,6748960,28949,9997,32,7,True,True,54.39268194444445,-0.7337077754925032
8528,6710249,2100,8,0.900998,77,6710475,-1,4000.0,6715975,6718075,5726,2100,64,0,True,True,492.9841666666667,-0.8863936118690632
8529,6710726,20,2,0.160313,81,6712675,-1,1000.0,6774170,6774190,63444,20,18,1,True,True,0.3027777777777778,-0.160313
8530,6710888,13426,42,0.198992,81,6712675,-1,21000.0,6850251,6863677,139363,13426,9,6,True,True,7170.2029,-0.19764277569885577
8531,6710908,15363,1,0.479295,81,6712675,-1,500.0,6824142,6839505,113234,15363,11,6,True,True,115.9276,-0.46612307157411326
8532,6711020,7021,21,0.665243,81,6712675,-1,10500.0,6723946,6730967,12926,7021,56,7,True,True,885.9355458333333,-0.61431600023771
8533,6711492,20210,4,0.2658,81,6712675,-1,2000.0,6859351,6879561,147859,20210,8,0,True,True,1001.2973722222222,-0.26192539799194836
8534,6711790,2644,1,0.421095,81,6712675,-1,500.0,6721746,6724390,9956,2644,58,0,True,True,18.460261111111112,-0.421095
8535,6711902,21375,256,0.550124,81,6712675,-1,128000.0,6931093,6952468,219191,21375,3,7,True,True,82700.01351111112,-0.49874874732825347
8536,6712080,73,4,0.79982,81,6712675,-1,2000.0,6717075,6717148,4995,73,70,0,True,True,8.70971111111111,-0.79982
8537,6712146,42,71,0.714321,81,6712675,-1,35500.0,6712675,6712717,529,42,78,0,True,True,112.74445000000001,-0.714321
8538,6712201,95,1,0.324888,81,6712675,-1,500.0,6755063,6755158,42862,95,29,0,True,True,0.5884722222222223,-0.324888
8539,6712467,6,16,0.764393,81,6712675,-1,8000.0,6718175,6718181,5708,6,68,0,True,True,2.658266666666667,-0.764393
8540,6712772,33,1,0.881767,84,6714875,-1,500.0,6720377,6720410,7605,33,63,0,True,True,0.9137791666666667,-0.881767
8541,6712792,8619,16,0.501859,84,6714875,-1,8000.0,6753963,6762582,41171,8619,31,3,True,True,894.3998666666668,-0.4952154489990425
8542,6713969,3251,1,0.923561,84,6714875,-1,500.0,6717075,6720326,3106,3251,76,6,True,True,91.14328055555556,-0.8680652542441919
8543,6714465,81,5,0.843063,84,6714875,-1,2500.0,6718177,6718258,3712,81,65,0,True,True,11.2145625,-0.843063
8544,6714576,16,2,0.388849,84,6714875,-1,1000.0,6774154,6774170,59578,16,23,7,True,True,0.24222222222222223,-0.388849
8545,6715167,3,1,0.109733,87,6715975,-1,500.0,6721746,6721749,6579,3,63,0,True,True,0.020945833333333337,-0.109733
8546,6715187,24,26,0.10788,87,6715975,-1,13000.0,6717075,6717099,1888,24,75,0,True,True,18.61253333333333,-0.10788
8547,6715308,98,8,0.021152,87,6715975,-1,4000.0,6742663,6742761,27355,98,36,0,True,True,4.051755555555555,-0.021152
8548,6715781,6502,8,0.155542,87,6715975,-1,4000.0,6782039,6788541,66258,6502,21,0,True,True,577.3299888888889,-0.1535395122517719
8549,6715792,68,1,0.500001,87,6715975,-1,500.0,6718175,6718243,2383,68,72,0,True,True,1.882938888888889,-0.500001
8550,6716171,15494,8,0.767385,89,6717075,-1,4000.0,6776370,6791864,60199,15494,23,7,True,True,1340.8376444444445,-0.7610247642595824
8551,6716218,21849,2,0.236505,89,6717075,-1,1000.0,6720377,6742226,4159,21849,70,7,True,True,292.95526944444447,-0.16537631913483575
8552,6716224,39,8,0.67831,89,6717075,-1,4000.0,6717075,6717114,851,39,84,0,True,True,9.306266666666666,-0.67831
8553,6716336,323,16,0.342141,89,6717075,-1,8000.0,6733922,6734245,17586,323,50,1,True,True,32.11337777777778,-0.342141
8554,6716745,436,9,0.976439,89,6717075,-1,4500.0,6717075,6717511,330,436,81,0,True,True,117.0442,-0.976439
8555,6716958,10598,32,0.737432,89,6717075,-1,16000.0,6726165,6736763,9207,10598,59,6,True,True,2008.4348444444445,-0.7273610196686805
8556,6717398,25270,1,0.434329,85,6718175,-1,500.0,6760563,6785833,43165,25270,31,7,True,True,211.27767916666664,-0.42649157993526915
8557,6717678,379,4,0.289467,85,6718175,-1,2000.0,6762763,6763142,45085,379,30,0,True,True,10.016127777777777,-0.289467
8558,6717855,52,3,0.485929,85,6718175,-1,1500.0,6729806,6729858,11951,52,58,0,True,True,0.9370833333333334,-0.485929
8559,6717865,4,16,0.7609,85,6718175,-1,8000.0,6718175,6718179,310,4,83,0,True,True,1.7721777777777779,-0.7609
8560,6718881,47,64,0.247747,87,6720377,-1,32000.0,6756163,6756210,37282,47,34,6,True,True,18.63288888888889,-0.247747
8561,6719183,5048,32,0.152496,87,6720377,-1,16000.0,6743763,6748811,24580,5048,41,6,True,True,911.473111111111,-0.1498292008151326
8562,6719217,1317,9,0.51124,87,6720377,-1,4500.0,6721624,6722941,2407,1317,75,0,True,True,82.75698750000001,-0.51124
8563,6719376,16026,16,0.249467,87,6720377,-1,8000.0,6805422,6821448,86046,16026,16,3,True,True,1864.3198666666667,-0.23472634749534402
8564,6719543,6,16,0.766728,87,6720377,-1,8000.0,6721746,6721752,2203,6,75,0,True,True,0.6702666666666668,-0.766728
8565,6719575,240,8,0.864167,87,6720377,-1,4000.0,6721624,6721864,2049,240,79,3,True,True,13.405333333333333,-0.864167
8566,6719590,9,4,0.994257,87,6720377,-1,2000.0,6720377,6720386,787,9,81,0,True,True,0.99685,-0.994257
8567,6719804,143,8,0.247354,87,6720377,-1,4000.0,6733922,6734065,14118,143,55,0,True,True,7.108688888888889,-0.247354
8568,6719831,1,3,0.820609,87,6720377,-1,1500.0,6721746,6721747,1915,1,75,0,True,True,0.020945833333333334,-0.820609
8569,6719897,12,4,0.198412,87,6720377,-1,2000.0,6758363,6758375,38466,12,34,0,True,True,0.321,-0.198412
8570,6719987,93,8,0.706461,87,6720377,-1,4000.0,6721746,6721839,1759,93,76,0,True,True,5.194566666666667,-0.706461
8571,6720322,860,8,0.809952,87,6720377,-1,4000.0,6725046,6725906,4724,860,71,0,True,True,39.760666666666665,-0.809952
8572,6720698,28,32,0.701145,86,6721624,-1,16000.0,6725046,6725074,4348,28,71,0,True,True,5.178133333333333,-0.701145
8573,6720775,10084,1,0.502334,86,6721624,-1,500.0,6782039,6792123,61264,10084,22,0,True,True,108.01804027777777,-0.48253236374760644
8574,6724918,7775,1,0.181188,76,6725046,-1,500.0,6895216,6902991,170298,7775,5,7,True,True,51.74596805555556,-0.17336267571597241
8575,6750100,26,3,0.992552,43,6750363,-1,1500.0,6755063,6755089,4963,26,40,6,True,True,0.4831666666666667,-0.992552
8576,6753849,169,4,0.591196,43,6753963,-1,2000.0,6780770,6780939,26921,169,26,7,True,True,7.5420944444444435,-0.591196
8577,6756623,10137,16,0.634477,41,6758363,-1,8000.0,6804137,6814274,47514,10137,18,1,True,True,1336.6770000000001,-0.630196786802982
8578,6756733,11913,1,0.229384,41,6758363,-1,500.0,6784263,6796176,27530,11913,24,1,True,True,116.946475,-0.21838196498829712
8579,6757768,2,4,0.132296,41,6758363,-1,2000.0,6778570,6778572,20802,2,29,0,True,True,0.08526666666666666,-0.132296
8580,6759208,10,8,0.038366,47,6760563,-1,4000.0,6784239,6784249,25031,10,25,6,True,True,0.8753333333333334,-0.038366
8581,6759419,51,8,0.990399,47,6760563,-1,4000.0,6762763,6762814,3344,51,39,0,True,True,2.6956333333333333,-0.990399
8582,6759463,20,32,0.929098,47,6760563,-1,16000.0,6791864,6791884,32401,20,20,0,True,True,6.0551111111111116,-0.929098
8583,6759475,9246,1,0.426303,47,6760563,-1,500.0,6893016,6902262,133541,9246,6,0,True,True,63.26549166666666,-0.4144000225452927
8584,6759776,2755,1,0.616467,47,6760563,-1,500.0,6786463,6789218,26687,2755,26,7,True,True,31.169763888888884,-0.616467
8585,6760116,14,16,0.090935,47,6760563,-1,8000.0,6784249,6784263,24133,14,28,1,True,True,2.4509333333333334,-0.090935
8586,6760143,10204,8,0.050955,47,6760563,-1,4000.0,6818642,6828846,58499,10204,17,6,True,True,434.4834888888888,-0.05042410892730537
8587,6760202,8,30,0.407297,47,6760563,-1,15000.0,6762763,6762771,2561,8,46,7,True,True,1.5856666666666666,-0.407297
8588,6760727,12352,4,0.306446,62,6762763,-1,2000.0,6844751,6857103,84024,12352,15,6,True,True,607.8562111111111,-0.30216643379145536
8589,6760798,17,4,0.63331,62,6762763,-1,2000.0,6778570,6778587,17772,17,37,7,True,True,0.7247666666666667,-0.63331
8590,6760809,91,32,0.231428,62,6762763,-1,16000.0,6764963,6765054,4154,91,44,7,True,True,16.857244444444444,-0.231428
8591,6760837,5,8,0.336178,62,6762763,-1,4000.0,6782039,6782044,21202,5,34,6,True,True,0.4462777777777778,-0.336178
8592,6760951,309,32,0.479195,62,6762763,-1,16000.0,6780770,6781079,19819,309,36,0,True,True,110.31986666666666,-0.479195
8593,6761259,15,1,0.509864,62,6762763,-1,500.0,6771954,6771969,10695,15,44,0,True,True,0.11354166666666667,-0.509864
8594,6761321,23,2,0.643873,62,6762763,-1,1000.0,6770854,6770877,9533,23,45,7,True,True,0.27753333333333335,-0.643873
8595,6761626,29,4,0.30429,62,6762763,-1,2000.0,6792964,6792993,31338,29,23,6,True,True,1.097488888888889,-0.30429
8596,6761885,5,2,0.269246,62,6762763,-1,1000.0,6783139,6783144,21254,5,33,6,True,True,0.10941666666666668,-0.269246
8597,6762086,24,1,0.280556,62,6762763,-1,500.0,6780939,6780963,18853,24,38,1,True,True,0.26776666666666665,-0.280556
8598,6762107,17051,8,0.351025,62,6762763,-1,4000.0,6896316,6913367,134209,17051,5,6,True,True,788.4551555555555,-0.33116799174604505
8599,6762250,951,16,0.418074,62,6762763,-1,8000.0,6771954,6772905,9704,951,49,6,True,True,115.17666666666666,-0.418074
8600,6762557,16076,1,0.319841,62,6762763,-1,500.0,6857151,6873227,94594,16076,13,6,True,True,203.91653055555557,-0.3067523198141633
8601,6762605,22,4,0.047556,62,6762763,-1,2000.0,6780939,6780961,18334,22,39,0,True,True,0.9818111111111112,-0.047556
8602,6762689,13406,8,0.040889,62,6762763,-1,4000.0,6856051,6869457,93362,13406,14,0,True,True,1340.3277444444445,-0.03858729066245239
8603,6762751,645,1,0.052131,62,6762763,-1,500.0,6806542,6807187,43791,645,22,0,True,True,6.368479166666667,-0.052131
8604,6762947,4452,4,0.744755,63,6764963,-1,2000.0,6784249,6788701,21302,4452,35,0,True,True,198.87068888888888,-0.7397758939321691
8605,6763239,643,2,0.211978,63,6764963,-1,1000.0,6780939,6781582,17700,643,42,0,True,True,14.347830555555555,-0.211978
8606,6763259,6866,64,0.472058,63,6764963,-1,32000.0,6784249,6791115,20990,6866,36,0,True,True,4750.236266666667,-0.4582106310051877
8607,6763736,251,8,0.908482,63,6764963,-1,4000.0,6768654,6768905,4918,251,59,4,True,True,12.114933333333333,-0.908482
8608,6764066,118,32,0.100762,63,6764963,-1,16000.0,6801808,6801926,37742,118,26,0,True,True,35.698933333333336,-0.100762
8609,6764140,11607,7,0.18484,63,6764963,-1,3500.0,6815342,6826949,51202,11607,22,0,True,True,471.8706513888889,-0.17130717471804352
8610,6792760,455,1,0.948328,34,6792964,-1,500.0,6792993,6793448,233,455,28,1,True,True,3.8876833333333334,-0.8564379767107818
8611,6792892,89,2,0.363581,34,6792964,-1,1000.0,6820842,6820931,27950,89,21,7,True,True,0.8415444444444444,-0.363581
8612,6792903,2,8,0.304357,34,6792964,-1,4000.0,6826949,6826951,34046,2,19,1,True,True,0.10148888888888889,-0.304357
8613,6792922,9391,8,0.096887,34,6792964,-1,4000.0,6862651,6872042,69729,9391,11,7,True,True,927.5378666666666,-0.09612027991604134
8614,6792964,41,4,0.013662,34,6792964,-1,2000.0,6826951,6826992,33987,41,20,1,True,True,1.0402611111111113,-0.013662
8615,6792988,13,8,0.551768,33,6792993,-1,4000.0,6796593,6796606,3605,13,32,5,True,True,0.8090333333333333,-0.551768
8616,6793046,25,1,0.861974,51,6796593,-1,500.0,6801808,6801833,8762,25,31,0,True,True,0.23635416666666664,-0.861974
8617,6793120,1,64,0.331212,51,6796593,-1,32000.0,6835951,6835952,42831,1,20,1,True,True,0.42648888888888886,-0.331212
8618,6793359,12183,4,0.741292,51,6796593,-1,2000.0,6832351,6844534,38992,12183,21,8,True,True,542.3508277777778,-0.6647344397269016
8619,6793507,94,2,0.361385,51,6796593,-1,1000.0,6826951,6827045,33444,94,22,0,True,True,1.1924944444444445,-0.361385
8620,6793644,375,2,0.778808,51,6796593,-1,1000.0,6796593,6796968,2949,375,36,0,True,True,6.286575000000001,-0.7154023601972602
8621,6793657,5,1,0.528862,51,6796593,-1,500.0,6801803,6801808,8146,5,36,6,True,True,0.04727083333333333,-0.528862
8622,6793690,13373,16,0.371592,51,6796593,-1,8000.0,6842551,6855924,48861,13373,20,7,True,True,2668.2042444444446,-0.3470023361216532
8623,6794425,36,1,0.650248,51,6796593,-1,500.0,6798793,6798829,4368,36,38,7,True,True,0.3285,-0.650248
8624,6794611,16,8,0.210033,51,6796593,-1,4000.0,6801808,6801824,7197,16,36,0,True,True,1.2101333333333333,-0.210033
8625,6794650,8,1,0.384049,51,6796593,-1,500.0,6800703,6800711,6053,8,39,0,True,True,0.07563333333333333,-0.384049
8626,6794882,6903,16,0.887194,51,6796593,-1,8000.0,6801808,6808711,6926,6903,38,1,True,True,1056.9722222222222,-0.8777423862041043
8627,6794897,9,4,0.130485,51,6796593,-1,2000.0,6846951,6846960,52054,9,19,7,True,True,0.44395000000000007,-0.130485
8628,6795119,4,1,0.742587,51,6796593,-1,500.0,6796593,6796597,1474,4,43,0,True,True,0.031116666666666664,-0.742587
8629,6795199,30161,62,0.120354,51,6796593,-1,31000.0,6893016,6923177,97817,30161,8,8,True,True,11417.62989166667,-0.11346909924580251
8630,6795317,113,1,0.586561,51,6796593,-1,500.0,6804024,6804137,8707,113,37,7,True,True,1.1157180555555557,-0.586561
8631,6795662,23,4,0.912177,51,6796593,-1,2000.0,6801808,6801831,6146,23,41,0,True,True,0.8697833333333332,-0.912177
8632,6795678,11543,4,0.654355,51,6796593,-1,2000.0,6853851,6865394,58173,11543,18,2,True,True,583.5146555555556,-0.6350055025526935
8633,6795730,72,16,0.190434,51,6796593,-1,8000.0,6805237,6805309,9507,72,37,6,True,True,11.374400000000001,-0.190434
8634,6795780,240,4,0.70466,51,6796593,-1,2000.0,6808742,6808982,12962,240,34,7,True,True,8.461333333333334,-0.70466
8635,6796706,8,32,0.925501,57,6798793,-1,16000.0,6801824,6801832,5118,8,41,1,True,True,2.4202666666666666,-0.925501
8636,6797232,9963,1,0.07488,57,6798793,-1,500.0,6853851,6863814,56619,9963,18,0,True,True,128.197175,-0.07326669693430451
8637,6797280,18,2,0.546579,57,6798793,-1,1000.0,6823042,6823060,25762,18,31,0,True,True,0.17845,-0.546579
8638,6797293,62,8,0.342898,57,6798793,-1,4000.0,6818642,6818704,21349,62,34,0,True,True,2.344977777777778,-0.342898
8639,6797647,13965,128,0.725351,57,6798793,-1,64000.0,6864851,6878816,67204,13965,12,7,True,True,22379.14737777778,-0.7249008202316782
8640,6797758,1656,1,0.989645,57,6798793,-1,500.0,6800703,6802359,2945,1656,53,0,True,True,15.656099999999999,-0.989645
8641,6797788,16,1,0.201999,57,6798793,-1,500.0,6815342,6815358,17554,16,38,7,True,True,0.1255111111111111,-0.201999
8642,6797820,77,16,0.720769,57,6798793,-1,8000.0,6800703,6800780,2883,77,55,2,True,True,11.647533333333332,-0.720769
8643,6797940,56,1,0.043811,57,6798793,-1,500.0,6840351,6840407,42411,56,26,0,True,True,0.8582777777777777,-0.043811
8644,6801335,5109,64,0.191707,56,6801803,-1,32000.0,6840351,6845460,39016,5109,27,7,True,True,4654.902666666667,-0.18897613824057266
8645,6801695,17432,1,0.550496,56,6801803,-1,500.0,6881016,6898448,79321,17432,11,7,True,True,137.72514444444445,-0.539132783496501
8646,6801769,11,1,0.252526,56,6801803,-1,500.0,6843651,6843662,41882,11,26,6,True,True,0.13565138888888892,-0.252526
8647,6801804,22853,35,0.877075,56,6801808,-1,17500.0,6813142,6835995,11338,22853,43,0,True,True,4993.439111111111,-0.8605822306087375
8648,6801841,23,32,0.853438,54,6804024,-1,16000.0,6810942,6810965,9101,23,44,7,True,True,6.4870222222222225,-0.853438
8649,6802457,5,2,0.906815,54,6804024,-1,1000.0,6805237,6805242,2780,5,49,0,True,True,0.09873611111111112,-0.906815
8650,6802703,23827,1,0.975126,54,6804024,-1,500.0,6883216,6907043,80513,23827,11,7,True,True,169.1377236111111,-0.9748635583257949
8651,6802844,5402,1,0.894913,54,6804024,-1,500.0,6817542,6822944,14698,5402,42,7,True,True,28.42988888888889,-0.6844397361783143
8652,6808475,12039,1,0.448482,49,6808742,-1,500.0,6859351,6871390,50876,12039,18,7,True,True,149.7065763888889,-0.4303709252816334
8653,6808515,225,16,0.717326,49,6808742,-1,8000.0,6808742,6808967,227,225,48,0,True,True,31.73,-0.717326
8654,6809122,42,1,0.910849,51,6810942,-1,500.0,6813142,6813184,4020,42,47,7,True,True,0.2407416666666667,-0.910849
8655,6809142,3938,1,0.067708,51,6810942,-1,500.0,6849151,6853089,40009,3938,26,7,True,True,47.424280555555555,-0.06639765603962121
8656,6809863,679,1,0.419004,51,6810942,-1,500.0,6838151,6838830,28288,679,33,7,True,True,7.859425000000001,-0.419004
8657,6810153,9066,32,0.931332,51,6810942,-1,16000.0,6826951,6836017,16798,9066,36,0,True,True,1972.4243999999999,-0.9294790339284261
6872,5320285,20178,32,0.782156,1,5320285,-1,16000.0,5322485,5342663,2200,20178,0,7,True,True,7853.519244444444,-0.7602350362533085
6873,5320299,5629,1,0.947383,6,5322485,-1,500.0,5326928,5332557,6629,5629,0,6,True,True,74.74010416666667,-0.9416391331817702
6874,5320322,43,1,0.82361,6,5322485,-1,500.0,5325785,5325828,5463,43,1,7,True,True,0.5550583333333333,-0.82361
6875,5320330,6210,64,0.041969,6,5322485,-1,32000.0,5368488,5374698,48158,6210,0,7,True,True,7187.0741333333335,-0.041792748494726986
6876,5320417,54,8,0.105411,6,5322485,-1,4000.0,5362688,5362742,42271,54,1,0,True,True,6.598199999999999,-0.105411
6877,5320442,4531,11,0.629926,6,5322485,-1,5500.0,5325828,5330359,5386,4531,3,1,True,True,661.6366625,-0.6209051875084923
6878,5320811,78,1,0.870869,6,5322485,-1,500.0,5323585,5323663,2774,78,5,6,True,True,0.7937583333333333,-0.870869
6879,5326366,3,16,0.910986,13,5326928,-1,8000.0,5329128,5329131,2762,3,2,6,True,True,0.6534000000000001,-0.910986
6880,5326406,82,2,0.157033,13,5326928,-1,1000.0,5368515,5368597,42109,82,0,1,True,True,2.5367611111111112,-0.157033
6881,5326414,738,1,0.292123,13,5326928,-1,500.0,5361588,5362326,35174,738,3,0,True,True,11.271925,-0.292123
6882,5326463,8,4,0.441518,13,5326928,-1,2000.0,5348533,5348541,22070,8,4,0,True,True,0.5034666666666666,-0.441518
6883,5326490,27824,32,0.505897,13,5326928,-1,16000.0,5436489,5464313,109999,27824,0,4,True,True,16097.974133333335,-0.5041076678589653
6884,5326642,8,1,0.732552,13,5326928,-1,500.0,5341828,5341836,15186,8,6,0,True,True,0.08537777777777777,-0.732552
6885,5326650,12078,75,0.099294,13,5326928,-1,37500.0,5467171,5479249,140521,12078,0,0,True,True,16811.8865625,-0.09166904660398642
6886,5326702,2168,1,0.647093,13,5326928,-1,500.0,5341828,5343996,15126,2168,8,4,True,True,26.067811111111112,-0.6220317363573936
6887,5326733,123,16,0.334608,13,5326928,-1,8000.0,5359733,5359856,33000,123,6,6,True,True,32.14126666666667,-0.334608
6888,5326785,41,64,0.137772,13,5326928,-1,32000.0,5328028,5328069,1243,41,11,6,True,True,35.7192,-0.137772
6889,5326885,9,21,0.848595,13,5326928,-1,10500.0,5331328,5331337,4443,9,10,7,True,True,2.5727625,-0.848595
6890,5327312,15,32,0.439108,13,5328028,-1,16000.0,5368500,5368515,41188,15,3,1,True,True,7.424666666666667,-0.439108
6891,5329574,6132,123,0.41575,25,5331328,-1,61500.0,5428489,5434621,98915,6132,2,4,True,True,13720.139720833333,-0.3811661874968179
6892,5329625,78,4,0.769033,25,5331328,-1,2000.0,5341909,5341987,12284,78,10,2,True,True,3.3297333333333334,-0.769033
6893,5329685,3044,1,0.245316,25,5331328,-1,500.0,5394925,5397969,65240,3044,3,0,True,True,54.36865,-0.2447994534736235
6894,5329717,4,1,0.809145,25,5331328,-1,500.0,5346327,5346331,16610,4,11,1,True,True,0.06293333333333333,-0.809145
6895,5329743,52,16,0.34132,25,5331328,-1,8000.0,5359733,5359785,29990,52,9,0,True,True,13.588177777777778,-0.34132
6896,5329758,22,16,0.505023,25,5331328,-1,8000.0,5353233,5353255,23475,22,11,1,True,True,4.696266666666667,-0.505023
6897,5329929,64,8,0.085234,25,5331328,-1,4000.0,5343009,5343073,13080,64,14,6,True,True,6.4042666666666666,-0.085234
6898,5329953,19403,32,0.372436,25,5331328,-1,16000.0,5401269,5420672,71316,19403,3,7,True,True,12321.416444444443,-0.36971211637996265
6899,5329987,18,1,0.754845,25,5331328,-1,500.0,5346309,5346327,16322,18,15,6,True,True,0.2832,-0.754845
6900,5330013,41,1,0.360643,25,5331328,-1,500.0,5345209,5345250,15196,41,16,0,True,True,0.5128416666666668,-0.360643
6901,5330215,11785,4,0.664995,25,5331328,-1,2000.0,5349633,5361418,19418,11785,13,6,True,True,703.2168944444445,-0.6464537756865455
6902,5330225,41,4,0.151611,25,5331328,-1,2000.0,5332428,5332469,2203,41,22,6,True,True,2.0388388888888893,-0.151611
6903,5330796,12039,128,0.753507,25,5331328,-1,64000.0,5334628,5346667,3832,12039,22,7,True,True,18566.42631111111,-0.6764785344345199
6904,5331322,6,3,0.421722,25,5331328,-1,1500.0,5348527,5348533,17205,6,15,7,True,True,0.2832,-0.421722
6905,5331339,5,2,0.228182,30,5332428,-1,1000.0,5368515,5368520,37176,5,5,0,True,True,0.15468055555555557,-0.228182
6906,5331402,7,1,0.801769,30,5332428,-1,500.0,5332428,5332435,1026,7,25,0,True,True,0.08702361111111111,-0.801769
6907,5331500,12101,32,0.413409,30,5332428,-1,16000.0,5361588,5373689,30088,12101,11,4,True,True,5944.688177777778,-0.3865524269825023
6908,5331724,2922,1,0.409309,30,5332428,-1,500.0,5368500,5371422,36776,2922,7,0,True,True,46.22841666666667,-0.32199122484174164
6909,5332028,13055,64,0.458753,30,5332428,-1,32000.0,5348533,5361588,16505,13055,18,1,True,True,12523.681066666666,-0.43962199634468374
6910,5332161,81,32,0.85239,30,5332428,-1,16000.0,5341828,5341909,9667,81,25,0,True,True,27.6624,-0.85239
6911,5332646,86,1,0.794607,34,5334628,-1,500.0,5348527,5348613,15881,86,19,0,True,True,1.3530666666666666,-0.794607
6912,5332815,13,62,0.361774,34,5334628,-1,31000.0,5338228,5338241,5413,13,29,2,True,True,9.849991666666666,-0.361774
6913,5332881,34,4,0.029763,34,5334628,-1,2000.0,5376215,5376249,43334,34,5,0,True,True,2.7534333333333336,-0.029763
6914,5333114,8162,1,0.145584,34,5334628,-1,500.0,5366288,5374450,33174,8162,11,0,True,True,136.78646666666668,-0.1426229657410599
6915,5333205,8,1,0.009949,34,5334628,-1,500.0,5345209,5345217,12004,8,26,0,True,True,0.10006666666666666,-0.009949
6916,5333254,19,1,0.806247,34,5334628,-1,500.0,5338228,5338247,4974,19,32,0,True,True,0.23219583333333332,-0.806247
6917,5335249,15,1,0.943643,36,5338228,-1,500.0,5348527,5348542,13278,15,22,0,True,True,0.236,-0.943643
6918,5335270,6733,64,0.084778,36,5338228,-1,32000.0,5362688,5369421,27418,6733,13,6,True,True,5849.363644444444,-0.0748368155904906
6919,5335279,3,32,0.314805,36,5338228,-1,16000.0,5366288,5366291,31009,3,12,2,True,True,1.1517333333333333,-0.314805
6920,5340417,383,2,0.981945,39,5341828,-1,1000.0,5345209,5345592,4792,383,30,7,True,True,9.581383333333335,-0.981945
6921,5340511,14931,4,0.164325,39,5341828,-1,2000.0,5375115,5390046,34604,14931,6,7,True,True,1083.09705,-0.16216166822066352
6922,5340780,110,6,0.061468,39,5341828,-1,3000.0,5390415,5390525,49635,110,5,7,True,True,11.223666666666666,-0.061468
6923,5340881,12,1,0.759192,39,5341828,-1,500.0,5368488,5368500,27607,12,12,0,True,True,0.18561666666666668,-0.759192
6924,5340988,39962,32,0.660176,39,5341828,-1,16000.0,5483444,5523406,142456,39962,0,6,True,True,26073.38844444445,-0.6509519532021545
6925,5344910,8897,8,0.641466,37,5345209,-1,4000.0,5382715,5391612,37805,8897,7,0,True,True,1172.2835333333335,-0.6363419121426552
6926,5344928,82,2,0.902511,37,5345209,-1,1000.0,5348533,5348615,3605,82,27,0,True,True,2.5802666666666667,-0.902511
6927,5345018,18384,32,0.05781,37,5345209,-1,16000.0,5396046,5414430,51028,18384,5,0,True,True,11159.746400000002,-0.05597989731792799
6928,5345307,137,1,0.631608,35,5346309,-1,500.0,5369615,5369752,24308,137,11,6,True,True,2.119123611111111,-0.631608
6929,5346560,21193,5,0.71337,41,5348527,-1,2500.0,5402369,5423562,55809,21193,4,6,True,True,2131.104208333333,-0.705255131854625
6930,5346791,429,4,0.660362,41,5348527,-1,2000.0,5358633,5359062,11842,429,27,8,True,True,28.025616666666668,-0.660362
6931,5347388,67,4,0.519778,41,5348527,-1,2000.0,5368515,5368582,21127,67,14,0,True,True,4.145438888888889,-0.519778
6932,5347761,27299,2,0.295724,41,5348527,-1,1000.0,5584384,5611683,236623,27299,0,7,True,True,999.4736972222222,-0.29346610864658557
6933,5347929,6468,64,0.402003,41,5348527,-1,32000.0,5371815,5378283,23886,6468,13,7,True,True,8355.065866666668,-0.40195446756789793
6934,5348178,7111,2,0.680871,41,5348527,-1,1000.0,5362688,5369799,14510,7111,25,0,True,True,194.48646388888886,-0.6057058248075912
6935,5348221,13489,128,0.55361,41,5348527,-1,64000.0,5475840,5489329,127619,13489,2,7,True,True,34713.96337777778,-0.551221129110097
6936,5348239,5,8,0.304323,41,5348527,-1,4000.0,5376215,5376220,27976,5,12,0,True,True,0.8098333333333334,-0.304323
6937,5351461,8142,14,0.742698,38,5353233,-1,7000.0,5368500,5376642,17039,8142,20,0,True,True,2120.3920500000004,-0.703674305892979
6938,5351872,9,16,0.909231,38,5353233,-1,8000.0,5361588,5361597,9716,9,31,0,True,True,2.1994000000000002,-0.909231
6939,5352215,331,1,0.007902,38,5353233,-1,500.0,5392725,5393056,40510,331,10,7,True,True,5.83755,-0.007820087931866296
6940,5352494,6,38,0.279781,38,5353233,-1,19000.0,5372915,5372921,20421,6,16,6,True,True,4.585333333333334,-0.279781
6941,5354007,20,4,0.527792,39,5358633,-1,2000.0,5382715,5382735,28708,20,13,8,True,True,1.3126666666666666,-0.527792
6942,5354320,591,1,0.920451,39,5358633,-1,500.0,5361588,5362179,7268,591,33,0,True,True,9.026704166666667,-0.920451
6943,5365988,59,1,0.700295,30,5366288,-1,500.0,5368515,5368574,2527,59,20,0,True,True,0.9126152777777778,-0.700295
6944,5366909,14,8,0.446189,30,5368488,-1,4000.0,5394925,5394939,28016,14,9,0,True,True,1.9959333333333333,-0.446189
6945,5368060,28288,32,0.205134,30,5368488,-1,16000.0,5424889,5453177,56829,28288,6,6,True,True,16970.44008888889,-0.19982659975241165
6946,5368628,29,4,0.544425,23,5369615,-1,2000.0,5383815,5383844,15187,29,14,6,True,True,1.9033666666666667,-0.544425
6947,5368861,25820,32,0.788342,23,5369615,-1,16000.0,5397969,5423789,29108,25820,9,4,True,True,16289.071866666667,-0.7800541444541186
6948,5369672,15,16,0.652037,27,5371815,-1,8000.0,5377315,5377330,7643,15,18,6,True,True,4.859,-0.652037
6949,5370616,1305,1,0.697471,27,5371815,-1,500.0,5390525,5391830,19909,1305,14,1,True,True,22.192249999999998,-0.697471
6950,5370641,67,16,0.887675,27,5371815,-1,8000.0,5376215,5376282,5574,67,22,6,True,True,21.703533333333333,-0.887675
6951,5370673,44,32,0.781563,27,5371815,-1,16000.0,5386015,5386059,15342,44,16,7,True,True,22.754844444444444,-0.781563
6952,5371268,13678,10,0.404506,27,5371815,-1,5000.0,5415082,5428760,43814,13678,7,7,True,True,2854.8254444444447,-0.40435846977407036
6953,5372935,449,1,0.197296,27,5375115,-1,500.0,5415082,5415531,42147,449,7,0,True,True,9.331716666666665,-0.197296
6954,5373410,98,64,0.301531,27,5375115,-1,32000.0,5388215,5388313,14805,98,18,7,True,True,101.36248888888888,-0.301531
6955,5378120,396,13,0.03697,23,5382715,-1,6500.0,5412882,5413278,34762,396,9,6,True,True,102.81700000000001,-0.03697
6956,5388412,6,1,0.334493,24,5390415,-1,500.0,5396052,5396058,7640,6,13,1,True,True,0.106925,-0.334493
6957,5388565,8152,2,0.725099,24,5390415,-1,1000.0,5405969,5414121,17404,8152,10,2,True,True,322.7053638888889,-0.7214939192892627
6958,5389569,16113,2,0.740052,24,5390415,-1,1000.0,5464971,5481084,75402,16113,4,7,True,True,603.5170999999999,-0.7184061877240292
6959,5389584,10674,128,0.126006,24,5390415,-1,64000.0,5452097,5462771,62513,10674,5,7,True,True,23705.215111111112,-0.1247255509175438
6960,5389601,1979,4,0.991924,24,5390415,-1,2000.0,5390525,5392504,924,1979,21,0,True,True,134.61597777777777,-0.991924
6961,5389650,26581,155,0.283928,24,5390415,-1,77500.0,5647985,5674566,258335,26581,0,6,True,True,84410.5141875,-0.2825246158935208
6962,5391038,45,1,0.09282,32,5392725,-1,500.0,5412882,5412927,21844,45,12,0,True,True,0.8987500000000002,-0.09282
6963,5391101,5394,8,0.551786,32,5392725,-1,4000.0,5415089,5420483,23988,5394,10,1,True,True,894.1662777777776,-0.5513281319780072
6964,5391112,6,4,0.521336,32,5392725,-1,2000.0,5396046,5396052,4934,6,20,0,True,True,0.4277,-0.521336
6965,5391518,27437,32,0.757046,32,5392725,-1,16000.0,5420672,5448109,29154,27437,10,4,True,True,17030.526222222223,-0.7462792818393661
6966,5391702,8,12,0.160027,32,5392725,-1,6000.0,5401269,5401277,9567,8,18,0,True,True,1.6887999999999999,-0.16002700000000003
6967,5391780,16,1,0.027891,32,5392725,-1,500.0,5430689,5430705,38909,16,8,0,True,True,0.2865777777777778,-0.027891
6968,5391840,32318,256,0.796599,32,5392725,-1,128000.0,5726032,5758350,334192,32318,0,7,True,True,184201.59573333338,-0.788138562426347
6969,5391868,7,1,0.592504,32,5392725,-1,500.0,5422872,5422879,31004,7,12,7,True,True,0.14758333333333334,-0.592504
6970,5391915,8,16,0.24134,32,5392725,-1,8000.0,5396046,5396054,4131,8,27,0,True,True,2.281066666666667,-0.24134
6971,5391923,81,1,0.774158,32,5392725,-1,500.0,5394925,5395006,3002,81,30,7,True,True,1.4434875,-0.774158
6972,5392042,21,8,0.726509,32,5392725,-1,4000.0,5396025,5396046,3983,21,28,6,True,True,2.9939,-0.726509
6973,5394059,27,8,0.986955,37,5394925,-1,4000.0,5396046,5396073,1987,27,28,1,True,True,3.8493,-0.986955
6974,5394249,11103,32,0.110442,37,5394925,-1,16000.0,5438689,5449792,44440,11103,8,7,True,True,6694.329733333334,-0.10808594156180898
6975,5394560,7298,14,0.059946,37,5394925,-1,7000.0,5454297,5461595,59737,7298,7,7,True,True,1787.4654583333333,-0.059372607763456986
6976,5394817,14571,2,0.372979,37,5394925,-1,1000.0,5589784,5604355,194967,14571,2,8,True,True,528.521888888889,-0.3672894726861091
6977,5394829,50,2,0.62699,37,5394925,-1,1000.0,5411782,5411832,16953,50,22,0,True,True,1.9972222222222222,-0.62699
6978,5394850,119,1,0.354473,37,5394925,-1,500.0,5399069,5399188,4219,119,27,6,True,True,2.129934722222222,-0.354473
6979,5394947,10210,61,0.047733,37,5396025,-1,30500.0,5411782,5421992,16835,10210,22,0,True,True,12792.12361111111,-0.0470232184498702
6980,5395042,13069,128,0.650962,37,5396025,-1,64000.0,5462771,5475840,67729,13069,8,7,True,True,28715.3072,-0.5966733095934871
6981,5395051,13,1,0.12475,37,5396025,-1,500.0,5432889,5432902,37838,13,13,7,True,True,0.23734027777777775,-0.12475
6982,5404216,108,8,0.297961,43,5405969,-1,4000.0,5412882,5412990,8666,108,22,0,True,True,17.256,-0.297961
6983,5404231,12590,4,0.736859,43,5405969,-1,2000.0,5444497,5457087,40266,12590,11,7,True,True,880.5015333333333,-0.7262578984984055
6984,5404251,19571,32,0.453147,43,5405969,-1,16000.0,5456497,5476068,52246,19571,9,0,True,True,10877.11137777778,-0.42947012740881924
6985,5404355,423,1,0.982951,43,5405969,-1,500.0,5408169,5408592,3814,423,29,7,True,True,8.288450000000001,-0.982951
6986,5404531,3,32,0.805388,43,5405969,-1,16000.0,5415082,5415085,10551,3,23,0,True,True,1.9951999999999999,-0.805388
6987,5404663,8273,256,0.989,43,5405969,-1,128000.0,5624009,5632282,219346,8273,2,8,True,True,35021.00373333333,-0.9850934534919527
6988,5404726,360,1,0.565597,43,5405969,-1,500.0,5422872,5423232,18146,360,20,0,True,True,7.590000000000001,-0.565597
6989,5404883,1167,32,0.894339,43,5405969,-1,16000.0,5405969,5407136,1086,1167,33,0,True,True,742.7825333333334,-0.894339
6990,5405062,5649,1,0.627744,43,5405969,-1,500.0,5420672,5426321,15610,5649,22,0,True,True,118.5530888888889,-0.626239350887399
6991,5405093,38,1,0.533289,43,5405969,-1,500.0,5415089,5415127,9996,38,24,0,True,True,0.7897666666666666,-0.533289
6992,5405279,2611,6,0.595549,43,5405969,-1,3000.0,5415085,5417696,9806,2611,26,1,True,True,325.59169999999995,-0.595549
6993,5405300,6178,1,0.350337,43,5405969,-1,500.0,5423789,5429967,18489,6178,20,5,True,True,126.09084999999999,-0.3400025134874748
6994,5405341,13,32,0.284535,43,5405969,-1,16000.0,5411769,5411782,6428,13,36,5,True,True,8.308444444444445,-0.284535
6995,5405392,6561,1,0.784789,43,5405969,-1,500.0,5405969,5412530,577,6561,38,0,True,True,129.5768763888889,-0.7774794126528215
6996,5405421,11,5,0.714854,43,5405969,-1,2500.0,5405969,5405980,548,11,39,0,True,True,1.093965277777778,-0.714854
6997,5405739,13037,8,0.672434,43,5405969,-1,4000.0,5442297,5455334,36558,13037,14,4,True,True,1857.4159111111112,-0.6481734082095153
6998,5405856,10708,4,0.714351,43,5405969,-1,2000.0,5430689,5441397,24833,10708,19,7,True,True,805.2275777777777,-0.7033677053528478
6999,5406099,4,4,0.519667,44,5408169,-1,2000.0,5415085,5415089,8986,4,29,0,True,True,0.3325333333333333,-0.519667
7000,5406479,9453,64,0.247633,44,5408169,-1,32000.0,5438697,5448150,32218,9453,15,0,True,True,11525.711200000002,-0.24373691809554876
7001,5406487,7846,2,0.327847,44,5408169,-1,1000.0,5469371,5477217,62884,7846,7,7,True,True,283.43567222222225,-0.3032698773967701
7002,5406499,17137,16,0.582369,44,5408169,-1,8000.0,5482344,5499481,75845,17137,6,1,True,True,5409.645955555556,-0.5515347981638877
7003,5407008,60,32,0.822843,44,5408169,-1,16000.0,5420672,5420732,13664,60,28,0,True,True,39.645333333333326,-0.822843
7004,5408337,30,1,0.361268,50,5411769,-1,500.0,5417289,5417319,8952,30,31,7,True,True,0.6234999999999999,-0.361268
7005,5408442,13751,4,0.097988,50,5411769,-1,2000.0,5576384,5590135,167942,13751,5,6,True,True,904.4814666666666,-0.09355776378592888
7006,5408570,39,2,0.71164,50,5411769,-1,1000.0,5411782,5411821,3212,39,45,1,True,True,1.5578333333333334,-0.71164
7007,5408757,11264,1,0.828438,50,5411769,-1,500.0,5420672,5431936,11915,11264,29,0,True,True,226.67115555555554,-0.8025403013114093
7008,5408765,62,16,0.081947,50,5411769,-1,8000.0,5456497,5456559,47732,62,14,7,True,True,17.098222222222223,-0.081947
7009,5408895,18,14,0.062194,50,5411769,-1,7000.0,5422872,5422890,13977,18,28,0,True,True,5.313000000000001,-0.062194
7010,5409161,8,71,0.888509,50,5411769,-1,35500.0,5438689,5438697,29528,8,20,0,True,True,10.978966666666665,-0.888509
7011,5420634,14037,16,0.476253,36,5420672,-1,8000.0,5481240,5495277,60606,14037,8,8,True,True,4327.420533333334,-0.44931274774859686
7012,5422871,157,16,0.446164,33,5422872,-1,8000.0,5449897,5450054,27026,157,18,8,True,True,44.29493333333333,-0.446164
7013,5422941,8321,16,0.369294,31,5423789,-1,8000.0,5467171,5475492,44230,8321,12,7,True,True,2253.084,-0.36567517519623965
7014,5477459,2,8,0.526256,28,5481240,-1,4000.0,5489329,5489331,11870,2,6,2,True,True,0.2790222222222222,-0.526256
7015,5477492,47,4,0.588239,28,5481240,-1,2000.0,5482344,5482391,4852,47,8,0,True,True,4.09605,-0.588239
7016,5477898,6728,1,0.518945,28,5481240,-1,500.0,5544741,5551469,66843,6728,6,0,True,True,130.52194444444444,-0.5029667896388592
7017,5477922,13,32,0.394782,28,5481240,-1,16000.0,5503942,5503955,26020,13,7,0,True,True,9.372133333333334,-0.394782
7018,5478470,419,8,0.263694,28,5481240,-1,4000.0,5503940,5504359,25470,419,8,6,True,True,75.51776666666667,-0.263694
7019,5478503,40,16,0.498827,28,5481240,-1,8000.0,5508642,5508682,30139,40,7,0,True,True,13.680888888888889,-0.498827
7020,5478704,24,15,0.423422,28,5481240,-1,7500.0,5514156,5514180,35452,24,7,6,True,True,6.135000000000001,-0.423422
7021,5478751,62,2,0.44008,28,5481240,-1,1000.0,5503942,5504004,25191,62,10,0,True,True,2.793616666666667,-0.44008
7022,5479037,2589,2,0.931036,28,5481240,-1,1000.0,5488844,5491433,9807,2589,13,0,True,True,96.89434722222222,-0.8825709115099992
7023,5479188,71,1,0.489541,28,5481240,-1,500.0,5494729,5494800,15541,71,12,0,True,True,1.523738888888889,-0.489541
7024,5479215,588,8,0.973272,28,5481240,-1,4000.0,5482340,5482928,3125,588,18,0,True,True,99.13337777777778,-0.9414113290531742
7025,5479876,5033,32,0.823812,28,5481240,-1,16000.0,5501740,5506773,21864,5033,12,1,True,True,3575.7241333333336,-0.8190273547721125
7026,5479895,11349,1,0.144346,28,5481240,-1,500.0,5523210,5534559,43315,11349,7,8,True,True,233.615075,-0.14349879136847243
7027,5480199,37,3,0.127124,28,5481240,-1,1500.0,5541141,5541178,60942,37,7,7,True,True,2.0345375,-0.127124
7028,5480208,151,1,0.711151,28,5481240,-1,500.0,5488844,5488995,8636,151,18,8,True,True,2.6332722222222222,-0.711151
7029,5480252,1035,2,0.129385,28,5481240,-1,1000.0,5501629,5502664,21377,1035,15,7,True,True,46.635374999999996,-0.129385
7030,5480313,14,32,0.704525,28,5481240,-1,16000.0,5482340,5482354,2027,14,24,6,True,True,9.7608,-0.704525
7031,5480362,4,1,0.863272,28,5481240,-1,500.0,5482340,5482344,1978,4,23,0,True,True,0.08715,-0.863272
7032,5480469,3,4,0.118058,28,5481240,-1,2000.0,5494729,5494732,14260,3,17,8,True,True,0.2575333333333334,-0.118058
7033,5480759,566,16,0.212643,28,5481240,-1,8000.0,5532034,5532600,51275,566,8,0,True,True,182.252,-0.212643
7034,5485254,131,2,0.473356,34,5488844,-1,1000.0,5516359,5516490,31105,131,10,7,True,True,5.238908333333333,-0.473356
7035,5485298,15703,245,0.746496,34,5488844,-1,122500.0,5632282,5647985,146984,15703,2,7,True,True,66267.67247916666,-0.7423327483477278
7036,5485316,3332,8,0.94407,34,5488844,-1,4000.0,5495829,5499161,10513,3332,19,6,True,True,582.1774222222223,-0.9327454563710379
7037,5486882,13,5,0.369332,34,5488844,-1,2500.0,5514159,5514172,27277,13,12,0,True,True,1.1077083333333333,-0.369332
7038,5486925,10610,19,0.951822,34,5488844,-1,9500.0,5511942,5522552,25017,10610,14,0,True,True,3968.210272222222,-0.8939218293137202
7039,5487043,7,26,0.6016,34,5488844,-1,13000.0,5503942,5503949,16899,7,18,0,True,True,4.100308333333333,-0.6016
7040,5487080,10179,3,0.40862,34,5488844,-1,1500.0,5532034,5542213,44954,10179,10,6,True,True,589.1745875,-0.4010258912431502
7041,5487115,84,1,0.120866,34,5488844,-1,500.0,5536734,5536818,49619,84,9,0,True,True,1.630875,-0.12080488922596065
7042,5487163,45,6,0.571765,34,5488844,-1,3000.0,5503940,5503985,16777,45,21,0,True,True,6.082875000000001,-0.5717650000000001
7043,5487270,308,31,0.040282,34,5488844,-1,15500.0,5536734,5537042,49464,308,10,5,True,True,185.12605833333336,-0.040207321413249994
7044,5487342,177,4,0.153305,34,5488844,-1,2000.0,5530923,5531100,43581,177,13,7,True,True,14.2485,-0.153305
7045,5487359,26976,32,0.371467,34,5488844,-1,16000.0,5570241,5597217,82882,26976,7,8,True,True,14886.1392,-0.36706762168811935
7046,5487843,2,1,0.99102,34,5488844,-1,500.0,5503940,5503942,16097,2,25,0,True,True,0.04505833333333333,-0.99102
7047,5490421,5,1,0.30326,59,5494729,-1,500.0,5530923,5530928,40502,5,14,0,True,True,0.100625,-0.30326
7048,5490572,21,2,0.485926,59,5494729,-1,1000.0,5516710,5516731,26138,21,17,0,True,True,0.839825,-0.485926
7049,5490962,111,4,0.791204,59,5494729,-1,2000.0,5501629,5501740,10667,111,30,0,True,True,10.00295,-0.791204
7050,5491084,157,4,0.14214,59,5494729,-1,2000.0,5533134,5533291,42050,157,12,6,True,True,12.383700000000001,-0.13927436942675156
7051,5491425,61,1,0.589624,59,5494729,-1,500.0,5511942,5512003,20517,61,23,0,True,True,1.0395416666666668,-0.589624
7052,5491435,11921,1,0.048651,59,5494729,-1,500.0,5550541,5562462,59106,11921,8,0,True,True,226.72200555555557,-0.0464339709047801
7053,5491457,33,16,0.894253,59,5494729,-1,8000.0,5503942,5503975,12485,33,29,0,True,True,11.8954,-0.894253
7054,5491562,13,16,0.889057,59,5494729,-1,8000.0,5502840,5502853,11278,13,33,6,True,True,4.686066666666667,-0.889057
7055,5491583,3979,4,0.215581,59,5494729,-1,2000.0,5513056,5517035,21473,3979,23,0,True,True,292.91874999999993,-0.20125148116273273
7056,5491672,6016,16,0.819125,59,5494729,-1,8000.0,5514159,5520175,22487,6016,22,1,True,True,1913.0976666666666,-0.7745793390536866
7057,5491709,6190,14,0.488794,59,5494729,-1,7000.0,5513056,5519246,21347,6190,25,6,True,True,1654.8334833333333,-0.4446947999412477
7058,5491949,14,16,0.122328,59,5494729,-1,8000.0,5511942,5511956,19993,14,26,0,True,True,3.8173333333333335,-0.122328
7059,5491967,22,5,0.348649,59,5494729,-1,2500.0,5508642,5508664,16675,22,30,0,True,True,2.351402777777778,-0.348649
7060,5491982,9,32,0.870427,59,5494729,-1,16000.0,5527610,5527619,35628,9,18,7,True,True,6.0656,-0.870427
7061,5492093,656,13,0.417575,59,5494729,-1,6500.0,5510842,5511498,18749,656,30,7,True,True,182.29784444444442,-0.417575
7062,5492111,86,6,0.573059,59,5494729,-1,3000.0,5502840,5502926,10729,86,40,0,True,True,11.625050000000002,-0.573059
7063,5492209,66,4,0.565764,59,5494729,-1,2000.0,5505042,5505108,12833,66,33,6,True,True,5.764366666666667,-0.565764
7064,5492297,16,2,0.900287,59,5494729,-1,1000.0,5499429,5499445,7132,16,46,2,True,True,0.7073777777777778,-0.900287
7065,5492396,13696,10,0.781349,59,5494729,-1,5000.0,5503942,5517638,11546,13696,38,0,True,True,2759.782,-0.7320268299999954
7066,5492736,12909,32,0.475228,59,5494729,-1,16000.0,5530934,5543843,38198,12909,16,1,True,True,7948.978266666667,-0.47068864396332744
7067,5492746,6972,4,0.720033,59,5494729,-1,2000.0,5510842,5517814,18096,6972,31,0,True,True,519.2896444444444,-0.6474290419862639
7068,5492762,7019,8,0.60571,59,5494729,-1,4000.0,5508642,5515661,15880,7019,35,5,True,True,1070.3954999999999,-0.5576881138063526
7069,5492799,67,8,0.761951,59,5494729,-1,4000.0,5505042,5505109,12243,67,36,0,True,True,11.70341111111111,-0.761951
7070,5493423,5372,16,0.504764,59,5494729,-1,8000.0,5530934,5536306,37511,5372,16,0,True,True,1694.9968000000001,-0.5003535595422898
7071,5493530,88,13,0.460936,59,5494729,-1,6500.0,5514159,5514247,20629,88,24,0,True,True,19.495666666666665,-0.460936
7072,5493769,13421,1,0.449929,59,5494729,-1,500.0,5579984,5593405,86215,13421,6,0,True,True,221.5427208333333,-0.42352791521589567
7073,5493787,13,8,0.449075,59,5494729,-1,4000.0,5511951,5511964,18164,13,31,0,True,True,1.7723333333333333,-0.449075
7074,5493820,8,4,0.866346,59,5494729,-1,2000.0,5503942,5503950,10122,8,44,0,True,True,0.7209333333333333,-0.866346
7075,5498257,36,16,0.325216,59,5499429,-1,8000.0,5523210,5523246,24953,36,22,0,True,True,12.1696,-0.325216
7076,5498524,6193,16,0.799812,59,5499429,-1,8000.0,5503942,5510135,5418,6193,47,0,True,True,2152.991177777778,-0.7814577302501339
7077,5498578,7933,4,0.664502,59,5499429,-1,2000.0,5538934,5546867,40356,7933,12,0,True,True,591.2346444444445,-0.6536166131475639
7078,5503043,45,2,0.409628,65,5503940,-1,1000.0,5525410,5525455,22367,45,23,7,True,True,1.9015000000000002,-0.409628
7079,5503055,41,4,0.232822,65,5503940,-1,2000.0,5527619,5527660,24564,41,22,0,True,True,3.454022222222222,-0.232822
7080,5503068,48,18,0.395397,65,5503940,-1,9000.0,5510842,5510890,7774,48,40,0,True,True,18.4692,-0.395397
7081,5503216,94,4,0.540994,65,5503940,-1,2000.0,5511942,5512036,8726,94,39,0,True,True,6.4076666666666675,-0.540994
7082,5503428,11,1,0.958079,65,5503940,-1,500.0,5503942,5503953,514,11,55,1,True,True,0.24782083333333335,-0.958079
7083,5503584,37,1,0.890043,65,5503940,-1,500.0,5503942,5503979,358,37,54,0,True,True,0.8335791666666668,-0.890043
7084,5503596,4,1,0.735913,65,5503940,-1,500.0,5528719,5528723,25123,4,22,6,True,True,0.08424444444444444,-0.735913
7085,5503600,11,32,0.645917,65,5503940,-1,16000.0,5511951,5511962,8351,11,37,1,True,True,5.998666666666667,-0.645917
7086,5503641,4,4,0.865954,65,5503940,-1,2000.0,5508642,5508646,5001,4,47,0,True,True,0.3420222222222222,-0.865954
7087,5503690,23431,64,0.707209,65,5503940,-1,32000.0,5517810,5541241,14120,23431,28,6,True,True,30551.725066666666,-0.7035355497459037
7088,5503736,280,16,0.571995,65,5503940,-1,8000.0,5511942,5512222,8206,280,43,0,True,True,76.34666666666666,-0.571995
7089,5503803,35,16,0.796159,65,5503940,-1,8000.0,5503942,5503977,139,35,59,0,True,True,12.616333333333333,-0.796159
7090,5504030,35,2,0.707399,55,5505042,-1,1000.0,5516710,5516745,12680,35,30,2,True,True,1.3997083333333333,-0.707399
7091,5504142,9,2,0.561044,55,5505042,-1,1000.0,5511942,5511951,7800,9,45,6,True,True,0.30675,-0.561044
7092,5504872,4,4,0.123782,55,5505042,-1,2000.0,5538941,5538945,34069,4,12,1,True,True,0.31006666666666666,-0.123782
7093,5505288,30625,128,0.559353,63,5508642,-1,64000.0,5593384,5624009,88096,30625,4,5,True,True,73762.74755555556,-0.5532811753069251
7094,5505382,7,2,0.192427,63,5508642,-1,1000.0,5538934,5538941,33552,7,14,0,True,True,0.2713083333333333,-0.192427
7095,5505403,262,33,0.618704,63,5508642,-1,16500.0,5511942,5512204,6539,262,45,0,True,True,147.34224999999998,-0.618704
7096,5505919,8727,128,0.576856,63,5508642,-1,64000.0,5572441,5581168,66522,8727,9,7,True,True,19867.624177777776,-0.5647457710680475
7097,5506043,1264,1,0.052874,63,5508642,-1,500.0,5538941,5540205,32898,1264,14,0,True,True,24.495266666666666,-0.052874
7098,5506093,121,1,0.570244,63,5508642,-1,500.0,5517810,5517931,11717,121,33,0,True,True,2.4194958333333334,-0.570244
7099,5507487,30,8,0.189396,63,5508642,-1,4000.0,5544741,5544771,37254,30,13,0,True,True,4.471333333333333,-0.189396
7100,5508181,351,2,0.475836,63,5508642,-1,1000.0,5516359,5516710,8178,351,38,0,True,True,14.037075,-0.475836
7101,5508235,556,16,0.896864,63,5508642,-1,8000.0,5510842,5511398,2607,556,57,0,True,True,190.16435555555555,-0.896864
7102,5508271,117,32,0.120283,63,5508642,-1,16000.0,5511956,5512073,3685,117,46,1,True,True,63.804,-0.120283
7103,5512274,9671,7,0.936182,48,5513056,-1,3500.0,5538934,5548605,26660,9671,19,7,True,True,1270.680425,-0.9055747865464101
7104,5512317,6,1,0.179743,48,5513056,-1,500.0,5527619,5527625,15302,6,31,1,True,True,0.12636666666666665,-0.179743
7105,5512777,20,7,0.018974,48,5513056,-1,3500.0,5544741,5544761,31964,20,14,5,True,True,2.6082777777777775,-0.018974
7106,5513422,88,138,0.786757,49,5514156,-1,69000.0,5552741,5552829,39319,88,11,7,True,True,243.6558666666667,-0.786757
7107,5513454,3,10,0.245287,49,5514156,-1,5000.0,5514156,5514159,702,3,47,0,True,True,0.51125,-0.245287
7108,5513708,7,2,0.705618,49,5514156,-1,1000.0,5514159,5514166,451,7,44,0,True,True,0.23858333333333334,-0.705618
7109,5517238,53,1,0.887656,40,5517810,-1,500.0,5525410,5525463,8172,53,35,0,True,True,1.1197722222222222,-0.887656
7110,5519081,16744,4,0.444229,43,5523210,-1,2000.0,5595605,5612349,76524,16744,4,7,True,True,1295.9330388888889,-0.44272163978188483
7111,5519111,53,15,0.806921,43,5523210,-1,7500.0,5528723,5528776,9612,53,32,1,True,True,16.74358333333333,-0.806921
7112,5519157,42120,185,0.606855,43,5523210,-1,92500.0,5674566,5716686,155409,42120,1,6,True,True,166057.24875000003,-0.606517991785208
7113,5519879,144,4,0.401798,43,5523210,-1,2000.0,5548341,5548485,28462,144,15,4,True,True,11.4976,-0.401798
7114,5522376,10914,32,0.044984,43,5523210,-1,16000.0,5579984,5590898,57608,10914,10,4,True,True,5568.342311111111,-0.0401785066642257
7115,5524692,16121,8,0.861974,44,5525410,-1,4000.0,5550541,5566662,25849,16121,16,7,True,True,2412.278977777778,-0.8329022445900975
7116,5525123,5,6,0.023263,44,5525410,-1,3000.0,5559341,5559346,34218,5,14,7,True,True,0.49745833333333334,-0.023262999999999995
7117,5525158,6,13,0.437017,44,5525410,-1,6500.0,5528723,5528729,3565,6,37,0,True,True,1.6427666666666665,-0.437017
7118,5525495,6,60,0.414936,50,5527610,-1,30000.0,5530928,5530934,5433,6,35,1,True,True,7.245000000000001,-0.414936
7119,5526245,9346,256,0.859648,50,5527610,-1,128000.0,5716686,5726032,190441,9346,1,7,True,True,51603.90186666667,-0.8316785295985882
7120,5526393,11543,64,0.317382,50,5527610,-1,32000.0,5564841,5576384,38448,11543,15,7,True,True,13256.06293333333,-0.31540108838109615
7121,5526548,25,1,0.257178,50,5527610,-1,500.0,5560441,5560466,33893,25,16,6,True,True,0.4145486111111111,-0.257178
7122,5526694,11103,1,0.114645,50,5527610,-1,500.0,5593405,5604508,66711,11103,7,1,True,True,201.66023472222224,-0.10951237012939657
7123,5526755,39,32,0.099334,50,5527610,-1,16000.0,5557141,5557180,30386,39,19,7,True,True,25.43146666666667,-0.099334
7124,5526871,12087,32,0.168156,50,5527610,-1,16000.0,5572441,5584528,45570,12087,14,0,True,True,6706.716177777777,-0.16235248172124345
7125,5526964,9,32,0.144034,50,5527610,-1,16000.0,5554941,5554950,27977,9,21,7,True,True,5.8688,-0.144034
7126,5529375,6075,128,0.255555,46,5530923,-1,64000.0,5582184,5588259,52809,6075,11,7,True,True,12080.955733333334,-0.2411569102307096
7127,5529431,6,1,0.089629,46,5530923,-1,500.0,5562641,5562647,33210,6,19,7,True,True,0.10756666666666669,-0.089629
1150,994133,154,1,0.052609,1,994133,-1,500.0,996333,996487,2200,154,0,7,True,True,3.247261111111111,-0.052609
1151,994202,6763,2,0.15741,10,996333,-1,1000.0,1007633,1014396,13431,6763,0,7,True,True,226.15995833333332,-0.1540474208191054
1152,994284,10744,16,0.617838,10,996333,-1,8000.0,1000733,1011477,6449,10744,1,0,True,True,2874.790911111111,-0.6128797583693111
1153,994848,30,1,0.673969,10,996333,-1,500.0,996333,996363,1485,30,2,0,True,True,0.6325833333333333,-0.673969
1154,994925,4132,128,0.272103,10,996333,-1,64000.0,1009833,1013965,14908,4132,0,7,True,True,8901.219022222223,-0.26781577968175974
1155,995038,72,1,0.661939,10,996333,-1,500.0,998533,998605,3495,72,3,7,True,True,1.2047,-0.661939
1156,995070,14346,1,0.485662,10,996333,-1,500.0,1005433,1019779,10363,14346,2,2,True,True,259.43778055555555,-0.4483866950237953
1157,995191,16,40,0.442044,10,996333,-1,20000.0,1000733,1000749,5542,16,4,7,True,True,10.708444444444444,-0.442044
1158,995919,234,8,0.273167,10,996333,-1,4000.0,1001833,1002067,5914,234,3,6,True,True,31.6446,-0.273167
1159,995960,21928,16,0.754943,10,996333,-1,8000.0,1011477,1033405,15517,21928,0,1,True,True,7399.723177777779,-0.7277456743581256
1160,995966,8966,256,0.113818,10,996333,-1,128000.0,1093171,1042371,97205,8966,0,7,True,True,31257.030755555556,-0.11368206877218108
1161,1093171,1,5,0.429914,1,1093171,-1,2500.0,1093221,1093172,50,1,0,0,True,True,0.06438888888888888,-0.429914
1162,1093221,15556,64,0.283246,1,1093221,-1,32000.0,1094321,1109877,1100,15556,0,6,True,True,14652.885511111112,-0.25943012202774823
1163,1093281,10,1,0.678486,8,1094321,-1,500.0,1095421,1095431,2140,10,0,6,True,True,0.13009722222222223,-0.678486
1164,1093299,23,1,0.486633,8,1094321,-1,500.0,1110830,1110853,17531,23,0,7,True,True,0.4907305555555556,-0.486633
1165,1093712,4738,32,0.667133,8,1094321,-1,16000.0,1099821,1104559,6109,4738,1,0,True,True,2125.4385333333335,-0.6544974315804292
1166,1093772,12,8,0.045417,8,1094321,-1,4000.0,1123230,1123242,29458,12,0,1,True,True,1.8242666666666667,-0.045417
1167,1093777,14,8,0.395263,8,1094321,-1,4000.0,1107530,1107544,13753,14,2,7,True,True,1.7594888888888889,-0.395263
1168,1093910,16958,1,0.599325,8,1094321,-1,500.0,1334347,1351305,240437,16958,0,7,True,True,206.7727375,-0.5748698134875717
1169,1093937,63,1,0.007687,8,1094321,-1,500.0,1097621,1097684,3684,63,5,7,True,True,0.8196125000000001,-0.007687
1170,1093970,6681,4,0.301419,8,1094321,-1,2000.0,1145030,1151711,51060,6681,1,7,True,True,495.4602555555556,-0.30006474784920745
1171,1094413,13584,4,0.211234,16,1095421,-1,2000.0,1352847,1366431,258434,13584,0,4,True,True,945.9113,-0.19905482021038462
1172,1094762,81,1,0.137235,16,1095421,-1,500.0,1116330,1116411,21568,81,4,6,True,True,1.4599125000000002,-0.137235
1173,1094806,4127,4,0.25552,16,1095421,-1,2000.0,1108630,1112757,13824,4127,6,6,True,True,344.04707777777776,-0.25422127616674567
1174,1094913,15538,1,0.328122,16,1095421,-1,500.0,1127630,1143168,32717,15538,3,7,True,True,316.8572361111111,-0.3261528100995293
1175,1095007,5,6,0.00773,16,1095421,-1,3000.0,1105330,1105335,10323,5,9,6,True,True,0.47129166666666666,-0.00773
1176,1095043,7568,1,0.747014,16,1095421,-1,500.0,1111930,1119498,16887,7568,6,6,True,True,138.93456388888887,-0.6951386145907396
1177,1095366,20494,2,0.175695,16,1095421,-1,1000.0,1170752,1191246,75386,20494,2,8,True,True,886.3887888888888,-0.175053786301802
1178,1095385,18,16,0.380207,16,1095421,-1,8000.0,1118530,1118548,23145,18,6,7,True,True,5.1908,-0.380207
1179,1095413,34,4,0.703671,16,1095421,-1,2000.0,1102030,1102064,6617,34,13,7,True,True,1.8705666666666667,-0.703671
1180,1095456,22,2,0.500262,23,1097621,-1,1000.0,1105330,1105352,9874,22,12,0,True,True,0.6912277777777778,-0.500262
1181,1095651,10565,1,0.833354,23,1097621,-1,500.0,1118530,1129095,22879,10565,6,0,True,True,201.2522013888889,-0.8246775367648936
1182,1095814,3,16,0.8062,23,1097621,-1,8000.0,1104230,1104233,8416,3,15,7,True,True,0.6602,-0.8062
1183,1095861,25,1,0.072075,23,1097621,-1,500.0,1113030,1113055,17169,25,9,6,True,True,0.4573611111111111,-0.072075
1184,1095977,15240,7,0.861764,23,1097621,-1,3500.0,1119630,1134870,23653,15240,6,6,True,True,2081.692375,-0.8541515622460714
1185,1095989,22,1,0.042302,23,1097621,-1,500.0,1135230,1135252,39241,22,4,8,True,True,0.437525,-0.042302
1186,1096064,35,2,0.018742,23,1097621,-1,1000.0,1099830,1099865,3766,35,20,1,True,True,1.0120833333333332,-0.018742
1187,1097312,6379,2,0.921162,23,1097621,-1,1000.0,1099821,1106200,2509,6379,22,7,True,True,181.89219444444444,-0.8660396072187119
1188,1098703,9,1,0.86211,23,1099821,-1,500.0,1099821,1099830,1118,9,22,0,True,True,0.130125,-0.86211
1189,1102692,3,8,0.575759,20,1104230,-1,4000.0,1125430,1125433,22738,3,6,7,True,True,0.4560666666666667,-0.575759
1190,1102770,8,2,0.5734,20,1104230,-1,1000.0,1115230,1115238,12460,8,12,7,True,True,0.2927111111111111,-0.5734
1191,1126168,9182,1,0.709499,9,1127630,-1,500.0,1137430,1146612,11262,9182,4,7,True,True,190.95780833333333,-0.7085371925156333
1192,1126543,12,1,0.417694,9,1127630,-1,500.0,1135230,1135242,8687,12,5,0,True,True,0.23865,-0.417694
1193,1126627,8,2,0.115173,9,1127630,-1,1000.0,1146130,1146138,19503,8,3,0,True,True,0.3159111111111111,-0.115173
1194,1127158,4722,32,0.020857,9,1127630,-1,16000.0,1129830,1134552,2672,4722,8,7,True,True,3043.2914666666666,-0.020846934879175615
1195,1135592,103,36,0.324768,8,1137430,-1,18000.0,1142830,1142933,7238,103,5,8,True,True,77.79075,-0.324768
1196,1135907,12,1,0.801322,8,1137430,-1,500.0,1137430,1137442,1523,12,6,0,True,True,0.23865,-0.801322
1197,1137382,3744,8,0.618125,8,1137430,-1,4000.0,1146130,1149874,8748,3744,4,6,True,True,562.7244888888888,-0.5909659949112659
1198,1139349,9081,1,0.832026,7,1142830,-1,500.0,1147230,1156311,7881,9081,3,6,True,True,157.76864999999998,-0.7935743840454015
1199,1146845,26,1,0.91977,8,1147230,-1,500.0,1149430,1149456,2585,26,3,7,True,True,0.45016111111111107,-0.91977
1200,1146985,279,1,0.08813,8,1147230,-1,500.0,1152074,1152353,5089,279,3,7,True,True,4.746875,-0.08813
1201,1147010,5,23,0.844484,8,1147230,-1,11500.0,1149874,1149879,2864,5,4,2,True,True,1.9910972222222225,-0.844484
1202,1147066,593,16,0.243316,8,1147230,-1,8000.0,1157574,1158167,10508,593,3,0,True,True,147.9600888888889,-0.243316
1203,1147188,25840,32,0.588871,8,1147230,-1,16000.0,1340947,1366787,193759,25840,1,6,True,True,12151.927911111112,-0.5587222525903204
1204,1147611,3,10,0.523963,9,1149430,-1,5000.0,1154274,1154277,6663,3,5,7,True,True,0.5104166666666666,-0.523963
1205,1148007,12000,2,0.395767,9,1149430,-1,1000.0,1299866,1311866,151859,12000,3,6,True,True,361.41532222222224,-0.38454052647169695
1206,1149858,6,8,0.310275,9,1149874,-1,4000.0,1163152,1163158,13294,6,5,0,True,True,0.9970666666666668,-0.310275
1207,1149895,19,1,0.339513,14,1152074,-1,500.0,1187338,1187357,37443,19,4,7,True,True,0.46365277777777775,-0.339513
1208,1149959,40703,8,0.333069,14,1152074,-1,4000.0,1344547,1385250,194588,40703,1,4,True,True,4981.825122222222,-0.33098962667128035
1209,1150623,31,1,0.168133,14,1152074,-1,500.0,1155374,1155405,4751,31,9,6,True,True,0.5274305555555555,-0.168133
1210,1150917,11999,8,0.510483,14,1152074,-1,4000.0,1298766,1310765,147849,11999,5,1,True,True,1430.3153444444445,-0.49004209107700075
1211,1151265,945,1,0.114027,14,1152074,-1,500.0,1187338,1188283,36073,945,6,0,True,True,22.03553611111111,-0.10895828175262669
1212,1151881,41,4,0.509952,14,1152074,-1,2000.0,1157574,1157615,5693,41,11,7,True,True,2.557488888888889,-0.509952
1213,1152096,5885,64,0.905923,17,1154274,-1,32000.0,1219498,1225383,67402,5885,6,0,True,True,6428.777511111111,-0.7449803694691829
1214,1152326,16,4,0.349375,17,1154274,-1,2000.0,1171901,1171917,19575,16,9,0,True,True,1.2505777777777778,-0.349375
1215,1152376,78,1,0.727379,17,1154274,-1,500.0,1157574,1157652,5198,78,13,0,True,True,1.2163666666666668,-0.727379
1216,1152625,2691,32,0.818949,17,1154274,-1,16000.0,1171917,1174608,19292,2691,9,0,True,True,1648.1116000000002,-0.8021379500058361
1217,1154344,11288,256,0.815037,21,1155374,-1,128000.0,1424256,1435544,269912,11288,0,7,True,True,46484.545422222225,-0.7456227588031045
1218,1154580,39231,21,0.236269,21,1155374,-1,10500.0,1336547,1375778,181967,39231,4,7,True,True,12927.245216666668,-0.233213732178724
1219,1154754,47,4,0.146444,21,1155374,-1,2000.0,1185138,1185185,30384,47,11,6,True,True,4.587722222222222,-0.146444
1220,1154807,20,1,0.197272,21,1155374,-1,500.0,1163152,1163172,8345,20,15,0,True,True,0.41544444444444445,-0.197272
1221,1155116,73,1,0.602399,21,1155374,-1,500.0,1173022,1173095,17906,73,12,1,True,True,1.4264402777777776,-0.602399
1222,1156885,275,32,0.760215,24,1157574,-1,16000.0,1158752,1159027,1867,275,18,6,True,True,137.23111111111112,-0.760215
1223,1156930,21,16,0.655509,24,1157574,-1,8000.0,1157652,1157673,722,21,19,2,True,True,5.239733333333334,-0.655509
1224,1157013,250,16,0.177146,24,1157574,-1,8000.0,1204129,1204379,47116,250,9,1,True,True,80.72222222222223,-0.177146
1225,1157242,3957,128,0.772848,24,1157574,-1,64000.0,1160952,1164909,3710,3957,19,7,True,True,9299.232,-0.6987732054178706
1226,1157590,4,1,0.494117,22,1157652,-1,500.0,1163152,1163156,5562,4,18,0,True,True,0.08308888888888889,-0.494117
1227,1157662,571,4,0.754446,26,1158752,-1,2000.0,1163152,1163723,5490,571,20,0,True,True,47.44375555555556,-0.754446
1228,1157674,47,22,0.759877,26,1158752,-1,11000.0,1158752,1158799,1078,47,22,0,True,True,16.12465555555556,-0.759877
1229,1157686,12145,27,0.448905,26,1158752,-1,13500.0,1171893,1184038,14207,12145,16,0,True,True,6941.6543624999995,-0.4423020916102056
1230,1158062,1278,1,0.924154,26,1158752,-1,500.0,1163152,1164430,5090,1278,22,7,True,True,26.5469,-0.924154
1231,1158132,9455,1,0.564492,26,1158752,-1,500.0,1204157,1213612,46025,9455,9,0,True,True,217.30939722222223,-0.5473290834368869
1232,1159630,20,4,0.635298,27,1160952,-1,2000.0,1165352,1165372,5722,20,19,7,True,True,1.6617777777777778,-0.635298
1233,1160181,12751,8,0.624522,27,1160952,-1,4000.0,1191733,1204484,31552,12751,11,0,True,True,1895.8120555555556,-0.6121996682379685
1234,1160206,1405,23,0.864247,27,1160952,-1,11500.0,1171893,1173298,11687,1405,19,0,True,True,631.4440763888889,-0.864247
1235,1162444,17559,29,0.627217,35,1163152,-1,14500.0,1242017,1259576,79573,17559,8,0,True,True,7894.158955555556,-0.6271532456471576
1236,1162633,10395,1,0.150957,35,1163152,-1,500.0,1208869,1219264,46236,10395,10,0,True,True,243.62429722222222,-0.14943757642871766
1237,1162667,27183,1,0.068286,35,1163152,-1,500.0,1339847,1367030,177180,27183,4,7,True,True,399.70046111111117,-0.06595874341126166
1238,1162881,1,1,0.442208,35,1163152,-1,500.0,1177438,1177439,14557,1,18,7,True,True,0.022569444444444444,-0.442208
1239,1162899,378,16,0.30282,35,1163152,-1,8000.0,1163152,1163530,253,378,26,0,True,True,125.6304,-0.30282
1240,1162909,8618,32,0.274674,35,1163152,-1,16000.0,1171893,1180511,8984,8618,24,0,True,True,5586.325911111111,-0.2697115392684459
1241,1162924,907,61,0.056172,35,1163152,-1,30500.0,1171901,1172808,8977,907,22,1,True,True,1081.1049486111112,-0.056172
1242,1162981,3,2,0.507337,35,1163152,-1,1000.0,1171917,1171920,8936,3,20,0,True,True,0.11724166666666667,-0.507337
1243,1163064,15836,49,0.310408,35,1163152,-1,24500.0,1240917,1256753,77853,15836,10,7,True,True,12151.102551388889,-0.30749655753728095
1244,1163448,240,4,0.451914,33,1165352,-1,2000.0,1180511,1180751,17063,240,19,0,True,True,21.666666666666668,-0.451914
1245,1164035,54,2,0.05689,33,1165352,-1,1000.0,1204103,1204157,40068,54,15,0,True,True,2.1795,-0.05689
1246,1164071,1339,2,0.831697,33,1165352,-1,1000.0,1165352,1166691,1281,1339,31,0,True,True,54.118852777777775,-0.8091335030622562
1247,1165297,130,1,0.076731,33,1165352,-1,500.0,1204126,1204256,38829,130,15,0,True,True,2.623472222222222,-0.076731
1248,1165977,107,16,0.86425,61,1170752,-1,8000.0,1171893,1172000,5916,107,30,0,True,True,33.452955555555555,-0.86425
1249,1166085,343,1,0.855293,61,1170752,-1,500.0,1171917,1172260,5832,343,26,2,True,True,6.702315277777778,-0.855293
1250,1166325,41,16,0.615008,61,1170752,-1,8000.0,1171852,1171893,5527,41,33,6,True,True,12.818422222222223,-0.615008
1251,1166467,320,4,0.507068,61,1170752,-1,2000.0,1171893,1172213,5426,320,31,0,True,True,25.011555555555557,-0.507068
1252,1166489,16048,16,0.462712,61,1170752,-1,8000.0,1204103,1220151,37614,16048,16,0,True,True,5946.810488888889,-0.461753026347274
1253,1166504,6611,8,0.554316,61,1170752,-1,4000.0,1171893,1178504,5389,6611,30,0,True,True,1034.2064777777778,-0.5115412255920304
1254,1166548,6845,8,0.791818,61,1170752,-1,4000.0,1182711,1189556,16163,6845,22,7,True,True,1278.6330222222223,-0.7715986859038129
1255,1166563,8,5,0.895877,61,1170752,-1,2500.0,1171893,1171901,5330,8,37,0,True,True,0.7816111111111111,-0.895877
1256,1166965,13672,32,0.449734,61,1170752,-1,16000.0,1211032,1224704,44067,13672,12,2,True,True,9191.662222222221,-0.42967385519710843
1257,1166983,17,1,0.809816,61,1170752,-1,500.0,1171893,1171910,4910,17,39,1,True,True,0.33218472222222223,-0.809816
1258,1167043,5,2,0.651837,61,1170752,-1,1000.0,1184038,1184043,16995,5,23,0,True,True,0.23472222222222222,-0.651837
1259,1167058,13082,32,0.321527,61,1170752,-1,16000.0,1223794,1236876,56736,13082,11,4,True,True,6933.245777777778,-0.3151428762026602
1260,1167100,21,32,0.475629,61,1170752,-1,16000.0,1188433,1188454,21333,21,21,0,True,True,13.964533333333334,-0.475629
1261,1167121,2163,1,0.150861,61,1170752,-1,500.0,1208869,1211032,41748,2163,14,0,True,True,50.88909722222222,-0.14732564923216518
1262,1167209,4961,4,0.061874,61,1170752,-1,2000.0,1238717,1243678,71508,4961,11,2,True,True,316.7351611111111,-0.06099190754136111
1263,1167268,1093,1,0.103502,61,1170752,-1,500.0,1175238,1176331,7970,1093,31,0,True,True,20.187102777777778,-0.103502
1264,1167302,11886,27,0.899127,61,1170752,-1,13500.0,1185138,1197024,17836,11886,26,0,True,True,6601.18725,-0.87997978427013
1265,1167605,8344,4,0.343438,61,1170752,-1,2000.0,1204157,1212501,36552,8344,18,0,True,True,765.3551222222222,-0.33964326027899455
1266,1167610,121,4,0.714316,61,1170752,-1,2000.0,1171917,1172038,4307,121,37,0,True,True,9.457494444444444,-0.714316
1267,1169111,2,8,0.504549,61,1170752,-1,4000.0,1175238,1175240,6127,2,34,1,True,True,0.2955111111111111,-0.504549
1268,1169121,13195,173,0.172559,61,1170752,-1,86500.0,1175238,1188433,6117,13195,34,0,True,True,51698.460286111105,-0.16997979639281022
1269,1169177,61,8,0.247744,61,1170752,-1,4000.0,1204126,1204187,34949,61,20,0,True,True,9.848111111111113,-0.247744
1270,1169243,16,32,0.437758,61,1170752,-1,16000.0,1175222,1175238,5979,16,37,0,True,True,9.456355555555556,-0.437758
1271,1169296,5,16,0.439422,61,1170752,-1,8000.0,1173017,1173022,3721,5,39,6,True,True,1.5632222222222223,-0.439422
1272,1169303,8961,16,0.522748,61,1170752,-1,8000.0,1231513,1240474,62210,8961,12,7,True,True,2440.3768666666665,-0.5219803225965315
1273,1169527,7861,44,0.158746,61,1170752,-1,22000.0,1204157,1212018,34630,7861,20,1,True,True,7925.033477777777,-0.1556226075677289
1274,1169538,9,2,0.372852,61,1170752,-1,1000.0,1208869,1208878,39331,9,18,5,True,True,0.43365000000000004,-0.372852
1275,1169590,7460,1,0.282894,61,1170752,-1,500.0,1349247,1356707,179657,7460,2,5,True,True,95.72619305555556,-0.26637909973596885
1276,1170047,76,4,0.408769,61,1170752,-1,2000.0,1204139,1204215,34092,76,23,0,True,True,6.13488888888889,-0.408769
1277,1170344,75,1,0.338367,61,1170752,-1,500.0,1175222,1175297,4878,75,43,7,True,True,1.3852083333333332,-0.338367
1278,1173850,14008,30,0.597886,55,1175222,-1,15000.0,1220194,1234202,46344,14008,15,1,True,True,6802.737416666667,-0.534496712397424
1279,1174083,8200,16,0.789227,55,1175222,-1,8000.0,1188433,1196633,14350,8200,32,0,True,True,2542.8265333333334,-0.7815905034483303
1280,1174102,3921,77,0.647305,55,1175222,-1,38500.0,1190633,1194554,16531,3921,31,7,True,True,5873.740094444445,-0.6102393849705873
1281,1174179,15452,16,0.065912,55,1175222,-1,8000.0,1309266,1324718,135087,15452,8,4,True,True,4828.960266666667,-0.06576582830074003
1282,1174239,1532,1,0.094506,55,1175222,-1,500.0,1204126,1205658,29887,1532,29,0,True,True,30.916611111111116,-0.094506
1283,1174274,58,32,0.678379,55,1175222,-1,16000.0,1184038,1184096,9764,58,41,0,True,True,43.56444444444444,-0.678379
1284,1174317,200,2,0.284147,55,1175222,-1,1000.0,1215432,1215632,41115,200,18,6,True,True,9.443333333333332,-0.284147
1285,1174618,578,1,0.723734,55,1175222,-1,500.0,1175238,1175816,620,578,46,0,True,True,10.675338888888888,-0.723734
1286,1174663,23,35,0.656564,55,1175222,-1,17500.0,1204103,1204126,29440,23,33,2,True,True,16.245347222222225,-0.656564
1287,1174775,16600,4,0.906343,55,1175222,-1,2000.0,1238717,1255317,63942,16600,13,0,True,True,1045.5165555555554,-0.9053365091922494
1288,1174799,9673,32,0.87328,55,1175222,-1,16000.0,1296978,1306651,122179,9673,11,7,True,True,4609.608888888889,-0.8719069736225018
1289,1174889,6527,4,0.333362,55,1175222,-1,2000.0,1240917,1247444,66028,6527,13,0,True,True,419.3279611111111,-0.33280099298308186
1290,1176555,56,1,0.58274,53,1177438,-1,500.0,1188283,1188339,11728,56,41,0,True,True,1.1637111111111111,-0.58274
1291,1176646,63,32,0.141428,53,1177438,-1,16000.0,1197133,1197196,20487,63,37,8,True,True,34.664,-0.141428
1292,1176692,460,40,0.349821,53,1177438,-1,20000.0,1180511,1180971,3819,460,51,1,True,True,421.4527777777778,-0.3413679674749164
1293,1176978,311,1,0.967697,53,1177438,-1,500.0,1178538,1178849,1560,311,52,6,True,True,7.019097222222222,-0.967697
1294,1177613,2086,2,0.69848,56,1178538,-1,1000.0,1184038,1186124,6425,2086,49,1,True,True,101.13466666666666,-0.6938577728641658
1295,1177628,9,16,0.391958,56,1178538,-1,8000.0,1204126,1204135,26498,9,34,1,True,True,2.906,-0.391958
1296,1177643,65,1,0.595041,56,1178538,-1,500.0,1188433,1188498,10790,65,41,0,True,True,1.350736111111111,-0.595041
1297,1178313,4026,32,0.938002,56,1178538,-1,16000.0,1187338,1191364,9025,4026,46,0,True,True,2753.933688888889,-0.8347751036787334
1298,1178624,16454,256,0.309582,59,1180511,-1,128000.0,1462734,1479188,284110,16454,0,8,True,True,82912.81351111112,-0.30303029435781914
1299,1178638,12363,256,0.376679,59,1180511,-1,128000.0,1443404,1455767,264766,12363,1,8,True,True,66923.36675555554,-0.37568599537659253
1300,1178662,147,1,0.791662,59,1180511,-1,500.0,1180511,1180658,1849,147,57,0,True,True,3.3177083333333335,-0.791662
1301,1178718,6469,32,0.813185,59,1180511,-1,16000.0,1208869,1215338,30151,6469,27,0,True,True,4855.86,-0.7988827008808567
1302,1183323,278,32,0.670116,62,1184038,-1,16000.0,1188433,1188711,5110,278,47,0,True,True,184.8638222222222,-0.670116
1303,1183672,116,1,0.828959,62,1184038,-1,500.0,1188298,1188414,4626,116,48,1,True,True,2.4105444444444446,-0.828959
1304,1183685,13339,8,0.738775,62,1184038,-1,4000.0,1270553,1283892,86868,13339,14,7,True,True,1962.6777000000002,-0.7378580210714359
1305,1183718,6208,8,0.685414,62,1184038,-1,4000.0,1187338,1193546,3620,6208,51,0,True,True,1023.8334444444445,-0.6175387845098275
1306,1183767,10726,2,0.526393,62,1184038,-1,1000.0,1282678,1293404,98911,10726,14,0,True,True,320.7364666666667,-0.5055665029371667
1307,1183900,76,4,0.646025,62,1184038,-1,2000.0,1191733,1191809,7833,76,45,6,True,True,5.782333333333333,-0.646025
1308,1183938,4,8,0.423406,62,1184038,-1,4000.0,1205269,1205273,21331,4,31,6,True,True,0.6457777777777778,-0.423406
1309,1184946,18041,8,0.361828,62,1185138,-1,4000.0,1345647,1363688,160701,18041,5,6,True,True,2046.4513444444444,-0.34864486369060893
1310,1185012,163,2,0.362598,62,1185138,-1,1000.0,1204157,1204320,19145,163,34,0,True,True,6.578861111111111,-0.362598
1311,1185031,22,12,0.180263,62,1185138,-1,6000.0,1215432,1215454,30401,22,26,0,True,True,6.2326,-0.180263
1312,1185212,4,1,0.214193,63,1187338,-1,500.0,1291478,1291482,106266,4,15,7,True,True,0.05530555555555555,-0.214193
1313,1185291,84,32,0.947668,63,1187338,-1,16000.0,1198303,1198387,13012,84,48,1,True,True,46.21866666666667,-0.947668
1314,1185684,15,4,0.486271,63,1187338,-1,2000.0,1188283,1188298,2599,15,59,2,True,True,1.2468333333333335,-0.486271
1315,1191642,84,1,0.226543,52,1191733,-1,500.0,1238633,1238717,46991,84,23,0,True,True,1.3238166666666666,-0.226543
1316,1191737,2892,1,0.137565,70,1197133,-1,500.0,1216532,1219424,24795,2892,28,6,True,True,67.41521111111112,-0.1358320434549537
1317,1191778,247,3,0.077165,70,1197133,-1,1500.0,1243678,1243925,51900,247,18,4,True,True,12.119466666666666,-0.07716500000000001
1318,1191811,5636,8,0.844428,70,1197133,-1,4000.0,1200503,1206139,8692,5636,51,7,True,True,890.7483222222223,-0.7355919283137822
1319,1192077,4,1,0.101141,70,1197133,-1,500.0,1231733,1231737,39656,4,25,1,True,True,0.06590555555555555,-0.101141
1320,1192104,16915,256,0.770875,70,1197133,-1,128000.0,1479188,1496103,287084,16915,0,7,True,True,63177.22595555555,-0.7382358631335267
1321,1192299,3,8,0.83512,70,1197133,-1,4000.0,1198300,1198303,6001,3,55,1,True,True,0.4126666666666667,-0.83512
1322,1192348,269,64,0.883682,70,1197133,-1,32000.0,1204169,1204438,11821,269,40,1,True,True,347.42844444444444,-0.883682
1323,1194337,3071,8,0.037747,70,1197133,-1,4000.0,1243678,1246749,49341,3071,19,0,True,True,395.4654888888889,-0.03714975269444037
1324,1194394,48,8,0.336764,70,1197133,-1,4000.0,1198300,1198348,3906,48,57,0,True,True,6.602666666666667,-0.336764
1325,1194454,28023,1,0.766308,70,1197133,-1,500.0,1226013,1254036,31559,28023,29,0,True,True,454.8345541666667,-0.7606617462130459
1326,1194499,48,16,0.131049,70,1197133,-1,8000.0,1219424,1219472,24925,48,33,3,True,True,17.87946666666667,-0.131049
1327,1194846,25,32,0.37672,70,1197133,-1,16000.0,1219424,1219449,24578,25,33,0,True,True,18.624444444444443,-0.37672
1328,1194889,6967,256,0.162247,70,1197133,-1,128000.0,1455767,1462734,260878,6967,2,7,True,True,33888.825955555556,-0.1486551417389283
1329,1195374,67,16,0.831345,70,1197133,-1,8000.0,1198233,1198300,2859,67,63,6,True,True,18.432444444444442,-0.831345
1330,1195475,6491,128,0.771098,70,1197133,-1,64000.0,1305666,1312157,110191,6491,14,4,True,True,12504.227377777777,-0.740984489162472
1331,1195492,4762,4,0.809044,70,1197133,-1,2000.0,1215432,1220194,19940,4762,39,0,True,True,445.24162222222225,-0.8037611903299561
1332,1195820,14,8,0.165539,70,1197133,-1,4000.0,1237533,1237547,41713,14,29,5,True,True,2.0433777777777777,-0.165539
1333,1195870,669,19,0.437673,70,1197133,-1,9500.0,1205269,1205938,9399,669,47,0,True,True,256.51504166666666,-0.437673
1334,1196468,8784,128,0.410859,70,1197133,-1,64000.0,1214332,1223116,17864,8784,42,7,True,True,23617.164088888887,-0.39167183524870863
1335,1197052,6,8,0.676363,70,1197133,-1,4000.0,1216532,1216538,19480,6,38,0,True,True,1.1332,-0.676363
1336,1197189,7288,36,0.23753,74,1198233,-1,18000.0,1291478,1298766,94289,7288,18,0,True,True,3834.9962000000005,-0.23631203363164835
1337,1197554,19,2,0.444199,74,1198233,-1,1000.0,1225994,1226013,28440,19,34,7,True,True,0.6376083333333333,-0.444199
1338,1197715,7726,184,0.284928,74,1198233,-1,92000.0,1256753,1264479,59038,7726,22,0,True,True,20341.340044444445,-0.264090544789433
1339,1197805,30512,128,0.748537,74,1198233,-1,64000.0,1356447,1386959,158642,30512,5,5,True,True,63818.67413333333,-0.722377189135502
1340,1197926,48,8,0.448928,74,1198233,-1,4000.0,1238633,1238681,40707,48,32,6,True,True,6.051733333333334,-0.448928
1341,1198812,23,1,0.534011,75,1200503,-1,500.0,1216538,1216561,17726,23,43,1,True,True,0.5429916666666667,-0.534011
1342,1198938,16,1,0.309468,75,1200503,-1,500.0,1226013,1226029,27075,16,36,0,True,True,0.2684666666666667,-0.309468
1343,1198971,14212,2,0.808624,75,1200503,-1,1000.0,1219424,1233636,20453,14212,42,0,True,True,470.7166111111111,-0.7409984172429473
1344,1199693,30,8,0.469016,75,1200503,-1,4000.0,1204139,1204169,4446,30,65,2,True,True,4.843333333333334,-0.469016
1345,1199930,7380,1,0.835113,75,1200503,-1,500.0,1212132,1219512,12202,7380,52,6,True,True,172.946,-0.8349343744645427
1346,1202155,74,8,0.367841,84,1204103,-1,4000.0,1219424,1219498,17269,74,42,0,True,True,13.78208888888889,-0.367841
1347,1202424,36,2,0.94713,84,1204103,-1,1000.0,1204103,1204139,1679,36,74,0,True,True,1.453,-0.94713
1348,1202559,26,8,0.98444,84,1204103,-1,4000.0,1204103,1204129,1544,26,74,0,True,True,4.197555555555556,-0.98444
1349,1202714,24,7,0.46168,84,1204103,-1,3500.0,1231733,1231757,29019,24,34,0,True,True,2.7680333333333333,-0.46168
1350,1203627,197,1,0.281772,84,1204103,-1,500.0,1219424,1219621,15797,197,45,0,True,True,4.5862694444444445,-0.281772
1351,1203673,4662,4,0.381872,84,1204103,-1,2000.0,1215432,1220094,11759,4662,53,0,True,True,435.92940000000004,-0.37932558219989354
1352,1203713,62,32,0.52746,84,1204103,-1,16000.0,1211032,1211094,7319,62,57,0,True,True,46.10595555555555,-0.52746
1353,1203772,135,2,0.966268,84,1204103,-1,1000.0,1204103,1204238,331,135,81,0,True,True,5.44875,-0.966268
1354,1203872,57,32,0.816891,84,1204103,-1,16000.0,1217638,1217695,13766,57,48,6,True,True,42.46373333333334,-0.816891
1355,1203924,23275,43,0.801259,84,1204103,-1,21500.0,1294778,1318053,90854,23275,19,6,True,True,15808.597579166666,-0.750404074082468
1356,1205505,6,32,0.138399,67,1208869,-1,16000.0,1216538,1216544,11033,6,50,0,True,True,4.5328,-0.138399
1357,1205783,9475,256,0.250003,67,1208869,-1,128000.0,1396436,1405911,190653,9475,5,8,True,True,48312.14755555555,-0.24972537199331973
1358,1206862,128,32,0.641179,67,1208869,-1,16000.0,1233933,1234061,27071,128,36,7,True,True,67.48728888888888,-0.641179
1359,1223498,27,4,0.874117,45,1223794,-1,2000.0,1227113,1227140,3615,27,40,6,True,True,1.81215,-0.874117
1360,1223641,226,1,0.554541,45,1223794,-1,500.0,1244778,1245004,21137,226,26,6,True,True,3.696355555555556,-0.554541
1361,1224041,21,1,0.10259,47,1225994,-1,500.0,1287078,1287099,63037,21,23,7,True,True,0.30237083333333337,-0.10259
1362,1225226,28,16,0.845892,47,1225994,-1,8000.0,1229313,1229341,4087,28,42,7,True,True,6.950222222222222,-0.845892
1363,1225273,21,4,0.851166,47,1225994,-1,2000.0,1226013,1226034,740,21,46,1,True,True,1.40945,-0.851166
1364,1227915,12,32,0.285063,46,1229313,-1,16000.0,1276053,1276065,48138,12,25,0,True,True,7.444800000000001,-0.285063
1365,1228250,7654,8,0.763117,46,1229313,-1,4000.0,1231733,1239387,3483,7654,41,0,True,True,1054.1434444444444,-0.7609111871711817
1366,1229002,48,16,0.272791,46,1229313,-1,8000.0,1268353,1268401,39351,48,27,7,True,True,13.4304,-0.272791
1367,1229105,220,16,0.905306,46,1229313,-1,8000.0,1231513,1231733,2408,220,44,0,True,True,57.99688888888888,-0.905306
1368,1229713,20658,119,0.147349,51,1231513,-1,59500.0,1375778,1396436,146065,20658,6,7,True,True,30071.786577777777,-0.14661539659484918
1369,1230193,7676,1,0.437473,51,1231513,-1,500.0,1256753,1264429,26560,7676,29,0,True,True,109.72853888888889,-0.40473901883247787
1370,1230556,6,16,0.946413,51,1231513,-1,8000.0,1237533,1237539,6977,6,41,0,True,True,1.751466666666667,-0.946413
1371,1230732,17,8,0.222038,51,1231513,-1,4000.0,1240917,1240934,10185,17,35,0,True,True,2.1433222222222224,-0.222038
1372,1230788,599,1,0.451128,51,1231513,-1,500.0,1273853,1274452,43065,599,27,6,True,True,10.569254166666667,-0.4105778268918001
1373,1230842,9605,4,0.349585,51,1231513,-1,2000.0,1256753,1266358,25911,9605,30,0,True,True,565.7994888888888,-0.34227606319903603
1374,1235051,23287,128,0.02667,57,1237533,-1,64000.0,1332147,1355434,97096,23287,16,0,True,True,37311.743822222226,-0.025634440516795007
1375,1235300,14,8,0.053257,57,1237533,-1,4000.0,1289278,1289292,53978,14,25,7,True,True,1.5485555555555555,-0.053257
1376,1235392,17,2,0.502007,57,1237533,-1,1000.0,1242017,1242034,6625,17,39,6,True,True,0.556088888888889,-0.502007
1377,1235511,454,1,0.235778,57,1237533,-1,500.0,1238633,1239087,3122,454,45,0,True,True,7.154913888888889,-0.235778
1378,1236012,295,4,0.994525,57,1237533,-1,2000.0,1240917,1241212,4905,295,42,0,True,True,18.59647222222222,-0.994525
1379,1236187,17,4,0.374913,57,1237533,-1,2000.0,1272753,1272770,36566,17,30,7,True,True,1.1885833333333333,-0.374913
1380,1236211,51,4,0.028188,57,1237533,-1,2000.0,1282653,1282704,46442,51,28,7,True,True,3.5411,-0.028188
1381,1236861,297,4,0.930826,57,1237533,-1,2000.0,1242017,1242314,5156,297,40,0,True,True,19.430400000000002,-0.930826
1382,1236977,126,1,0.839176,57,1237533,-1,500.0,1260353,1260479,23376,126,34,4,True,True,1.6896250000000002,-0.839176
1383,1237020,12617,1,0.649961,57,1237533,-1,500.0,1293678,1306295,56658,12617,23,7,True,True,187.78852222222224,-0.6470193455516273
1384,1237041,19866,16,0.791381,57,1237533,-1,8000.0,1302066,1321932,65025,19866,19,7,True,True,5497.326,-0.7324391796553578
1385,1237455,182,16,0.1376,57,1237533,-1,8000.0,1276053,1276235,38598,182,32,7,True,True,56.4564,-0.1376
1386,1237793,10471,1,0.286879,59,1238633,-1,500.0,1337647,1348118,99854,10471,14,6,True,True,128.51414722222222,-0.2794941793435236
1387,1237852,53,16,0.829762,59,1238633,-1,8000.0,1240917,1240970,3065,53,50,0,True,True,13.364244444444443,-0.829762
1388,1237979,28,8,0.696072,59,1238633,-1,4000.0,1242017,1242045,4038,28,47,0,True,True,3.6636444444444445,-0.696072
1389,1238030,25,4,0.138793,59,1238633,-1,2000.0,1282653,1282678,44623,25,31,0,True,True,1.7358333333333333,-0.138793
1390,1240035,15281,128,0.705536,60,1240917,-1,64000.0,1316866,1332147,76831,15281,18,7,True,True,39870.79377777778,-0.697047999697803
1391,1240185,56,1,0.448601,60,1240917,-1,500.0,1245878,1245934,5693,56,44,6,True,True,0.8771777777777777,-0.448601
1392,1240201,34,2,0.005251,60,1240917,-1,1000.0,1266153,1266187,25952,34,40,6,True,True,1.1182222222222222,-0.005251
1393,1240206,7860,256,0.079226,60,1240917,-1,128000.0,1435544,1443404,195338,7860,4,7,True,True,34296.32426666666,-0.07894399685951817
1394,1240227,36,64,0.255924,60,1240917,-1,32000.0,1272753,1272789,32526,36,38,0,True,True,40.272,-0.255924
1395,1240251,222,10,0.834963,60,1240917,-1,5000.0,1240917,1241139,666,222,58,0,True,True,34.986583333333336,-0.834963
1396,1242062,7846,3,0.548804,60,1243678,-1,1500.0,1299866,1307712,57804,7846,23,0,True,True,351.8602916666667,-0.542854007092157
1397,1242109,31,1,0.727235,60,1243678,-1,500.0,1261453,1261484,19344,31,44,6,True,True,0.41570138888888886,-0.727235
1398,1242152,2651,8,0.527772,60,1243678,-1,4000.0,1265053,1267704,22901,2651,44,4,True,True,352.95937777777783,-0.5022773898382807
1399,1242232,9941,12,0.111187,60,1243678,-1,6000.0,1284878,1294819,42646,9941,33,7,True,True,1719.5145499999999,-0.10234561774040747
1400,1242481,46,41,0.288102,60,1243678,-1,20500.0,1280453,1280499,37972,46,37,7,True,True,35.891627777777785,-0.288102
1401,1242829,8,1,0.301151,60,1243678,-1,500.0,1282678,1282686,39849,8,35,0,True,True,0.13886666666666667,-0.301151
1402,1242973,34,8,0.047749,60,1243678,-1,4000.0,1282678,1282712,39705,34,36,1,True,True,4.721466666666667,-0.047749
1403,1243056,18345,1,0.419826,60,1243678,-1,500.0,1405911,1424256,162855,18345,6,7,True,True,265.44892916666663,-0.3909932778655052
1404,1243104,34,30,0.793899,60,1243678,-1,15000.0,1278253,1278287,35149,34,41,7,True,True,19.411166666666666,-0.793899
1405,1243221,20017,4,0.457114,60,1243678,-1,2000.0,1314666,1334683,71445,20017,21,8,True,True,1555.14915,-0.45371151913776747
9512,7420904,105,2,0.730865,1,7420904,-1,1000.0,7421140,7421009,236,105,0,0,True,True,2.801458333333333,-0.730865
9513,7421140,3189,4,0.225831,1,7421140,-1,2000.0,7447663,7426529,26523,3189,0,7,True,True,234.42828888888891,-0.225831
9514,7447663,476,16,0.263812,1,7447663,-1,8000.0,7451106,7450339,3443,476,0,7,True,True,132.72995555555556,-0.263812
9515,7451106,21769,32,0.296234,1,7451106,-1,16000.0,7453306,7475075,2200,21769,0,7,True,True,12207.907555555556,-0.28691545284114034
9516,7451300,22056,128,0.082794,3,7453306,-1,64000.0,7570435,7592491,119135,22056,0,6,True,True,37948.21813333333,-0.07885229239393912
9517,7451557,281,1,0.558515,3,7453306,-1,500.0,7458706,7458987,7149,281,1,8,True,True,4.584983333333334,-0.558515
9518,7451869,38,64,0.872872,3,7453306,-1,32000.0,7472801,7472839,20932,38,1,8,True,True,43.52942222222222,-0.872872
9519,7453317,7620,1,0.659481,15,7458706,-1,500.0,7487414,7495034,34097,7620,1,0,True,True,99.72990555555556,-0.6552344588055773
9520,7453877,29,2,0.735268,15,7458706,-1,1000.0,7459806,7459835,5929,29,3,6,True,True,0.9959083333333333,-0.735268
9521,7453926,1089,32,0.205891,15,7458706,-1,16000.0,7480424,7481513,26498,1089,2,7,True,True,478.5907555555556,-0.1876059127084943
9522,7454242,9589,42,0.078017,15,7458706,-1,21000.0,7482687,7492276,28445,9589,2,0,True,True,5195.810200000001,-0.07641309930733815
9523,7455218,114,4,0.971765,15,7458706,-1,2000.0,7463106,7463220,7888,114,5,7,True,True,8.232066666666666,-0.971765
9524,7457507,7217,1,0.060267,15,7458706,-1,500.0,7557179,7564396,99672,7217,1,0,True,True,115.29468472222223,-0.056280492834356904
9525,7457873,11752,130,0.013128,15,7458706,-1,65000.0,7556079,7567831,98206,11752,2,7,True,True,24738.710208333334,-0.012762362181315748
9526,7458016,11,8,0.216135,15,7458706,-1,4000.0,7483811,7483822,25795,11,4,0,True,True,1.1464444444444444,-0.216135
9527,7458182,96,4,0.818511,15,7458706,-1,2000.0,7467401,7467497,9219,96,8,2,True,True,6.354666666666668,-0.818511
9528,7458304,10277,71,0.187917,15,7458706,-1,35500.0,7518519,7528796,60215,10277,3,2,True,True,10910.990083333334,-0.16454511921198606
9529,7458385,27,5,0.104535,15,7458706,-1,2500.0,7482700,7482727,24315,27,6,0,True,True,1.7587499999999998,-0.104535
9530,7458487,184,4,0.208661,15,7458706,-1,2000.0,7483811,7483995,25324,184,5,0,True,True,9.588444444444445,-0.208661
9531,7458666,13,32,0.590523,15,7458706,-1,16000.0,7478211,7478224,19545,13,10,0,True,True,6.270044444444444,-0.590523
9532,7458715,1395,2,0.527645,21,7459806,-1,1000.0,7482700,7484095,23985,1395,8,0,True,True,36.3475,-0.527645
9533,7458727,46,1,0.858459,21,7459806,-1,500.0,7481587,7481633,22860,46,10,0,True,True,0.5992777777777778,-0.858459
9534,7458977,37320,8,0.760488,21,7459806,-1,4000.0,7824340,7861660,365363,37320,0,7,True,True,3545.3,-0.7532245132264727
9535,7459029,14846,1,0.311825,21,7459806,-1,500.0,7619390,7634236,160361,14846,1,1,True,True,172.82566666666668,-0.30745530396266335
9536,7459262,6908,16,0.454022,21,7459806,-1,8000.0,7513943,7520851,54681,6908,6,1,True,True,1254.8560000000002,-0.41059286129230893
9537,7459573,3195,4,0.153999,21,7459806,-1,2000.0,7464206,7467401,4633,3195,18,0,True,True,224.69181666666668,-0.14997893532851211
9538,7459790,12,8,0.504511,21,7459806,-1,4000.0,7460906,7460918,1116,12,20,6,True,True,1.6484,-0.504511
9539,7460179,8139,16,0.914125,23,7460906,-1,8000.0,7480429,7488568,20250,8139,14,1,True,True,1698.6713777777777,-0.8567678995062273
9540,7460299,234,8,0.218785,23,7460906,-1,4000.0,7480424,7480658,20125,234,15,0,True,True,28.2152,-0.218785
9541,7460340,6157,1,0.363644,23,7460906,-1,500.0,7594045,7600202,133705,6157,2,6,True,True,73.24219027777778,-0.35223896407827615
9542,7462757,1,1,0.975065,26,7463106,-1,500.0,7467401,7467402,4644,1,20,0,True,True,0.01654861111111111,-0.975065
9543,7462847,46,3,0.867859,26,7463106,-1,1500.0,7478224,7478270,15377,46,18,0,True,True,2.079966666666667,-0.867859
9544,7462894,755,4,0.513464,26,7463106,-1,2000.0,7464206,7464961,1312,755,24,6,True,True,54.519388888888884,-0.513464
9545,7462915,17458,16,0.780021,26,7463106,-1,8000.0,7573921,7591379,111006,17458,3,0,True,True,3615.9815555555556,-0.7387540568963874
9546,7463964,11,2,0.187953,26,7464206,-1,1000.0,7482700,7482711,18736,11,14,0,True,True,0.2866111111111111,-0.187953
9547,7464892,13,4,0.277838,39,7467401,-1,2000.0,7501764,7501777,36872,13,9,0,True,True,0.6123,-0.277838
9548,7465082,6755,128,0.164196,39,7467401,-1,64000.0,7539269,7546024,74187,6755,7,7,True,True,13199.821511111111,-0.16394696505672673
9549,7465329,22,2,0.307147,39,7467401,-1,1000.0,7510916,7510938,45587,22,10,1,True,True,0.45362777777777785,-0.307147
9550,7465376,7661,16,0.869831,39,7467401,-1,8000.0,7483822,7491483,18446,7661,13,1,True,True,1572.971888888889,-0.8619193678870962
9551,7465404,2698,32,0.648383,39,7467401,-1,16000.0,7478211,7480909,12807,2698,25,0,True,True,1294.1443555555554,-0.6448298446414417
9552,7465458,15,6,0.14729,39,7467401,-1,3000.0,7478211,7478226,12753,15,26,0,True,True,1.3565,-0.14729
9553,7465541,9,4,0.876196,39,7467401,-1,2000.0,7478211,7478220,12670,9,28,8,True,True,0.5426,-0.876196
9554,7465580,45,4,0.745026,39,7467401,-1,2000.0,7472801,7472846,7221,45,29,0,True,True,3.22175,-0.745026
9555,7465625,700,1,0.240562,39,7467401,-1,500.0,7507177,7507877,41552,700,11,8,True,True,7.544444444444444,-0.240562
9556,7465675,13,1,0.894098,39,7467401,-1,500.0,7482687,7482700,17012,13,21,0,True,True,0.1693611111111111,-0.894098
9557,7465724,4622,8,0.18703,39,7467401,-1,4000.0,7515103,7519725,49379,4622,9,1,True,True,416.44025555555555,-0.18518565975292034
9558,7465781,102,4,0.028586,39,7467401,-1,2000.0,7478224,7478326,12443,102,28,3,True,True,6.149466666666666,-0.028586
9559,7465790,1354,8,0.661886,39,7467401,-1,4000.0,7482700,7484054,16910,1354,21,1,True,True,141.1168888888889,-0.661886
9560,7465971,63,32,0.452641,39,7467401,-1,16000.0,7480424,7480487,14453,63,26,0,True,True,30.3856,-0.452641
9561,7466592,21,2,0.265579,39,7467401,-1,1000.0,7482711,7482732,16119,21,18,0,True,True,0.5471666666666667,-0.265579
9562,7468178,56,2,0.926928,66,7472801,-1,1000.0,7482711,7482767,14533,56,19,0,True,True,1.459111111111111,-0.926928
9563,7468182,484,16,0.084067,66,7472801,-1,8000.0,7512016,7512500,43834,484,11,6,True,True,79.83848888888889,-0.084067
9564,7468203,10,8,0.431474,66,7472801,-1,4000.0,7478211,7478221,10008,10,34,0,True,True,1.2057777777777778,-0.431474
9565,7468269,26,16,0.15062,66,7472801,-1,8000.0,7480487,7480513,12218,26,28,0,True,True,6.270044444444444,-0.15062
9566,7468381,1733,4,0.50219,66,7472801,-1,2000.0,7483811,7485544,15430,1733,19,6,True,True,89.7302,-0.4989738664381498
9567,7468392,9270,256,0.507927,66,7472801,-1,128000.0,7735904,7745174,267512,9270,1,8,True,True,37825.38097777778,-0.49525495086305127
9568,7469489,16453,1,0.053157,66,7472801,-1,500.0,7528536,7544989,59047,16453,9,0,True,True,277.7132875,-0.051863215222526675
9569,7469646,52,2,0.272589,66,7472801,-1,1000.0,7487384,7487436,17738,52,18,0,True,True,1.3417444444444444,-0.272589
9570,7469780,170,1,0.097813,66,7472801,-1,500.0,7501777,7501947,31997,170,16,0,True,True,2.00175,-0.097813
9571,7469818,11436,128,0.648622,66,7472801,-1,64000.0,7667894,7679330,198076,11436,2,7,True,True,17762.511644444443,-0.639201716475172
9572,7470263,126,2,0.732002,66,7472801,-1,1000.0,7478211,7478337,7948,126,45,0,True,True,3.7982,-0.732002
9573,7470324,19,8,0.422588,66,7472801,-1,4000.0,7483811,7483830,13487,19,23,0,True,True,1.9802222222222223,-0.422588
9574,7470968,77,2,0.294006,66,7472801,-1,1000.0,7546179,7546256,75211,77,9,0,True,True,2.1838055555555553,-0.294006
9575,7471047,5,8,0.402692,66,7472801,-1,4000.0,7480424,7480429,9377,5,39,0,True,True,0.6028888888888889,-0.402692
9576,7471089,262,1,0.594049,66,7472801,-1,500.0,7486022,7486284,14933,262,22,6,True,True,3.3801638888888887,-0.594049
9577,7471439,140,32,0.529563,66,7472801,-1,16000.0,7498214,7498354,26775,140,20,9,True,True,54.687111111111115,-0.529563
9578,7471767,213,1,0.493616,66,7472801,-1,500.0,7481587,7481800,9820,213,38,6,True,True,2.7749166666666665,-0.493616
9579,7471808,102,11,0.433565,66,7472801,-1,5500.0,7482711,7482813,10903,102,31,1,True,True,14.617166666666666,-0.433565
9580,7471834,10,4,0.681161,66,7472801,-1,2000.0,7472801,7472811,967,10,55,0,True,True,0.7159444444444445,-0.681161
9581,7471849,155,1,0.646345,66,7472801,-1,500.0,7478211,7478366,6362,155,49,0,True,True,2.3361944444444442,-0.646345
9582,7471908,27,1,0.958972,66,7472801,-1,500.0,7472811,7472838,903,27,55,1,True,True,0.4832625,-0.958972
9583,7471940,6347,32,0.21958,66,7472801,-1,16000.0,7484922,7491269,12982,6347,24,6,True,True,2602.307866666667,-0.21933752669202977
9584,7472063,7103,16,0.053138,66,7472801,-1,8000.0,7509377,7516480,37314,7103,17,7,True,True,1197.8400000000001,-0.05196854952076608
9585,7472164,321,1,0.035688,66,7472801,-1,500.0,7523036,7523357,50872,321,12,0,True,True,4.327704166666667,-0.035688
9586,7472257,9092,64,0.266178,66,7472801,-1,32000.0,7556079,7565171,83822,9092,8,0,True,True,9260.269955555555,-0.2556834448520293
9587,7472310,34,4,0.065847,66,7472801,-1,2000.0,7523025,7523059,50715,34,14,6,True,True,1.8335444444444444,-0.065847
9588,7472367,260,2,0.101032,66,7472801,-1,1000.0,7521925,7522185,49558,260,15,6,True,True,7.01061111111111,-0.101032
9589,7472391,7,1,0.226465,66,7472801,-1,500.0,7500664,7500671,28273,7,25,6,True,True,0.082425,-0.226465
9590,7472466,44,16,0.620221,66,7472801,-1,8000.0,7482687,7482731,10221,44,45,6,True,True,9.171555555555555,-0.620221
9591,7472913,203,5,0.715823,74,7478211,-1,2500.0,7482700,7482903,9787,203,40,0,True,True,13.223194444444443,-0.715823
9592,7473068,4428,32,0.391908,74,7478211,-1,16000.0,7487414,7491842,14346,4428,28,2,True,True,1812.8385777777778,-0.3746086279691376
9593,7473076,9633,85,0.101304,74,7478211,-1,42500.0,7529636,7539269,56560,9633,12,6,True,True,14211.118833333334,-0.09521306371055631
9594,7473095,5,32,0.733924,74,7478211,-1,16000.0,7480487,7480492,7392,5,51,0,True,True,2.4115555555555557,-0.733924
9595,7473646,211,1,0.879528,74,7478211,-1,500.0,7480424,7480635,6778,211,57,0,True,True,3.180238888888889,-0.879528
9596,7474035,16855,220,0.268267,74,7478211,-1,110000.0,7805285,7822140,331250,16855,1,7,True,True,44650.48958333334,-0.2668327787501511
9597,7474304,116,32,0.205705,74,7478211,-1,16000.0,7518403,7518519,44099,116,19,0,True,True,42.85297777777778,-0.205705
9598,7475199,4,8,0.785728,74,7478211,-1,4000.0,7480487,7480491,5288,4,55,1,True,True,0.4823111111111111,-0.785728
9599,7475208,21,1,0.347633,74,7478211,-1,500.0,7500664,7500685,25456,21,28,0,True,True,0.24727500000000002,-0.347633
9600,7475834,57,16,0.287993,74,7478211,-1,8000.0,7486284,7486341,10450,57,34,0,True,True,11.766066666666667,-0.287993
9601,7477326,23,1,0.596313,74,7478211,-1,500.0,7486022,7486045,8696,23,35,0,True,True,0.29673194444444445,-0.596313
9602,7477372,2,32,0.733882,74,7478211,-1,16000.0,7486022,7486024,8650,2,36,0,True,True,0.8256888888888889,-0.733882
9603,7478388,75,4,0.094243,72,7480424,-1,2000.0,7501777,7501852,23389,75,27,1,True,True,3.5324999999999998,-0.094243
9604,7478403,4037,1,0.50324,72,7480424,-1,500.0,7527436,7531473,49033,4037,15,7,True,True,83.07841805555555,-0.502361260894223
9605,7478737,15613,25,0.700471,72,7480424,-1,12500.0,7529636,7545249,50899,15613,13,0,True,True,6467.665520833333,-0.6652119918946441
9606,7478932,12150,4,0.476758,72,7480424,-1,2000.0,7487414,7499564,8482,12150,35,0,True,True,619.6452555555557,-0.4694155882148379
9607,7479608,11987,1,0.305324,72,7480424,-1,500.0,7566725,7578712,87117,11987,8,1,True,True,186.80800833333336,-0.28937687771568343
9608,7479731,23,16,0.906668,72,7480424,-1,8000.0,7482700,7482723,2969,23,55,0,True,True,4.794222222222222,-0.906668
9609,7480361,86,8,0.238619,72,7480424,-1,4000.0,7523036,7523122,42675,86,19,0,True,True,9.275577777777778,-0.238619
9610,7480435,12668,237,0.315112,67,7480487,-1,118500.0,7723236,7735904,242801,12668,3,7,True,True,50712.59508333333,-0.30564977425956213
9611,7480498,8452,1,0.069455,72,7481587,-1,500.0,7599845,7608297,119347,8452,6,1,True,True,101.45456805555554,-0.06769893022862238
9612,7481026,93,3,0.187344,72,7481587,-1,1500.0,7484922,7485015,3896,93,46,0,True,True,3.5994875,-0.187344
9613,7481280,23947,247,0.899869,72,7481587,-1,123500.0,7822140,7846087,340860,23947,1,7,True,True,74450.29814444444,-0.8887335920757325
9614,7481294,9,8,0.141834,72,7481587,-1,4000.0,7513943,7513952,32649,9,28,0,True,True,0.7759,-0.141834
9615,7481416,4845,4,0.012735,72,7481587,-1,2000.0,7535440,7540285,54024,4845,17,1,True,True,307.6487777777778,-0.012509322140236716
9616,7481427,46,20,0.474601,72,7481587,-1,10000.0,7486284,7486330,4857,46,46,3,True,True,11.86927777777778,-0.474601
9617,7481465,14246,16,0.334054,72,7481587,-1,8000.0,7628090,7642336,146625,14246,6,8,True,True,2466.4215999999997,-0.311668371255089
9618,7481557,48,7,0.177515,72,7481587,-1,3500.0,7525236,7525284,43679,48,23,7,True,True,5.437133333333334,-0.177515
9619,7481724,5912,64,0.263832,73,7482687,-1,32000.0,7520825,7526737,39101,5912,28,6,True,True,5574.089955555555,-0.2569574885504008
9620,7482405,12589,32,0.076977,73,7482687,-1,16000.0,7523036,7535625,40631,12589,26,1,True,True,7112.127688888889,-0.0755858680665661
9621,7482495,5781,4,0.679203,73,7482687,-1,2000.0,7486284,7492065,3789,5781,49,0,True,True,296.9573833333334,-0.6572166489955227
9622,7483729,367,1,0.85309,63,7483811,-1,500.0,7500664,7501031,16935,367,43,0,True,True,4.3214250000000005,-0.85309
9623,7483771,6,1,0.594005,63,7483811,-1,500.0,7487384,7487390,3613,6,50,6,True,True,0.07740833333333334,-0.594005
9624,7483829,733,1,0.969542,60,7484922,-1,500.0,7484922,7485655,1093,733,57,0,True,True,9.456718055555555,-0.969542
9625,7484125,6337,128,0.583159,60,7484922,-1,64000.0,7499564,7505901,15439,6337,45,2,True,True,9426.024000000001,-0.581474894413439
9626,7485298,6441,64,0.488307,64,7486022,-1,32000.0,7501764,7508205,16466,6441,42,6,True,True,4648.8896,-0.47262149036712864
9627,7485400,6086,16,0.24751,64,7486022,-1,8000.0,7530736,7536822,45336,6086,19,6,True,True,1680.2268,-0.2199060672720522
9628,7485441,42,4,0.109386,64,7486022,-1,2000.0,7528536,7528578,43095,42,23,6,True,True,3.5357000000000003,-0.109386
9629,7485503,324,2,0.818926,64,7486022,-1,1000.0,7500664,7500988,15161,324,45,0,True,True,7.630199999999999,-0.818926
9630,7485531,3,19,0.567267,64,7486022,-1,9500.0,7487414,7487417,1883,3,52,0,True,True,0.7353791666666667,-0.567267
9631,7485881,968,16,0.990413,64,7486022,-1,8000.0,7487384,7488352,1503,968,56,0,True,True,198.84675555555555,-0.9856053110619598
9632,7485930,30,16,0.835359,64,7486022,-1,8000.0,7487384,7487414,1454,30,55,0,True,True,6.192666666666667,-0.835359
9633,7486024,1347,4,0.525269,62,7486284,-1,2000.0,7500664,7502011,14640,1347,48,0,True,True,63.4437,-0.525269
9634,7486423,322,1,0.167305,68,7487384,-1,500.0,7531836,7532158,45413,322,19,6,True,True,5.4959138888888885,-0.167305
9635,7486522,39,8,0.146583,68,7487384,-1,4000.0,7515103,7515142,28581,39,35,0,True,True,3.3622333333333336,-0.146583
9636,7486545,96,32,0.09391,68,7487384,-1,16000.0,7519725,7519821,33180,96,33,2,True,True,35.464533333333335,-0.09391
9637,7486552,12,1,0.304602,68,7487384,-1,500.0,7519725,7519737,33173,12,33,0,True,True,0.13853333333333334,-0.304602
9638,7486563,517,8,0.736186,68,7487384,-1,4000.0,7487414,7487931,851,517,59,0,True,True,53.360144444444444,-0.736186
9639,7486797,12091,64,0.452616,68,7487384,-1,32000.0,7536540,7548631,49743,12091,18,6,True,True,11765.238222222222,-0.44200009769133963
9640,7486842,462,1,0.734815,68,7487384,-1,500.0,7487414,7487876,572,462,57,0,True,True,5.960441666666666,-0.734815
9641,7486887,589,32,0.989793,68,7487384,-1,16000.0,7499564,7500153,12677,589,55,0,True,True,221.9352,-0.989793
9642,7486917,28843,4,0.25734,68,7487384,-1,2000.0,7684894,7713737,197977,28843,5,7,True,True,1531.4108055555553,-0.2567267926399427
9643,7505496,7,2,0.486493,51,7507177,-1,1000.0,7542879,7542886,37383,7,18,0,True,True,0.223125,-0.486493
9644,7505618,77,1,0.364289,51,7507177,-1,500.0,7559379,7559456,53761,77,14,7,True,True,1.1157513888888888,-0.364289
9645,7505678,5,4,0.013561,51,7507177,-1,2000.0,7561579,7561584,55901,5,14,0,True,True,0.33647222222222223,-0.013561
9646,7505987,3,1,0.352626,51,7507177,-1,500.0,7512016,7512019,6029,3,46,0,True,True,0.03092916666666667,-0.352626
9647,7506481,10809,1,0.710157,51,7507177,-1,500.0,7535436,7546245,28955,10809,24,0,True,True,168.453775,-0.7034179932404832
9648,7507707,1443,16,0.891372,55,7509377,-1,8000.0,7512500,7513943,4793,1443,47,2,True,True,243.57860000000002,-0.872646896699668
9649,7508060,599,16,0.774526,55,7509377,-1,8000.0,7509377,7509976,1317,599,51,0,True,True,100.47840000000001,-0.753412258344664
9650,7508335,25,32,0.856956,55,7509377,-1,16000.0,7513952,7513977,5617,25,45,1,True,True,8.62111111111111,-0.856956
9651,7508355,439,16,0.902167,55,7509377,-1,8000.0,7510477,7510916,2122,439,52,6,True,True,72.41548888888889,-0.902167
9652,7508810,41,1,0.595744,55,7509377,-1,500.0,7515052,7515093,6242,41,45,6,True,True,0.44183194444444446,-0.595744
9653,7509792,1361,1,0.112761,55,7510477,-1,500.0,7545079,7546440,35287,1361,20,7,True,True,20.215104166666666,-0.10508883541513593
9654,7510285,49,1,0.685784,55,7510477,-1,500.0,7518403,7518452,8118,49,44,7,True,True,0.5656777777777777,-0.685784
9655,7511158,181,4,0.728216,57,7512016,-1,2000.0,7516203,7516384,5045,181,45,6,True,True,7.802105555555555,-0.728216
9656,7511337,264,4,0.020727,57,7512016,-1,2000.0,7556079,7556343,44742,264,18,0,True,True,15.204933333333333,-0.020727
9657,7511356,16631,256,0.978637,57,7512016,-1,128000.0,7745174,7761805,233818,16631,3,7,True,True,53871.724088888885,-0.9436810175540571
9658,7511475,10,1,0.856266,57,7512016,-1,500.0,7515093,7515103,3618,10,50,1,True,True,0.1077638888888889,-0.856266
9659,7514110,15957,32,0.659367,53,7515052,-1,16000.0,7569335,7585292,55225,15957,14,2,True,True,7215.4833777777785,-0.6347246019866868
9660,7514206,8830,6,0.141633,53,7515052,-1,3000.0,7575021,7583851,60815,8830,12,6,True,True,698.6883333333333,-0.13992298520100507
9661,7515103,4,7,0.497832,52,7515103,-1,3500.0,7535436,7535440,20333,4,30,4,True,True,0.46810555555555555,-0.497832
9662,7515573,71,1,0.244368,52,7516203,-1,500.0,7528536,7528607,12963,71,35,0,True,True,1.4942541666666667,-0.244368
9663,7516063,225,8,0.741012,52,7516203,-1,4000.0,7518403,7518628,2340,225,50,0,True,True,20.78,-0.741012
9664,7516430,12454,64,0.973291,53,7518403,-1,32000.0,7621590,7634044,105160,12454,9,7,True,True,9308.17688888889,-0.9689641251104251
9665,7516582,11,1,0.35942,53,7518403,-1,500.0,7523025,7523036,6443,11,44,0,True,True,0.14830138888888889,-0.35942
9666,7523724,10082,16,0.744365,43,7525236,-1,8000.0,7548379,7558461,24655,10082,24,0,True,True,2376.187177777778,-0.7427640638619786
9667,7524970,12360,8,0.193842,43,7525236,-1,4000.0,7705150,7717510,180180,12360,6,0,True,True,1351.0868888888888,-0.18696788559459565
9668,7525197,20221,4,0.954814,43,7525236,-1,2000.0,7549479,7569700,24282,20221,25,6,True,True,1275.6039666666668,-0.9477753304698452
9669,7525374,37,8,0.638734,44,7527436,-1,4000.0,7529636,7529673,4262,37,38,0,True,True,6.229566666666667,-0.638734
9670,7526550,15363,1,0.965453,44,7527436,-1,500.0,7569335,7584698,42785,15363,17,0,True,True,218.2079027777778,-0.9284476601773215
9671,7537641,10,8,0.877144,36,7539269,-1,4000.0,7542869,7542879,5228,10,31,2,True,True,1.2750000000000001,-0.877144
9672,7537765,8549,2,0.678802,36,7539269,-1,1000.0,7573921,7582470,36156,8549,16,4,True,True,232.68977222222225,-0.6176273921834812
9673,7537949,63,20,0.899221,36,7539269,-1,10000.0,7542879,7542942,4930,63,32,1,True,True,20.08125,-0.899221
9674,7538406,43480,111,0.449269,36,7539269,-1,55500.0,7761805,7805285,223399,43480,3,0,True,True,60105.800854166664,-0.4472989537725815
9675,7538432,144,8,0.958306,36,7539269,-1,4000.0,7546179,7546323,7747,144,31,6,True,True,16.336,-0.958306
9676,7541236,118,1,0.526907,46,7542869,-1,500.0,7561579,7561697,20343,118,23,6,True,True,1.9851861111111113,-0.526907
9677,7541612,16086,8,0.265309,46,7542869,-1,4000.0,7612598,7628684,70986,16086,13,6,True,True,1588.5206444444443,-0.25835121767995145
9678,7541791,407,4,0.679066,46,7542869,-1,2000.0,7542879,7543286,1088,407,35,0,True,True,25.946250000000003,-0.679066
9679,7541852,19,58,0.887995,46,7542869,-1,29000.0,7548379,7548398,6527,19,31,0,True,True,15.626972222222221,-0.887995
9680,7542109,173,4,0.391026,46,7542869,-1,2000.0,7566710,7566883,24601,173,23,0,True,True,12.04272222222222,-0.391026
9681,7542142,19,2,0.417294,46,7542869,-1,1000.0,7542869,7542888,727,19,40,0,True,True,0.605625,-0.417294
9682,7542176,299,7,0.993944,46,7542869,-1,3500.0,7542869,7543168,693,299,41,0,True,True,33.357187499999995,-0.993944
9683,7542197,10425,8,0.309323,46,7542869,-1,4000.0,7572681,7583106,30484,10425,19,0,True,True,1154.1415333333334,-0.2943116808886446
9684,7542226,15,8,0.0411,46,7542869,-1,4000.0,7566710,7566725,24484,15,25,6,True,True,2.0883333333333334,-0.0411
9685,7542506,5,1,0.520078,46,7542869,-1,500.0,7553879,7553884,11373,5,33,7,True,True,0.07199305555555556,-0.520078
9686,7542518,10317,1,0.343274,46,7542869,-1,500.0,7659876,7670193,117358,10317,10,0,True,True,128.37765,-0.3290604928411971
9687,7543012,8973,128,0.612367,45,7545079,-1,64000.0,7702950,7711923,159938,8973,8,7,True,True,15243.443733333334,-0.5906369859216039
9688,7543040,8227,32,0.43346,45,7545079,-1,16000.0,7608156,7616383,65116,8227,16,4,True,True,3457.934888888889,-0.43028780580654896
9689,7543055,5167,1,0.455028,45,7545079,-1,500.0,7638190,7643357,95135,5167,12,3,True,True,58.99818611111111,-0.4496820392735905
9690,7543071,9,4,0.968153,45,7545079,-1,2000.0,7548379,7548388,5308,9,41,7,True,True,0.5105,-0.968153
9691,7543195,2172,1,0.792341,45,7545079,-1,500.0,7551679,7553851,8484,2172,38,7,True,True,32.312265277777776,-0.7691644985552356
9692,7554084,9942,4,0.288409,52,7556079,-1,2000.0,7705150,7715092,151066,9942,8,7,True,True,512.9732444444444,-0.2544654904917545
9693,7554231,35,32,0.96947,52,7556079,-1,16000.0,7566710,7566745,12479,35,30,0,True,True,19.49111111111111,-0.96947
9694,7554406,43,32,0.498927,52,7556079,-1,16000.0,7566725,7566768,12319,43,28,0,True,True,23.94622222222222,-0.498927
9695,7554775,2,8,0.685527,52,7556079,-1,4000.0,7564396,7564398,9621,2,33,2,True,True,0.27844444444444444,-0.685527
9696,7554832,53,16,0.466317,52,7556079,-1,8000.0,7573921,7573974,19089,53,22,0,True,True,13.770577777777778,-0.466317
9697,7554839,40,55,0.150228,52,7556079,-1,27500.0,7592945,7592985,38106,40,21,6,True,True,28.040833333333335,-0.150228
9698,7554850,1522,14,0.966671,52,7556079,-1,7000.0,7564396,7565918,9546,1522,35,0,True,True,370.8183888888889,-0.966671
9699,7554855,11313,128,0.623795,52,7556079,-1,64000.0,7711923,7723236,157068,11313,7,7,True,True,23325.321066666667,-0.5635796379273826
9700,7554941,19250,16,0.66432,52,7556079,-1,8000.0,7583106,7602356,28165,19250,23,1,True,True,3740.708577777778,-0.6607176942907711
9701,7555000,46,8,0.303646,52,7556079,-1,4000.0,7570435,7570481,15435,46,29,0,True,True,6.004533333333334,-0.303646
9702,7555030,5551,4,0.28826,52,7556079,-1,2000.0,7622690,7628241,67660,5551,16,6,True,True,282.7266,-0.2872914943431216
9703,7555576,9,3,0.799785,52,7556079,-1,1500.0,7557179,7557188,1603,9,45,6,True,True,0.39123749999999996,-0.7997850000000002
9704,7555625,8,12,0.015592,52,7556079,-1,6000.0,7572681,7572689,17056,8,30,7,True,True,1.5589333333333333,-0.015592
9705,7555664,5,1,0.040953,52,7556079,-1,500.0,7560479,7560484,4815,5,44,6,True,True,0.08411805555555556,-0.040953
9706,7555997,5,3,0.283017,52,7556079,-1,1500.0,7564396,7564401,8399,5,41,0,True,True,0.26104166666666667,-0.283017
9707,7556017,9121,32,0.593072,52,7556079,-1,16000.0,7579421,7588542,23404,9121,25,7,True,True,3606.9079111111114,-0.5898898823243576
9708,7556166,31,8,0.053193,56,7557179,-1,4000.0,7567845,7567876,11679,31,36,6,True,True,4.0465333333333335,-0.053193
9709,7556438,21446,1,0.305822,56,7557179,-1,500.0,7614798,7636244,58360,21446,19,7,True,True,248.47903611111113,-0.30239706932718036
9710,7556455,96,31,0.430323,56,7557179,-1,15500.0,7588545,7588641,32090,96,25,0,True,True,36.55106666666667,-0.4303229999999999
9711,7556597,36,2,0.660253,56,7557179,-1,1000.0,7561579,7561615,4982,36,48,0,True,True,1.2113,-0.660253
9712,7556755,6,1,0.000642,56,7557179,-1,500.0,7577221,7577227,20466,6,28,7,True,True,0.08720833333333335,-0.000642
9713,7556892,9528,32,0.251433,56,7557179,-1,16000.0,7604556,7614084,47664,9528,22,7,True,True,3973.6538666666665,-0.2500834971874856
9714,7556984,9,16,0.350218,56,7557179,-1,8000.0,7561579,7561588,4595,9,49,0,True,True,2.4226,-0.350218
9715,7558656,58,8,0.283266,59,7559379,-1,4000.0,7591845,7591903,33189,58,26,7,True,True,5.760044444444444,-0.283266
9716,7558728,21,2,0.859011,59,7559379,-1,1000.0,7561579,7561600,2851,21,52,0,True,True,0.7065916666666666,-0.859011
9717,7558783,39,32,0.665326,59,7559379,-1,16000.0,7573921,7573960,15138,39,34,0,True,True,20.266133333333336,-0.665326
9718,7558912,32,32,0.768885,59,7559379,-1,16000.0,7563779,7563811,4867,32,51,7,True,True,17.820444444444444,-0.768885
9719,7559187,7647,29,0.155037,59,7559379,-1,14500.0,7596245,7603892,37058,7647,24,6,True,True,2571.3092874999998,-0.1524741210744687
9720,7559722,9032,16,0.086003,63,7560479,-1,8000.0,7634590,7643622,74868,9032,15,6,True,True,1591.7956444444444,-0.08403922836316574
9721,7559765,2,2,0.270669,63,7560479,-1,1000.0,7611498,7611500,51733,2,22,6,True,True,0.05541666666666667,-0.270669
9722,7559900,26386,165,0.995914,63,7560479,-1,82500.0,7633490,7659876,73590,26386,16,0,True,True,53137.92366666667,-0.9848235436110162
9723,7559976,9378,1,0.196727,63,7560479,-1,500.0,7687094,7696472,127118,9378,11,7,True,True,121.82156666666667,-0.19655059829488122
9724,7560136,28,13,0.585225,63,7560479,-1,6500.0,7564510,7564538,4374,28,53,0,True,True,6.334611111111111,-0.585225
9725,7560771,9,2,0.080718,69,7561579,-1,1000.0,7604556,7604565,43785,9,26,0,True,True,0.21585000000000001,-0.080718
9726,7560886,251,8,0.218858,69,7561579,-1,4000.0,7588545,7588796,27659,251,34,0,True,True,24.662144444444447,-0.218858
9727,7561424,240,8,0.473178,69,7561579,-1,4000.0,7570481,7570721,9057,240,45,1,True,True,31.328,-0.473178
9728,7561428,10,2,0.354632,69,7561579,-1,1000.0,7566745,7566755,5317,10,51,1,True,True,0.34805555555555556,-0.354632
9729,7561500,8311,8,0.811709,69,7561579,-1,4000.0,7565610,7573921,4110,8311,57,0,True,True,1096.7359111111111,-0.7980899336532384
9730,7561546,8018,128,0.637045,69,7561579,-1,64000.0,7659876,7667894,98330,8018,15,7,True,True,12917.522844444444,-0.6083021169208909
9731,7561575,499,8,0.422563,69,7561579,-1,4000.0,7570448,7570947,8873,499,47,1,True,True,65.04466666666667,-0.4219696207634882
9732,7561780,114,32,0.966907,85,7563779,-1,16000.0,7564396,7564510,2616,114,61,0,True,True,63.48533333333334,-0.966907
9733,7561869,11828,123,0.098139,85,7563779,-1,61500.0,7679330,7691158,117461,11828,13,7,True,True,18412.690000000002,-0.09706140565418712
9734,7561916,15,16,0.261261,85,7563779,-1,8000.0,7592945,7592960,31029,15,33,0,True,True,3.0589999999999997,-0.261261
9735,7561944,37,1,0.302023,85,7563779,-1,500.0,7583106,7583143,21162,37,38,0,True,True,0.4529930555555556,-0.302023
9736,7562063,148,64,0.310736,85,7563779,-1,32000.0,7615898,7616046,53835,148,24,6,True,True,116.4135111111111,-0.310736
9737,7562097,26,32,0.563908,85,7563779,-1,16000.0,7572689,7572715,10592,26,48,1,True,True,13.510755555555555,-0.563908
9738,7562119,700,13,0.678923,85,7563779,-1,6500.0,7566710,7567410,4591,700,62,0,True,True,155.40019444444442,-0.666211480782123
9739,7562305,3,2,0.32248,85,7563779,-1,1000.0,7588542,7588545,26237,3,39,2,True,True,0.07369166666666668,-0.32248
9740,7562431,6273,8,0.578167,85,7563779,-1,4000.0,7602356,7608629,39925,6273,31,2,True,True,612.2890222222222,-0.5643229343956615
9741,7562440,4825,16,0.683321,85,7563779,-1,8000.0,7564510,7569335,2070,4825,69,0,True,True,1306.392888888889,-0.6751483846915848
9742,7562457,999,4,0.199507,85,7563779,-1,2000.0,7610398,7611397,47941,999,28,1,True,True,55.35343888888889,-0.1994788508641975
9743,7562624,42,1,0.135691,85,7563779,-1,500.0,7610356,7610398,47732,42,29,7,True,True,0.5408666666666667,-0.135691
9744,7562724,6792,128,0.554284,85,7563779,-1,64000.0,7612598,7619390,49874,6792,26,0,True,True,10786.99911111111,-0.5242255442558084
9745,7562749,15,1,0.301062,85,7563779,-1,500.0,7589645,7589660,26896,15,41,6,True,True,0.1862083333333333,-0.301062
9746,7562848,7025,2,0.085598,85,7563779,-1,1000.0,7618098,7625123,55250,7025,24,7,True,True,164.99852777777778,-0.07995731762422871
9747,7562964,28,1,0.566665,85,7563779,-1,500.0,7564510,7564538,1546,28,73,0,True,True,0.48727777777777775,-0.566665
9748,7562969,86,1,0.628319,85,7563779,-1,500.0,7564396,7564482,1427,86,79,0,True,True,1.4966388888888889,-0.628319
9749,7562995,13964,16,0.545831,85,7563779,-1,8000.0,7691158,7705122,128163,13964,11,4,True,True,3072.310888888889,-0.5372038522622579
9750,7563194,10781,20,0.375966,85,7563779,-1,10000.0,7579421,7590202,16227,10781,49,0,True,True,2665.7777222222226,-0.37324203856878424
9751,7563252,6624,2,0.875921,85,7563779,-1,1000.0,7564510,7571134,1258,6624,78,4,True,True,221.95452222222224,-0.867987541295111
9752,7563313,139,8,0.436893,85,7563779,-1,4000.0,7565610,7565749,2297,139,75,6,True,True,19.351888888888887,-0.436893
9753,7564405,6,1,0.13861,80,7564510,-1,500.0,7594045,7594051,29640,6,39,0,True,True,0.076475,-0.13861
9754,7564740,14547,1,0.441901,81,7565610,-1,500.0,7633490,7648037,68750,14547,21,8,True,True,161.32836527777778,-0.4325515621442084
9755,7564774,6,16,0.31326,81,7565610,-1,8000.0,7585306,7585312,20532,6,49,7,True,True,1.179066666666667,-0.31326
9756,7564834,20618,32,0.93488,81,7565610,-1,16000.0,7662076,7682694,97242,20618,16,0,True,True,8080.755644444444,-0.9245220097715574
9757,7564875,32,4,0.712599,81,7565610,-1,2000.0,7573921,7573953,9046,32,59,0,True,True,2.078577777777778,-0.712599
9758,7564880,13,8,0.468379,81,7565610,-1,4000.0,7570435,7570448,5555,13,68,0,True,True,1.6969333333333334,-0.468379
9759,7565888,11,2,0.427669,86,7566710,-1,1000.0,7569335,7569346,3447,11,70,0,True,True,0.3589666666666667,-0.427669
9760,7565897,69,2,0.420506,86,7566710,-1,1000.0,7580521,7580590,14624,69,53,6,True,True,1.7476166666666666,-0.420506
9761,7565911,20256,128,0.410259,86,7566710,-1,64000.0,7682694,7702950,116783,20256,14,1,True,True,34470.68373333333,-0.40797460843704264
9762,7566277,4590,1,0.027673,86,7566710,-1,500.0,7662076,7666666,95799,4590,18,7,True,True,56.88734166666667,-0.027536601372535736
9763,7566559,28,32,0.558909,86,7566710,-1,16000.0,7588545,7588573,21986,28,50,0,True,True,11.004622222222222,-0.558909
9764,7566576,2,32,0.957492,86,7566710,-1,16000.0,7572689,7572691,6113,2,66,0,True,True,1.039288888888889,-0.957492
9765,7566639,79,4,0.420919,86,7566710,-1,2000.0,7588545,7588624,21906,79,52,1,True,True,3.8810944444444444,-0.420919
9766,7566742,64,5,0.755856,81,7566745,-1,2500.0,7572689,7572753,5947,64,68,0,True,True,5.196444444444444,-0.755856
9767,7566922,8560,8,0.615209,81,7567845,-1,4000.0,7595145,7603705,28223,8560,43,6,True,True,801.0678333333333,-0.587440118013961
7477,5838914,19466,16,0.616028,1,5838914,-1,8000.0,5839417,5858380,503,19466,0,0,True,True,6870.681866666666,-0.5800960644690955
7478,5839417,118,8,0.189102,1,5839417,-1,4000.0,5839583,5839535,166,118,0,0,True,True,16.516066666666667,-0.189102
7479,5839583,4,2,0.535468,1,5839583,-1,1000.0,5840683,5840687,1100,4,0,6,True,True,0.13996666666666666,-0.535468
7480,5839618,2272,4,0.789588,7,5840683,-1,2000.0,5850483,5852755,10865,2272,0,7,True,True,225.98826666666665,-0.789588
7481,5839644,34,8,0.327681,7,5840683,-1,4000.0,5855883,5855917,16239,34,0,8,True,True,6.995311111111111,-0.327681
7482,5839700,19967,1,0.053259,7,5840683,-1,500.0,5870614,5881250,30914,19967,0,8,True,True,497.4079611111111,-0.053102871211505503
7483,5839896,20,1,0.795612,7,5840683,-1,500.0,5842883,5842903,2987,20,3,7,True,True,0.35858333333333337,-0.795612
7484,5840012,82,4,0.872851,7,5840683,-1,2000.0,5842883,5842965,2871,82,3,0,True,True,5.880766666666667,-0.872851
7485,5840100,18,1,0.851503,7,5840683,-1,500.0,5842883,5842901,2783,18,3,0,True,True,0.32272500000000004,-0.851503
7486,5840188,107,1,0.968384,7,5840683,-1,500.0,5848283,5848390,8095,107,3,8,True,True,2.2799916666666666,-0.968384
7487,5870614,11551,32,0.885834,1,5870614,-1,16000.0,5880600,5883265,9986,11551,0,6,True,True,8658.27431111111,-0.8851091172603899
7488,5880600,3,16,0.209238,1,5880600,-1,8000.0,5882800,5882803,2200,3,0,7,True,True,1.1638,-0.209238
7489,5880962,15,2,0.081408,4,5882800,-1,1000.0,5897112,5897127,16150,15,0,7,True,True,0.6016666666666667,-0.081408
7490,5881100,68,4,0.470667,4,5882800,-1,2000.0,5915612,5915680,34512,68,0,7,True,True,2.9353333333333333,-0.470667
7491,5881385,2,8,0.663502,4,5882800,-1,4000.0,5888200,5888202,6815,2,2,8,True,True,0.3676888888888889,-0.663502
7492,5881622,112,17,0.064873,4,5882800,-1,8500.0,5894800,5894912,13178,112,2,7,True,True,42.120711111111106,-0.064873
7493,5883158,1641,1,0.508614,7,5888200,-1,500.0,5894912,5896553,11754,1641,2,1,True,True,36.302566666666664,-0.508614
7494,5883784,6,1,0.751308,7,5888200,-1,500.0,5889300,5889306,5516,6,4,6,True,True,0.13788333333333336,-0.751308
7495,5885585,1201,64,0.645072,7,5888200,-1,32000.0,5913412,5914613,27827,1201,1,8,True,True,866.2145777777779,-0.645072
7496,5887426,17,64,0.509159,7,5888200,-1,32000.0,5899312,5899329,11886,17,2,7,True,True,21.820444444444444,-0.509159
7497,5888353,2940,16,0.498588,10,5889300,-1,8000.0,5891500,5894440,3147,2940,6,7,True,True,1034.7359999999999,-0.49576437665412715
7498,5888516,102,4,0.464267,10,5889300,-1,2000.0,5924412,5924514,35896,102,0,7,True,True,4.131566666666666,-0.464267
7499,5889002,20,8,0.321823,10,5889300,-1,4000.0,5928914,5928934,39912,20,0,0,True,True,1.2353333333333334,-0.321823
7500,5889054,7028,1,0.373879,10,5889300,-1,500.0,5961842,5968870,72788,7028,0,7,True,True,149.15351111111113,-0.371297404897874
7501,5890305,1107,1,0.69451,13,5891500,-1,500.0,5904712,5905819,14407,1107,5,0,True,True,20.0197875,-0.69451
7502,5890888,78,1,0.71565,13,5891500,-1,500.0,5892600,5892678,1712,78,10,6,True,True,1.7086333333333334,-0.71565
7503,5890994,2,64,0.494792,13,5891500,-1,32000.0,5965142,5965144,74148,2,0,0,True,True,2.768177777777778,-0.494792
7504,5891319,21,4,0.268335,13,5891500,-1,2000.0,5906912,5906933,15593,21,6,7,True,True,1.519116666666667,-0.268335
7505,5894446,38,1,0.400946,12,5894800,-1,500.0,5904712,5904750,10266,38,8,8,True,True,0.6872194444444445,-0.400946
7506,5895769,6344,1,0.921185,13,5897112,-1,500.0,5926714,5933058,30945,6344,3,7,True,True,59.79426666666667,-0.7247744996616151
7507,5895801,14,16,0.583983,13,5897112,-1,8000.0,5920012,5920026,24211,14,5,7,True,True,2.2885333333333335,-0.583983
7508,5896365,6,16,0.036604,13,5897112,-1,8000.0,5928914,5928920,32549,6,3,7,True,True,0.7412000000000001,-0.036604
7509,5897788,87,45,0.219526,14,5899312,-1,22500.0,5943214,5943301,45426,87,2,7,True,True,66.8595,-0.21952600000000005
7510,5897835,22,1,0.203,14,5899312,-1,500.0,5935514,5935536,37679,22,3,7,True,True,0.291225,-0.203
7511,5903646,2,16,0.863168,26,5904712,-1,8000.0,5908012,5908014,4366,2,11,6,True,True,0.5259111111111111,-0.863168
7512,5903692,5511,16,0.3959,26,5904712,-1,8000.0,5924514,5930025,20822,5511,7,1,True,True,757.0211333333334,-0.3313175029315486
7513,5903830,14,1,0.305999,26,5904712,-1,500.0,5956314,5956328,52484,14,2,0,True,True,0.31787777777777776,-0.305999
7514,5903854,21512,256,0.888709,26,5904712,-1,128000.0,6091169,6112681,187315,21512,0,7,True,True,114657.04142222222,-0.8834792432584905
7515,5903891,13741,32,0.57137,26,5904712,-1,16000.0,5988360,6002101,84469,13741,1,6,True,True,6779.948222222222,-0.5441068703235243
7516,5903910,6463,1,0.935499,26,5904712,-1,500.0,5904712,5911175,802,6463,18,0,True,True,110.98280972222221,-0.9257000730442462
7517,5904073,7,16,0.374107,26,5904712,-1,8000.0,5928914,5928921,24841,7,8,0,True,True,0.8647333333333334,-0.374107
7518,5904109,192,32,0.550552,26,5904712,-1,16000.0,5920012,5920204,15903,192,13,0,True,True,62.77120000000001,-0.550552
7519,5904173,54,29,0.13433,26,5904712,-1,14500.0,5956314,5956368,52141,54,5,7,True,True,35.5569,-0.13433
7520,5904231,20,8,0.084028,26,5904712,-1,4000.0,5953014,5953034,48783,20,6,7,True,True,3.321111111111111,-0.084028
7521,5904299,7667,1,0.444505,26,5904712,-1,500.0,5931114,5938781,26815,7667,9,7,True,True,100.4575875,-0.4213279131981866
7522,5904344,7,4,0.351575,26,5904712,-1,2000.0,5906912,5906919,2568,7,21,0,True,True,0.5063722222222222,-0.351575
7523,5904545,13,64,0.583962,26,5904712,-1,32000.0,5948614,5948627,44069,13,7,8,True,True,15.640444444444443,-0.583962
7524,5905986,11287,128,0.465253,28,5906912,-1,64000.0,5975973,5987260,69987,11287,2,7,True,True,26308.868977777776,-0.43685554799532256
7525,5906035,4050,67,0.621126,28,5906912,-1,33500.0,5954114,5958164,48079,4050,7,6,True,True,6113.313569444444,-0.6191986184944415
7526,5906485,4656,2,0.426102,28,5906912,-1,1000.0,6006324,6010980,99839,4656,1,0,True,True,126.44663333333332,-0.4161405787898884
7527,5906664,83,37,0.467551,28,5906912,-1,18500.0,5917812,5917895,11148,83,22,7,True,True,33.14120833333334,-0.467551
7528,5906719,25,1,0.408953,28,5906912,-1,500.0,5941014,5941039,34295,25,12,7,True,True,0.4269444444444444,-0.408953
7529,5906995,65,8,0.804504,30,5908012,-1,4000.0,5922212,5922277,15217,65,21,7,True,True,5.265722222222221,-0.804504
7530,5907080,18,4,0.31702,30,5908012,-1,2000.0,5922212,5922230,15132,18,21,0,True,True,0.7291,-0.31702
7531,5907182,677,2,0.382371,30,5908012,-1,1000.0,5938814,5939491,31632,677,13,6,True,True,20.123825,-0.382371
7532,5907513,29749,128,0.179566,30,5908012,-1,64000.0,5973270,6003019,65757,29749,4,0,True,True,64950.40088888889,-0.1766997797382512
7533,5908228,324,8,0.23379,30,5913412,-1,4000.0,5937714,5938038,29486,324,15,0,True,True,38.5236,-0.23379
7534,5922727,807,2,0.645355,30,5924412,-1,1000.0,5956328,5957135,33601,807,7,0,True,True,36.646766666666664,-0.645355
7535,5922836,12,1,0.359093,30,5924412,-1,500.0,5933314,5933326,10478,12,18,7,True,True,0.15885000000000002,-0.359093
7536,5922893,56,8,0.082419,30,5924412,-1,4000.0,5967342,5967398,44449,56,5,7,True,True,9.340177777777779,-0.082419
7537,5923043,9440,30,0.842603,30,5924412,-1,15000.0,5928914,5938354,5871,9440,21,0,True,True,3482.6845000000008,-0.7869625542391633
7538,5923741,6610,32,0.512791,30,5924412,-1,16000.0,5994984,6001594,71243,6610,2,7,True,True,3015.505688888889,-0.4911974856200864
7539,5924008,267,32,0.643654,30,5924412,-1,16000.0,5937714,5937981,13706,267,19,7,True,True,126.98520000000002,-0.643654
7540,5924145,828,2,0.785873,30,5924412,-1,1000.0,5933314,5934142,9169,828,21,0,True,True,21.921300000000002,-0.785873
7541,5937302,20,8,0.926606,23,5937714,-1,4000.0,5938814,5938834,1512,20,17,0,True,True,2.378,-0.926606
7542,5937343,15455,1,0.098409,23,5937714,-1,500.0,6024042,6039497,86699,15455,1,6,True,True,203.9344638888889,-0.0975500465461112
7543,5937364,22032,1,0.071349,23,5937714,-1,500.0,6050333,6072365,112969,22032,1,7,True,True,382.66515277777773,-0.07093140873001955
7544,5937459,60,16,0.038281,23,5937714,-1,8000.0,5962942,5963002,25483,60,10,6,True,True,20.761333333333333,-0.038281
7545,5938122,17491,128,0.200307,22,5938814,-1,64000.0,6028442,6045933,90320,17491,2,7,True,True,29719.12622222222,-0.19703745174319984
7546,5939596,10,1,0.196646,22,5941014,-1,500.0,5973284,5973294,33688,10,8,1,True,True,0.2056111111111111,-0.196646
7547,5940046,5,9,0.329241,22,5941014,-1,4500.0,5965142,5965147,25096,5,11,0,True,True,0.9731875000000001,-0.329241
7548,5943944,43,16,0.302716,25,5948614,-1,8000.0,5971070,5971113,27126,43,10,6,True,True,14.517755555555556,-0.302716
7549,5944054,4569,8,0.815565,25,5948614,-1,4000.0,5950814,5955383,6760,4569,21,7,True,True,774.031711111111,-0.774731969930253
7550,5944985,16221,32,0.683539,25,5948614,-1,16000.0,6032842,6049063,87857,16221,2,7,True,True,7078.267955555555,-0.6522345681471136
7551,5945227,20,1,0.274465,25,5948614,-1,500.0,5990560,5990580,45333,20,7,7,True,True,0.32425000000000004,-0.274465
7552,5945250,9156,1,0.705643,25,5948614,-1,500.0,6037242,6046398,91992,9156,2,7,True,True,123.69660833333333,-0.7052415752190171
7553,5949338,6946,1,0.997996,28,5950814,-1,500.0,5965142,5972088,15804,6946,16,0,True,True,145.69069722222224,-0.9793782226924983
7554,5949610,9251,4,0.998405,28,5950814,-1,2000.0,5959642,5968893,10032,9251,20,1,True,True,789.8357166666667,-0.9885176698730936
7555,5950566,59,4,0.752383,28,5950814,-1,2000.0,5957428,5957487,6862,59,21,6,True,True,5.3585111111111114,-0.752383
7556,5950742,7103,32,0.739821,28,5950814,-1,16000.0,5968870,5975973,18128,7103,14,2,True,True,4734.488088888889,-0.7396319364752889
7557,5950940,1359,8,0.912383,38,5953014,-1,4000.0,5954114,5955473,3174,1359,26,0,True,True,242.3963777777778,-0.8959045331345482
7558,5951016,40,8,0.008534,38,5953014,-1,4000.0,5998584,5998624,47568,40,7,1,True,True,4.603555555555555,-0.008534
7559,5951084,22235,2,0.299474,38,5953014,-1,1000.0,6039442,6061677,88358,22235,2,7,True,True,709.0676527777778,-0.29707173547058296
7560,5951247,6,1,0.822309,38,5953014,-1,500.0,5956328,5956334,5081,6,26,1,True,True,0.13623333333333335,-0.822309
7561,5951296,6,78,0.783128,38,5953014,-1,39000.0,5969970,5969976,18674,6,16,0,True,True,9.87545,-0.783128
7562,5951655,140,1,0.403811,38,5953014,-1,500.0,5998584,5998724,46929,140,8,0,True,True,2.0140555555555557,-0.403811
7563,5951854,12,1,0.405758,38,5953014,-1,500.0,5968870,5968882,17016,12,18,0,True,True,0.2532166666666667,-0.405758
7564,5951926,14,1,0.579954,38,5953014,-1,500.0,5959628,5959642,7702,14,27,7,True,True,0.3045,-0.579954
7565,5951995,14,28,0.655309,38,5953014,-1,14000.0,5973270,5973284,21275,14,16,7,True,True,8.059955555555554,-0.655309
7566,5952001,11284,16,0.472004,38,5953014,-1,8000.0,6000824,6012108,48823,11284,8,7,True,True,2560.330844444444,-0.46030456982393364
7567,5952197,8289,16,0.512647,38,5953014,-1,8000.0,5992760,6001049,40563,8289,12,7,True,True,1917.3791555555556,-0.4902347777382661
7568,5953161,12067,16,0.761161,38,5954114,-1,8000.0,6012124,6024191,58963,12067,7,4,True,True,2478.698311111111,-0.75974665232797
7569,5955024,20,4,0.149281,41,5956314,-1,2000.0,6017442,6017462,62418,20,7,1,True,True,1.0235555555555556,-0.149281
7570,5955318,15,1,0.397505,41,5956314,-1,500.0,5969970,5969985,14652,15,23,6,True,True,0.31652083333333336,-0.397505
7571,5955467,16,16,0.226926,41,5956314,-1,8000.0,5992784,5992800,37317,16,14,1,True,True,4.1504,-0.226926
7572,5955906,27,1,0.749137,41,5956314,-1,500.0,5965142,5965169,9236,27,31,7,True,True,0.5839125000000001,-0.749137
7573,5956088,10745,1,0.474438,41,5956314,-1,500.0,6004124,6014869,48036,10745,10,7,True,True,145.1961527777778,-0.4516929728575306
7574,5961665,86,1,0.515825,35,5961842,-1,500.0,5998624,5998710,36959,86,12,0,True,True,1.2372055555555557,-0.515825
7575,5969778,334,8,0.785975,27,5969970,-1,4000.0,5973284,5973618,3506,334,21,0,True,True,54.93928888888889,-0.785975
7576,5970831,20,1,0.757621,26,5971070,-1,500.0,5987260,5987280,16429,20,20,0,True,True,0.37077777777777776,-0.757621
7577,5972158,9422,1,0.72251,29,5973270,-1,500.0,6026242,6035664,54084,9422,6,0,True,True,123.93797777777777,-0.7127893591087491
7578,5972911,50,1,0.461401,29,5973270,-1,500.0,6008524,6008574,35613,50,10,7,True,True,0.6568055555555555,-0.461401
7579,5972972,7561,17,0.791915,29,5973270,-1,8500.0,5998584,6006145,25612,7561,16,0,True,True,1899.1175291666668,-0.7901267502428481
7580,5973042,2995,5,0.313075,29,5973270,-1,2500.0,6032842,6035837,59800,2995,4,0,True,True,195.358125,-0.309283221220264
7581,5973569,43036,2,0.187847,27,5975973,-1,1000.0,6048133,6091169,74564,43036,2,7,True,True,1368.8289444444445,-0.18759792239655657
7582,5975531,24,16,0.770131,27,5975973,-1,8000.0,5992760,5992784,17229,24,22,0,True,True,6.225600000000001,-0.770131
7583,5993285,22793,128,0.697941,21,5994984,-1,64000.0,6045933,6068726,52648,22793,3,6,True,True,49453.71928888888,-0.691884735864723
7584,5995698,2,8,0.209585,28,5998584,-1,4000.0,6022942,6022944,27244,2,11,7,True,True,0.20675555555555558,-0.209585
7585,5995748,7,4,0.449972,28,5998584,-1,2000.0,6006324,6006331,10576,7,15,0,True,True,0.39561666666666667,-0.449972
7586,5995800,686,1,0.558447,28,5998584,-1,500.0,6006324,6007010,10524,686,17,7,True,True,9.692608333333334,-0.558447
7587,5995817,602,1,0.3747,28,5998584,-1,500.0,5998624,5999226,2807,602,21,1,True,True,8.660438888888889,-0.3747
7588,5995826,170,4,0.577508,28,5998584,-1,2000.0,6001924,6002094,6098,170,19,6,True,True,10.403055555555556,-0.577508
7589,5997313,37,6,0.128346,28,5998584,-1,3000.0,6026242,6026279,28929,37,10,7,True,True,2.8687333333333336,-0.128346
7590,5997397,69,8,0.943354,28,5998584,-1,4000.0,5998584,5998653,1187,69,25,0,True,True,7.941133333333332,-0.943354
7591,5997607,47,16,0.009681,28,5998584,-1,8000.0,6020742,6020789,23135,47,13,0,True,True,9.696622222222222,-0.009681
7592,6010433,2573,2,0.810401,21,6012124,-1,1000.0,6014869,6017442,4436,2573,15,1,True,True,65.83615,-0.8103510133968282
7593,6010526,2,4,0.834299,21,6012124,-1,2000.0,6020742,6020744,10216,2,14,7,True,True,0.10315555555555556,-0.834299
7594,6010551,78,1,0.339822,21,6012124,-1,500.0,6035042,6035120,24491,78,6,7,True,True,1.0300333333333334,-0.339822
7595,6010570,6486,32,0.419147,21,6012124,-1,16000.0,6030642,6037128,20072,6486,9,7,True,True,2681.0221333333334,-0.41891949468526263
7596,6010615,23,1,0.685763,21,6012124,-1,500.0,6018542,6018565,7927,23,17,0,True,True,0.29427222222222227,-0.685763
7597,6011833,103,8,0.403369,21,6012124,-1,4000.0,6018542,6018645,6709,103,18,6,True,True,10.542622222222223,-0.403369
7598,6084405,10,1,0.778643,6,6091169,-1,500.0,6112681,6112691,28276,10,0,7,True,True,0.35325,-0.778643
7599,6084716,8396,8,0.537604,6,6091169,-1,4000.0,6137816,6146212,53100,8396,0,0,True,True,2741.1306666666665,-0.5308677133535961
7600,6085683,12,4,0.32608,6,6091169,-1,2000.0,6114905,6114917,29222,12,1,0,True,True,2.024866666666667,-0.32608
7601,6085768,291,64,0.02324,6,6091169,-1,32000.0,6119317,6119608,33549,291,1,0,True,True,815.9639999999999,-0.02324
7602,6085843,31,32,0.785358,6,6091169,-1,16000.0,6120204,6120235,34361,31,1,1,True,True,41.03022222222222,-0.785358
7603,6085865,8087,26,0.922144,6,6091169,-1,13000.0,6119608,6127695,33743,8087,2,0,True,True,8664.29525,-0.8893701540394198
7604,6093970,4,2,0.153691,78,6112681,-1,1000.0,6130116,6130120,36146,4,1,6,True,True,0.33580000000000004,-0.153691
7605,6094137,1277,1,0.952638,78,6112681,-1,500.0,6114917,6116194,20780,1277,5,0,True,True,53.86989027777778,-0.952638
7606,6094181,836,16,0.330251,78,6112681,-1,8000.0,6119608,6120444,25427,836,3,0,True,True,568.6213333333333,-0.3204372495114066
7607,6094592,4818,1,0.629839,78,6112681,-1,500.0,6120205,6125023,25613,4818,2,1,True,True,198.2856861111111,-0.629385319277467
7608,6094727,8,8,0.603003,78,6112681,-1,4000.0,6117117,6117125,22390,8,7,0,True,True,2.804,-0.603003
7609,6094907,18787,2,0.607837,78,6112681,-1,1000.0,6170147,6188934,75240,18787,0,3,True,True,843.0093499999999,-0.5588912206617979
7610,6094978,10,4,0.866945,78,6112681,-1,2000.0,6114917,6114927,19939,10,10,0,True,True,1.687388888888889,-0.866945
7611,6095254,11,44,0.980172,78,6112681,-1,22000.0,6127905,6127916,32651,11,3,0,True,True,20.315900000000003,-0.980172
7612,6095273,34,1,0.204205,78,6112681,-1,500.0,6121305,6121339,26032,34,4,0,True,True,1.4062777777777777,-0.204205
7613,6095276,750,8,0.390636,78,6112681,-1,4000.0,6119608,6120358,24332,750,7,0,True,True,255.85422222222223,-0.3802030240684736
7614,6095281,697,1,0.534491,78,6112681,-1,500.0,6120204,6120901,24923,697,6,0,True,True,28.828694444444448,-0.534491
7615,6095288,87,1,0.188339,78,6112681,-1,500.0,6165447,6165534,70159,87,1,0,True,True,2.7566916666666663,-0.188339
7616,6095300,5354,8,0.108638,78,6112681,-1,4000.0,6135616,6140970,40316,5354,3,0,True,True,1776.3599555555556,-0.1084828203891634
7617,6095363,19008,8,0.569515,78,6112681,-1,4000.0,6165447,6184455,70084,19008,2,7,True,True,3400.5237999999995,-0.5346839751835758
7618,6095534,31,4,0.451535,78,6112681,-1,2000.0,6119736,6119767,24202,31,11,2,True,True,5.4327499999999995,-0.451535
7619,6095582,113,2,0.894744,78,6112681,-1,1000.0,6117117,6117230,21535,113,17,7,True,True,9.901625,-0.894744
7620,6095896,137,32,0.093242,78,6112681,-1,16000.0,6135616,6135753,39720,137,5,7,True,True,180.59035555555556,-0.093242
7621,6095972,9,2,0.104313,78,6112681,-1,1000.0,6135616,6135625,39644,9,4,0,True,True,0.741475,-0.104313
7622,6095994,6961,17,0.552907,78,6112681,-1,8500.0,6119721,6126682,23727,6961,14,0,True,True,4869.6464819444445,-0.5337341066738206
7623,6096053,39045,8,0.032059,78,6112681,-1,4000.0,6210126,6249171,114073,39045,0,6,True,True,9714.970733333334,-0.032008472916519
7624,6096103,12315,4,0.689025,78,6112681,-1,2000.0,6196711,6209026,100608,12315,1,1,True,True,1671.9912333333332,-0.6865842254510143
7625,6096127,23680,2,0.488613,78,6112681,-1,1000.0,6249761,6273441,153634,23680,0,7,True,True,894.1852833333334,-0.4879838065674686
7626,6096190,11,1,0.186692,78,6112681,-1,500.0,6119317,6119328,23127,11,21,0,True,True,0.4819375,-0.186692
7627,6096215,699,18,0.069491,78,6112681,-1,9000.0,6120204,6120903,23989,699,15,0,True,True,520.4055,-0.069491
7628,6096769,50,1,0.962995,78,6112681,-1,500.0,6114905,6114955,18136,50,28,0,True,True,2.109236111111111,-0.962995
7629,6096778,13995,36,0.283818,78,6112681,-1,18000.0,6166547,6180542,69769,13995,4,6,True,True,11209.883,-0.25142308679403275
7630,6096933,51,1,0.233039,78,6112681,-1,500.0,6180182,6180233,83249,51,3,2,True,True,0.9937208333333333,-0.233039
7631,6096961,72,4,0.65957,78,6112681,-1,2000.0,6119317,6119389,22356,72,24,0,True,True,12.618,-0.65957
7632,6097020,8852,128,0.069979,78,6112681,-1,64000.0,6146909,6155761,49889,8852,8,7,True,True,41365.994666666666,-0.06885428670008258
7633,6097126,33,8,0.057453,78,6112681,-1,4000.0,6125705,6125738,28579,33,15,7,True,True,10.735266666666666,-0.057453
7634,6097130,279,4,0.518532,78,6112681,-1,2000.0,6119608,6119887,22478,279,23,0,True,True,48.894749999999995,-0.518532
7635,6097184,6985,8,0.171826,78,6112681,-1,4000.0,6189726,6196711,92542,6985,3,7,True,True,1728.9703555555557,-0.16149869881311615
7636,6097211,410,4,0.859707,78,6112681,-1,2000.0,6119389,6119799,22178,410,28,2,True,True,71.85249999999999,-0.859707
7637,6097271,3,8,0.410861,78,6112681,-1,4000.0,6118217,6118220,20946,3,32,6,True,True,1.0515,-0.410861
7638,6097277,278,2,0.157035,78,6112681,-1,1000.0,6157747,6158025,60470,278,9,7,True,True,19.110955555555556,-0.157035
7639,6097332,23,4,0.110744,78,6112681,-1,2000.0,6137816,6137839,40484,23,11,0,True,True,3.789761111111111,-0.110744
7640,6097351,23,32,0.536453,78,6112681,-1,16000.0,6120205,6120228,22854,23,20,0,True,True,30.44177777777778,-0.536453
7641,6098046,203,8,0.478251,78,6112681,-1,4000.0,6121305,6121508,23259,203,19,0,True,True,67.17044444444446,-0.478251
7642,6098145,19,1,0.068763,78,6112681,-1,500.0,6137816,6137835,39671,19,13,0,True,True,0.7826680555555555,-0.068763
7643,6098202,1062,2,0.955097,78,6112681,-1,1000.0,6119317,6120379,21115,1062,37,6,True,True,91.19959722222222,-0.9360258732685109
7644,6098431,6,1,0.865699,78,6112681,-1,500.0,6114917,6114923,16486,6,43,0,True,True,0.2531083333333334,-0.865699
7645,6098546,4961,16,0.129932,78,6112681,-1,8000.0,6127905,6132866,29359,4961,19,6,True,True,3325.3800444444446,-0.1298463567536121
7646,6098955,14,1,0.205677,78,6112681,-1,500.0,6127905,6127919,28950,14,19,0,True,True,0.58765,-0.205677
7647,6100368,8,26,0.432201,78,6112681,-1,13000.0,6120196,6120204,19828,8,29,4,True,True,8.603111111111112,-0.432201
7648,6100373,624,1,0.709672,78,6112681,-1,500.0,6129016,6129640,28643,624,18,0,True,True,26.192400000000003,-0.709672
7649,6100434,3,2,0.47478,78,6112681,-1,1000.0,6120204,6120207,19770,3,29,0,True,True,0.2481666666666667,-0.47478
7650,6100512,20254,16,0.603709,78,6112681,-1,8000.0,6212326,6232580,111814,20254,1,7,True,True,11737.149777777779,-0.5996925570876931
7651,6100987,28,2,0.939154,78,6112681,-1,1000.0,6114905,6114933,13918,28,52,7,True,True,2.3623444444444446,-0.939154
7652,6101020,9091,128,0.587492,78,6112681,-1,64000.0,6214526,6223617,113506,9091,1,7,True,True,40271.581155555556,-0.5763009300769407
7653,6101026,128,16,0.502475,78,6112681,-1,8000.0,6119608,6119736,18582,128,39,0,True,True,89.728,-0.502475
7654,6101073,7,1,0.684836,78,6112681,-1,500.0,6114917,6114924,13844,7,51,0,True,True,0.2952930555555556,-0.684836
7655,6106453,89,16,0.275441,78,6112681,-1,8000.0,6119608,6119697,13155,89,39,0,True,True,62.388999999999996,-0.275441
7656,6106775,9486,8,0.007443,78,6112681,-1,4000.0,6218126,6227612,111351,9486,1,4,True,True,2961.913,-0.007362849474633216
7657,6106898,10,16,0.142692,78,6112681,-1,8000.0,6129016,6129026,22118,10,22,0,True,True,6.716000000000001,-0.142692
7658,6107010,66,32,0.06397,78,6112681,-1,16000.0,6119608,6119674,12598,66,44,1,True,True,92.532,-0.06397
7659,6107212,15,1,0.399237,78,6112681,-1,500.0,6129016,6129031,21804,15,22,0,True,True,0.6296250000000001,-0.399237
7660,6107349,5513,1,0.807566,78,6112681,-1,500.0,6114917,6120430,7568,5513,58,1,True,True,238.07022083333334,-0.8063664509027028
7661,6107760,42,4,0.525857,78,6112681,-1,2000.0,6120205,6120247,12445,42,31,0,True,True,6.948666666666667,-0.525857
7662,6107783,6,4,0.910303,78,6112681,-1,2000.0,6112705,6112711,4922,6,63,2,True,True,0.8478000000000001,-0.910303
7663,6108059,58,1,0.879239,78,6112681,-1,500.0,6114917,6114975,6858,58,59,0,True,True,2.446713888888889,-0.879239
7664,6108112,537,1,0.460205,78,6112681,-1,500.0,6135616,6136153,27504,537,19,0,True,True,22.12067083333333,-0.460205
7665,6108162,11,4,0.576133,78,6112681,-1,2000.0,6120204,6120215,12042,11,37,0,True,True,1.8198888888888891,-0.576133
7666,6108299,73,1,0.737291,78,6112681,-1,500.0,6121305,6121378,13006,73,31,6,True,True,3.019361111111111,-0.737291
7667,6109439,8251,8,0.287912,78,6112681,-1,4000.0,6174588,6182839,65149,8251,8,0,True,True,1339.2160888888889,-0.28351464258570547
7668,6110021,745,2,0.880994,78,6112681,-1,1000.0,6120204,6120949,10183,745,37,0,True,True,61.628055555555555,-0.880994
7669,6110292,24,16,0.456307,78,6112681,-1,8000.0,6112681,6112705,2389,24,70,0,True,True,13.564800000000002,-0.456307
7670,6110560,683,2,0.700317,78,6112681,-1,1000.0,6123505,6124188,12945,683,30,7,True,True,55.67934444444444,-0.6901538036763497
7671,6110618,475,1,0.711648,78,6112681,-1,500.0,6119721,6120196,9103,475,46,3,True,True,20.330465277777776,-0.6952178369667391
7672,6111648,10744,4,0.297449,78,6112681,-1,2000.0,6174582,6185326,62934,10744,9,0,True,True,884.2054333333333,-0.2710961329836499
7673,6111677,29494,4,0.613028,78,6112681,-1,2000.0,6247561,6277055,135884,29494,1,3,True,True,2173.951577777778,-0.6078101600463756
7674,6112290,396,7,0.809985,78,6112681,-1,3500.0,6119325,6119721,7035,396,57,1,True,True,121.44825,-0.809985
7675,6112402,206,1,0.175126,78,6112681,-1,500.0,6120204,6120410,7802,206,42,0,True,True,8.52038888888889,-0.175126
7676,6112602,13650,14,0.249135,78,6112681,-1,7000.0,6243591,6257241,130989,13650,2,7,True,True,3804.676925,-0.2427123999174745
7677,6112924,20785,193,0.899965,76,6114905,-1,96500.0,6241391,6262176,128467,20785,3,7,True,True,80390.67439166666,-0.8542790217532485
7678,6116203,5,8,0.733244,72,6117117,-1,4000.0,6119721,6119726,3518,5,50,0,True,True,1.7525,-0.733244
7679,6116352,1695,8,0.457828,72,6117117,-1,4000.0,6120204,6121899,3852,1695,42,0,True,True,560.8566666666667,-0.457828
7680,6116390,8,4,0.910833,72,6117117,-1,2000.0,6119317,6119325,2927,8,63,0,True,True,1.402,-0.910833
7681,6116853,16547,64,0.183444,72,6117117,-1,32000.0,6224844,6241391,107991,16547,4,6,True,True,34750.14026666667,-0.1808571381911117
7682,6117029,5,2,0.568615,72,6117117,-1,1000.0,6125705,6125710,8676,5,34,0,True,True,0.4066388888888889,-0.568615
7683,6118255,11693,41,0.393551,76,6119317,-1,20500.0,6125705,6137398,7450,11693,34,0,True,True,19918.18107222222,-0.39329310704051346
7684,6118441,9726,24,0.945687,76,6119317,-1,12000.0,6127916,6137642,9475,9726,31,1,True,True,9720.330866666667,-0.9443815308913986
7685,6118880,394,1,0.239695,76,6119317,-1,500.0,6173482,6173876,54602,394,14,0,True,True,9.48828611111111,-0.239695
7686,6118914,18,1,0.87054,76,6119317,-1,500.0,6120196,6120214,1282,18,54,0,True,True,0.7445,-0.87054
7687,6118928,95,1,0.273776,76,6119317,-1,500.0,6140016,6140111,21088,95,21,0,True,True,3.9612361111111114,-0.273776
7688,6119064,23817,2,0.628083,76,6119317,-1,1000.0,6223744,6247561,104680,23817,5,7,True,True,1444.2294499999998,-0.5818604817598819
7689,6119108,9,4,0.29189,76,6119317,-1,2000.0,6120196,6120205,1088,9,56,0,True,True,1.489,-0.29189
7690,6123749,14,4,0.916296,48,6125705,-1,2000.0,6126805,6126819,3056,14,38,0,True,True,2.2771777777777773,-0.916296
7691,6123915,18,4,0.698044,48,6125705,-1,2000.0,6132316,6132334,8401,18,30,7,True,True,3.0082,-0.698044
7692,6124059,81,1,0.722409,48,6125705,-1,500.0,6129016,6129097,4957,81,35,6,True,True,3.399975,-0.722409
7693,6124598,92,2,0.217255,48,6125705,-1,1000.0,6178988,6179080,54390,92,13,0,True,True,3.5851888888888888,-0.217255
7694,6124770,8,1,0.493488,48,6125705,-1,500.0,6137816,6137824,13046,8,27,0,True,True,0.3295444444444444,-0.493488
7695,6125092,2,5,0.99239,48,6125705,-1,2500.0,6126805,6126807,1713,2,43,6,True,True,0.4066388888888889,-0.99239
7696,6125214,4,4,0.552824,48,6125705,-1,2000.0,6135616,6135620,10402,4,28,0,True,True,0.6590888888888888,-0.552824
7697,6125511,10193,16,0.995316,48,6125705,-1,8000.0,6136716,6146909,11205,10193,28,6,True,True,6633.854088888889,-0.9825863992873279
7698,6125774,15531,128,0.076534,47,6126805,-1,64000.0,6140016,6155547,14242,15531,24,7,True,True,75943.57226666667,-0.07487187754714728
7699,6126004,10,16,0.105225,47,6126805,-1,8000.0,6158847,6158857,32843,10,21,6,True,True,5.499555555555555,-0.105225
7700,6126999,20414,256,0.766539,48,6127905,-1,128000.0,6299664,6320078,172665,20414,0,7,True,True,90448.26595555554,-0.756310170270157
7701,6127255,15208,4,0.326013,48,6127905,-1,2000.0,6187526,6202734,60271,15208,13,7,True,True,1937.5011333333334,-0.3256349891199397
7702,6127551,151,16,0.450936,48,6127905,-1,8000.0,6163247,6163398,35696,151,23,7,True,True,76.55364444444444,-0.450936
7703,6128779,3,1,0.252767,48,6129016,-1,500.0,6155547,6155550,26768,3,26,0,True,True,0.10549166666666668,-0.252767
7704,6128835,200,32,0.506065,48,6129016,-1,16000.0,6161047,6161247,32212,200,24,7,True,True,221.41333333333333,-0.506065
7705,6128855,154,2,0.462167,48,6129016,-1,1000.0,6174588,6174742,45733,154,17,1,True,True,6.546711111111111,-0.462167
7706,6129010,26,32,0.073195,48,6129016,-1,16000.0,6129016,6129042,6,26,47,0,True,True,34.9232,-0.073195
7707,6130829,3,5,0.694486,43,6132316,-1,2500.0,6133416,6133419,2587,3,42,6,True,True,0.6267083333333333,-0.6944859999999999
7708,6132809,32539,37,0.749736,44,6133416,-1,18500.0,6221544,6254083,88735,32539,7,7,True,True,34674.18483055556,-0.7329510372212946
7709,6133298,352,1,0.381156,44,6133416,-1,500.0,6142216,6142568,8918,352,31,7,True,True,14.299022222222224,-0.381156
7710,6133568,34,106,0.745957,49,6135616,-1,53000.0,6155547,6155581,21979,34,29,0,True,True,126.73065555555556,-0.745957
7711,6133731,53,4,0.855773,49,6135616,-1,2000.0,6140016,6140069,6285,53,34,0,True,True,8.839811111111112,-0.855773
7712,6133928,6435,4,0.396674,49,6135616,-1,2000.0,6174588,6181023,40660,6435,18,0,True,True,522.87175,-0.3935392144086727
7713,6134348,3,8,0.010737,49,6135616,-1,4000.0,6170147,6170150,35799,3,22,0,True,True,0.5522,-0.010737
7714,6134461,109,4,0.114683,49,6135616,-1,2000.0,6172382,6172491,37921,109,22,1,True,True,10.499727777777776,-0.114683
7715,6134542,144,8,0.917137,49,6135616,-1,4000.0,6137816,6137960,3274,144,43,6,True,True,47.4544,-0.917137
7716,6157938,30,8,0.32711,34,6158847,-1,4000.0,6166547,6166577,8609,30,25,0,True,True,7.604666666666666,-0.32711
7717,6158059,72,1,0.748676,34,6158847,-1,500.0,6158847,6158919,788,72,31,0,True,True,2.4748,-0.748676
7718,6158070,1194,32,0.484759,34,6158847,-1,16000.0,6178988,6180182,20918,1194,17,7,True,True,744.4722666666667,-0.484759
7719,6158142,61,8,0.068237,34,6158847,-1,4000.0,6207511,6207572,49369,61,12,9,True,True,16.05045555555556,-0.068237
7720,6166540,36,1,0.548429,29,6166547,-1,500.0,6176788,6176824,10248,36,19,7,True,True,0.7652,-0.548429
7721,6166801,8740,64,0.242294,36,6170147,-1,32000.0,6182382,6191122,15581,8740,16,7,True,True,14112.421688888888,-0.23469852182351977
7722,6167111,15477,8,0.950018,36,6170147,-1,4000.0,6184582,6200059,17471,15477,16,7,True,True,3738.7215,-0.902451062164916
7723,6167127,12518,64,0.140256,36,6170147,-1,32000.0,6209026,6221544,41899,12518,12,2,True,True,26444.20248888889,-0.13277522793228883
7724,6167151,6896,1,0.820427,36,6170147,-1,500.0,6170147,6177043,2996,6896,29,0,True,True,157.19676388888888,-0.7935033477235414
7725,6167179,4606,42,0.841563,36,6170147,-1,21000.0,6193326,6197932,26147,4606,15,4,True,True,6363.560466666667,-0.8229672086790145
7726,6167293,35,32,0.170589,36,6170147,-1,16000.0,6172347,6172382,5054,35,30,7,True,True,26.971777777777778,-0.170589
7727,6167321,2351,32,0.018066,36,6170147,-1,16000.0,6180182,6182533,12861,2351,20,0,True,True,1499.7032,-0.01776005708011164
7728,6167402,3,64,0.100515,36,6170147,-1,32000.0,6173482,6173485,6080,3,30,6,True,True,4.623733333333333,-0.100515
7729,6168363,50,16,0.294145,36,6170147,-1,8000.0,6174582,6174632,6219,50,29,6,True,True,17.00444444444444,-0.294145
7730,6170285,6,15,0.534654,36,6172347,-1,7500.0,6174582,6174588,4297,6,28,0,True,True,1.913,-0.534654
7731,6170812,28303,8,0.39085,36,6172347,-1,4000.0,6271361,6299664,100549,28303,1,10,True,True,3717.3557888888886,-0.38945562318972365
7732,6170820,852,1,0.077585,36,6172347,-1,500.0,6185326,6186178,14506,852,19,1,True,True,22.28335,-0.077585
7714,6134461,109,4,0.114683,1,6134461,-1,2000.0,6135561,6135670,1100,109,0,6,True,True,10.944205555555556,-0.114683
7715,6134542,144,8,0.917137,1,6135561,-1,4000.0,6157938,6135705,23396,144,0,0,True,True,21.296,-0.917137
7716,6157938,30,8,0.32711,1,6157938,-1,4000.0,6159038,6159068,1100,30,0,6,True,True,4.4366666666666665,-0.32711
7717,6158059,72,1,0.748676,3,6159038,-1,500.0,6159038,6159110,979,72,0,0,True,True,1.331,-0.748676
7718,6158070,1194,32,0.484759,3,6159038,-1,16000.0,6159068,6160262,998,1194,0,1,True,True,721.8228444444444,-0.4765327508169112
7719,6158142,61,8,0.068237,3,6159038,-1,4000.0,6166540,6161329,8398,61,0,7,True,True,9.423822222222222,-0.068237
7720,6166540,36,1,0.548429,1,6166540,-1,500.0,6168740,6168776,2200,36,0,7,True,True,0.7565000000000001,-0.548429
7721,6166801,8740,64,0.242294,9,6168740,-1,32000.0,6185536,6194276,18735,8740,0,0,True,True,12558.110222222222,-0.24053343212199715
7722,6167111,15477,8,0.950018,9,6168740,-1,4000.0,6187736,6203213,20625,15477,0,7,True,True,2912.541,-0.8961130101962298
7723,6167127,12518,64,0.140256,9,6168740,-1,32000.0,6214243,6226761,47116,12518,0,9,True,True,19839.68168888889,-0.13844722191498862
7724,6167151,6896,1,0.820427,9,6168740,-1,500.0,6172040,6178936,4889,6896,3,7,True,True,143.8274888888889,-0.8137426606359272
7725,6167179,4606,42,0.841563,9,6168740,-1,21000.0,6185536,6190142,18357,4606,3,7,True,True,4447.787866666667,-0.8359308228770873
7726,6167293,35,32,0.170589,9,6168740,-1,16000.0,6169840,6169875,2547,35,5,6,True,True,23.535555555555558,-0.170589
7727,6167321,2351,32,0.018066,9,6168740,-1,16000.0,6177440,6179791,10119,2351,4,8,True,True,1552.6136444444442,-0.017390838555850423
7728,6167402,3,64,0.100515,9,6168740,-1,32000.0,6183336,6183339,15934,3,4,7,True,True,4.210133333333333,-0.100515
7729,6168363,50,16,0.294145,9,6168740,-1,8000.0,6178936,6178986,10573,50,5,1,True,True,16.46333333333333,-0.294145
7730,6170285,6,15,0.534654,16,6172040,-1,7500.0,6185536,6185542,15251,6,3,0,True,True,2.10225,-0.534654
7731,6170812,28303,8,0.39085,16,6172040,-1,4000.0,6218955,6247258,48143,28303,0,1,True,True,5963.085744444444,-0.37179550133704975
7732,6170820,852,1,0.077585,16,6172040,-1,500.0,6214243,6215095,43423,852,1,0,True,True,20.120216666666668,-0.077585
7733,6171254,11,32,0.763589,16,6172040,-1,16000.0,6183336,6183347,12082,11,7,0,True,True,7.718577777777778,-0.763589
7734,6171266,6290,1,0.677383,16,6172040,-1,500.0,6226243,6232533,54977,6290,0,7,True,True,125.9188,-0.5299826128855005
7735,6171277,10237,3,0.153496,16,6172040,-1,1500.0,6226251,6236488,54974,10237,0,1,True,True,755.4057833333333,-0.13348324404262146
7736,6171329,8,10,0.358087,16,6172040,-1,5000.0,6181136,6181144,9807,8,11,7,True,True,1.6463333333333332,-0.358087
7737,6171796,29,4,0.216672,16,6172040,-1,2000.0,6196777,6196806,24981,29,5,5,True,True,2.7909277777777777,-0.216672
7738,6171947,8514,128,0.034445,16,6172040,-1,64000.0,6392227,6400741,220280,8514,0,6,True,True,21281.351288888887,-0.0330392911616717
7739,6180587,10886,2,0.675044,18,6181136,-1,1000.0,6240905,6251791,60318,10886,1,1,True,True,555.7499472222223,-0.6347906628484419
7740,6180626,47,1,0.216166,18,6181136,-1,500.0,6230654,6230701,50028,47,2,6,True,True,0.8708055555555556,-0.216166
7741,6180674,58,1,0.696742,18,6181136,-1,500.0,6198977,6199035,18303,58,8,7,True,True,1.3954638888888888,-0.696742
7742,6180804,34,2,0.836501,18,6181136,-1,1000.0,6187736,6187770,6932,34,10,0,True,True,1.5883666666666667,-0.836501
7743,6180922,3,1,0.811512,18,6181136,-1,500.0,6187736,6187739,6814,3,10,0,True,True,0.07007500000000001,-0.811512
7744,6181531,14512,1,0.641012,35,6183336,-1,500.0,6429063,6443575,247532,14512,0,6,True,True,395.35440694444446,-0.6390550767228586
7745,6181893,34,4,0.71641,35,6183336,-1,2000.0,6185536,6185570,3643,34,15,0,True,True,3.1767333333333334,-0.71641
7746,6181980,11445,16,0.89701,35,6183336,-1,8000.0,6185536,6196981,3556,11445,16,0,True,True,4124.635888888889,-0.872233469149114
7747,6182070,10698,256,0.390618,35,6183336,-1,128000.0,6552928,6563626,370858,10698,0,8,True,True,49637.1456,-0.38000356647766015
7748,6182223,59,2,0.308324,35,6183336,-1,1000.0,6214243,6214302,32020,59,9,0,True,True,2.786602777777778,-0.308324
7749,6182229,14021,8,0.052415,35,6183336,-1,4000.0,6325820,6339841,143591,14021,3,0,True,True,1628.4023333333332,-0.05191137403746112
7750,6182245,6,7,0.004666,35,6183336,-1,3500.0,6228454,6228460,46209,6,6,1,True,True,0.7781666666666668,-0.004666
7751,6182363,11,15,0.77241,35,6183336,-1,7500.0,6183336,6183347,973,11,24,0,True,True,3.6180833333333333,-0.77241
7752,6182386,12,2,0.767114,35,6183336,-1,1000.0,6187770,6187782,5384,12,15,1,True,True,0.5606000000000001,-0.767114
7753,6182528,13,32,0.928821,35,6183336,-1,16000.0,6183336,6183349,808,13,24,0,True,True,9.121955555555555,-0.928821
7754,6182662,527,8,0.374645,35,6183336,-1,4000.0,6203443,6203970,20781,527,13,1,True,True,114.92113333333334,-0.374645
7755,6182694,1989,2,0.23854,35,6183336,-1,1000.0,6187736,6189725,5042,1989,17,0,True,True,90.35042222222222,-0.23194486963589314
7756,6182782,38,2,0.091386,35,6183336,-1,1000.0,6239800,6239838,57018,38,5,0,True,True,2.373205555555556,-0.091386
7757,6182850,21,4,0.421683,35,6183336,-1,2000.0,6229554,6229575,46704,21,7,6,True,True,1.5563333333333336,-0.421683
7758,6182870,18,2,0.989291,35,6183336,-1,1000.0,6185536,6185554,2666,18,25,0,True,True,0.8409000000000001,-0.989291
7759,6182876,16473,21,0.337117,35,6183336,-1,10500.0,6370645,6387118,187769,16473,3,1,True,True,8035.5001416666655,-0.33468419794168525
7760,6183019,13368,6,0.192152,35,6183336,-1,3000.0,6317311,6330679,134292,13368,5,0,True,True,1178.0410749999999,-0.18374630145446336
7761,6183053,24,4,0.668949,35,6183336,-1,2000.0,6183336,6183360,283,24,32,0,True,True,2.1050666666666666,-0.668949
7762,6184878,28,1,0.220568,31,6185536,-1,500.0,6240900,6240928,56022,28,7,0,True,True,0.8743388888888889,-0.220568
7763,6186030,10651,4,0.882286,43,6187736,-1,2000.0,6220055,6230706,34025,10651,14,0,True,True,886.0099166666666,-0.7424550212001565
7764,6186037,134,4,0.796924,43,6187736,-1,2000.0,6187739,6187873,1702,134,23,1,True,True,12.520066666666667,-0.796924
7765,6186291,7,1,0.830451,43,6187736,-1,500.0,6193177,6193184,6886,7,22,1,True,True,0.1498486111111111,-0.830451
7766,6186296,4,1,0.167883,43,6187736,-1,500.0,6224043,6224047,37747,4,14,0,True,True,0.09497222222222222,-0.167883
7767,6186359,9079,16,0.167047,43,6187736,-1,8000.0,6220174,6229253,33815,9079,15,4,True,True,3053.1156888888886,-0.13616711721245753
7768,6186610,2,64,0.41568,43,6187736,-1,32000.0,6237600,6237602,50990,2,9,1,True,True,4.3443555555555555,-0.41568
7769,6186646,12762,5,0.107684,43,6187736,-1,2500.0,6261733,6274495,75087,12762,6,8,True,True,1204.1493611111111,-0.1069616861122866
7770,6186691,94,4,0.327141,43,6187736,-1,2000.0,6220055,6220149,33364,94,19,0,True,True,11.886300000000002,-0.327141
7771,6186720,10727,1,0.562054,43,6187736,-1,500.0,6301660,6312387,114940,10727,6,0,True,True,216.61665416666668,-0.5582255568806477
7772,6186760,4,16,0.189548,43,6187736,-1,8000.0,6220055,6220059,33295,4,21,6,True,True,2.0232,-0.189548
7773,6187354,35732,16,0.207119,43,6187736,-1,8000.0,6431263,6466995,243909,35732,1,7,True,True,14910.62597777778,-0.20578259545145275
7774,6187374,16088,32,0.541703,43,6187736,-1,16000.0,6224043,6240131,36669,16088,19,1,True,True,13195.63502222222,-0.4830330843803256
7775,6187428,7,4,0.938923,43,6187736,-1,2000.0,6193170,6193177,5742,7,32,0,True,True,0.5993944444444445,-0.938923
7776,6187452,40,4,0.120804,43,6187736,-1,2000.0,6230654,6230694,43202,40,13,0,True,True,2.9644444444444447,-0.120804
7777,6187476,230,32,0.21378,43,6187736,-1,16000.0,6203213,6203443,15737,230,30,2,True,True,200.6213333333333,-0.21378
7778,6187562,4,1,0.356576,43,6187736,-1,500.0,6200077,6200081,12515,4,31,6,True,True,0.10335555555555555,-0.356576
7779,6187628,5482,64,0.173622,43,6187736,-1,32000.0,6193170,6198652,5542,5482,36,8,True,True,8028.745422222222,-0.1716330917840423
7780,6187688,7780,16,0.402139,43,6187736,-1,8000.0,6229554,6237334,41866,7780,15,0,True,True,3542.982177777778,-0.36490514045068256
7781,6196956,48,8,0.31624,42,6198977,-1,4000.0,6236454,6236502,39498,48,13,3,True,True,13.033066666666668,-0.31624
7782,6197065,8715,64,0.389187,42,6198977,-1,32000.0,6308596,6317311,111531,8715,7,5,True,True,10294.119733333333,-0.3729874781967622
7783,6197309,20587,32,0.458776,42,6198977,-1,16000.0,6367017,6387604,169708,20587,5,1,True,True,14930.858622222222,-0.4499355996837577
7784,6197333,132,8,0.066016,42,6198977,-1,4000.0,6229554,6229686,32221,132,18,0,True,True,19.565333333333335,-0.066016
7785,6197371,40,8,0.815085,42,6198977,-1,4000.0,6201177,6201217,3806,40,36,6,True,True,8.268444444444444,-0.815085
7786,6197433,8,4,0.649945,42,6198977,-1,2000.0,6226243,6226251,28810,8,23,0,True,True,0.5541333333333334,-0.649945
7787,6198518,5,2,0.36898,42,6198977,-1,1000.0,6240900,6240905,42382,5,13,6,True,True,0.3122638888888889,-0.36898
7788,6198545,6037,1,0.067331,42,6198977,-1,500.0,6243119,6249156,44574,6037,11,0,True,True,151.3146708333333,-0.06608582670941515
7789,6198567,13942,3,0.218561,42,6198977,-1,1500.0,6339331,6353273,140764,13942,6,1,True,True,636.137575,-0.21653965989149251
7790,6199325,12,4,0.301534,44,6200077,-1,2000.0,6237588,6237600,38263,12,18,6,True,True,1.6291333333333335,-0.301534
7791,6199601,9528,16,0.598869,44,6200077,-1,8000.0,6236488,6246016,36887,9528,19,1,True,True,4623.210844444444,-0.5811198529704029
7792,6199623,16060,128,0.983102,44,6200077,-1,64000.0,6244219,6260279,44596,16060,12,6,True,True,46776.06737777778,-0.9517877313544368
7793,6200106,14,3,0.101814,45,6201177,-1,1500.0,6239800,6239814,39694,14,18,0,True,True,1.3115083333333333,-0.101814
7794,6200395,17,19,0.536182,45,6201177,-1,9500.0,6214243,6214260,13848,17,41,0,True,True,7.627734722222222,-0.536182
7795,6201790,98,3,0.990531,56,6203213,-1,1500.0,6203443,6203541,1653,98,43,0,True,True,8.01395,-0.990531
7796,6201992,13,32,0.850465,56,6203213,-1,16000.0,6220174,6220187,18182,13,34,0,True,True,13.1508,-0.850465
7797,6202188,15248,8,0.171459,56,6203213,-1,4000.0,6431603,6446851,229415,15248,1,1,True,True,3387.528322222223,-0.17062775553672607
7798,6202259,119,4,0.959035,56,6203213,-1,2000.0,6203443,6203562,1184,119,45,0,True,True,12.974966666666665,-0.959035
7799,6202348,13269,32,0.599867,56,6203213,-1,16000.0,6226243,6239512,23895,13269,32,0,True,True,11284.594311111112,-0.5404059234487625
7800,6202504,4977,8,0.981416,56,6203213,-1,4000.0,6215355,6220332,12851,4977,42,6,True,True,1140.6443,-0.9563130448853004
7801,6202738,9543,16,0.696315,56,6203213,-1,8000.0,6228451,6237994,25713,9543,30,7,True,True,4228.369733333333,-0.6650533673587429
7802,6202784,3,4,0.677901,56,6203213,-1,2000.0,6228451,6228454,25667,3,30,0,True,True,0.22233333333333336,-0.677901
7803,6202795,12009,1,0.972367,56,6203213,-1,500.0,6220174,6232183,17379,12009,39,0,True,True,252.29645277777774,-0.7371977987409686
7804,6202868,670,1,0.693721,56,6203213,-1,500.0,6218955,6219625,16087,670,44,0,True,True,21.180375,-0.693721
7805,6203049,269,8,0.332047,56,6203213,-1,4000.0,6223774,6224043,20725,269,38,4,True,True,51.09505555555555,-0.332047
7806,6203171,1197,3,0.635353,56,6203213,-1,1500.0,6232854,6234051,29683,1197,24,0,True,True,110.82225,-0.635353
7807,6204006,19249,128,0.883967,70,6214243,-1,64000.0,6372978,6392227,168972,19249,5,2,True,True,56946.696177777776,-0.8817487022650299
7808,6204286,8237,4,0.317967,70,6214243,-1,2000.0,6244219,6252456,39933,8237,14,0,True,True,788.1094166666667,-0.30587518625821253
7809,6204343,16776,1,0.851554,70,6214243,-1,500.0,6303876,6320652,99533,16776,12,0,True,True,303.8730166666667,-0.8465869065003053
7810,6206461,119,16,0.48213,70,6214243,-1,8000.0,6220055,6220174,13594,119,48,0,True,True,60.1902,-0.48213
7811,6207230,21,4,0.335105,70,6214243,-1,2000.0,6250819,6250840,43589,21,15,0,True,True,1.9198666666666668,-0.335105
7812,6207482,681,8,0.608533,70,6214243,-1,4000.0,6220055,6220736,12573,681,50,0,True,True,172.22490000000002,-0.608533
7813,6207629,10100,64,0.585037,70,6214243,-1,32000.0,6320911,6331011,113282,10100,10,4,True,True,9656.746577777778,-0.5767173631445498
7814,6207858,109,32,0.382371,70,6214243,-1,16000.0,6214255,6214364,6397,109,56,0,True,True,82.37008888888889,-0.382371
7815,6207901,27,32,0.640592,70,6214243,-1,16000.0,6214255,6214282,6354,27,57,1,True,True,20.4036,-0.640592
7816,6208349,196,1,0.232425,70,6214243,-1,500.0,6269115,6269311,60766,196,15,0,True,True,3.6319888888888885,-0.232425
7817,6210331,11382,10,0.587469,70,6214243,-1,5000.0,6253033,6264415,42702,11382,17,7,True,True,2353.7671111111113,-0.5587158146644907
7818,6210539,12,2,0.988381,70,6214243,-1,1000.0,6214243,6214255,3704,12,63,0,True,True,0.5667666666666668,-0.988381
7819,6210662,20824,32,0.232606,70,6214243,-1,16000.0,6304996,6325820,94334,20824,13,0,True,True,11381.763377777777,-0.22418059807862817
7820,6210840,189,3,0.616349,70,6214243,-1,1500.0,6239800,6239989,28960,189,26,0,True,True,17.7053625,-0.616349
7821,6210850,9410,4,0.896779,70,6214243,-1,2000.0,6230654,6240064,19804,9410,35,0,True,True,1161.1297333333334,-0.8596980298122266
7822,6211134,23,4,0.308849,70,6214243,-1,2000.0,6239800,6239823,28666,23,26,0,True,True,2.872827777777778,-0.308849
7823,6211443,21,5,0.737913,70,6214243,-1,2500.0,6226243,6226264,14800,21,46,0,True,True,1.8182500000000001,-0.737913
7824,6212544,5,2,0.757246,70,6214243,-1,1000.0,6232854,6232859,20310,5,35,7,True,True,0.3086111111111111,-0.757246
7825,6214784,7,16,0.619766,65,6215355,-1,8000.0,6220055,6220062,5271,7,60,0,True,True,3.5406,-0.619766
7826,6214847,161,4,0.059923,65,6215355,-1,2000.0,6261733,6261894,46886,161,17,0,True,True,12.525799999999998,-0.059923
7827,6219088,11,1,0.374524,63,6220055,-1,500.0,6250819,6250830,31731,11,20,0,True,True,0.25141111111111114,-0.374524
7828,6223783,10,4,0.296615,54,6224043,-1,2000.0,6246419,6246429,22636,10,22,7,True,True,0.926888888888889,-0.296615
7829,6224187,10232,4,0.151671,55,6226243,-1,2000.0,6265515,6275747,41328,10232,17,6,True,True,776.1049833333333,-0.14773196415014103
7830,6225090,18531,100,0.204385,55,6226243,-1,50000.0,6445901,6464432,220811,18531,1,7,True,True,46937.801666666666,-0.1999380825985968
7831,6225413,11946,113,0.037907,55,6226243,-1,56500.0,6315046,6326992,89633,11946,13,2,True,True,19803.098391666666,-0.03697316292310841
7832,6226281,9339,64,0.923409,52,6228451,-1,32000.0,6239800,6249139,13519,9339,36,7,True,True,16103.757866666667,-0.8947682798361134
7833,6226847,91,1,0.598075,52,6228451,-1,500.0,6239800,6239891,12953,91,32,0,True,True,2.841601388888889,-0.598075
7834,6232781,8,8,0.945876,44,6232854,-1,4000.0,6237600,6237608,4819,8,38,0,True,True,2.1721777777777778,-0.945876
7835,6234484,38,64,0.739256,46,6236454,-1,32000.0,6269115,6269153,34631,38,19,2,True,True,45.066311111111105,-0.739256
7836,6234645,5418,32,0.32869,46,6236454,-1,16000.0,6250819,6256237,16174,5418,26,7,True,True,3900.7849777777774,-0.32661237439514385
7837,6234774,319,4,0.278126,46,6236454,-1,2000.0,6243119,6243438,8345,319,31,1,True,True,34.627449999999996,-0.278126
7838,6235408,28813,1,0.643602,46,6236454,-1,500.0,6442503,6471316,207095,28813,2,7,True,True,717.5053930555556,-0.6325473773008208
7839,6237416,7,8,0.760494,46,6237588,-1,4000.0,6240900,6240907,3484,7,35,0,True,True,1.7486777777777778,-0.760494
7840,6237461,1018,1,0.520873,46,6237588,-1,500.0,6248619,6249637,11158,1018,28,7,True,True,23.577605555555557,-0.5206142856859907
7841,6237706,12201,1,0.977568,46,6239800,-1,500.0,6301660,6313861,63954,12201,18,0,True,True,244.7721013888889,-0.9714010258275063
7842,6237799,10444,14,0.648046,46,6239800,-1,7000.0,6348624,6359068,110825,10444,10,1,True,True,2443.601222222222,-0.627512108594754
7843,6237848,14170,2,0.288455,46,6239800,-1,1000.0,6378803,6392973,140955,14170,7,2,True,True,656.6181777777778,-0.28369680363847
7844,6239963,212,2,0.023693,43,6240900,-1,1000.0,6287794,6288006,47831,212,22,0,True,True,8.750888888888888,-0.023693
7845,6240057,14,1,0.846935,43,6240900,-1,500.0,6243105,6243119,3048,14,38,7,True,True,0.37992499999999996,-0.846935
7846,6240278,19618,2,0.33127,43,6240900,-1,1000.0,6417259,6436877,176981,19618,6,6,True,True,905.4797722222221,-0.30655260362026177
7847,6241516,23,1,0.242249,43,6243105,-1,500.0,6250833,6250856,9317,23,30,0,True,True,0.5256777777777778,-0.242249
7848,6242557,54,4,0.539312,43,6243105,-1,2000.0,6256333,6256387,13776,54,29,7,True,True,4.7993999999999994,-0.539312
7849,6242604,9233,64,0.906632,43,6243105,-1,32000.0,6360105,6369338,117501,9233,12,3,True,True,10485.123377777778,-0.8234412975593478
7850,6242942,14832,119,0.665006,43,6243105,-1,59500.0,6400227,6415059,157285,14832,7,1,True,True,28940.464320833333,-0.6368566593484942
7851,6244121,9,64,0.248338,43,6244219,-1,32000.0,6288006,6288015,43885,9,25,1,True,True,11.888,-0.248338
7852,6244172,10,8,0.68735,43,6244219,-1,4000.0,6248619,6248629,4447,10,38,0,True,True,1.853777777777778,-0.68735
7853,6244213,24,1,0.719502,43,6244219,-1,500.0,6244219,6244243,6,24,42,0,True,True,0.6513,-0.719502
7854,6244275,3,8,0.608063,45,6246419,-1,4000.0,6250819,6250822,6544,3,35,0,True,True,0.5485333333333334,-0.608063
7855,6244781,5455,114,0.381486,45,6246419,-1,57000.0,6293804,6299259,49023,5455,25,0,True,True,12533.526541666668,-0.3785571704712287
7856,6245020,28567,1,0.321637,45,6246419,-1,500.0,6488992,6517559,243972,28567,1,0,True,True,325.2244111111112,-0.29876624922927647
7857,6245128,3,2,0.442361,45,6246419,-1,1000.0,6250830,6250833,5702,3,37,0,True,True,0.13713333333333336,-0.442361
7858,6246233,8,3,0.006043,45,6246419,-1,1500.0,6293804,6293812,47571,8,26,0,True,True,0.4943666666666666,-0.006043
7859,6246872,28,2,0.869867,47,6248619,-1,1000.0,6250830,6250858,3958,28,39,2,True,True,1.279911111111111,-0.869867
7860,6247440,6376,4,0.069985,47,6248619,-1,2000.0,6265515,6271891,18075,6376,32,0,True,True,473.98062222222217,-0.068535761239088
7861,6247495,18,17,0.192465,47,6248619,-1,8500.0,6261733,6261751,14238,18,34,0,True,True,5.9517,-0.192465
7862,6249536,43,4,0.634367,51,6250819,-1,2000.0,6263951,6263994,14415,43,34,0,True,True,3.3454,-0.634367
7863,6249682,63,16,0.141532,51,6250819,-1,8000.0,6250833,6250896,1151,63,41,1,True,True,23.038400000000003,-0.141532
7864,6249698,7093,1,0.20422,51,6250819,-1,500.0,6341531,6348624,91833,7093,16,7,True,True,106.17884166666667,-0.19811016321497982
7865,6249760,22807,32,0.091759,51,6250819,-1,16000.0,6410427,6433234,160667,22807,8,7,True,True,15108.665155555555,-0.08493788048547832
7866,6249915,15444,16,0.592631,51,6250819,-1,8000.0,6416159,6431603,166244,15444,8,0,True,True,5255.916177777777,-0.5698523479488115
7867,6249937,23254,64,0.831221,51,6250819,-1,32000.0,6349724,6372978,99787,23254,17,6,True,True,26878.36017777778,-0.8010546061181326
7868,6250937,20830,2,0.931813,50,6253033,-1,1000.0,6354373,6375203,103436,20830,17,6,True,True,786.8884666666667,-0.926468820947044
7869,6250948,49,2,0.23631,50,6253033,-1,1000.0,6303889,6303938,52941,49,28,1,True,True,1.9700722222222222,-0.23631
7870,6251161,27,1,0.078165,50,6253033,-1,500.0,6301642,6301669,50481,27,32,7,True,True,0.5410125,-0.078165
7871,6251172,7,26,0.724989,50,6253033,-1,13000.0,6254133,6254140,2961,7,46,6,True,True,4.0439388888888885,-0.724989
7872,6251927,99,4,0.311463,50,6253033,-1,2000.0,6264415,6264514,12488,99,41,0,True,True,7.2996,-0.311463
7873,6251990,5,1,0.721674,50,6253033,-1,500.0,6264415,6264420,12425,5,41,0,True,True,0.09216666666666667,-0.721674
7874,6252113,2,4,0.244925,50,6253033,-1,2000.0,6288006,6288008,35893,2,35,0,True,True,0.1651111111111111,-0.244925
7875,6256781,23843,84,0.176436,64,6261733,-1,42000.0,6263951,6287794,7170,23843,45,7,True,True,39559.36086666667,-0.1740050878035093
7876,6256847,10440,1,0.248969,64,6261733,-1,500.0,6394427,6404867,137580,10440,11,7,True,True,181.51005138888888,-0.2378816443872205
7877,6256880,29,1,0.285353,64,6261733,-1,500.0,6303860,6303889,46980,29,31,0,True,True,0.5829805555555556,-0.285353
7878,6260604,7213,16,0.448271,64,6261733,-1,8000.0,6304989,6312202,44385,7213,29,6,True,True,2340.5982222222224,-0.44404889606029857
7879,6260611,2338,4,0.635604,64,6261733,-1,2000.0,6296004,6298342,35393,2338,36,7,True,True,186.05698888888887,-0.6138894546602873
7880,6260754,18,16,0.271861,64,6261733,-1,8000.0,6304993,6305011,44239,18,29,0,True,True,5.7896,-0.271861
7881,6260898,10,4,0.781289,64,6261733,-1,2000.0,6264415,6264425,3517,10,49,5,True,True,0.7373333333333334,-0.781289
7882,6261066,16,1,0.080016,64,6261733,-1,500.0,6303860,6303876,42794,16,34,7,True,True,0.32164444444444446,-0.080016
7883,6261074,10,1,0.972555,64,6261733,-1,500.0,6261751,6261761,677,10,53,1,True,True,0.1945,-0.972555
7884,6261097,13,2,0.398244,64,6261733,-1,1000.0,6299442,6299455,38345,13,38,6,True,True,0.5135361111111111,-0.398244
7885,6261328,12317,1,0.167766,64,6261733,-1,500.0,6304989,6317306,43661,12317,30,0,True,True,234.32023333333333,-0.16363674902693046
7886,6261346,12203,4,0.441376,64,6261733,-1,2000.0,6440303,6452506,178957,12203,4,8,True,True,1335.4875277777778,-0.4328627089933306
7887,6261501,36,4,0.505293,64,6261733,-1,2000.0,6293804,6293840,32303,36,43,0,True,True,2.9662,-0.505293
7888,6261542,10,32,0.734928,64,6261733,-1,16000.0,6264415,6264425,2873,10,52,0,True,True,5.898666666666667,-0.734928
7889,6261575,49,8,0.760324,64,6261733,-1,4000.0,6263951,6264000,2376,49,56,0,True,True,7.624399999999999,-0.760324
7890,6261599,12716,8,0.819604,64,6261733,-1,4000.0,6263951,6276667,2352,12716,56,0,True,True,1933.4210333333335,-0.7969755960496382
7891,6261631,6,1,0.793559,64,6261733,-1,500.0,6263951,6263957,2320,6,59,0,True,True,0.1167,-0.793559
7892,6262442,10208,1,0.019811,70,6263951,-1,500.0,6349897,6360105,87455,10208,20,0,True,True,173.71571805555556,-0.01951365570104465
7893,6262462,277,4,0.381419,70,6263951,-1,2000.0,6303876,6304153,41414,277,36,0,True,True,22.273877777777777,-0.381419
7894,6262642,15546,8,0.854042,70,6263951,-1,4000.0,6303876,6319422,41234,15546,37,0,True,True,2296.7364666666667,-0.8487710088957466
7895,6262648,29052,128,0.758858,70,6263951,-1,64000.0,6488992,6518044,226344,29052,2,1,True,True,42688.913066666675,-0.7140695268163203
7896,6262662,82,32,0.921532,70,6263951,-1,16000.0,6263951,6264033,1289,82,60,0,True,True,49.96319999999999,-0.9021468356636779
7897,6262673,18,1,0.595183,70,6263951,-1,500.0,6301642,6301660,38969,18,43,0,True,True,0.360675,-0.595183
7898,6262684,4772,32,0.152799,70,6263951,-1,16000.0,6365814,6370586,103130,4772,19,1,True,True,2954.5787555555557,-0.1431613568701467
7899,6262698,15738,128,0.726648,70,6263951,-1,64000.0,6427963,6443701,165265,15738,9,7,True,True,54553.58275555555,-0.7251987340742116
7900,6262737,401,2,0.257292,70,6263951,-1,1000.0,6288006,6288407,25269,401,52,0,True,True,16.55238888888889,-0.257292
7901,6263014,52,8,0.463651,70,6263951,-1,4000.0,6301642,6301694,38628,52,46,0,True,True,8.3356,-0.463651
7902,6263982,24,1,0.453603,70,6264415,-1,500.0,6308651,6308675,44669,24,32,0,True,True,0.5004000000000001,-0.453603
7903,6264048,132,8,0.375147,70,6264415,-1,4000.0,6301642,6301774,37594,132,48,0,True,True,21.1596,-0.375147
7904,6264128,24339,1,0.606025,70,6264415,-1,500.0,6434903,6459242,170775,24339,6,7,True,True,654.5138069444445,-0.6008459444611983
7905,6264153,4789,16,0.07194,70,6264415,-1,8000.0,6303860,6308649,39707,4789,43,0,True,True,1557.6788444444446,-0.07077160075003947
7906,6264206,6395,4,0.136656,70,6264415,-1,2000.0,6308651,6315046,44445,6395,34,2,True,True,495.23223333333334,-0.1317191681473865
7907,6264222,10100,1,0.469258,70,6264415,-1,500.0,6379903,6390003,115681,10100,17,6,True,True,239.08944722222222,-0.4674262540213519
7908,6264833,3,16,0.154724,71,6265515,-1,8000.0,6298342,6298345,33509,3,55,1,True,True,0.9480666666666668,-0.154724
7909,6264838,6470,8,0.189626,71,6265515,-1,4000.0,6304996,6311466,40158,6470,37,0,True,True,1056.7043777777778,-0.18867337037014098
7910,6265259,27,1,0.012834,71,6265515,-1,500.0,6303876,6303903,38617,27,46,1,True,True,0.542775,-0.012834
7911,6265407,245,2,0.5007,71,6265515,-1,1000.0,6301660,6301905,36253,245,51,0,True,True,9.818375,-0.5007
7912,6265505,6010,176,0.725345,71,6265515,-1,88000.0,6287794,6293804,22289,6010,67,7,True,True,21957.633866666667,-0.7251099662568247
7913,6265684,16444,36,0.491454,71,6269115,-1,18000.0,6315533,6331977,49849,16444,33,0,True,True,8811.46335,-0.48487014696816083
7914,6266486,10,32,0.925691,71,6269115,-1,16000.0,6298342,6298352,31856,10,59,0,True,True,6.320444444444445,-0.925691
7915,6293965,6405,256,0.940285,70,6296004,-1,128000.0,6546523,6552928,252558,6405,1,7,True,True,33664.084266666665,-0.9252378730283469
7916,6294014,47,2,0.970493,70,6296004,-1,1000.0,6301660,6301707,7646,47,55,1,True,True,1.8835250000000003,-0.970493
7917,6294183,8744,2,0.373145,70,6296004,-1,1000.0,6325820,6334564,31637,8744,31,0,True,True,263.08491111111107,-0.37044834311083075
7918,6294238,76,1,0.489551,70,6296004,-1,500.0,6320922,6320998,26684,76,33,1,True,True,1.0368722222222222,-0.489551
7919,6294258,12626,1,0.641049,70,6296004,-1,500.0,6396627,6409253,102369,12626,16,7,True,True,207.58456805555556,-0.5854324240440292
7920,6294397,5647,43,0.588309,70,6296004,-1,21500.0,6375203,6380850,80806,5647,21,1,True,True,5676.342925,-0.5760482530559227
7921,6294565,28479,256,0.408788,70,6296004,-1,128000.0,6518044,6546523,223479,28479,2,7,True,True,150744.50311111112,-0.40398560254697774
7922,6294966,67,8,0.038827,70,6296004,-1,4000.0,6314051,6314118,19085,67,41,8,True,True,10.238344444444444,-0.038827
7923,6295829,7814,32,0.921603,70,6296004,-1,16000.0,6303876,6311690,8047,7814,54,0,True,True,5084.219822222223,-0.9200026072795193
7924,6298965,26663,64,0.384826,68,6299442,-1,32000.0,6464432,6491095,165467,26663,5,7,True,True,32197.749155555553,-0.364110599953867
7925,6299872,10537,4,0.565609,72,6301642,-1,2000.0,6304996,6315533,5124,10537,48,1,True,True,824.3394055555556,-0.5519851776404562
7926,6300302,13,1,0.194228,72,6301642,-1,500.0,6357973,6357986,57671,13,29,0,True,True,0.24161944444444441,-0.194228
7927,6300322,11,4,0.436298,72,6301642,-1,2000.0,6335720,6335731,35398,11,36,7,True,True,0.6054277777777778,-0.436298
7928,6300898,46,1,0.255258,72,6301642,-1,500.0,6333520,6333566,32622,46,37,7,True,True,0.6329472222222222,-0.255258
7929,6300934,906,1,0.913086,72,6301642,-1,500.0,6301660,6302566,726,906,66,0,True,True,18.153975,-0.913086
7930,6302260,33,1,0.722245,69,6303860,-1,500.0,6303860,6303893,1600,33,62,0,True,True,0.6633916666666667,-0.722245
7931,6302530,24,5,0.509608,69,6303860,-1,2500.0,6329120,6329144,26590,24,38,7,True,True,1.8719999999999999,-0.509608
7932,6303072,4,32,0.488622,69,6303860,-1,16000.0,6304993,6304997,1921,4,54,2,True,True,2.5731555555555556,-0.488622
7933,6303104,118,16,0.688489,69,6303860,-1,8000.0,6308596,6308714,5492,118,49,0,True,True,39.3648,-0.688489
7934,6303782,4,2,0.696455,69,6303860,-1,1000.0,6304989,6304993,1207,4,56,0,True,True,0.16082222222222223,-0.696455
7935,6303857,21992,1,0.650906,69,6303860,-1,500.0,6367017,6389009,63160,21992,26,0,True,True,498.9316513888889,-0.6436385195162032
7936,6304128,4,2,0.926519,62,6304989,-1,1000.0,6304989,6304993,861,4,58,0,True,True,0.16082222222222223,-0.926519
7937,6304268,3,4,0.735664,62,6304989,-1,2000.0,6304993,6304996,725,3,55,0,True,True,0.24123333333333336,-0.735664
7938,6304793,55,4,0.242353,62,6304989,-1,2000.0,6308596,6308651,3803,55,51,0,True,True,4.587,-0.242353
7939,6305356,7261,1,0.034508,56,6308596,-1,500.0,6363705,6370966,58349,7261,29,4,True,True,136.62548055555555,-0.03328081543794484
7940,6306232,11,4,0.813126,56,6308596,-1,2000.0,6320911,6320922,14679,11,44,0,True,True,0.6002944444444445,-0.813126
7941,6306483,18483,16,0.630953,56,6308596,-1,8000.0,6347331,6365814,40848,18483,36,4,True,True,5005.644333333334,-0.6229996768777211
7942,6307347,18643,1,0.676426,56,6308596,-1,500.0,6420859,6439502,113512,18643,14,1,True,True,462.62879861111105,-0.6633285070419309
7943,6312530,12644,19,0.697471,54,6314051,-1,9500.0,6354373,6367017,41843,12644,33,0,True,True,4173.919129166667,-0.6943685115553877
7944,6312649,6370,4,0.645334,54,6314051,-1,2000.0,6335731,6342101,23082,6370,41,0,True,True,349.2309611111111,-0.6397889920934152
7945,6312732,16236,8,0.261331,54,6314051,-1,4000.0,6408227,6424463,95495,16236,18,7,True,True,2343.6864222222225,-0.2550892733886588
7946,6320189,19481,1,0.455471,51,6320911,-1,500.0,6443701,6463182,123512,19481,7,2,True,True,503.0648847222222,-0.4440419736634394
7947,6322813,10286,1,0.681066,53,6325820,-1,500.0,6385303,6395589,62490,10286,24,8,True,True,225.7964763888889,-0.6574291845244086
7948,6322961,88,1,0.254288,53,6325820,-1,500.0,6353273,6353361,30312,88,38,1,True,True,1.4511444444444446,-0.254288
7949,6324202,102,16,0.602149,53,6325820,-1,8000.0,6326920,6327022,2718,102,49,6,True,True,24.976399999999998,-0.602149
7950,6324844,9561,1,0.951778,53,6325820,-1,500.0,6339331,6348892,14487,9561,44,0,True,True,140.85755138888888,-0.9321478686748907
7951,6325444,11804,128,0.841516,53,6325820,-1,64000.0,6416159,6427963,90715,11804,18,6,True,True,30243.1696,-0.8006295368949621
7952,6325959,19,4,0.012337,55,6326920,-1,2000.0,6370626,6370645,44667,19,31,1,True,True,1.6515222222222223,-0.012337
7953,6325980,159,1,0.770972,55,6326920,-1,500.0,6331320,6331479,5340,159,51,7,True,True,2.4804,-0.770972
7954,6326647,10527,1,0.644397,55,6326920,-1,500.0,6349897,6360424,23250,10527,42,1,True,True,179.6446875,-0.6373774215192185
7955,6326677,9368,16,0.916883,55,6326920,-1,8000.0,6335731,6345099,9054,9368,50,1,True,True,2098.5186444444444,-0.8974256504978464
7956,6327300,4292,32,0.397667,57,6329120,-1,16000.0,6357973,6362265,30673,4292,38,2,True,True,2493.808177777778,-0.39440543125902083
7957,6327484,176,8,0.58616,57,6329120,-1,4000.0,6339331,6339507,11847,176,49,0,True,True,19.12728888888889,-0.58616
7958,6327837,11,1,0.900996,57,6329120,-1,500.0,6348624,6348635,20787,11,45,0,True,True,0.17369305555555556,-0.900996
7959,6331957,33,10,0.518537,66,6333520,-1,5000.0,6343731,6343764,11774,33,48,7,True,True,4.970166666666667,-0.518537
7960,6332001,17,128,0.188823,66,6333520,-1,64000.0,6415059,6415076,83058,17,19,4,True,True,39.48835555555556,-0.188823
7961,6332054,26653,1,0.422945,66,6333520,-1,500.0,6432703,6459356,100649,26653,11,6,True,True,717.4858902777779,-0.4209871439169205
7962,6332099,123,2,0.82975,66,6333520,-1,1000.0,6333520,6333643,1421,123,58,0,True,True,3.3848916666666664,-0.82975
7963,6332200,1273,16,0.252871,66,6333520,-1,8000.0,6348624,6349897,16424,1273,48,0,True,True,321.61637777777776,-0.252871
7964,6332235,9,16,0.30222,66,6333520,-1,8000.0,6370617,6370626,38382,9,34,4,True,True,3.1292000000000004,-0.30222
7965,6332293,18787,128,0.967683,66,6333520,-1,64000.0,6448101,6466888,115808,18787,6,7,True,True,59244.48871111111,-0.9630283472010398
7966,6332822,138,1,0.658486,66,6333520,-1,500.0,6353273,6353411,20451,138,45,0,True,True,2.2756583333333333,-0.658486
7967,6333000,21997,128,0.382789,66,6333520,-1,64000.0,6466995,6488992,133995,21997,5,2,True,True,54032.844088888894,-0.36979131747326144
7968,6333005,11747,64,0.307979,66,6333520,-1,32000.0,6403827,6415574,70822,11747,25,4,True,True,12651.413866666668,-0.29937337770446193
7969,6333011,11207,19,0.411609,66,6333520,-1,9500.0,6406027,6417234,73016,11207,25,7,True,True,3654.6446694444444,-0.40656581165912203
1472,1293277,13,1,0.496203,1,1293277,-1,500.0,1294554,1293290,1277,13,0,0,True,True,0.2574722222222222,-0.496203
1473,1294554,6774,64,0.497523,1,1294554,-1,32000.0,1296754,1303528,2200,6774,0,7,True,True,7445.43608888889,-0.48378456284858457
1474,1294669,12239,3,0.92431,4,1296754,-1,1500.0,1301154,1313393,6485,12239,0,7,True,True,495.3018083333333,-0.8844657064672256
1475,1294737,112,2,0.519276,4,1296754,-1,1000.0,1305554,1305666,10817,112,0,0,True,True,3.2604444444444445,-0.519276
1476,1295058,292,16,0.801148,4,1296754,-1,8000.0,1298954,1299246,3896,292,2,7,True,True,91.14293333333333,-0.801148
1477,1296674,31905,16,0.727081,4,1296754,-1,8000.0,1335703,1367608,39029,31905,0,6,True,True,10374.11011111111,-0.7252633244933733
1478,1298004,12956,1,0.078927,4,1298954,-1,500.0,1482642,1495598,184638,12956,0,1,True,True,88.03276944444445,-0.07127187037497894
1479,1299053,5794,178,0.602453,10,1301154,-1,89000.0,1546240,1552034,247187,5794,0,7,True,True,5868.137372222222,-0.593871539557834
1480,1299172,10160,8,0.822341,10,1301154,-1,4000.0,1305554,1315714,6382,10160,4,7,True,True,982.017288888889,-0.759575584718187
1481,1300217,5981,128,0.545474,10,1301154,-1,64000.0,1319854,1325835,19637,5981,3,7,True,True,8802.413155555554,-0.4591394211592701
1482,1300293,11,1,0.321211,10,1301154,-1,500.0,1307754,1307765,7461,11,4,7,True,True,0.14845416666666666,-0.321211
1483,1300678,4,9,0.080069,10,1301154,-1,4500.0,1314354,1314358,13676,4,4,7,True,True,0.3617,-0.080069
1484,1300931,8,4,0.660919,10,1301154,-1,2000.0,1303354,1303362,2423,8,8,7,True,True,0.4657777777777778,-0.660919
1485,1301041,7580,2,0.306496,10,1301154,-1,1000.0,1317654,1325234,16613,7580,4,6,True,True,164.72259444444444,-0.2556984270927657
1486,1305566,17109,1,0.602622,10,1307754,-1,500.0,1503012,1520121,197446,17109,1,6,True,True,119.62289166666666,-0.5867101843216996
1487,1305714,670,1,0.426116,10,1307754,-1,500.0,1309954,1310624,4240,670,7,7,True,True,8.43398611111111,-0.39745339780258937
1488,1306220,46393,55,0.689765,10,1307754,-1,27500.0,1387135,1433528,80915,46393,3,6,True,True,64975.52103472223,-0.6624404463342946
1489,1306545,14816,1,0.351547,10,1307754,-1,500.0,1609700,1624516,303155,14816,0,0,True,True,152.48583333333332,-0.34234007752143425
1490,1309878,42,2,0.042355,10,1309954,-1,1000.0,1312154,1312196,2276,42,9,7,True,True,0.9055666666666667,-0.042355
1491,1310397,16,8,0.870037,10,1312154,-1,4000.0,1312154,1312170,1757,16,9,0,True,True,1.379911111111111,-0.870037
1492,1312556,496,64,0.352559,13,1314354,-1,32000.0,1342308,1342804,29752,496,5,0,True,True,870.8963555555555,-0.35217022322254393
1493,1313082,51,43,0.998151,13,1314354,-1,21500.0,1339003,1339054,25921,51,6,7,True,True,62.607104166666666,-0.998151
1494,1313539,32,2,0.274555,13,1314354,-1,1000.0,1362674,1362706,49135,32,5,7,True,True,1.0094222222222222,-0.274555
1495,1313662,8755,32,0.980027,13,1314354,-1,16000.0,1332403,1341158,18741,8755,9,6,True,True,7814.499111111111,-0.9797067761720387
1496,1314069,13,10,0.947904,13,1314354,-1,5000.0,1316554,1316567,2485,13,12,7,True,True,1.3061388888888887,-0.947904
1497,1315723,46,8,0.075041,15,1316554,-1,4000.0,1329046,1329092,13323,46,10,7,True,True,8.273866666666667,-0.075041
1498,1316219,12086,8,0.637513,15,1316554,-1,4000.0,1386035,1398121,69816,12086,5,1,True,True,2360.0149,-0.6367368843930608
1499,1316353,12827,25,0.363311,15,1316554,-1,12500.0,1392635,1405462,76282,12827,4,7,True,True,5945.419479166667,-0.3185641840262411
1500,1319043,143,2,0.801096,14,1319854,-1,1000.0,1322054,1322197,3011,143,13,7,True,True,3.0629805555555554,-0.801096
1501,1320593,9,2,0.679411,15,1322054,-1,1000.0,1326846,1326855,6253,9,13,1,True,True,0.281,-0.679411
1502,1320865,90,8,0.952789,15,1322054,-1,4000.0,1324254,1324344,3389,90,14,7,True,True,7.711,-0.952789
1503,1322450,37,1,0.142779,23,1324254,-1,500.0,1367078,1367115,44628,37,7,7,True,True,0.6071597222222223,-0.142779
1504,1322616,57,1,0.607573,23,1324254,-1,500.0,1331246,1331303,8630,57,13,6,True,True,1.28155,-0.607573
1505,1323015,12743,2,0.781312,23,1324254,-1,1000.0,1362674,1375417,39659,12743,8,0,True,True,521.4600055555557,-0.6564263685886732
1506,1323031,8047,37,0.034799,23,1324254,-1,18500.0,1360471,1368518,37440,8047,10,1,True,True,4855.678144444444,-0.03181815949490372
1507,1323428,727,4,0.067233,23,1324254,-1,2000.0,1364878,1365605,41450,727,8,7,True,True,47.71947222222223,-0.067233
1508,1323517,392,1,0.778515,23,1324254,-1,500.0,1326454,1326846,2937,392,19,7,True,True,6.119555555555555,-0.778515
1509,1323542,13448,128,0.366328,23,1324254,-1,64000.0,1600516,1613964,276974,13448,1,7,True,True,14775.356444444446,-0.3346714200459372
1510,1323995,46337,4,0.382854,23,1324254,-1,2000.0,1712406,1758743,388411,46337,0,7,True,True,5106.940727777777,-0.37717158113682303
1511,1324200,44,28,0.567245,23,1324254,-1,14000.0,1334603,1334647,10403,44,17,6,True,True,33.77733333333334,-0.567245
1512,1327945,7659,16,0.605095,26,1329046,-1,8000.0,1340108,1347767,12163,7659,15,1,True,True,2901.5327111111114,-0.5726058338413877
1513,1327951,5,16,0.679062,26,1329046,-1,8000.0,1330146,1330151,2195,5,21,6,True,True,1.7986666666666666,-0.679062
1514,1328512,20621,179,0.948824,26,1329046,-1,89500.0,1801722,1822343,473210,20621,0,7,True,True,94365.45742361111,-0.9383730898762294
1515,1328728,11,2,0.372013,26,1329046,-1,1000.0,1347067,1347078,18339,11,15,0,True,True,0.3549333333333333,-0.372013
1516,1328802,12,1,0.763084,26,1329046,-1,500.0,1340103,1340115,11301,12,18,0,True,True,0.32958333333333334,-0.763084
1517,1328814,5,1,0.573922,26,1329046,-1,500.0,1340103,1340108,11289,5,19,0,True,True,0.1373263888888889,-0.573922
1518,1330137,7732,1,0.52946,26,1330146,-1,500.0,1400895,1408627,70758,7732,7,0,True,True,135.41459583333335,-0.4935747212547886
1519,1330153,7,16,0.398034,32,1331246,-1,8000.0,1333503,1333510,3350,7,24,0,True,True,3.070666666666667,-0.398034
1520,1330385,43,2,0.649561,32,1331246,-1,1000.0,1331246,1331289,861,43,26,0,True,True,1.9335666666666667,-0.649561
1521,1330698,7,8,0.249612,32,1331246,-1,4000.0,1360467,1360474,29769,7,16,0,True,True,0.8765555555555555,-0.249612
1522,1331059,8744,128,0.113449,32,1331246,-1,64000.0,1470176,1478920,139117,8744,7,0,True,True,12530.517333333333,-0.11036790049555677
1523,1331092,33237,13,0.735675,32,1331246,-1,6500.0,1406005,1439242,74913,33237,8,4,True,True,12236.108570833332,-0.7304275080363499
1524,1331191,443,16,0.499044,32,1331246,-1,8000.0,1331303,1331746,112,443,29,2,True,True,159.36186666666666,-0.499044
1525,1331228,4,2,0.386987,32,1331246,-1,1000.0,1362674,1362678,31446,4,16,0,True,True,0.12617777777777778,-0.386987
1526,1331306,21,32,0.561673,37,1332403,-1,16000.0,1351467,1351488,20161,21,20,6,True,True,14.978133333333332,-0.561673
1527,1331604,25,1,0.261777,37,1332403,-1,500.0,1360467,1360492,28863,25,19,0,True,True,0.39131944444444444,-0.261777
1528,1331611,39,1,0.26029,37,1332403,-1,500.0,1356867,1356906,25256,39,21,8,True,True,0.6524375,-0.26029
1529,1331759,8757,200,0.446273,37,1332403,-1,100000.0,1639179,1647936,307420,8757,2,7,True,True,48399.6925,-0.4383585847240098
1530,1331776,17,8,0.996365,37,1332403,-1,4000.0,1333503,1333520,1727,17,33,6,True,True,3.728666666666667,-0.996365
1531,1331818,3,28,0.285577,37,1332403,-1,14000.0,1349267,1349270,17449,3,24,0,True,True,1.3552,-0.285577
1532,1331990,15,2,0.916479,37,1332403,-1,1000.0,1333503,1333518,1513,15,33,0,True,True,0.8225,-0.916479
1533,1332252,26,8,0.4912,37,1332403,-1,4000.0,1335703,1335729,3451,26,31,0,True,True,5.938111111111112,-0.4912
1534,1333108,18,4,0.122637,39,1333503,-1,2000.0,1362678,1362696,29570,18,16,1,True,True,1.1356,-0.122637
1535,1333163,16498,128,0.852826,39,1333503,-1,64000.0,1413562,1430060,80399,16498,9,7,True,True,66599.19644444445,-0.8392561095028157
1536,1333242,867,1,0.452043,39,1333503,-1,500.0,1347008,1347875,13766,867,28,4,True,True,13.9876,-0.452043
1537,1333786,19,32,0.898679,40,1334603,-1,16000.0,1335703,1335722,1917,19,35,0,True,True,17.357555555555557,-0.898679
1538,1333912,5033,84,0.445111,40,1334603,-1,42000.0,1340103,1345136,6191,5033,33,6,True,True,10874.620283333334,-0.43374872395913416
1539,1334006,872,8,0.087791,40,1334603,-1,4000.0,1364878,1365750,30872,872,16,0,True,True,114.47422222222222,-0.087791
1540,1334127,58,12,0.681929,40,1334603,-1,6000.0,1336803,1336861,2676,58,36,6,True,True,19.869833333333332,-0.681929
1541,1334696,29,3,0.845521,42,1335703,-1,1500.0,1335703,1335732,1007,29,37,0,True,True,2.4837291666666665,-0.845521
1542,1334724,2511,8,0.319588,42,1335703,-1,4000.0,1347067,1349578,12343,2511,28,0,True,True,324.08639999999997,-0.319588
1543,1334768,8,36,0.347425,42,1335703,-1,18000.0,1343408,1343416,8640,8,31,6,True,True,6.8284,-0.347425
1544,1337018,21038,1,0.064939,54,1339003,-1,500.0,1540440,1561478,203422,21038,6,7,True,True,124.209425,-0.064440760495661
1545,1337084,10203,16,0.542171,54,1339003,-1,8000.0,1378010,1388213,40926,10203,16,0,True,True,4560.531533333333,-0.5252093969818318
1546,1337224,459,3,0.891332,54,1339003,-1,1500.0,1340103,1340562,2879,459,36,0,True,True,37.8196875,-0.891332
1547,1337255,11,16,0.851362,54,1339003,-1,8000.0,1349267,1349278,12012,11,30,6,True,True,2.8394666666666666,-0.851362
1548,1337380,8,1,0.711809,54,1339003,-1,500.0,1342308,1342316,4928,8,35,0,True,True,0.21972222222222224,-0.711809
1549,1337421,5291,16,0.927324,54,1339003,-1,8000.0,1349267,1354558,11846,5291,30,0,True,True,1729.4764,-0.9235922341548817
1550,1337520,59,16,0.6377,54,1339003,-1,8000.0,1342308,1342367,4788,59,36,0,True,True,25.927222222222223,-0.6377
1551,1337540,58,8,0.793696,54,1339003,-1,4000.0,1342308,1342366,4768,58,39,7,True,True,12.743888888888888,-0.793696
1552,1337563,8260,2,0.508756,54,1339003,-1,1000.0,1390435,1398695,52872,8260,14,7,True,True,366.00340277777775,-0.48672949707589
1553,1337577,18561,16,0.121362,54,1339003,-1,8000.0,1498612,1517173,161035,18561,8,3,True,True,1975.2204222222222,-0.11706712293105885
1554,1337629,12183,8,0.20098,54,1339003,-1,4000.0,1381610,1393793,43981,12183,18,1,True,True,2657.961733333333,-0.19797743555343617
1555,1337691,25,1,0.138877,54,1339003,-1,500.0,1362678,1362703,24987,25,23,0,True,True,0.3943055555555555,-0.138877
1556,1337703,119,8,0.790373,54,1339003,-1,4000.0,1339003,1339122,1300,119,49,0,True,True,27.178277777777776,-0.790373
1557,1337729,7,16,0.026284,54,1339003,-1,8000.0,1360474,1360481,22745,7,28,1,True,True,1.753111111111111,-0.026284
1558,1338585,19622,32,0.554021,54,1339003,-1,16000.0,1398695,1418317,60110,19622,14,2,True,True,13251.252444444446,-0.5503795182429703
1559,1338629,64,1,0.368911,54,1339003,-1,500.0,1350367,1350431,11738,64,35,0,True,True,1.4264888888888887,-0.368911
1560,1338983,182,16,0.803662,54,1339003,-1,8000.0,1347067,1347249,8084,182,41,1,True,True,46.980266666666665,-0.803662
1561,1339153,4,71,0.551647,53,1340103,-1,35500.0,1383810,1383814,44657,4,19,7,True,True,7.8242,-0.551647
1562,1340956,9,8,0.611948,50,1342308,-1,4000.0,1349267,1349276,8311,9,38,0,True,True,1.1616,-0.611948
1563,1341428,4,8,0.086215,50,1342308,-1,4000.0,1360467,1360471,19039,4,34,2,True,True,0.5008888888888889,-0.086215
1564,1343396,18753,128,0.309291,48,1343408,-1,64000.0,1495012,1513765,151616,18753,9,6,True,True,15273.4608,-0.29871661903103913
1565,1343404,59,1,0.999595,48,1343408,-1,500.0,1347008,1347067,3604,59,46,0,True,True,0.9518666666666667,-0.999595
1566,1343558,25529,16,0.71887,54,1347008,-1,8000.0,1538240,1563769,194682,25529,7,7,True,True,2416.189066666667,-0.709868343710941
1567,1343568,19,32,0.525696,54,1347008,-1,16000.0,1370388,1370407,26820,19,24,1,True,True,12.007155555555556,-0.525696
1568,1343589,9,4,0.769165,54,1347008,-1,2000.0,1349267,1349276,5678,9,42,0,True,True,0.5808,-0.769165
1569,1343888,11393,1,0.823339,54,1347008,-1,500.0,1378010,1389403,34122,11393,24,1,True,True,318.1267902777778,-0.8006005382362089
1570,1344060,19979,128,0.073751,54,1347008,-1,64000.0,1441326,1461305,97266,19979,13,6,True,True,39697.87342222223,-0.07236642523944524
1571,1344137,5,32,0.97238,54,1347008,-1,16000.0,1348167,1348172,4030,5,48,6,True,True,2.5813333333333333,-0.97238
1572,1344253,122,32,0.642339,54,1347008,-1,16000.0,1350367,1350489,6114,122,43,6,True,True,87.01582222222223,-0.642339
1573,1363780,12229,38,0.449974,32,1364878,-1,19000.0,1429263,1441492,65483,12229,14,4,True,True,12652.840894444444,-0.4490217641470063
1574,1364676,40,1,0.680109,32,1364878,-1,500.0,1368178,1368218,3502,40,28,6,True,True,0.7899444444444444,-0.680109
1575,1364795,22,16,0.344515,32,1364878,-1,8000.0,1377988,1378010,13193,22,27,8,True,True,10.823022222222223,-0.344515
1576,1366877,6679,32,0.87796,31,1367078,-1,16000.0,1398121,1404800,31244,6679,19,1,True,True,3639.033511111111,-0.8540972064345275
1577,1367148,7834,13,0.780263,35,1368178,-1,6500.0,1386010,1393844,18862,7834,24,7,True,True,2754.5002694444443,-0.7799945263853783
1578,1367189,10,8,0.639794,35,1368178,-1,4000.0,1370378,1370388,3189,10,31,7,True,True,1.579888888888889,-0.639794
1579,1367258,28,1,0.181963,35,1368178,-1,500.0,1400895,1400923,33637,28,18,7,True,True,0.4649944444444444,-0.181963
1580,1367279,4,19,0.966265,35,1368178,-1,9500.0,1372588,1372592,5309,4,31,7,True,True,2.0407055555555558,-0.966265
1581,1367491,70,1,0.432618,35,1368178,-1,500.0,1402405,1402475,34914,70,17,1,True,True,1.162486111111111,-0.432618
1582,1369153,7330,4,0.910712,35,1370378,-1,2000.0,1370388,1377718,1235,7330,33,0,True,True,792.0872888888889,-0.8590837326727009
1583,1371674,29978,16,0.055413,35,1372588,-1,8000.0,1544040,1574018,172366,29978,6,4,True,True,2958.851377777778,-0.05378724329757125
1584,1371746,7570,32,0.124161,35,1372588,-1,16000.0,1394835,1402405,23089,7570,23,7,True,True,4375.749555555556,-0.11861596456835637
1585,1371766,22985,1,0.153015,35,1372588,-1,500.0,1586018,1609003,214252,22985,5,7,True,True,150.93417083333333,-0.15243029995928573
1586,1374454,11567,32,0.164657,36,1377988,-1,16000.0,1401995,1413562,27541,11567,20,6,True,True,7280.81,-0.15789950461417213
1587,1376090,11,17,0.322661,36,1377988,-1,8500.0,1388235,1388246,12145,11,28,6,True,True,5.200418055555556,-0.322661
1588,1381788,16620,8,0.709332,33,1383810,-1,4000.0,1501912,1518532,120124,16620,11,6,True,True,914.8016444444445,-0.7011178013105436
1589,1384832,10899,256,0.346023,35,1386010,-1,128000.0,1524041,1534940,139209,10899,10,4,True,True,15677.740088888888,-0.33127312064366626
1590,1385180,25,3,0.940904,35,1386010,-1,1500.0,1386010,1386035,830,25,33,0,True,True,2.0857291666666664,-0.940904
1591,1385597,192,1,0.894926,35,1386010,-1,500.0,1386035,1386227,438,192,32,0,True,True,5.339466666666667,-0.894926
1592,1389857,6,1,0.845934,32,1390435,-1,500.0,1398121,1398127,8264,6,26,0,True,True,0.10521666666666668,-0.845934
1593,1389978,10134,32,0.250605,32,1390435,-1,16000.0,1484842,1494976,94864,10134,15,7,True,True,2128.2582222222222,-0.23816130824713988
1594,1390228,10712,64,0.635057,32,1390435,-1,32000.0,1456456,1467168,66228,10712,18,6,True,True,10130.003911111111,-0.6195004705956391
1595,1405595,74,1,0.550841,25,1406005,-1,500.0,1414662,1414736,9067,74,21,0,True,True,1.8109444444444445,-0.550841
1596,1405663,4790,256,0.12517,25,1406005,-1,128000.0,1574018,1578808,168355,4790,6,7,True,True,8210.75911111111,-0.12224706159592065
1597,1406002,106,32,0.302825,25,1406005,-1,16000.0,1421263,1421369,15261,106,22,7,True,True,114.08426666666666,-0.302825
1598,1406116,50,4,0.533478,40,1413562,-1,2000.0,1425663,1425713,19547,50,22,0,True,True,6.399166666666666,-0.533478
1599,1406373,15161,64,0.502573,40,1413562,-1,32000.0,1583818,1598979,177445,15161,6,7,True,True,5292.533777777779,-0.4205771238374879
1600,1406442,14079,1,0.168636,40,1413562,-1,500.0,1614100,1628179,207658,14079,3,6,True,True,148.4475972222222,-0.16275101009186013
1601,1406530,1,8,0.941607,40,1413562,-1,4000.0,1416862,1416863,10332,1,26,7,True,True,0.22722222222222221,-0.941607
1602,1406645,12,16,0.154194,40,1413562,-1,8000.0,1425663,1425675,19018,12,25,6,True,True,6.1432,-0.154194
1603,1407095,154,32,0.658733,40,1413562,-1,16000.0,1448438,1448592,41343,154,22,0,True,True,76.86995555555555,-0.658733
1604,1407146,4350,4,0.720633,40,1413562,-1,2000.0,1416863,1421213,9717,4350,28,1,True,True,553.0625444444445,-0.6997985829045088
1605,1408195,10170,128,0.605139,40,1413562,-1,64000.0,1484842,1495012,76647,10170,18,0,True,True,8540.51448888889,-0.5751829649645703
1606,1408412,53,9,0.84253,40,1413562,-1,4500.0,1414662,1414715,6250,53,32,0,True,True,11.67325,-0.84253
1607,1408478,13,16,0.563618,40,1413562,-1,8000.0,1419063,1419076,10585,13,29,7,True,True,6.995733333333333,-0.563618
1608,1408524,16770,21,0.825236,40,1413562,-1,10500.0,1433528,1450298,25004,16770,25,0,True,True,7401.604408333333,-0.8025759019824572
1609,1408588,818,16,0.028373,40,1413562,-1,8000.0,1448438,1449256,39850,818,24,4,True,True,204.15462222222223,-0.028373
1610,1408763,78,1,0.045462,40,1413562,-1,500.0,1458789,1458867,50026,78,22,0,True,True,1.0930833333333334,-0.045462
1611,1408861,22648,16,0.641454,40,1413562,-1,8000.0,1455356,1478004,46495,22648,24,0,True,True,4876.828622222221,-0.6310572366159076
1612,1409391,32,2,0.576771,40,1413562,-1,1000.0,1423463,1423495,14072,32,32,7,True,True,2.2392,-0.576771
1613,1409433,50,1,0.65113,40,1413562,-1,500.0,1414662,1414712,5229,50,39,6,True,True,1.223611111111111,-0.65113
1614,1419280,17420,1,0.766959,45,1421263,-1,500.0,1460989,1478409,41709,17420,22,0,True,True,227.2267777777778,-0.7296023260002326
1615,1419841,10,1,0.416587,45,1421263,-1,500.0,1453938,1453948,34097,10,26,0,True,True,0.14758333333333334,-0.416587
1616,1419867,10276,128,0.638991,45,1421263,-1,64000.0,1513765,1524041,93898,10276,14,7,True,True,9444.474844444445,-0.6280949328496671
1617,1419942,13212,32,0.498038,45,1421263,-1,16000.0,1431463,1444675,11521,13212,32,7,True,True,10370.8604,-0.4587430399974904
1618,1419965,3682,32,0.627164,45,1421263,-1,16000.0,1433528,1437210,13563,3682,32,0,True,True,3373.7073777777778,-0.6149152101814105
1619,1420003,3,32,0.289672,45,1421263,-1,16000.0,1424563,1424566,4560,3,37,6,True,True,3.3588,-0.289672
1620,1420167,12298,141,0.95665,45,1421263,-1,70500.0,1588218,1600516,168051,12298,6,7,True,True,10735.243366666667,-0.901426551540796
1621,1420244,56,2,0.482945,45,1421263,-1,1000.0,1440226,1440282,19982,56,32,7,True,True,2.0707555555555555,-0.482945
1622,1420284,9835,8,0.804688,45,1421263,-1,4000.0,1443526,1453361,23242,9835,31,7,True,True,1230.8341555555558,-0.7449257861996306
1623,1420302,31,1,0.684991,45,1421263,-1,500.0,1424563,1424594,4261,31,40,0,True,True,1.0846125,-0.684991
1624,1420306,8332,256,0.297434,45,1421263,-1,128000.0,1822343,1830675,402037,8332,0,2,True,True,31771.497244444447,-0.28099472720058066
1625,1420347,34,16,0.072973,45,1421263,-1,8000.0,1455356,1455390,35009,34,29,2,True,True,8.153955555555555,-0.072973
1626,1424591,1809,1,0.059913,43,1425663,-1,500.0,1440226,1442035,15635,1809,35,0,True,True,33.4464,-0.059913
1627,1424612,768,1,0.439605,43,1425663,-1,500.0,1443738,1444506,19126,768,33,1,True,True,12.487466666666666,-0.439605
1628,1426672,18,24,0.484251,43,1429263,-1,12000.0,1433528,1433546,6856,18,40,1,True,True,12.643799999999999,-0.484251
1629,1427179,524,8,0.204023,43,1429263,-1,4000.0,1463189,1463713,36010,524,25,7,True,True,63.6136,-0.204023
1630,1432315,7,1,0.60666,48,1433528,-1,500.0,1433528,1433535,1213,7,41,0,True,True,0.20487638888888887,-0.60666
1631,1432369,8,4,0.312582,48,1433528,-1,2000.0,1435728,1435736,3359,8,39,7,True,True,0.9365777777777777,-0.312582
1632,1432443,52,16,0.718363,48,1433528,-1,8000.0,1436926,1436978,4483,52,39,2,True,True,21.95093333333333,-0.718363
1633,1432465,5,2,0.7342,48,1433528,-1,1000.0,1436828,1436833,4363,5,40,6,True,True,0.26383333333333336,-0.7342
1634,1432472,7933,197,0.860777,48,1433528,-1,98500.0,1672459,1680392,239987,7933,3,7,True,True,47261.66586666666,-0.8521430993140424
1635,1432563,40,1,0.975374,48,1433528,-1,500.0,1433528,1433568,965,40,46,0,True,True,1.1707222222222222,-0.975374
1636,1432902,16297,1,0.130766,48,1433528,-1,500.0,1534940,1551237,102038,16297,16,6,True,True,90.87060833333332,-0.13021692493616474
1637,1433882,10,1,0.37054,54,1435728,-1,500.0,1460989,1460999,27107,10,29,7,True,True,0.1401388888888889,-0.37054
1638,1434306,672,2,0.561651,54,1435728,-1,1000.0,1463276,1463948,28970,672,27,1,True,True,20.395200000000003,-0.561651
1639,1434340,258,2,0.319116,54,1435728,-1,1000.0,1463273,1463531,28933,258,28,0,True,True,7.830300000000001,-0.319116
1640,1434383,83,41,0.466473,54,1435728,-1,20500.0,1443738,1443821,9355,83,39,0,True,True,55.33183472222222,-0.46647299999999997
1641,1434752,30097,16,0.267472,54,1435728,-1,8000.0,1581618,1611715,146866,30097,11,7,True,True,3204.7207777777776,-0.25634571378331333
1642,1435236,54,1,0.247919,54,1435728,-1,500.0,1458656,1458710,23420,54,34,7,True,True,0.75675,-0.247919
1643,1435263,34,1,0.096812,54,1435728,-1,500.0,1465476,1465510,30213,34,28,7,True,True,0.5193027777777778,-0.096812
1644,1435411,15,32,0.290212,54,1435728,-1,16000.0,1444838,1444853,9427,15,42,0,True,True,7.804666666666666,-0.290212
1645,1435621,33,32,0.38415,54,1435728,-1,16000.0,1449538,1449571,13917,33,40,6,True,True,16.472133333333336,-0.38415
1646,1435683,2,2,0.615377,54,1435728,-1,1000.0,1451738,1451740,16055,2,40,7,True,True,0.059033333333333333,-0.615377
1647,1435706,6918,1,0.24827,54,1435728,-1,500.0,1448438,1455356,12732,6918,43,0,True,True,104.30329722222223,-0.2445541231692419
1648,1435860,98,2,0.865308,60,1436828,-1,1000.0,1436828,1436926,968,98,53,0,True,True,5.171133333333334,-0.865308
1649,1435902,860,5,0.1597,60,1436828,-1,2500.0,1438026,1438886,2124,860,52,6,True,True,113.44833333333334,-0.1597
1650,1435919,238,4,0.327436,60,1436828,-1,2000.0,1482404,1482642,46485,238,27,0,True,True,8.500566666666668,-0.327436
1651,1436041,8762,16,0.577687,60,1436828,-1,8000.0,1472376,1481138,36335,8762,28,7,True,True,1479.3502666666668,-0.5298720437329925
1652,1436063,18,4,0.312715,60,1436828,-1,2000.0,1443738,1443756,7675,18,48,0,True,True,1.1706999999999999,-0.312715
1653,1436085,79,1,0.763121,60,1436828,-1,500.0,1458710,1458789,22625,79,37,1,True,True,1.1070972222222222,-0.763121
1654,1436093,26,28,0.498266,60,1436828,-1,14000.0,1453938,1453964,17845,26,43,7,True,True,10.744066666666667,-0.498266
1655,1438443,13,1,0.514725,59,1440226,-1,500.0,1463276,1463289,24833,13,31,0,True,True,0.197275,-0.514725
1656,1439228,3,2,0.49876,59,1440226,-1,1000.0,1463273,1463276,24045,3,34,1,True,True,0.09105,-0.49876
1657,1440078,14813,8,0.30854,59,1440226,-1,4000.0,1536040,1550853,95962,14813,17,6,True,True,669.4078,-0.30565969097067136
1658,1440364,46,2,0.023176,60,1441326,-1,1000.0,1455356,1455402,14992,46,44,0,True,True,1.3789777777777779,-0.023176
1659,1440682,10185,1,0.945233,60,1441326,-1,500.0,1458789,1468974,18107,10185,40,0,True,True,151.04770833333333,-0.9427442547173575
1660,1440832,120,64,0.505444,60,1441326,-1,32000.0,1455038,1455158,14206,120,47,6,True,True,115.11466666666666,-0.505444
1661,1441739,12,1,0.966687,64,1443526,-1,500.0,1444838,1444850,3099,12,56,6,True,True,0.19511666666666666,-0.966687
1662,1441788,212,1,0.215144,64,1443526,-1,500.0,1443526,1443738,1738,212,60,0,True,True,3.6120194444444444,-0.19825887841867745
1663,1442362,3461,128,0.352895,64,1443526,-1,64000.0,1579418,1582879,137056,3461,12,8,True,True,2688.0947555555554,-0.34810104405872383
1664,1442591,40,1,0.05054,64,1443526,-1,500.0,1478004,1478044,35413,40,30,1,True,True,0.3894444444444444,-0.05054
1665,1442660,76316,128,0.494894,64,1443526,-1,64000.0,1725406,1801722,282746,76316,2,9,True,True,243148.60871111107,-0.48726451260237214
1666,1450502,450,32,0.882339,58,1451738,-1,16000.0,1482404,1482854,31902,450,30,0,True,True,128.58,-0.882339
1667,1450575,102,2,0.65426,58,1451738,-1,1000.0,1453938,1454040,3363,102,53,0,True,True,3.0107,-0.65426
1668,1451480,778,32,0.470587,58,1451738,-1,16000.0,1480204,1480982,28724,778,32,7,True,True,222.30053333333336,-0.470587
1669,1451527,12814,32,0.536691,58,1451738,-1,16000.0,1482404,1495218,30877,12814,32,7,True,True,2812.5322666666666,-0.48810045129407276
1670,1451581,96,4,0.847172,58,1451738,-1,2000.0,1453938,1454034,2357,96,56,0,True,True,5.6672,-0.847172
1671,1451844,30,16,0.430928,63,1453938,-1,8000.0,1466576,1466606,14732,30,37,6,True,True,7.331333333333333,-0.430928
1672,1451875,16774,1,0.882456,63,1453938,-1,500.0,1500812,1517586,48937,16774,25,7,True,True,113.47500277777777,-0.8512430874173057
1673,1452049,27,1,0.727508,63,1453938,-1,500.0,1463189,1463216,11140,27,44,0,True,True,0.409725,-0.727508
1674,1452085,57,1,0.763857,63,1453938,-1,500.0,1463216,1463273,11131,57,44,1,True,True,0.8649750000000002,-0.763857
1675,1452408,18768,1,0.365937,63,1453938,-1,500.0,1802822,1821590,350414,18768,1,6,True,True,493.82329999999996,-0.3658664924023897
1676,1452615,52,16,0.400582,63,1453938,-1,8000.0,1470176,1470228,17561,52,39,5,True,True,9.752888888888888,-0.400582
1677,1454614,8,1,0.570282,61,1455038,-1,500.0,1472376,1472384,17762,8,37,0,True,True,0.09377777777777778,-0.570282
1678,1454636,39,1,0.194655,61,1455038,-1,500.0,1458789,1458828,4153,39,54,1,True,True,0.5465416666666667,-0.194655
1679,1456872,6712,86,0.553223,57,1458656,-1,43000.0,1474576,1481288,17704,6712,37,7,True,True,5786.730733333334,-0.505131241965702
1680,1596460,10681,32,0.073532,26,1600516,-1,16000.0,1609700,1620381,13240,10681,8,0,True,True,3539.290488888889,-0.07347329538573798
1681,1596869,64,32,0.504256,26,1600516,-1,16000.0,1605300,1605364,8431,64,10,7,True,True,16.443733333333334,-0.504256
1682,1597436,24,10,0.764404,26,1600516,-1,5000.0,1600516,1600540,3080,24,11,0,True,True,1.9616666666666667,-0.764404
1683,1597484,939,2,0.279721,26,1600516,-1,1000.0,1605300,1606239,7816,939,10,0,True,True,13.868224999999999,-0.2572645168606203
1684,1597521,994,8,0.989091,26,1600516,-1,4000.0,1600516,1601510,2995,994,12,0,True,True,64.99655555555555,-0.989091
1685,1597734,3,42,0.680399,26,1600516,-1,21000.0,1618593,1618596,20859,3,7,6,True,True,1.2677,-0.680399
1686,1597776,122,1,0.118811,26,1600516,-1,500.0,1641379,1641501,43603,122,6,7,True,True,2.9620583333333337,-0.118811
1687,1597818,384,8,0.975083,26,1600516,-1,4000.0,1600516,1600900,2698,384,16,0,True,True,25.109333333333336,-0.975083
1688,1597823,17302,18,0.393904,26,1600516,-1,9000.0,1647979,1665281,50156,17302,6,7,True,True,8909.303675,-0.38346425736610545
1689,1598531,28,1,0.794897,26,1600516,-1,500.0,1600900,1600928,2369,28,15,0,True,True,0.2288611111111111,-0.794897
1690,1598542,127,51,0.339085,26,1600516,-1,25500.0,1607500,1607627,8958,127,13,7,True,True,45.86975416666667,-0.339085
1691,1598584,14,3,0.938949,26,1600516,-1,1500.0,1600900,1600914,2316,14,17,2,True,True,0.34329166666666666,-0.938949
1692,1598620,11847,3,0.754965,26,1600516,-1,1500.0,1636979,1648826,38359,11847,9,6,True,True,951.4161041666667,-0.7095121296449163
1693,1598714,12681,256,0.199058,26,1600516,-1,128000.0,1699725,1712406,101011,12681,5,8,True,True,57970.872533333335,-0.1948495830389699
1694,1598776,6557,2,0.509123,26,1600516,-1,1000.0,1620793,1627350,22017,6557,11,7,True,True,139.6547,-0.480292176374116
1695,1598819,490,37,0.500078,26,1600516,-1,18500.0,1600900,1601390,2081,490,20,0,True,True,148.18756944444442,-0.5000779999999999
1696,1598835,37,32,0.045303,26,1600516,-1,16000.0,1603100,1603137,4265,37,19,7,True,True,9.506533333333334,-0.045303
1697,1603039,14883,16,0.137036,20,1603100,-1,8000.0,1650179,1665062,47140,14883,7,7,True,True,6817.205422222223,-0.13478872729168628
1698,1603587,160,1,0.333041,22,1605300,-1,500.0,1644679,1644839,41092,160,9,7,True,True,4.575777777777778,-0.333041
1699,1603891,46,32,0.473744,22,1605300,-1,16000.0,1609700,1609746,5809,46,18,0,True,True,14.767022222222224,-0.473744
1700,1604086,27,64,0.456989,22,1605300,-1,32000.0,1633679,1633706,29593,27,13,7,True,True,29.5128,-0.456989
1701,1605702,50,4,0.606261,32,1607500,-1,2000.0,1610800,1610850,5098,50,17,6,True,True,2.006388888888889,-0.606261
1702,1605723,93,1,0.515506,32,1607500,-1,500.0,1617400,1617493,11677,93,16,7,True,True,0.9356833333333333,-0.515506
1703,1605946,11059,128,0.327966,32,1607500,-1,64000.0,1652379,1663438,46433,11059,7,7,True,True,41540.231822222224,-0.32151974820319906
1704,1606006,11257,64,0.613068,32,1607500,-1,32000.0,1661202,1672459,55196,11257,7,7,True,True,18674.08426666667,-0.5858744325122515
1705,1606043,41,1,0.162502,32,1607500,-1,500.0,1609700,1609741,3657,41,24,7,True,True,0.4113097222222223,-0.162502
1706,1606213,16,2,0.990616,32,1607500,-1,1000.0,1609700,1609716,3487,16,24,0,True,True,0.32102222222222226,-0.990616
1707,1606308,359,2,0.739319,32,1607500,-1,1000.0,1609700,1610059,3392,359,23,0,True,True,7.202936111111112,-0.739319
1708,1606337,1891,8,0.299234,32,1607500,-1,4000.0,1617493,1619384,11156,1891,18,1,True,True,152.20448888888887,-0.299234
1709,1606500,13621,1,0.336373,32,1607500,-1,500.0,1714606,1728227,108106,13621,4,7,True,True,490.36623194444445,-0.3152494869956388
1710,1606528,59,2,0.828289,32,1607500,-1,1000.0,1613000,1613059,6472,59,22,7,True,True,1.296361111111111,-0.828289
1711,1606786,19333,64,0.53234,32,1607500,-1,32000.0,1680392,1699725,73606,19333,7,6,True,True,38622.29093333334,-0.5097199207056358
1712,1606809,112,64,0.70874,32,1607500,-1,32000.0,1615200,1615312,8391,112,22,6,True,True,78.74844444444443,-0.70874
1713,1608097,518,2,0.299791,36,1609700,-1,1000.0,1628179,1628697,20082,518,18,2,True,True,11.698166666666667,-0.299791
1714,1608200,15423,32,0.815749,36,1609700,-1,16000.0,1645779,1661202,37579,15423,13,6,True,True,14596.527733333332,-0.8135030636745874
1715,1608220,15378,1,0.368358,36,1609700,-1,500.0,1672459,1687837,64239,15378,8,0,True,True,497.8386263888889,-0.3657481700695831
1716,1608688,1992,1,0.673806,36,1609700,-1,500.0,1635879,1637871,27191,1992,19,7,True,True,39.84276666666666,-0.673806
1717,1608889,7265,8,0.979898,36,1609700,-1,4000.0,1610800,1618065,1911,7265,29,0,True,True,610.9251111111112,-0.9791743479352016
1718,1611130,6,4,0.583702,32,1613000,-1,2000.0,1617493,1617499,6363,6,24,0,True,True,0.24146666666666666,-0.583702
1719,1611158,29,32,0.796755,32,1613000,-1,16000.0,1631479,1631508,20321,29,21,0,True,True,15.849466666666666,-0.796755
1720,1611488,390,32,0.725324,32,1613000,-1,16000.0,1635879,1636269,24391,390,19,0,True,True,249.61733333333333,-0.725324
1721,1611548,15,8,0.688044,32,1613000,-1,4000.0,1617493,1617508,5945,15,26,0,True,True,1.2073333333333334,-0.688044
1722,1618229,16,1,0.026647,28,1618593,-1,500.0,1642479,1642495,24250,16,16,6,True,True,0.45757777777777775,-0.026647
1723,1618309,13,2,0.47459,28,1618593,-1,1000.0,1629279,1629292,10970,13,24,6,True,True,0.2935833333333333,-0.47459
1724,1618347,25525,16,0.967071,28,1618593,-1,8000.0,1625493,1651018,7146,25525,26,6,True,True,8849.9526,-0.9266532115803081
1725,1618857,5,13,0.782904,30,1620793,-1,6500.0,1631479,1631484,12622,5,24,7,True,True,1.1101458333333334,-0.782904
1726,1618870,2,8,0.776162,30,1620793,-1,4000.0,1624393,1624395,5523,2,28,1,True,True,0.18055555555555555,-0.776162
1727,1618883,135,32,0.577634,30,1620793,-1,16000.0,1633679,1633814,14796,135,22,0,True,True,73.782,-0.577634
4529,3668186,12,8,0.701314,1,3668186,-1,4000.0,3669286,3669298,1100,12,0,6,True,True,0.8990666666666668,-0.701314
4530,3668196,39839,1,0.255939,6,3669286,-1,500.0,3992350,4032189,324154,39839,0,7,True,True,514.9999069444443,-0.25432852127699934
4531,3668426,38,4,0.366354,6,3669286,-1,2000.0,3681436,3681474,13010,38,1,0,True,True,1.5820666666666667,-0.366354
4532,3668615,13,64,0.605954,6,3669286,-1,32000.0,3671486,3671499,2871,13,2,7,True,True,7.791911111111111,-0.605954
4533,3668830,23991,4,0.070874,6,3669286,-1,2000.0,3820117,3844108,151287,23991,1,0,True,True,1819.1393055555552,-0.07057425588296262
4534,3668847,12081,256,0.930211,6,3669286,-1,128000.0,4130994,4143075,462147,12081,0,7,True,True,101966.7584,-0.9076821302192536
4535,3668865,5,1,0.208738,6,3669286,-1,500.0,3707888,3707893,39023,5,3,2,True,True,0.06341666666666666,-0.208738
4536,3669374,4541,184,0.491406,17,3671486,-1,92000.0,4077918,4082459,408544,4541,1,6,True,True,17881.291733333335,-0.4719389481698005
4537,3669407,7819,4,0.889767,17,3671486,-1,2000.0,3675886,3683705,6479,7819,6,7,True,True,325.6798333333333,-0.8531350483368363
4538,3669434,2,4,0.079957,17,3671486,-1,2000.0,3681436,3681438,12002,2,6,0,True,True,0.08326666666666667,-0.079957
4539,3669546,5723,2,0.80102,17,3671486,-1,1000.0,3678131,3683854,8585,5723,7,0,True,True,120.72426666666667,-0.7642429518651607
4540,3669588,33704,64,0.0607,17,3671486,-1,32000.0,3891734,3925438,222146,33704,3,7,True,True,29624.95911111111,-0.0600127202121878
4541,3669597,10,1,0.55802,17,3671486,-1,500.0,3681436,3681446,11839,10,7,0,True,True,0.10408333333333333,-0.55802
4542,3670045,612,43,0.938244,17,3671486,-1,21500.0,3678131,3678743,8086,612,10,2,True,True,266.815,-0.938244
4543,3670118,3,16,0.415953,17,3671486,-1,8000.0,3686974,3686977,16856,3,6,6,True,True,0.5982666666666667,-0.415953
4544,3670126,12,8,0.369069,17,3671486,-1,4000.0,3675886,3675898,5760,12,12,0,True,True,0.9733333333333334,-0.369069
4545,3670158,26577,128,0.708434,17,3671486,-1,64000.0,4051341,4077918,381183,26577,2,7,True,True,69364.8032,-0.7033128740952381
4546,3670351,9,2,0.823643,17,3671486,-1,1000.0,3673686,3673695,3335,9,15,7,True,True,0.16287500000000002,-0.823643
4547,3670440,3747,1,0.265816,17,3671486,-1,500.0,3725217,3728964,54777,3747,6,6,True,True,49.16426666666666,-0.2628128381010094
4548,3672786,28250,128,0.040653,21,3673686,-1,64000.0,3948265,3976515,275479,28250,4,8,True,True,40152.045333333335,-0.037954645461381144
4549,3672822,13457,128,0.070388,21,3673686,-1,64000.0,3942865,3956322,270043,13457,5,8,True,True,19767.630577777778,-0.06829319700909615
4550,3673201,21313,16,0.303905,21,3673686,-1,8000.0,3784727,3806040,111526,21313,8,7,True,True,6706.322155555555,-0.29869324866907904
4551,3673565,89,1,0.944603,21,3673686,-1,500.0,3675886,3675975,2321,89,18,0,True,True,0.9023611111111111,-0.944603
4552,3673625,16711,4,0.960587,21,3673686,-1,2000.0,3743375,3760086,69750,16711,9,0,True,True,683.9872277777778,-0.8746398339350374
4553,3673741,75,2,0.097119,37,3675886,-1,1000.0,3700858,3700933,27117,75,12,0,True,True,1.954375,-0.097119
4554,3673762,201,1,0.725172,37,3675886,-1,500.0,3678136,3678337,4374,201,17,1,True,True,2.037916666666667,-0.725172
4555,3673920,5,1,0.531661,37,3675886,-1,500.0,3678131,3678136,4211,5,19,0,True,True,0.050694444444444445,-0.531661
4556,3674946,25,1,0.18946,37,3675886,-1,500.0,3678086,3678111,3140,25,21,0,True,True,0.2534722222222222,-0.18946
4557,3674980,12598,32,0.526192,37,3675886,-1,16000.0,3747795,3760393,72815,12598,9,0,True,True,3737.387244444444,-0.521812874742641
4558,3675045,21116,45,0.248763,37,3675886,-1,22500.0,3710088,3731204,35043,21116,12,7,True,True,11821.743250000001,-0.24454959431362627
4559,3675284,288,3,0.625325,37,3675886,-1,1500.0,3681436,3681724,6152,288,19,7,True,True,8.992799999999999,-0.625325
4560,3675406,1649,5,0.178898,37,3675886,-1,2500.0,3721405,3723054,45999,1649,12,4,True,True,99.82316666666668,-0.17436000550341674
4561,3675425,101,1,0.749194,37,3675886,-1,500.0,3679236,3679337,3811,101,21,0,True,True,1.0512416666666666,-0.749194
4562,3675572,12,2,0.415185,37,3675886,-1,1000.0,3685874,3685886,10302,12,17,0,True,True,0.2744666666666667,-0.415185
4563,3675590,8667,16,0.105514,37,3675886,-1,8000.0,3714505,3723172,38915,8667,13,0,True,True,1664.715288888889,-0.10384167526945051
4564,3675622,29,12,0.638624,37,3675886,-1,6000.0,3678086,3678115,2464,29,29,7,True,True,3.5283333333333333,-0.638624
4565,3675637,7754,128,0.357963,37,3675886,-1,64000.0,3790849,3798603,115212,7754,8,6,True,True,20060.67768888889,-0.33813375354880837
4566,3675654,189,32,0.458721,37,3675886,-1,16000.0,3679236,3679425,3582,189,24,0,True,True,62.9496,-0.458721
4567,3675688,10761,1,0.665242,37,3675886,-1,500.0,3747775,3758536,72087,10761,11,6,True,True,104.03232777777777,-0.6597110448338092
4568,3675741,8744,4,0.882824,37,3675886,-1,2000.0,3679236,3687980,3495,8744,26,0,True,True,391.8329777777777,-0.8469248257941129
4569,3675872,9308,1,0.166809,37,3675886,-1,500.0,3734067,3743375,58195,9308,13,7,True,True,119.15330972222223,-0.16675919017168686
4570,3675903,11829,72,0.180397,46,3678086,-1,36000.0,3710088,3721917,34185,11829,17,0,True,True,10291.6728,-0.17827032606220328
4571,3676012,238,1,0.401557,46,3678086,-1,500.0,3691994,3692232,15982,238,21,5,True,True,2.9396305555555555,-0.401557
4572,3676024,33,8,0.337513,46,3678086,-1,4000.0,3689080,3689113,13056,33,22,0,True,True,3.2904666666666667,-0.337513
4573,3676082,23,5,0.158176,46,3678086,-1,2500.0,3686974,3686997,10892,23,23,0,True,True,1.4333472222222223,-0.15817600000000004
4574,3676130,45,1,0.998434,46,3678086,-1,500.0,3678086,3678131,1956,45,38,0,True,True,0.45625000000000004,-0.998434
4575,3676133,2356,2,0.443012,46,3678086,-1,1000.0,3700794,3703150,24661,2356,21,6,True,True,61.39743333333334,-0.4319890181209081
4576,3676184,230,8,0.352324,46,3678086,-1,4000.0,3689080,3689310,12896,230,24,6,True,True,22.933555555555554,-0.352324
4577,3677867,53,45,0.315155,46,3678086,-1,22500.0,3679236,3679289,1369,53,35,6,True,True,24.823874999999997,-0.315155
4578,3677893,32,1,0.991463,46,3678086,-1,500.0,3678111,3678143,218,32,40,1,True,True,0.3244444444444444,-0.991463
4579,3677973,1043,1,0.324654,46,3678086,-1,500.0,3685874,3686917,7901,1043,28,7,True,True,12.459225,-0.3111529405892083
4580,3677995,13208,38,0.37172,46,3678086,-1,19000.0,3714505,3727713,36510,13208,17,7,True,True,6154.752333333334,-0.3650583874282425
4581,3678079,1889,4,0.764184,46,3678086,-1,2000.0,3679236,3681125,1157,1889,35,0,True,True,78.64536666666666,-0.764184
4582,3678090,14913,128,0.430588,45,3678111,-1,64000.0,3829435,3844348,151345,14913,7,2,True,True,33698.38133333333,-0.4083798586549292
4583,3678108,13165,16,0.725868,45,3678111,-1,8000.0,3685874,3699039,7766,13165,29,0,True,True,2657.744511111111,-0.7161162310273329
4584,3678125,7,4,0.608413,45,3678131,-1,2000.0,3683674,3683681,5549,7,32,6,True,True,0.3202111111111111,-0.608413
4585,3678176,6,37,0.563145,45,3679236,-1,18500.0,3685874,3685880,7698,6,31,0,True,True,2.538816666666667,-0.563145
4586,3678377,8869,256,0.213928,45,3679236,-1,128000.0,3983481,3992350,305104,8869,4,2,True,True,25740.395022222223,-0.2139142600563697
4587,3678440,12027,210,0.765708,45,3679236,-1,105000.0,3925438,3937465,246998,12027,7,6,True,True,28682.576416666667,-0.7484169731426874
4588,3679211,14,64,0.926147,45,3679236,-1,32000.0,3679236,3679250,25,14,41,0,True,True,9.325866666666666,-0.926147
4589,3679280,44,128,0.254089,50,3681436,-1,64000.0,3736267,3736311,56987,44,16,7,True,True,71.38560000000001,-0.254089
4590,3679312,4,1,0.961652,50,3681436,-1,500.0,3681436,3681440,2124,4,38,0,True,True,0.041633333333333335,-0.961652
4591,3679372,7906,32,0.4475,50,3681436,-1,16000.0,3689116,3697022,9744,7906,28,0,True,True,3180.3035555555557,-0.44574814960894404
4592,3680172,1984,32,0.397091,50,3681436,-1,16000.0,3681436,3683420,1264,1984,42,0,True,True,681.1953777777778,-0.3725561389057567
4593,3680281,13,14,0.726313,50,3681436,-1,7000.0,3682574,3682587,2293,13,38,6,True,True,1.8943166666666666,-0.7263129999999999
4594,3680922,11742,86,0.982956,50,3681436,-1,43000.0,3689116,3700858,8194,11742,29,1,True,True,12945.474172222222,-0.967484262847015
4595,3681024,1300,8,0.595763,50,3681436,-1,4000.0,3689080,3690380,8056,1300,30,0,True,True,129.28244444444442,-0.5941911441137645
4596,3681070,19,1,0.517609,50,3681436,-1,500.0,3689113,3689132,8043,19,30,1,True,True,0.23681388888888888,-0.517609
4597,3681095,23,32,0.993412,50,3681436,-1,16000.0,3682574,3682597,1479,23,41,0,True,True,7.660533333333333,-0.993412
4598,3681213,5,32,0.301842,50,3681436,-1,16000.0,3681474,3681479,261,5,43,4,True,True,1.6653333333333333,-0.301842
4599,3681391,13,8,0.300334,50,3681436,-1,4000.0,3685874,3685887,4483,13,38,0,True,True,1.1893555555555555,-0.300334
4600,3681904,3459,4,0.221887,49,3682574,-1,2000.0,3717805,3721264,35901,3459,20,7,True,True,165.09062222222224,-0.2204248352627676
4601,3682096,13849,4,0.85572,49,3682574,-1,2000.0,3747775,3761624,65679,13849,14,0,True,True,502.61046666666664,-0.8497712647693892
4602,3682167,19827,32,0.021701,49,3682574,-1,16000.0,3751095,3770922,68928,19827,13,7,True,True,4868.4008,-0.01931298212654851
4603,3682283,6,1,0.82194,49,3682574,-1,500.0,3687980,3687986,5697,6,37,3,True,True,0.07478333333333334,-0.82194
4604,3682525,22,32,0.689719,49,3682574,-1,16000.0,3689113,3689135,6588,22,33,0,True,True,8.774577777777777,-0.689719
4605,3682574,13,1,0.275957,49,3682574,-1,500.0,3724117,3724130,41543,13,21,7,True,True,0.16148888888888888,-0.275957
4606,3682589,3,4,0.553663,48,3683674,-1,2000.0,3689113,3689116,6524,3,35,0,True,True,0.14956666666666668,-0.553663
4607,3683826,2914,1,0.556323,49,3685874,-1,500.0,3689080,3691994,5254,2914,38,0,True,True,36.09544722222222,-0.5528869333801041
4608,3685104,2,1,0.925922,49,3685874,-1,500.0,3685874,3685876,770,2,45,0,True,True,0.022872222222222224,-0.925922
4609,3688341,561,1,0.154715,46,3689080,-1,500.0,3727417,3727978,39076,561,20,0,True,True,7.464416666666666,-0.154715
4610,3688365,19295,64,0.037736,46,3689080,-1,32000.0,3901303,3920598,212938,19295,8,7,True,True,16282.346044444446,-0.03424950505562815
4611,3688398,12603,8,0.355656,46,3689080,-1,4000.0,3929038,3941641,240640,12603,7,1,True,True,1260.8808666666666,-0.3522381107999381
4612,3688772,56,1,0.138408,46,3689080,-1,500.0,3701958,3702014,13186,56,32,6,True,True,0.7296333333333334,-0.138408
4613,3688871,53,8,0.367083,46,3689080,-1,4000.0,3707758,3707811,18887,53,32,0,True,True,5.377733333333333,-0.367083
4614,3688977,11,8,0.582156,46,3689080,-1,4000.0,3697494,3697505,8517,11,36,7,True,True,1.1759,-0.582156
4615,3689104,7367,16,0.232994,43,3689113,-1,8000.0,3731867,3739234,42763,7367,22,1,True,True,1519.088511111111,-0.22857930752320757
4616,3689453,19,1,0.811074,47,3691994,-1,500.0,3691994,3692013,2541,19,38,0,True,True,0.23467638888888892,-0.811074
4617,3690701,14513,16,0.091905,47,3691994,-1,8000.0,3747775,3762288,57074,14513,18,0,True,True,2085.042222222222,-0.09118010924448039
4618,3690792,149,32,0.399798,47,3691994,-1,16000.0,3691994,3692143,1202,149,40,0,True,True,58.89142222222223,-0.399798
4619,3690846,16952,256,0.917882,47,3691994,-1,128000.0,4032189,4049141,341343,16952,3,7,True,True,69233.06986666666,-0.8912826932375375
4620,3690876,21615,64,0.734266,47,3691994,-1,32000.0,3860408,3882023,169532,21615,12,7,True,True,17497.46773333333,-0.7288699599223162
4621,3690903,30,8,0.723581,47,3691994,-1,4000.0,3699694,3699724,8791,30,40,7,True,True,3.207,-0.723581
4622,3691207,140,16,0.792904,47,3691994,-1,8000.0,3693094,3693234,1887,140,42,6,True,True,27.667111111111115,-0.792904
4623,3691710,20607,32,0.172902,47,3691994,-1,16000.0,3704158,3724765,12448,20607,37,7,True,True,8109.811644444445,-0.16999991686496854
4624,3691896,6844,35,0.825705,47,3691994,-1,17500.0,3695294,3702138,3398,6844,43,0,True,True,3149.6645833333337,-0.8222220619093717
4625,3692532,17,8,0.689595,49,3693094,-1,4000.0,3710088,3710105,17556,17,33,0,True,True,1.7294666666666667,-0.689595
4626,3692654,1207,32,0.576232,49,3693094,-1,16000.0,3704158,3705365,11504,1207,38,0,True,True,492.5592,-0.5640036565848561
4627,3692800,10,1,0.907656,49,3693094,-1,500.0,3695294,3695304,2494,10,46,7,True,True,0.12829166666666666,-0.907656
4628,3692903,3,12,0.595231,49,3693094,-1,6000.0,3700858,3700861,7955,3,42,1,True,True,0.46905,-0.595231
4629,3693006,11,21,0.300393,49,3693094,-1,10500.0,3710105,3710116,17099,11,33,1,True,True,2.93755,-0.3003930000000001
4630,3699045,8653,32,0.730789,52,3699694,-1,16000.0,3748895,3757548,49850,8653,18,0,True,True,2671.4152888888884,-0.6797913412623869
4631,3699066,22116,32,0.576284,52,3699694,-1,16000.0,3778805,3800921,79739,22116,17,2,True,True,12605.327555555556,-0.5670018897302875
4632,3699271,21,1,0.078477,52,3699694,-1,500.0,3731846,3731867,32575,21,28,7,True,True,0.2801458333333333,-0.078477
4633,3699282,111,18,0.055923,52,3699694,-1,9000.0,3715605,3715716,16323,111,34,6,True,True,23.998200000000004,-0.055923
4634,3699352,13,4,0.770902,52,3699694,-1,2000.0,3700858,3700871,1506,13,46,0,True,True,0.6775166666666667,-0.770902
4635,3699478,11,4,0.34793,52,3699694,-1,2000.0,3727435,3727446,27957,11,29,1,True,True,0.5854444444444444,-0.34793
4636,3699527,13020,12,0.817142,52,3699694,-1,6000.0,3727435,3740455,27908,13020,29,0,True,True,2037.5614166666667,-0.812223924758163
4637,3700163,6,11,0.416522,52,3700794,-1,5500.0,3712305,3712311,12142,6,39,7,True,True,0.7953,-0.416522
4638,3701086,44,32,0.867831,51,3701958,-1,16000.0,3701958,3702002,872,44,48,0,True,True,18.345066666666668,-0.867831
4639,3701224,130,1,0.869787,51,3701958,-1,500.0,3707758,3707888,6534,130,46,2,True,True,1.6488333333333332,-0.869787
4640,3701346,187,32,0.226718,51,3701958,-1,16000.0,3721917,3722104,20571,187,34,1,True,True,71.20960000000001,-0.226718
4641,3712058,24,36,0.652779,42,3712305,-1,18000.0,3731846,3731870,19788,24,28,0,True,True,11.526,-0.652779
4642,3712151,13959,64,0.602302,42,3712305,-1,32000.0,3743375,3757334,31224,13959,25,4,True,True,9697.67351111111,-0.5472457106959983
4643,3714914,7407,9,0.011434,43,3715605,-1,4500.0,3764895,3772302,49981,7407,18,5,True,True,485.61266250000006,-0.011336801311384736
4644,3715223,18,16,0.777419,43,3715605,-1,8000.0,3727417,3727435,12194,18,35,7,True,True,3.832,-0.777419
4645,3715324,18,16,0.382487,43,3715605,-1,8000.0,3727446,3727464,12122,18,32,1,True,True,3.832,-0.382487
4646,3715542,5,8,0.304783,43,3715605,-1,4000.0,3738467,3738472,22925,5,27,7,True,True,0.5181666666666667,-0.304783
4647,3720730,18,16,0.041182,43,3721405,-1,8000.0,3727435,3727453,6705,18,34,0,True,True,3.832,-0.041182
4648,3720939,56,4,0.53993,43,3721405,-1,2000.0,3727435,3727491,6496,56,34,0,True,True,2.9804444444444442,-0.53993
4649,3721655,12,1,0.14958,43,3721917,-1,500.0,3754695,3754707,33040,12,19,0,True,True,0.11998333333333333,-0.14958
4650,3723113,108,2,0.502402,47,3724117,-1,1000.0,3731846,3731954,8733,108,33,0,True,True,2.8815,-0.502402
4651,3723509,38,1,0.220797,47,3724117,-1,500.0,3771885,3771923,48376,38,18,6,True,True,0.29128055555555554,-0.220797
4652,3723658,819,1,0.05052,47,3724117,-1,500.0,3754695,3755514,31037,819,21,4,True,True,6.184704166666666,-0.03815563571863614
4653,3723949,12732,20,0.731579,47,3724117,-1,10000.0,3729646,3742378,5697,12732,37,7,True,True,3297.2026666666666,-0.7310337330542743
4654,3724018,394,4,0.392883,47,3724117,-1,2000.0,3745575,3745969,21557,394,28,7,True,True,20.159666666666666,-0.392883
4655,3733006,4,16,0.445616,35,3734067,-1,8000.0,3741767,3741771,8761,4,31,7,True,True,0.8148444444444445,-0.445616
4656,3733414,122,4,0.595132,35,3734067,-1,2000.0,3739567,3739689,6153,122,32,6,True,True,6.321633333333334,-0.595132
4657,3736777,71,3,0.504729,39,3738467,-1,1500.0,3741771,3741842,4994,71,31,1,True,True,2.7119041666666663,-0.504729
4658,3736867,291,2,0.222086,39,3738467,-1,1000.0,3800988,3801279,64121,291,15,6,True,True,12.836333333333334,-0.222086
4659,3737473,40,1,0.289783,39,3738467,-1,500.0,3748895,3748935,11422,40,25,6,True,True,0.4811111111111111,-0.289783
4660,3737586,14,4,0.394322,39,3738467,-1,2000.0,3741767,3741781,4181,14,34,0,True,True,0.7129888888888889,-0.394322
4661,3737606,16503,3,0.132189,39,3738467,-1,1500.0,3784727,3801230,47121,16503,17,0,True,True,956.2952375,-0.13132710578628656
4662,3737796,274,12,0.082545,39,3738467,-1,6000.0,3747795,3748069,9999,274,28,2,True,True,39.54733333333333,-0.082545
4663,3740770,18193,1,0.571441,43,3741767,-1,500.0,3994550,4012743,253780,18193,4,7,True,True,238.79730555555554,-0.5640173676429352
4664,3740870,2,4,0.049311,43,3741767,-1,2000.0,3747775,3747777,6905,2,32,0,True,True,0.09622222222222221,-0.049311
4665,3740946,4650,1,0.399191,43,3741767,-1,500.0,3771889,3776539,30943,4650,21,0,True,True,49.873676388888896,-0.34799694552116756
4666,3741105,22,1,0.085079,43,3741767,-1,500.0,3774097,3774119,32992,22,21,0,True,True,0.2514416666666667,-0.085079
4667,3741132,20,4,0.501823,43,3741767,-1,2000.0,3747775,3747795,6643,20,35,0,True,True,0.9622222222222222,-0.501823
4668,3741765,21010,1,0.773825,43,3741767,-1,500.0,3992350,4013360,250585,21010,5,0,True,True,274.2788888888889,-0.7699418156651969
4669,3741794,1379,32,0.130375,44,3743375,-1,16000.0,3743375,3744754,1581,1379,39,0,True,True,563.2762222222221,-0.13009912083808703
4670,3741818,8052,16,0.134871,44,3743375,-1,8000.0,3807667,3815719,65849,8052,17,2,True,True,2521.6011333333336,-0.13371109985809965
4671,3742130,11773,256,0.559296,44,3743375,-1,128000.0,4119221,4130994,377091,11773,1,8,True,True,75471.64337777777,-0.5159087680873529
4672,3742226,27737,2,0.487861,44,3743375,-1,1000.0,4049141,4076878,306915,27737,4,7,True,True,1130.9161500000002,-0.4761421153866522
4673,3744910,24,1,0.652248,45,3745575,-1,500.0,3747775,3747799,2865,24,39,0,True,True,0.2886666666666667,-0.652248
4674,3745166,37,4,0.196099,45,3745575,-1,2000.0,3774097,3774134,28931,37,26,1,True,True,1.6915166666666668,-0.196099
4675,3745225,5,16,0.615997,45,3745575,-1,8000.0,3746675,3746680,1450,5,43,6,True,True,1.0233333333333332,-0.615997
4676,3745556,5180,2,0.735668,45,3745575,-1,1000.0,3756895,3762075,11339,5180,30,7,True,True,73.11420833333334,-0.7263357263626578
4677,3745892,345,7,0.246246,50,3746675,-1,3500.0,3782182,3782527,36290,345,24,1,True,True,32.51864583333334,-0.24624599999999994
4678,3745926,7556,18,0.071644,50,3746675,-1,9000.0,3779905,3787461,33979,7556,25,0,True,True,2038.5408,-0.06416712322381221
4679,3746126,1346,1,0.776772,50,3746675,-1,500.0,3747775,3749121,1649,1346,40,0,True,True,16.18938888888889,-0.776772
4680,3746157,12869,5,0.323412,50,3746675,-1,2500.0,3781057,3793926,34900,12869,25,1,True,True,1076.2823402777776,-0.31952557004812043
4681,3746241,9785,64,0.924138,50,3746675,-1,32000.0,3834860,3844645,88619,9785,17,6,True,True,10685.174666666666,-0.9178277166743332
4682,3746249,7103,1,0.089595,50,3746675,-1,500.0,3779905,3787008,33656,7103,27,0,True,True,105.563975,-0.08904679316619893
4683,3755003,82,3,0.671748,54,3756895,-1,1500.0,3768503,3768585,13500,82,34,1,True,True,1.7226833333333333,-0.671748
4684,3755163,75,16,0.423541,54,3756895,-1,8000.0,3756895,3756970,1732,75,36,0,True,True,8.629999999999999,-0.423541
4685,3755216,149,15,0.348308,54,3756895,-1,7500.0,3774089,3774238,18873,149,32,0,True,True,25.544187500000003,-0.348308
4686,3755303,664,1,0.320738,54,3756895,-1,500.0,3770785,3771449,15482,664,35,7,True,True,5.089744444444444,-0.320738
4687,3755563,12,7,0.593877,54,3756895,-1,3500.0,3779905,3779917,24342,12,28,0,True,True,1.0549000000000002,-0.5938770000000001
4688,3755616,5197,2,0.024207,54,3756895,-1,1000.0,3856008,3861205,100392,5197,17,6,True,True,142.96963888888888,-0.02416906510520864
4689,3755685,162,1,0.304819,54,3756895,-1,500.0,3779905,3780067,24220,162,28,0,True,True,2.0952152777777777,-0.2927792909320701
4690,3755779,25,4,0.987652,54,3756895,-1,2000.0,3759095,3759120,3316,25,41,0,True,True,0.7001388888888888,-0.987652
4691,3755886,133,1,0.616221,54,3756895,-1,500.0,3768503,3768636,12617,133,39,0,True,True,0.9313694444444445,-0.616221
4692,3756006,65,1,0.990159,54,3756895,-1,500.0,3759095,3759160,3089,65,43,7,True,True,0.4550902777777777,-0.990159
4693,3756031,311,16,0.44221,54,3756895,-1,8000.0,3779905,3780216,23874,311,32,6,True,True,65.62466666666667,-0.43311176513899
4694,3756055,4751,128,0.145818,54,3756895,-1,64000.0,3896552,3901303,140497,4751,15,0,True,True,11141.722133333333,-0.14353670939579424
4695,3756222,13626,35,0.044878,54,3756895,-1,17500.0,3874808,3888434,118586,13626,17,3,True,True,5939.416388888889,-0.04429509783121661
4696,3756261,33,32,0.818172,54,3756895,-1,16000.0,3764895,3764928,8634,33,44,0,True,True,7.443333333333333,-0.818172
4697,3756506,69,2,0.199685,54,3756895,-1,1000.0,3814300,3814369,57794,69,23,6,True,True,2.5667999999999997,-0.199685
4698,3756759,40,8,0.373821,54,3756895,-1,4000.0,3781017,3781057,24258,40,31,6,True,True,4.308888888888889,-0.373821
4699,3756843,17162,1,0.757734,54,3756895,-1,500.0,3820117,3837279,63274,17162,22,0,True,True,339.31847083333327,-0.7549716659824965
4700,3756862,6542,32,0.852764,54,3756895,-1,16000.0,3775205,3781747,18343,6542,39,6,True,True,2636.534222222222,-0.8225162864265881
4701,3756895,3,1,0.112372,54,3756895,-1,500.0,3796285,3796288,39390,3,27,8,True,True,0.06332916666666667,-0.112372
4702,3756915,8,32,0.054538,55,3759095,-1,16000.0,3768495,3768503,11580,8,49,2,True,True,1.7927111111111111,-0.054538
4703,3757054,179,8,0.948941,55,3759095,-1,4000.0,3761295,3761474,4241,179,52,7,True,True,10.025988888888888,-0.948941
4704,3757085,210,1,0.92673,55,3759095,-1,500.0,3759095,3759305,2010,210,54,0,True,True,1.4702916666666666,-0.92673
4705,3762278,398,1,0.868752,60,3764895,-1,500.0,3768495,3768893,6217,398,49,0,True,True,2.7871055555555557,-0.868752
4706,3762315,1072,16,0.820134,60,3764895,-1,8000.0,3768495,3769567,6180,1072,50,0,True,True,124.00184444444444,-0.7735177715655959
4707,3762596,873,2,0.013733,60,3764895,-1,1000.0,3812100,3812973,49504,873,25,0,True,True,33.676433333333335,-0.01285732937262809
4708,3762738,3561,13,0.693795,60,3764895,-1,6500.0,3782157,3785718,19419,3561,33,0,True,True,704.1909875,-0.6434661063741811
4709,3763357,38,8,0.111278,60,3764895,-1,4000.0,3790885,3790923,27528,38,29,0,True,True,5.772622222222222,-0.111278
4710,3763829,30,16,0.450062,60,3764895,-1,8000.0,3779917,3779947,16088,30,37,0,True,True,6.0280000000000005,-0.450062
4711,3763901,3,1,0.022748,60,3764895,-1,500.0,3799885,3799888,35984,3,28,0,True,True,0.06616666666666668,-0.022748
4712,3764374,127,1,0.20901,60,3764895,-1,500.0,3833760,3833887,69386,127,21,6,True,True,2.2921736111111106,-0.20901
4713,3764568,25,1,0.538005,60,3764895,-1,500.0,3782157,3782182,17589,25,37,6,True,True,0.33663194444444444,-0.538005
4714,3765006,404,1,0.203801,69,3768495,-1,500.0,3779917,3780321,14911,404,41,0,True,True,5.364695833333334,-0.20098087469324297
4715,3765081,180,8,0.523266,69,3768495,-1,4000.0,3768503,3768683,3422,180,55,0,True,True,10.084000000000001,-0.523266
4716,3765135,8,64,0.258658,69,3768495,-1,32000.0,3774089,3774097,8954,8,52,7,True,True,5.851733333333334,-0.258658
4717,3765185,10,13,0.483026,69,3768495,-1,6500.0,3771889,3771899,6704,10,54,1,True,True,0.9964861111111112,-0.483026
4718,3766817,15506,16,0.729924,69,3768495,-1,8000.0,3820117,3835623,53300,15506,23,0,True,True,4961.146733333332,-0.7270130606067229
4719,3767495,22743,32,0.141347,69,3768495,-1,16000.0,3882023,3904766,114528,22743,17,7,True,True,11099.785511111111,-0.13832537594639244
4720,3767621,8118,85,0.698755,69,3768495,-1,42500.0,3888434,3896552,120813,8118,17,7,True,True,9832.49022222222,-0.6398150264280548
4721,3767629,340,11,0.018389,69,3768495,-1,5500.0,3782527,3782867,14898,340,38,0,True,True,50.36013888888888,-0.018389
4722,3767677,4,1,0.583005,69,3768495,-1,500.0,3768585,3768589,908,4,61,1,True,True,0.02801111111111111,-0.583005
4723,3767719,4,16,0.663528,69,3768495,-1,8000.0,3771885,3771889,4166,4,59,0,True,True,0.4905777777777778,-0.663528
4724,3767753,19427,32,0.043482,69,3768495,-1,16000.0,3774105,3793532,6352,19427,53,1,True,True,9390.322622222224,-0.04253095693683842
4725,3770600,21,4,0.17032,64,3770785,-1,2000.0,3782527,3782548,11927,21,39,0,True,True,1.1310833333333334,-0.17032
4726,3770711,12818,8,0.284014,64,3770785,-1,4000.0,3782527,3795345,11816,12818,40,1,True,True,1795.2954444444445,-0.26549751235014335
4727,3770842,8241,4,0.789188,66,3771885,-1,2000.0,3799885,3808126,29043,8241,32,0,True,True,680.0014777777778,-0.7645902058106955
4728,3771034,6679,3,0.617965,66,3771885,-1,1500.0,3800988,3807667,29954,6679,31,0,True,True,410.6439875,-0.585333374421452
4729,3771114,4923,32,0.053085,66,3771885,-1,16000.0,3816517,3821440,45403,4923,28,1,True,True,3090.2735999999995,-0.05240451386684699
4730,3773534,8,2,0.654758,64,3774089,-1,1000.0,3774097,3774105,563,8,59,0,True,True,0.18286666666666668,-0.654758
4731,3773691,23,2,0.008334,64,3774089,-1,1000.0,3813200,3813223,39509,23,30,6,True,True,0.8555999999999999,-0.008334
4732,3775251,3,3,0.388645,68,3778805,-1,1500.0,3781057,3781060,5806,3,48,0,True,True,0.1211875,-0.388645
4733,3775256,74203,8,0.27131,68,3778805,-1,4000.0,4143075,4217278,367819,74203,0,7,True,True,14493.295088888888,-0.26116244322316196
4734,3775461,22,8,0.852083,68,3778805,-1,4000.0,3778805,3778827,3344,22,59,0,True,True,2.210266666666667,-0.852083
4735,3775465,484,16,0.6601,68,3778805,-1,8000.0,3778805,3779289,3340,484,59,0,True,True,97.25173333333333,-0.6601
4736,3775529,23,11,0.864282,68,3778805,-1,5500.0,3779905,3779928,4376,23,56,0,True,True,3.177258333333334,-0.8642820000000002
4737,3775548,21509,8,0.019078,68,3778805,-1,4000.0,3858208,3879717,82660,21509,22,7,True,True,2200.478044444444,-0.018745870724318454
4738,3775801,117,16,0.86741,68,3778805,-1,8000.0,3779917,3780034,4116,117,55,1,True,True,24.00257777777778,-0.8259640572151475
4739,3775807,8667,128,0.649411,68,3778805,-1,64000.0,3782182,3790849,6375,8667,47,0,True,True,18134.940088888892,-0.593482206910197
4740,3775814,295,1,0.231169,68,3778805,-1,500.0,3823417,3823712,47603,295,27,7,True,True,6.247854166666667,-0.231169
4741,3775877,598,8,0.380701,68,3778805,-1,4000.0,3812100,3812698,36223,598,35,0,True,True,93.78573333333333,-0.3622706288220674
4742,3775944,10,16,0.976612,68,3778805,-1,8000.0,3779917,3779927,3973,10,57,0,True,True,2.0093333333333336,-0.976612
4743,3780875,22841,128,0.099604,59,3781017,-1,64000.0,3865808,3888649,84933,22841,21,8,True,True,36309.348266666675,-0.09772182596615785
4744,3780907,14592,1,0.315456,59,3781017,-1,500.0,3956322,3970914,175415,14592,11,7,True,True,148.75236666666666,-0.27264713943161356
4745,3780940,7,32,0.866773,59,3781017,-1,16000.0,3807738,3807745,26798,7,38,1,True,True,4.290533333333333,-0.866773
4746,3780982,152,8,0.531561,59,3781017,-1,4000.0,3808879,3809031,27897,152,38,1,True,True,25.05128888888889,-0.531561
4747,3781726,10507,128,0.186417,59,3782157,-1,64000.0,3854908,3865415,73182,10507,26,9,True,True,18324.05688888889,-0.18397832487427068
4748,3781779,44,1,0.500651,59,3782157,-1,500.0,3799885,3799929,18106,44,44,0,True,True,0.9704444444444446,-0.500651
4749,3782028,63,7,0.457986,59,3782157,-1,3500.0,3825617,3825680,43589,63,30,7,True,True,9.340012500000002,-0.457986
4750,3782175,100,16,0.92635,58,3782182,-1,8000.0,3790849,3790949,8674,100,50,0,True,True,30.38222222222222,-0.92635
4751,3782239,4,45,0.021488,59,3782527,-1,22500.0,3807588,3807592,25349,4,43,0,True,True,3.44775,-0.021488
4752,3782343,24,4,0.247392,59,3782527,-1,2000.0,3799885,3799909,17542,24,49,4,True,True,2.1173333333333337,-0.247392
4753,3782371,14628,1,0.529415,59,3782527,-1,500.0,3931238,3945866,148867,14628,14,7,True,True,194.7841388888889,-0.5132127611190523
4754,3782770,17,1,0.33357,60,3784727,-1,500.0,3816500,3816517,33730,17,37,7,True,True,0.32894999999999996,-0.33357
4755,3782813,3755,4,0.3934,60,3784727,-1,2000.0,3825680,3829435,42867,3755,31,0,True,True,324.23013888888886,-0.3906996458508874
4756,3782901,7,4,0.157005,60,3784727,-1,2000.0,3829280,3829287,46379,7,31,0,True,True,0.6092722222222221,-0.157005
4757,3784680,5380,32,0.34678,60,3784727,-1,16000.0,3799888,3805268,15208,5380,50,1,True,True,3686.131022222222,-0.3412973305350355
4758,3784760,79,2,0.351913,66,3790849,-1,1000.0,3799885,3799964,15125,79,53,0,True,True,3.484777777777778,-0.351913
4759,3786043,6140,12,0.625231,66,3790849,-1,6000.0,3807588,3813728,21545,6140,48,7,True,True,1464.9678,-0.6214845325324552
4760,3786103,4836,2,0.236205,66,3790849,-1,1000.0,3893934,3898770,107831,4836,19,7,True,True,161.87728333333334,-0.23589763912332917
4761,3786136,12503,32,0.978244,66,3790849,-1,16000.0,3809031,3821534,22895,12503,45,1,True,True,7834.462533333333,-0.9667967525054585
4762,3786949,7853,25,0.501251,66,3790849,-1,12500.0,3799885,3807738,12936,7853,57,0,True,True,4064.213819444444,-0.4849367956857525
4763,3787888,41,1,0.811893,66,3790849,-1,500.0,3808838,3808879,20950,41,47,6,True,True,0.8446569444444445,-0.811893
4764,3787929,5991,4,0.625792,66,3790849,-1,2000.0,3812100,3818091,24171,5991,45,2,True,True,454.40506666666664,-0.5903035963780598
4765,3788206,36,16,0.878677,66,3790849,-1,8000.0,3790849,3790885,2643,36,64,0,True,True,10.9376,-0.878677
4766,3793189,15235,1,0.890402,72,3796285,-1,500.0,3860408,3875643,67219,15235,25,0,True,True,194.02210277777777,-0.8799343737134141
4767,3793296,24,32,0.814859,72,3796285,-1,16000.0,3803188,3803212,9892,24,54,7,True,True,16.241066666666665,-0.814859
4768,3793755,43,8,0.029466,72,3796285,-1,4000.0,3832660,3832703,38905,43,32,6,True,True,6.208722222222222,-0.029466
4769,3794963,722,4,0.554939,72,3796285,-1,2000.0,3821217,3821939,26254,722,38,6,True,True,57.94049999999999,-0.554939
4770,3795019,219,1,0.280194,72,3796285,-1,500.0,3871208,3871427,76189,219,24,8,True,True,2.71195,-0.280194
4771,3795036,1550,1,0.151708,72,3796285,-1,500.0,3883123,3884673,88087,1550,22,6,True,True,19.062684722222222,-0.14865142065872558
4772,3795334,47,8,0.897175,72,3796285,-1,4000.0,3799885,3799932,4551,47,62,0,True,True,8.29288888888889,-0.897175
4773,3795560,19937,23,0.656932,72,3796285,-1,11500.0,3902403,3922340,106843,19937,17,6,True,True,5758.068176388889,-0.6537150388888349
4774,3795585,72,64,0.087795,72,3796285,-1,32000.0,3844108,3844180,48523,72,33,8,True,True,75.232,-0.087795
4775,3795959,6636,4,0.382207,72,3796285,-1,2000.0,3805388,3812024,9429,6636,60,0,True,True,527.0915777777777,-0.3806351688382395
4776,3796892,6712,4,0.960606,80,3799885,-1,2000.0,3805388,3812100,8496,6712,61,7,True,True,533.3543999999999,-0.9574883018661247
4777,3797073,6565,5,0.612448,80,3799885,-1,2500.0,3829280,3835845,32207,6565,39,1,True,True,609.6531944444444,-0.5663759391126485
4778,3797479,5880,31,0.625525,80,3799885,-1,15500.0,3825680,3831560,28201,5880,41,1,True,True,3812.7537222222218,-0.607585523630202
4779,3797575,40203,16,0.227428,80,3799885,-1,8000.0,4079018,4119221,281443,40203,3,6,True,True,13987.836644444447,-0.22442081016588927
4780,3798522,3,3,0.240361,80,3799885,-1,1500.0,3889534,3889537,91012,3,23,6,True,True,0.11625,-0.240361
4781,3798552,43,1,0.152749,80,3799885,-1,500.0,3820117,3820160,21565,43,50,2,True,True,0.8626874999999999,-0.152749
4782,3799182,12567,128,0.970537,80,3799885,-1,64000.0,3970914,3983481,171732,12567,12,8,True,True,20899.44053333333,-0.9609805694837232
4783,3799324,9878,1,0.909735,80,3799885,-1,500.0,3831560,3841438,32236,9878,40,1,True,True,173.82429166666665,-0.9040665775569493
4784,3799843,8419,64,0.329285,80,3799885,-1,32000.0,3937465,3945884,137622,8419,16,7,True,True,7755.529600000001,-0.32853749092468704
3774,2907987,14250,1,0.700882,1,2907987,-1,500.0,2910187,2924437,2200,14250,0,7,True,True,203.97764305555557,-0.6368207059455232
3775,2908151,9396,2,0.072589,1,2910187,-1,1000.0,2911601,2920683,3450,9396,0,6,True,True,292.3559722222222,-0.06683915611033928
3776,2911601,7,16,0.928048,1,2911601,-1,8000.0,2911671,2911608,70,7,0,0,True,True,1.9705777777777778,-0.928048
3777,2911671,19274,1,0.106136,1,2911671,-1,500.0,2913871,2933145,2200,19274,0,7,True,True,242.58584861111112,-0.09975972288922412
3778,2911700,18,20,0.786892,2,2913871,-1,10000.0,2917471,2917489,5771,18,0,1,True,True,5.6195,-0.7868919999999999
3779,2911760,8450,1,0.301351,2,2913871,-1,500.0,3033645,3042095,121885,8450,0,7,True,True,68.91529166666666,-0.27052395657049294
3780,2914905,17422,33,0.086505,8,2917471,-1,16500.0,2987501,3004923,72596,17422,1,11,True,True,5127.180391666667,-0.08556487957585832
3781,2915106,14,1,0.765274,8,2917471,-1,500.0,2918571,2918585,3465,14,2,6,True,True,0.2185361111111111,-0.765274
3782,2915277,18716,128,0.437676,8,2917471,-1,64000.0,3010713,3029429,95436,18716,1,1,True,True,16827.65351111111,-0.4084740855281225
3783,2915536,5,8,0.395113,8,2917471,-1,4000.0,2935501,2935506,19965,5,3,1,True,True,0.3877777777777778,-0.395113
3784,2916128,12127,2,0.660723,8,2917471,-1,1000.0,3031445,3043572,115317,12127,1,8,True,True,193.79088611111112,-0.6310546206690882
3785,2916370,2,16,0.473988,8,2917471,-1,8000.0,2922171,2922173,5801,2,5,4,True,True,0.26639999999999997,-0.473988
3786,2916683,5,1,0.533468,8,2917471,-1,500.0,2937701,2937706,21018,5,4,7,True,True,0.04096527777777778,-0.533468
3787,2921047,3,1,0.136381,11,2922171,-1,500.0,2991901,2991904,70854,3,3,7,True,True,0.028212499999999998,-0.136381
3788,2921059,7959,32,0.390993,11,2922171,-1,16000.0,2942101,2950060,21042,7959,5,7,True,True,2068.970088888889,-0.38139660241063
3789,2921234,330,8,0.797485,11,2922171,-1,4000.0,2935171,2935501,13937,330,8,9,True,True,25.59333333333333,-0.797485
3790,2921365,13007,16,0.545724,11,2922171,-1,8000.0,2998501,3011508,77136,13007,3,7,True,True,1789.334488888889,-0.5216555464569926
3791,2921446,78,16,0.960134,11,2922171,-1,8000.0,2924371,2924449,2925,78,10,7,True,True,14.7108,-0.960134
3792,2922343,10,16,0.144076,12,2924371,-1,8000.0,2944301,2944311,21958,10,6,7,True,True,1.4340000000000002,-0.144076
3793,2922366,529,2,0.677289,12,2924371,-1,1000.0,2939901,2940430,17535,529,8,7,True,True,8.668252777777777,-0.677289
3794,2928592,5647,2,0.914169,12,2935171,-1,1000.0,2939901,2945548,11309,5647,8,0,True,True,97.6942138888889,-0.910644071541302
3795,2944405,473,1,0.795017,28,2987501,-1,500.0,2994101,2994574,49696,473,4,7,True,True,4.448170833333333,-0.795017
3796,2961339,17,8,0.729325,28,2987501,-1,4000.0,2988601,2988618,27262,17,6,0,True,True,1.0783666666666667,-0.729325
3797,2961560,20,32,0.373131,28,2987501,-1,16000.0,2998501,2998521,36941,20,3,0,True,True,5.905777777777778,-0.373131
3798,2961635,16139,4,0.949465,28,2987501,-1,2000.0,3015113,3031252,53478,16139,2,7,True,True,438.0413722222222,-0.8758745378405247
3799,2962058,6,2,0.553524,28,2987501,-1,1000.0,2994101,2994107,32043,6,6,0,True,True,0.11284999999999999,-0.553524
3800,2962145,51,11,0.55507,28,2987501,-1,5500.0,2989701,2989752,27556,51,9,0,True,True,4.4482625,-0.55507
3801,2962163,751,16,0.123235,28,2987501,-1,8000.0,2995201,2995952,33038,751,6,6,True,True,110.88097777777777,-0.123235
3802,2963700,1749,1,0.00503,28,2987501,-1,500.0,3009301,3011050,45601,1749,4,9,True,True,14.723511111111112,-0.00494766591156369
3803,2964106,1,8,0.596655,28,2987501,-1,4000.0,2996301,2996302,32195,1,7,0,True,True,0.07382222222222222,-0.596655
3804,2964339,17,3,0.537152,28,2987501,-1,1500.0,2995201,2995218,30862,17,8,0,True,True,0.4706166666666667,-0.537152
3805,2964729,13132,56,0.946979,28,2987501,-1,28000.0,3012913,3026045,48184,13132,3,7,True,True,5019.2387,-0.8537738352916012
3806,2964774,9175,20,0.304691,28,2987501,-1,10000.0,3018713,3027888,53939,9175,2,4,True,True,1104.0809722222223,-0.2525753540831324
3807,2964873,338,32,0.748297,28,2987501,-1,16000.0,2988601,2988939,23728,338,17,6,True,True,85.76186666666666,-0.748297
3808,2965028,10775,16,0.903546,28,2987501,-1,8000.0,2989701,3000476,24673,10775,16,6,True,True,1566.3019333333332,-0.8783736385071341
3809,2966203,5734,7,0.343852,28,2987501,-1,3500.0,3026045,3031779,59842,5734,2,1,True,True,290.5096833333333,-0.32405402201525074
3810,2966671,7,4,0.412654,28,2987501,-1,2000.0,2996301,2996308,29630,7,10,0,True,True,0.25837777777777776,-0.412654
3811,2969763,1412,32,0.645932,28,2987501,-1,16000.0,3009301,3010713,39538,1412,7,0,True,True,378.85928888888884,-0.6328355493838226
3812,2970284,1812,19,0.512553,28,2987501,-1,9500.0,2989701,2991513,19417,1812,18,0,True,True,272.98535,-0.512553
3813,2970596,7173,2,0.160954,28,2987501,-1,1000.0,3025913,3033086,55317,7173,3,5,True,True,101.95483055555555,-0.15271355871549572
3814,2971170,3,32,0.220788,28,2987501,-1,16000.0,2996301,2996304,25131,3,14,6,True,True,0.8858666666666667,-0.220788
3815,2971241,3,1,0.834748,28,2987501,-1,500.0,2989701,2989704,18460,3,22,0,True,True,0.023787500000000003,-0.834748
3816,2971336,7275,2,0.194326,28,2987501,-1,1000.0,3010401,3017676,39065,7275,8,6,True,True,118.48851666666667,-0.189663936764134
3817,2972083,34,46,0.181358,28,2987501,-1,23000.0,3022313,3022347,50230,34,4,4,True,True,10.029150000000001,-0.181358
3818,3033384,13,4,0.79966,1,3033645,-1,2000.0,3036042,3035858,2658,13,0,7,True,True,0.34702777777777777,-0.79966
3819,3036042,28,16,0.852251,1,3036042,-1,8000.0,3038242,3038270,2200,28,0,7,True,True,2.9897777777777774,-0.852251
3820,3036207,8369,2,0.851388,1,3038242,-1,1000.0,3040442,3048811,4235,8369,0,7,True,True,138.71164444444446,-0.7748663617041032
3821,3038912,116,8,0.93237,2,3040442,-1,4000.0,3044842,3044958,5930,116,0,7,True,True,8.2708,-0.93237
3822,3038993,36,4,0.994313,2,3040442,-1,2000.0,3042642,3042678,3649,36,1,7,True,True,1.2834,-0.994313
3823,3040549,21,16,0.461265,4,3042642,-1,8000.0,3045942,3045963,5393,21,0,6,True,True,2.2577333333333334,-0.461265
3824,3041375,20,8,0.549665,4,3042642,-1,4000.0,3048142,3048162,6767,20,0,7,True,True,1.0751111111111111,-0.549665
3825,3041510,8394,32,0.290653,4,3042642,-1,16000.0,3044842,3053236,3332,8394,2,0,True,True,1845.1064,-0.242890002671212
3826,3042985,748,1,0.067363,4,3044842,-1,500.0,3060836,3061584,17851,748,0,7,True,True,7.899711111111112,-0.067363
3827,3044963,18059,128,0.098202,7,3045942,-1,64000.0,3076161,3087895,31198,18059,0,2,True,True,54102.63235555556,-0.09495554794936265
3828,3045113,16,128,0.725589,7,3045942,-1,64000.0,3049544,3049560,4431,16,2,6,True,True,13.206755555555555,-0.725589
3829,3045224,60,4,0.48719,7,3045942,-1,2000.0,3048444,3048504,3220,60,3,0,True,True,1.6126666666666667,-0.48719
3830,3045578,8846,9,0.330851,7,3045942,-1,4500.0,3051744,3060590,6166,8846,2,7,True,True,761.1821,-0.298079762423178
3831,3045763,297,1,0.128215,7,3045942,-1,500.0,3048147,3048444,2384,297,5,1,True,True,1.9956750000000003,-0.128215
3832,3046090,5,1,0.655473,12,3048142,-1,500.0,3048142,3048147,2052,5,6,0,True,True,0.03359722222222222,-0.655473
3833,3046231,21291,1,0.100045,12,3048142,-1,500.0,3058636,3079927,12405,21291,2,8,True,True,301.1754208333333,-0.09047024344439848
3834,3046353,13320,1,0.619516,12,3048142,-1,500.0,3066236,3079556,19883,13320,1,8,True,True,214.01961666666668,-0.541622215935795
3835,3046421,243,16,0.900119,12,3048142,-1,8000.0,3048142,3048385,1721,243,9,0,True,True,26.125200000000003,-0.900119
3836,3046471,28,8,0.317786,12,3048142,-1,4000.0,3048444,3048472,1973,28,7,0,True,True,1.5051555555555556,-0.317786
3837,3046776,105,2,0.450646,12,3048142,-1,1000.0,3048444,3048549,1668,105,8,3,True,True,1.4110833333333335,-0.450646
3838,3051388,6907,40,0.616342,5,3051744,-1,20000.0,3053236,3060143,1848,6907,4,1,True,True,2781.853555555556,-0.552584776621181
3839,3076161,6213,28,0.305675,1,3076161,-1,14000.0,3077261,3083474,1100,6213,0,6,True,True,4211.920883333333,-0.3017588412863519
3840,3076310,9327,256,0.58417,4,3077261,-1,128000.0,3312923,3322250,236613,9327,0,5,True,True,20239.01511111111,-0.5593110237237898
3841,3076349,116,1,0.565552,4,3077261,-1,500.0,3079461,3079577,3112,116,1,7,True,True,2.8453833333333334,-0.565552
3842,3076398,1137,16,0.364493,4,3077261,-1,8000.0,3096990,3098127,20592,1137,1,9,True,True,363.94106666666664,-0.364493
3843,3076422,11420,11,0.316333,4,3077261,-1,5500.0,3113490,3124910,37068,11420,1,7,True,True,2491.9477916666665,-0.24981704318984851
3844,3078387,151,1,0.428307,16,3079461,-1,500.0,3100290,3100441,21903,151,2,7,True,True,3.0743180555555556,-0.428307
3845,3078425,648,2,0.004832,16,3079461,-1,1000.0,3100290,3100938,21865,648,2,0,True,True,26.3862,-0.004832
3846,3078695,7,16,0.246175,16,3079461,-1,8000.0,3100290,3100297,21595,7,2,0,True,True,2.280288888888889,-0.246175
3847,3078713,5,32,0.221526,16,3079461,-1,16000.0,3079556,3079561,843,5,6,1,True,True,3.924666666666667,-0.221526
3848,3078777,9,1,0.739816,16,3079461,-1,500.0,3083990,3083999,5213,9,6,0,True,True,0.2206875,-0.739816
3849,3078809,68,32,0.436124,16,3079461,-1,16000.0,3086190,3086258,7381,68,6,6,True,True,52.91911111111111,-0.436124
3850,3078843,30,1,0.84011,16,3079461,-1,500.0,3081756,3081786,2913,30,8,7,True,True,0.7356250000000001,-0.84011
3851,3078987,14413,2,0.134306,16,3079461,-1,1000.0,3115690,3130103,36703,14413,1,7,True,True,640.0522638888889,-0.1188966291688863
3852,3079000,49,1,0.732973,16,3079461,-1,500.0,3083956,3084005,4956,49,9,0,True,True,1.2015208333333334,-0.732973
3853,3079028,18,2,0.877886,16,3079461,-1,1000.0,3083956,3083974,4928,18,10,7,True,True,0.88275,-0.877886
3854,3079202,45,8,0.462848,16,3079461,-1,4000.0,3104690,3104735,25488,45,3,7,True,True,8.339,-0.462848
3855,3079221,11740,130,0.358742,16,3079461,-1,65000.0,3117890,3129630,38669,11740,1,7,True,True,34108.79875,-0.3104032137191253
3856,3079456,9793,128,0.305472,16,3079461,-1,64000.0,3191962,3201755,112506,9793,1,7,True,True,13995.64408888889,-0.28837217137875276
3857,3079657,6,2,0.551672,19,3081756,-1,1000.0,3102490,3102496,22833,6,6,7,True,True,0.24431666666666668,-0.551672
3858,3079762,52,32,0.17577,19,3081756,-1,16000.0,3083990,3084042,4228,52,13,1,True,True,40.80266666666667,-0.17577
3859,3079785,16,1,0.606628,19,3081756,-1,500.0,3083974,3083990,4189,16,14,1,True,True,0.39233333333333337,-0.606628
3860,3079804,24,32,0.841793,19,3081756,-1,16000.0,3085090,3085114,5286,24,12,6,True,True,18.832,-0.841793
3861,3079891,14948,1,0.858714,19,3081756,-1,500.0,3109090,3124038,29199,14948,5,7,True,True,326.56256666666667,-0.7807118068329488
3862,3084371,19121,4,0.140002,15,3085090,-1,2000.0,3361501,3380622,277130,19121,0,8,True,True,1450.3127000000002,-0.12557667563286223
3863,3084438,7516,16,0.538618,15,3085090,-1,8000.0,3106890,3114406,22452,7516,7,7,True,True,3209.3889777777777,-0.5371244761988069
3864,3085236,6,1,0.263235,16,3086190,-1,500.0,3111290,3111296,26054,6,6,7,True,True,0.16753333333333334,-0.263235
3865,3085260,127,1,0.886336,16,3086190,-1,500.0,3098090,3098217,12830,127,14,6,True,True,2.5407055555555553,-0.886336
3866,3115127,186,2,0.076462,5,3115690,-1,1000.0,3124038,3124224,8911,186,3,0,True,True,8.706349999999999,-0.076462
3867,3116699,37,1,0.0754,10,3117890,-1,500.0,3126238,3126275,9539,37,3,7,True,True,0.9217625,-0.0754
3868,3117087,32,1,0.01863,10,3117890,-1,500.0,3124038,3124070,6951,32,5,0,True,True,0.7489333333333333,-0.01863
3869,3117246,44,1,0.507178,10,3117890,-1,500.0,3124038,3124082,6792,44,6,0,True,True,1.0297833333333333,-0.507178
3870,3117543,16767,8,0.031194,10,3117890,-1,4000.0,3322250,3339017,204707,16767,1,7,True,True,1124.814311111111,-0.026116604926429424
3871,3117657,16541,16,0.58189,10,3117890,-1,8000.0,3121490,3138031,3833,16541,8,2,True,True,5919.284377777777,-0.5676446836036341
3872,3117832,9,4,0.405134,10,3117890,-1,2000.0,3124038,3124047,6206,9,8,1,True,True,0.84255,-0.405134
3873,3117984,70,2,0.590036,14,3121490,-1,1000.0,3124038,3124108,6054,70,7,0,True,True,3.2765833333333334,-0.590036
3874,3119439,12175,8,0.906304,14,3121490,-1,4000.0,3123690,3135865,4251,12175,10,7,True,True,2242.6357222222223,-0.810347122177811
3875,3119671,13017,256,0.551594,14,3121490,-1,128000.0,3400269,3413286,280598,13017,0,7,True,True,23506.9152,-0.544021327867259
3876,3121027,22596,101,0.543469,14,3121490,-1,50500.0,3269230,3291826,148203,22596,4,7,True,True,32262.244272222226,-0.5424547936876501
3877,3121239,24557,16,0.998728,14,3121490,-1,8000.0,3222916,3247473,101677,24557,5,0,True,True,6754.814933333332,-0.97700736527361
3878,3121554,144,1,0.472104,14,3123690,-1,500.0,3124038,3124182,2484,144,10,0,True,True,3.3702,-0.472104
3879,3124725,9503,1,0.775197,14,3126238,-1,500.0,3157079,3166582,32354,9503,7,7,True,True,180.48116805555554,-0.7253065487263514
3880,3124877,70,16,0.365819,14,3126238,-1,8000.0,3131738,3131808,6861,70,8,6,True,True,35.894444444444446,-0.365819
3881,3125037,15,1,0.223307,14,3126238,-1,500.0,3133938,3133953,8901,15,8,7,True,True,0.1859375,-0.223307
3882,3125139,15384,4,0.772145,14,3126238,-1,2000.0,3159470,3174854,34331,15384,7,7,True,True,924.6549555555556,-0.7036430985626942
3883,3125742,295,4,0.733227,14,3126238,-1,2000.0,3128438,3128733,2696,295,11,7,True,True,37.81736111111111,-0.733227
3884,3125821,5,32,0.290999,14,3126238,-1,16000.0,3130638,3130643,4817,5,11,7,True,True,5.127777777777778,-0.290999
3885,3126121,9,1,0.464701,14,3126238,-1,500.0,3133938,3133947,7817,9,9,0,True,True,0.11156250000000001,-0.464701
3886,3127312,16009,4,0.510412,17,3128438,-1,2000.0,3324450,3340459,197138,16009,2,7,True,True,540.4965333333332,-0.4726984259260111
3887,3127546,188,2,0.396785,17,3128438,-1,1000.0,3141479,3141667,13933,188,10,8,True,True,8.280877777777778,-0.396785
3888,3128217,30,4,0.502167,17,3128438,-1,2000.0,3136079,3136109,7862,30,11,2,True,True,2.112833333333333,-0.502167
3889,3128359,23189,256,0.662678,17,3128438,-1,128000.0,3417727,3440916,289368,23189,0,6,True,True,85152.44586666668,-0.644039248384243
3890,3128551,4,32,0.847982,21,3130638,-1,16000.0,3144779,3144783,16228,4,11,6,True,True,2.836088888888889,-0.847982
3891,3128842,15010,1,0.80654,21,3130638,-1,500.0,3222916,3237926,94074,15010,8,0,True,True,281.3044972222222,-0.7959686678888451
3892,3129140,11442,1,0.614036,21,3130638,-1,500.0,3185062,3196504,55922,11442,10,7,True,True,117.7350388888889,-0.6125835920499765
3893,3129548,51,3,0.165844,21,3130638,-1,1500.0,3143679,3143730,14131,51,14,0,True,True,3.3900124999999997,-0.165844
3894,3130495,1041,8,0.514137,21,3130638,-1,4000.0,3135038,3136079,4543,1041,17,6,True,True,123.20147777777778,-0.43198639152187157
3895,3130726,102,2,0.44622,21,3131738,-1,1000.0,3166370,3166472,35644,102,11,2,True,True,3.1934499999999995,-0.44622
3896,3133786,7064,16,0.179145,21,3133938,-1,8000.0,3181762,3188826,47976,7064,11,7,True,True,1120.4273333333333,-0.17693485271865686
3897,3138149,8107,8,0.948712,20,3141479,-1,4000.0,3145879,3153986,7730,8107,15,6,True,True,1387.1129666666668,-0.9274123807179252
3898,3138585,45,4,0.659413,20,3141479,-1,2000.0,3141479,3141524,2894,45,18,0,True,True,3.96425,-0.659413
3899,3141174,50,1,0.967736,20,3141479,-1,500.0,3143679,3143729,2505,50,18,7,True,True,1.1078472222222222,-0.967736
3900,3141629,7049,1,0.73592,31,3143679,-1,500.0,3195562,3202611,53933,7049,9,0,True,True,82.9297,-0.7053202211511652
3901,3141729,9477,2,0.483503,31,3143679,-1,1000.0,3175962,3185439,34233,9477,13,6,True,True,184.60096666666664,-0.4832052300445096
3902,3141837,630,1,0.358796,31,3143679,-1,500.0,3172220,3172850,30383,630,14,2,True,True,6.718249999999999,-0.358796
3903,3141844,9584,128,0.218819,31,3143679,-1,64000.0,3202004,3211588,60160,9584,9,7,True,True,13467.672888888888,-0.1865322155992039
3904,3141861,17134,3,0.487642,31,3143679,-1,1500.0,3291826,3308960,149965,17134,6,0,True,True,416.69822500000004,-0.46262587392358717
3905,3141872,22292,32,0.062861,31,3143679,-1,16000.0,3207804,3230096,65932,22292,10,4,True,True,11544.703644444446,-0.05971321176245559
3906,3142446,49,71,0.369435,31,3143679,-1,35500.0,3168620,3168669,26174,49,18,1,True,True,41.54505833333334,-0.369435
3907,3142634,5,1,0.042808,31,3143679,-1,500.0,3173320,3173325,30686,5,17,0,True,True,0.05331944444444445,-0.042808
3908,3142888,15142,1,0.206774,31,3143679,-1,500.0,3225116,3240258,82228,15142,8,0,True,True,282.561825,-0.203250507245693
3909,3143000,19,21,0.907726,31,3143679,-1,10500.0,3143679,3143698,679,19,26,0,True,True,8.840620833333334,-0.907726
3910,3143277,10,1,0.361251,31,3143679,-1,500.0,3182862,3182872,39585,10,16,6,True,True,0.09702777777777778,-0.361251
3911,3143287,19,2,0.469674,31,3143679,-1,1000.0,3145879,3145898,2592,19,25,0,True,True,0.841963888888889,-0.469674
3912,3143655,266,16,0.454643,31,3143679,-1,8000.0,3145879,3146145,2224,266,26,0,True,True,94.29995555555556,-0.454643
3913,3143818,18,119,0.046437,29,3144779,-1,59500.0,3211588,3211606,67770,18,11,6,True,True,29.562575,-0.046437
3914,3145238,13,8,0.98059,35,3145879,-1,4000.0,3145879,3145892,641,13,28,0,True,True,2.304322222222222,-0.98059
3915,3145257,67,1,0.324071,35,3145879,-1,500.0,3179562,3179629,34305,67,19,2,True,True,0.6619041666666665,-0.324071
3916,3145276,11371,64,0.703736,35,3145879,-1,32000.0,3211606,3222977,66330,11371,11,0,True,True,11706.25377777778,-0.6407989939949253
3917,3145286,124,6,0.521373,35,3145879,-1,3000.0,3154879,3155003,9593,124,28,2,True,True,15.333633333333331,-0.521373
3918,3145601,23651,128,0.829647,35,3145879,-1,64000.0,3326650,3350301,181049,23651,3,6,True,True,33823.220799999996,-0.7752957779620846
3919,3145641,4022,1,0.834872,35,3145879,-1,500.0,3151279,3155301,5638,4022,30,8,True,True,83.5660375,-0.8311792558358291
3920,3145833,13,32,0.263316,35,3145879,-1,16000.0,3157270,3157283,11437,13,28,1,True,True,8.560355555555555,-0.263316
3921,3145957,16943,4,0.54435,33,3151279,-1,2000.0,3222916,3239859,76959,16943,10,0,True,True,1272.1152499999998,-0.5416495458791891
3922,3145988,5980,1,0.17385,33,3151279,-1,500.0,3199804,3205784,53816,5980,17,0,True,True,71.52294444444445,-0.16680025342350904
3923,3154183,25685,64,0.653675,34,3154879,-1,32000.0,3204204,3229889,50021,25685,16,7,True,True,25061.932622222226,-0.6153758764211668
3924,3154227,15680,1,0.365297,34,3154879,-1,500.0,3325550,3341230,171323,15680,4,6,True,True,133.2501388888889,-0.2847808147813908
3925,3154964,3,64,0.653337,51,3157079,-1,32000.0,3161670,3161673,6706,3,31,0,True,True,3.72,-0.653337
3926,3154982,17819,1,0.835469,51,3157079,-1,500.0,3204204,3222023,49222,17819,17,0,True,True,241.34142083333333,-0.7289030411566491
3927,3155084,46368,4,0.516663,51,3157079,-1,2000.0,3353901,3400269,198817,46368,3,1,True,True,2957.7517666666663,-0.493988617289546
3928,3155158,50,2,0.376329,51,3157079,-1,1000.0,3168570,3168620,13412,50,32,7,True,True,1.1941666666666666,-0.376329
3929,3155276,17218,16,0.907242,51,3157079,-1,8000.0,3182862,3200080,27586,17218,25,0,True,True,2863.9304,-0.9048066573495144
3930,3155303,8295,1,0.516372,51,3157079,-1,500.0,3199804,3208099,44501,8295,22,6,True,True,94.21570277777776,-0.4859990822002662
3931,3155323,13,6,0.352898,51,3157079,-1,3000.0,3174862,3174875,19539,13,31,0,True,True,0.8317833333333333,-0.352898
3932,3155807,14557,16,0.867719,51,3157079,-1,8000.0,3195562,3210119,39755,14557,24,1,True,True,2607.8030222222224,-0.8463205738014308
3933,3155869,18,4,0.486862,51,3157079,-1,2000.0,3173320,3173338,17451,18,34,6,True,True,0.7678,-0.486862
3934,3155965,191,8,0.48211,51,3157079,-1,4000.0,3157079,3157270,1114,191,42,0,True,True,31.473766666666663,-0.4818361365885636
3935,3156106,9,1,0.604211,51,3157079,-1,500.0,3161670,3161679,5564,9,40,7,True,True,0.174375,-0.604211
3936,3156253,9884,23,0.501837,51,3157079,-1,11500.0,3179562,3189446,23309,9884,30,0,True,True,2255.7936805555555,-0.5007685079600293
3937,3156525,23,32,0.138968,51,3157079,-1,16000.0,3162770,3162793,6245,23,40,6,True,True,14.260000000000002,-0.138968
3938,3156593,11878,64,0.165606,51,3157079,-1,32000.0,3174862,3186740,18269,11878,34,1,True,True,7437.067022222222,-0.15891797840622943
3939,3156607,13568,16,0.077088,51,3157079,-1,8000.0,3222916,3236484,66309,13568,15,0,True,True,4062.536,-0.07570049555722902
3940,3156819,25737,128,0.643477,51,3157079,-1,64000.0,3350301,3376038,193482,25737,4,8,True,True,68309.75839999999,-0.6234072281262507
3941,3156879,8983,2,0.211517,51,3157079,-1,1000.0,3215206,3224189,58327,8983,17,4,True,True,314.4340916666667,-0.1995406999371149
3942,3156951,13,8,0.186906,51,3157079,-1,4000.0,3172220,3172233,15269,13,40,0,True,True,1.1090444444444445,-0.186906
3943,3158636,83,3,0.362223,49,3159470,-1,1500.0,3182862,3182945,24226,83,30,0,True,True,2.4159916666666668,-0.362223
3944,3171252,8,7,0.717303,43,3172220,-1,3500.0,3174854,3174862,3602,8,39,2,True,True,0.5971777777777778,-0.717303
3945,3172221,502,64,0.11833,46,3173320,-1,32000.0,3195562,3196064,23341,502,27,0,True,True,342.0293333333334,-0.11833
3946,3172267,19,1,0.230346,46,3173320,-1,500.0,3188662,3188681,16395,19,30,4,True,True,0.1935888888888889,-0.230346
3947,3172413,40,8,0.811173,46,3173320,-1,4000.0,3174420,3174460,2007,40,42,6,True,True,3.4124444444444446,-0.811173
3948,3172710,24,128,0.720256,46,3173320,-1,64000.0,3233116,3233140,60406,24,12,6,True,True,57.480533333333334,-0.720256
3949,3172807,24672,16,0.481517,46,3173320,-1,8000.0,3329950,3354622,157143,24672,5,7,True,True,5303.017688888888,-0.4691787882077574
3950,3173805,31,1,0.478815,45,3174420,-1,500.0,3199804,3199835,25999,31,26,0,True,True,0.34745833333333337,-0.478815
3951,3174689,1629,2,0.210704,46,3174854,-1,1000.0,3189762,3191391,15073,1629,33,6,True,True,33.285900000000005,-0.210704
3952,3174838,26,4,0.161246,46,3174854,-1,2000.0,3198704,3198730,23866,26,29,7,True,True,1.1656666666666666,-0.161246
3953,3175208,2575,4,0.833365,46,3175962,-1,2000.0,3182862,3185437,7654,2575,39,0,True,True,99.93861111111111,-0.833365
3954,3175685,734,1,0.022446,46,3175962,-1,500.0,3196504,3197238,20819,734,30,2,True,True,8.060416666666667,-0.021991727864833926
3955,3175739,8,9,0.043144,46,3175962,-1,4500.0,3211606,3211614,35867,8,20,0,True,True,0.9937,-0.043144
3956,3213193,40,32,0.573487,25,3215206,-1,16000.0,3220716,3220756,7523,40,19,6,True,True,26.27555555555556,-0.573487
3957,3213292,7,32,0.161129,25,3215206,-1,16000.0,3217406,3217413,4114,7,20,7,True,True,2.8578666666666668,-0.161129
3958,3213707,12027,8,0.62954,25,3215206,-1,4000.0,3240867,3252894,27160,12027,13,1,True,True,1027.2757666666666,-0.5867385998314179
3959,3214079,7848,16,0.039191,25,3215206,-1,8000.0,3244169,3252017,30090,7848,13,0,True,True,1081.1459777777777,-0.038404526707742324
3960,3214664,8,4,0.572269,25,3215206,-1,2000.0,3219613,3219621,4949,8,22,7,True,True,0.656888888888889,-0.572269
3961,3215048,5,1,0.055912,25,3215206,-1,500.0,3246378,3246383,31330,5,13,0,True,True,0.04796527777777777,-0.055912
3962,3215258,6398,32,0.25826,34,3217406,-1,16000.0,3227316,3233714,12058,6398,17,7,True,True,3752.7121777777775,-0.2508764683926527
3963,3215295,3413,2,0.180038,34,3217406,-1,1000.0,3260017,3263430,44722,3413,13,7,True,True,101.42561111111112,-0.15984202706420292
3964,3215375,4547,22,0.958238,34,3217406,-1,11000.0,3219613,3224160,4238,4547,25,0,True,True,2002.0617222222222,-0.9446152145480671
3965,3215389,12527,8,0.599358,34,3217406,-1,4000.0,3287887,3300414,72498,12527,12,7,True,True,991.0588555555556,-0.5749264066068636
3966,3215507,23,8,0.563605,34,3217406,-1,4000.0,3222916,3222939,7409,23,25,7,True,True,3.5780333333333334,-0.563605
3967,3216620,813,1,0.01862,34,3217406,-1,500.0,3244169,3244982,27549,813,16,0,True,True,7.799154166666666,-0.01862
3968,3216752,5278,1,0.719547,34,3217406,-1,500.0,3222916,3228194,6164,5278,24,0,True,True,101.457,-0.7166086012537504
3969,3216902,6,8,0.661745,34,3217406,-1,4000.0,3217413,3217419,511,6,31,1,True,True,0.6124,-0.661745
3970,3216985,24,32,0.283455,34,3217406,-1,16000.0,3237546,3237570,20561,24,19,1,True,True,14.590933333333334,-0.283455
3971,3217098,6,1,0.085749,34,3217406,-1,500.0,3225116,3225122,8018,6,23,7,True,True,0.116675,-0.085749
3972,3218348,9722,16,0.449203,38,3219613,-1,8000.0,3290087,3299809,71739,9722,12,7,True,True,1477.6601555555555,-0.38893939076347234
3973,3218367,3,5,0.992776,38,3219613,-1,2500.0,3219613,3219616,1246,3,33,0,True,True,0.30791666666666667,-0.992776
3974,3218489,203,4,0.867302,38,3219613,-1,2000.0,3222916,3223119,4427,203,28,0,True,True,15.790016666666666,-0.867302
3975,3218788,14762,64,0.170567,38,3219613,-1,32000.0,3254217,3268979,35429,14762,16,7,True,True,13597.328622222221,-0.16900305773461785
3976,3218960,20,4,0.830364,38,3219613,-1,2000.0,3219616,3219636,656,20,34,1,True,True,1.6422222222222225,-0.830364
3977,3219242,5551,4,0.600839,38,3219613,-1,2000.0,3235316,3240867,16074,5551,22,7,True,True,417.0149611111111,-0.5971352475722866
3978,3223294,128,6,0.794616,27,3225116,-1,3000.0,3230916,3231044,7622,128,24,4,True,True,13.736533333333332,-0.794616
3979,3225540,754,2,0.820453,37,3227316,-1,1000.0,3232016,3232770,6476,754,24,6,True,True,26.972255555555556,-0.820453
3980,3226332,13412,1,0.181884,37,3227316,-1,500.0,3262217,3275629,35885,13412,15,7,True,True,170.86079305555555,-0.1807746204440131
3981,3226397,15893,32,0.659649,37,3227316,-1,16000.0,3252017,3267910,25620,15893,18,1,True,True,6884.851022222223,-0.6462673417729643
3982,3226436,332,2,0.264521,37,3227316,-1,1000.0,3270330,3270662,43894,332,14,6,True,True,8.282477777777778,-0.264521
3983,3226743,4441,256,0.724187,37,3227316,-1,128000.0,3413286,3417727,186543,4441,1,1,True,True,6606.1717333333345,-0.5333874951566454
3984,3226844,722,25,0.342671,37,3227316,-1,12500.0,3251878,3252600,25034,722,21,6,True,True,129.25805555555556,-0.342671
3985,3226926,8998,128,0.45347,37,3227316,-1,64000.0,3263430,3272428,36504,8998,17,1,True,True,14400.067200000001,-0.4336124620101387
3986,3227019,1061,1,0.590596,37,3227316,-1,500.0,3250778,3251839,23759,1061,23,7,True,True,7.6223833333333335,-0.5129130046884821
3987,3227040,6,1,0.229814,37,3227316,-1,500.0,3240867,3240873,13827,6,27,0,True,True,0.10779166666666667,-0.229814
3988,3227155,17147,13,0.385462,37,3227316,-1,6500.0,3273630,3290777,46475,17147,15,7,True,True,3276.031723611111,-0.3830320625525927
3989,3227187,12,1,0.10857,37,3227316,-1,500.0,3278030,3278042,50843,12,15,7,True,True,0.1774,-0.10857
3990,3227201,2,8,0.202349,37,3227316,-1,4000.0,3241967,3241969,14766,2,29,6,True,True,0.28744444444444445,-0.202349
3991,3227619,4377,16,0.859592,47,3230916,-1,8000.0,3232016,3236393,4397,4377,35,0,True,True,1300.0277333333333,-0.8595309084910207
3992,3227639,42,4,0.50436,47,3230916,-1,2000.0,3237529,3237571,9890,42,33,0,True,True,3.1917666666666666,-0.50436
3993,3227955,27,8,0.419795,47,3230916,-1,4000.0,3244178,3244205,16223,27,27,0,True,True,2.0721,-0.419795
3994,3228020,9,1,0.149561,47,3230916,-1,500.0,3257817,3257826,29797,9,22,2,True,True,0.14305,-0.149561
3995,3228272,12686,117,0.096299,47,3230916,-1,58500.0,3241969,3254655,13697,12686,31,1,True,True,14443.585812500001,-0.06910400049919017
3996,3228293,20,32,0.475869,47,3230916,-1,16000.0,3235329,3235349,7036,20,37,1,True,True,11.975111111111111,-0.475869
3997,3228695,243,1,0.614748,47,3230916,-1,500.0,3244169,3244412,15474,243,30,0,True,True,2.3311125,-0.614748
3998,3230542,15,32,0.039037,47,3230916,-1,16000.0,3247478,3247493,16936,15,27,6,True,True,3.970666666666667,-0.039037
3999,3230614,9,8,0.783868,47,3230916,-1,4000.0,3235329,3235338,4715,9,39,0,True,True,1.3472,-0.783868
4000,3230652,178,18,0.503329,47,3230916,-1,9000.0,3237544,3237722,6892,178,38,1,True,True,60.87155,-0.503329
4001,3230740,8,16,0.117516,47,3230916,-1,8000.0,3241969,3241977,11229,8,33,0,True,True,2.2995555555555556,-0.117516
4002,3230930,8191,8,0.482241,49,3232016,-1,4000.0,3254217,3262408,23287,8191,23,0,True,True,1035.793111111111,-0.4781364374277713
4003,3230950,15,4,0.130329,49,3232016,-1,2000.0,3237529,3237544,6579,15,42,7,True,True,1.1399166666666667,-0.130329
4004,3230965,13,16,0.603475,49,3232016,-1,8000.0,3235316,3235329,4351,13,45,0,True,True,3.891911111111111,-0.603475
4005,3232271,10541,85,0.827522,48,3233116,-1,42500.0,3283487,3294028,51216,10541,15,0,True,True,11401.083055555557,-0.8202528910593926
4006,3233206,180,32,0.896969,60,3235316,-1,16000.0,3239746,3239926,6540,180,40,0,True,True,109.432,-0.896969
4007,3233353,17432,1,0.77487,60,3235316,-1,500.0,3327750,3345182,94397,17432,7,6,True,True,169.90025277777778,-0.6721322390192105
4008,3233362,25,32,0.649232,60,3235316,-1,16000.0,3244178,3244203,10816,25,33,0,True,True,7.674444444444443,-0.649232
4009,3233466,312,1,0.522044,60,3235316,-1,500.0,3244178,3244490,10712,312,32,0,True,True,2.993033333333333,-0.522044
4010,3233513,5867,64,0.370377,60,3235316,-1,32000.0,3291826,3297693,58313,5867,14,0,True,True,3645.1367111111113,-0.3506468315732319
4011,3233675,21233,1,0.043438,60,3235316,-1,500.0,3356101,3377334,122426,21233,4,7,True,True,433.0854847222222,-0.04271004081630477
4012,3233900,15,16,0.529817,60,3235316,-1,8000.0,3235329,3235344,1429,15,51,0,True,True,4.490666666666667,-0.529817
4013,3233915,129,11,0.229486,60,3235316,-1,5500.0,3248578,3248707,14663,129,32,6,True,True,11.738283333333333,-0.229486
4014,3234031,323,1,0.8023,60,3235316,-1,500.0,3239746,3240069,5715,323,47,7,True,True,6.065251388888889,-0.7929781535141097
4015,3234059,24779,2,0.789556,60,3235316,-1,1000.0,3333550,3358329,99491,24779,7,2,True,True,770.4305916666667,-0.7783793840989975
4016,3234226,6230,8,0.381236,60,3235316,-1,4000.0,3285687,3291917,51461,6230,19,7,True,True,622.0325888888889,-0.34321010982757244
4017,3234243,12,4,0.589048,60,3235316,-1,2000.0,3246378,3246390,12135,12,37,7,True,True,0.46046666666666664,-0.589048
4018,3234606,47,1,0.741394,60,3235316,-1,500.0,3240846,3240893,6240,47,49,6,True,True,0.8443680555555556,-0.741394
4019,3237061,2,16,0.761539,61,3237529,-1,8000.0,3237544,3237546,483,2,53,0,True,True,0.6079555555555555,-0.761539
4020,3237080,18897,16,0.696708,61,3237529,-1,8000.0,3294026,3312923,56946,18897,15,7,True,True,2204.7591555555555,-0.6565219902491763
4021,3237244,9,32,0.097717,61,3237529,-1,16000.0,3244169,3244178,6925,9,45,7,True,True,2.7628,-0.097717
4022,3237380,132,16,0.133883,61,3237529,-1,8000.0,3263317,3263449,25937,132,27,6,True,True,27.951733333333337,-0.133883
4023,3237475,10306,32,0.477141,61,3237529,-1,16000.0,3241967,3252273,4492,10306,49,0,True,True,3334.4196888888887,-0.398054313358735
4024,3237506,11946,16,0.232513,61,3237529,-1,8000.0,3267030,3278976,29524,11946,26,3,True,True,2528.2432,-0.23013497317598716
4025,3237550,36,53,0.859053,61,3239746,-1,26500.0,3275830,3275866,38280,36,23,7,True,True,25.2174,-0.859053
4026,3237567,54,4,0.283267,61,3239746,-1,2000.0,3271430,3271484,33863,54,25,6,True,True,2.6943,-0.283267
4027,3237605,3,1,0.876766,61,3239746,-1,500.0,3244178,3244181,6573,3,46,1,True,True,0.028779166666666665,-0.876766
4028,3237639,57,1,0.408647,61,3239746,-1,500.0,3283430,3283487,45791,57,22,8,True,True,0.8559500000000001,-0.408647
4029,3237648,9,8,0.189021,61,3239746,-1,4000.0,3283487,3283496,45839,9,22,1,True,True,1.0812000000000002,-0.189021
9049,7067964,113,2,0.771941,1,7067964,-1,1000.0,7069064,7069177,1100,113,0,6,True,True,3.8344666666666667,-0.771941
9050,7067978,16,16,0.257944,2,7069064,-1,8000.0,7074464,7074480,6486,16,0,8,True,True,5.31591111111111,-0.257944
9051,7068000,5846,32,0.473261,2,7069064,-1,16000.0,7097464,7103310,29464,5846,0,6,True,True,2639.4950222222224,-0.46188326101833344
9052,7072488,40,16,0.256026,7,7074464,-1,8000.0,7085364,7085404,12876,40,1,7,True,True,11.918222222222223,-0.256026
9053,7072656,13729,98,0.876658,7,7074464,-1,49000.0,7110563,7124292,37907,13729,0,4,True,True,21799.407466666667,-0.8747062165736158
9054,7073592,28,4,0.650292,7,7074464,-1,2000.0,7079864,7079892,6272,28,3,8,True,True,2.292733333333333,-0.650292
9055,7073635,11342,32,0.140447,7,7074464,-1,16000.0,7099664,7111006,26029,11342,1,7,True,True,5004.2336,-0.14013876387477067
9056,7073725,13964,1,0.123966,7,7074464,-1,500.0,7359739,7373703,286014,13964,0,7,True,True,131.52892083333333,-0.12018457065999824
9057,7073777,19272,1,0.568733,7,7074464,-1,500.0,7308459,7327731,234682,19272,1,0,True,True,507.2253875,-0.5609049278978175
9058,7074702,11235,77,0.039593,14,7079864,-1,38500.0,7101864,7113099,27162,11235,3,0,True,True,11942.58065,-0.03955326251502744
9059,7074723,299,11,0.859003,14,7079864,-1,5500.0,7082064,7082363,7341,299,7,0,True,True,70.1059486111111,-0.859003
9060,7074773,12,1,0.400939,14,7079864,-1,500.0,7082064,7082076,7291,12,8,7,True,True,0.25578333333333336,-0.400939
9061,7074936,384,1,0.857001,14,7079864,-1,500.0,7087564,7087948,12628,384,6,7,True,True,7.1509333333333345,-0.857001
9062,7075408,4299,84,0.91714,14,7079864,-1,42000.0,7106264,7110563,30856,4299,3,7,True,True,4983.489933333333,-0.912660752945724
9063,7075631,4,32,0.128984,14,7079864,-1,16000.0,7101864,7101868,26233,4,5,7,True,True,1.7653333333333332,-0.128984
9064,7077889,9841,1,0.366732,14,7079864,-1,500.0,7101864,7111705,23975,9841,4,0,True,True,135.74508333333333,-0.36591960957535663
9065,7078039,10,3,0.844836,14,7079864,-1,1500.0,7083164,7083174,5125,10,11,6,True,True,0.6394583333333334,-0.844836
9066,7084626,842,32,0.952045,11,7085364,-1,16000.0,7091964,7092806,7338,842,9,7,True,True,333.5824,-0.9425307886624155
9067,7086232,13575,8,0.373683,13,7087564,-1,4000.0,7153800,7167375,67568,13575,2,0,True,True,1784.2958333333336,-0.37337940052387053
9068,7086472,105,1,0.682201,13,7087564,-1,500.0,7094164,7094269,7692,105,10,7,True,True,1.299375,-0.682201
9069,7086917,641,1,0.505942,13,7087564,-1,500.0,7089764,7090405,2847,641,12,7,True,True,8.016061111111112,-0.505942
9070,7089332,130,2,0.262827,13,7089764,-1,1000.0,7104064,7104194,14732,130,5,7,True,True,3.576805555555555,-0.262827
9071,7093090,2160,2,0.875536,12,7094164,-1,1000.0,7096364,7098524,3274,2160,11,7,True,True,64.24799999999999,-0.875536
9072,7106775,4,1,0.682556,9,7110563,-1,500.0,7116063,7116067,9288,4,3,7,True,True,0.06504444444444445,-0.682556
9073,7107032,28,1,0.620614,9,7110563,-1,500.0,7117167,7117195,10135,28,3,6,True,True,0.4553111111111111,-0.620614
9074,7107248,22,9,0.643867,9,7110563,-1,4500.0,7113863,7113885,6615,22,5,6,True,True,3.2197,-0.643867
9075,7107275,19759,32,0.741043,9,7110563,-1,16000.0,7112763,7132522,5488,19759,6,7,True,True,11201.901422222221,-0.716860196950589
9076,7109502,7380,8,0.244817,9,7110563,-1,4000.0,7192241,7199621,82739,7380,2,1,True,True,819.6259666666666,-0.23943255750966325
9077,7109724,215,1,0.821235,9,7110563,-1,500.0,7110563,7110778,839,215,8,0,True,True,2.9849166666666664,-0.821235
9078,7111029,2112,5,0.007943,13,7112763,-1,2500.0,7156000,7158112,44971,2112,3,0,True,True,171.95244444444447,-0.007911977289462167
9079,7112093,69,16,0.85306,13,7112763,-1,8000.0,7113863,7113932,1770,69,7,0,True,True,17.952266666666667,-0.85306
9080,7112485,34284,1,0.290661,13,7112763,-1,500.0,7407061,7441345,294576,34284,0,7,True,True,575.5517958333332,-0.2661964681135504
9081,7112504,34188,128,0.158206,13,7112763,-1,64000.0,7189474,7223662,76970,34188,4,7,True,True,66021.57297777777,-0.1542031422862235
9082,7112573,555,8,0.39928,13,7112763,-1,4000.0,7130705,7131260,18132,555,7,0,True,True,83.81116666666667,-0.39928
9083,7112578,194,2,0.072979,13,7112763,-1,1000.0,7172871,7173065,60293,194,5,0,True,True,6.616477777777778,-0.072979
9084,7113672,7824,128,0.388223,14,7113863,-1,64000.0,7140640,7148464,26968,7824,8,0,True,True,15508.269511111112,-0.37109633348200743
9085,7113827,11316,37,0.462279,14,7113863,-1,18500.0,7116067,7127383,2240,11316,11,1,True,True,7408.125919444445,-0.45519600628301915
9086,7114504,1157,32,0.093503,17,7116063,-1,16000.0,7119367,7120524,4863,1157,10,7,True,True,588.3730666666667,-0.093503
9087,7114587,17747,32,0.465878,17,7116063,-1,16000.0,7180571,7198318,65984,17747,5,6,True,True,7279.5921777777785,-0.44387352836239014
9088,7114913,86,1,0.642484,17,7116063,-1,500.0,7116067,7116153,1154,86,13,0,True,True,1.3984555555555556,-0.642484
9089,7114996,9,32,0.900127,17,7116063,-1,16000.0,7130696,7130705,15700,9,11,6,True,True,5.4364,-0.900127
9090,7115168,217,4,0.464853,17,7116063,-1,2000.0,7137333,7137550,22165,217,10,1,True,True,11.155005555555556,-0.464853
9091,7117993,60,4,0.085823,25,7119367,-1,2000.0,7158200,7158260,40207,60,7,6,True,True,3.8986666666666663,-0.085823
9092,7118079,105,1,0.731778,25,7119367,-1,500.0,7135111,7135216,17032,105,12,1,True,True,1.9565736111111112,-0.6931099909394383
9093,7118118,1402,1,0.91746,25,7119367,-1,500.0,7126267,7127669,8149,1402,15,0,True,True,27.28837222222222,-0.91746
9094,7118204,16,16,0.922491,25,7119367,-1,8000.0,7126267,7126283,8063,16,16,4,True,True,4.982755555555555,-0.922491
9095,7118234,9,4,0.768217,25,7119367,-1,2000.0,7130696,7130705,12462,9,14,0,True,True,0.67955,-0.768217
9096,7118410,13,8,0.199471,25,7119367,-1,4000.0,7153800,7153813,35390,13,10,1,True,True,1.7001111111111111,-0.199471
9097,7118430,11342,32,0.328721,25,7119367,-1,16000.0,7153791,7165133,35361,11342,11,0,True,True,5938.286088888889,-0.32630664740166626
9098,7118548,12493,143,0.317285,25,7119367,-1,71500.0,7226902,7239395,108354,12493,3,0,True,True,43930.64846805556,-0.31005833103752756
9099,7118583,6223,2,0.996438,25,7119367,-1,1000.0,7120467,7126690,1884,6223,21,6,True,True,232.77846111111114,-0.9783517499651054
9100,7119045,14,4,0.486295,25,7119367,-1,2000.0,7120467,7120481,1422,14,21,0,True,True,0.8899333333333334,-0.486295
9101,7119078,11505,64,0.702291,25,7119367,-1,32000.0,7140640,7152145,21562,11505,14,7,True,True,11914.938222222223,-0.685911825525283
9102,7119093,205,8,0.476219,25,7119367,-1,4000.0,7122667,7122872,3574,205,22,7,True,True,30.305833333333336,-0.476219
9103,7120629,13,3,0.278375,28,7122667,-1,1500.0,7127383,7127396,6754,13,20,0,True,True,0.7590916666666666,-0.278375
9104,7120844,9,8,0.038282,28,7122667,-1,4000.0,7156000,7156009,35156,9,9,0,True,True,1.177,-0.038282
9105,7120858,1,16,0.155741,28,7122667,-1,8000.0,7129596,7129597,8738,1,21,6,True,True,0.3020222222222222,-0.155741
9106,7120917,6726,4,0.469968,28,7122667,-1,2000.0,7191727,7198453,70810,6726,5,1,True,True,354.2010833333334,-0.42836523954688405
9107,7122370,25,7,0.640216,28,7122667,-1,3500.0,7127396,7127421,5026,25,23,2,True,True,3.406180555555555,-0.640216
9108,7122396,14,4,0.320187,28,7122667,-1,2000.0,7130705,7130719,8309,14,20,2,True,True,1.0570777777777778,-0.320187
9109,7123755,233,2,0.031323,46,7126267,-1,1000.0,7175071,7175304,51316,233,8,0,True,True,7.012005555555556,-0.031323
9110,7123774,21286,32,0.601077,46,7126267,-1,16000.0,7310659,7331945,186885,21286,2,7,True,True,16382.816355555557,-0.551287316050743
9111,7123901,75,32,0.380285,46,7126267,-1,16000.0,7127383,7127458,3482,75,28,0,True,True,46.713333333333324,-0.380285
9112,7123916,2,32,0.93646,46,7126267,-1,16000.0,7132905,7132907,8989,2,21,7,True,True,1.259111111111111,-0.93646
9113,7123947,113,16,0.361493,46,7126267,-1,8000.0,7135105,7135218,11158,113,21,0,True,True,33.605088888888886,-0.3415249464415907
9114,7124055,10574,32,0.43011,46,7126267,-1,16000.0,7135111,7145685,11056,10574,20,0,True,True,4612.490444444444,-0.3676894560296245
9115,7124427,388,39,0.47341,46,7126267,-1,19500.0,7130696,7131084,6269,388,27,0,True,True,285.63751666666667,-0.47341
9116,7124495,22,1,0.054078,46,7126267,-1,500.0,7127383,7127405,2888,22,33,1,True,True,0.42820555555555556,-0.054078
9117,7124616,44,5,0.868021,46,7126267,-1,2500.0,7128496,7128540,3880,44,30,6,True,True,4.152805555555556,-0.868021
9118,7124801,7,32,0.952645,46,7126267,-1,16000.0,7130696,7130703,5895,7,28,0,True,True,4.228311111111111,-0.952645
9119,7124812,19,1,0.683671,46,7126267,-1,500.0,7127396,7127415,2584,19,32,0,True,True,0.3698138888888889,-0.683671
9120,7124848,23,1,0.269848,46,7126267,-1,500.0,7127367,7127390,2519,23,37,6,True,True,0.44766944444444445,-0.269848
9121,7124867,5,66,0.635687,46,7126267,-1,33000.0,7182771,7182776,57904,5,8,7,True,True,4.818916666666667,-0.635687
9122,7125076,17378,8,0.083591,46,7126267,-1,4000.0,7342361,7359739,217285,17378,2,7,True,True,1436.7168,-0.07883563461963516
9123,7125353,8,1,0.069259,46,7126267,-1,500.0,7145075,7145083,19722,8,19,0,True,True,0.11811111111111111,-0.069259
9124,7125590,6757,1,0.405068,46,7126267,-1,500.0,7145040,7151797,19450,6757,20,0,True,True,117.8407263888889,-0.3964158007911285
9125,7125614,3678,1,0.298337,46,7126267,-1,500.0,7288359,7292037,162745,3678,5,6,True,True,43.42037083333333,-0.2829863027467979
9126,7125662,32562,128,0.712207,46,7126267,-1,64000.0,7337961,7370523,212299,32562,3,7,True,True,41297.880000000005,-0.6999061600997549
9127,7125680,178,8,0.871289,46,7126267,-1,4000.0,7127367,7127545,1687,178,43,0,True,True,27.716577777777776,-0.871289
9128,7126585,3522,8,0.524778,47,7127367,-1,4000.0,7140640,7144162,14055,3522,24,0,True,True,394.3784444444444,-0.4975178682972718
9129,7126867,11,56,0.669644,47,7127367,-1,28000.0,7138433,7138444,11566,11,26,6,True,True,7.916455555555556,-0.6696439999999999
9130,7126915,64,2,0.259447,47,7127367,-1,1000.0,7137311,7137375,10396,64,28,0,True,True,1.6449777777777779,-0.259447
9131,7131804,6,36,0.830549,40,7132905,-1,18000.0,7135105,7135111,3301,6,32,7,True,True,4.2495,-0.830549
9132,7131838,13,1,0.092441,40,7132905,-1,500.0,7189474,7189487,57636,13,10,0,True,True,0.13521805555555555,-0.092441
9133,7131896,178,6,0.901642,40,7132905,-1,3000.0,7132905,7133083,1009,178,34,0,True,True,21.011416666666666,-0.901642
9134,7132443,7,1,0.342019,40,7132905,-1,500.0,7138433,7138440,5990,7,27,0,True,True,0.08995972222222222,-0.342019
9135,7132562,60,1,0.753176,40,7132905,-1,500.0,7135111,7135171,2549,60,32,0,True,True,1.1804166666666667,-0.753176
9136,7132627,24738,7,0.164533,40,7132905,-1,3500.0,7304059,7328797,171432,24738,6,6,True,True,4435.235981944445,-0.16377045395908615
9137,7132730,6994,4,0.349276,40,7132905,-1,2000.0,7167071,7174065,34341,6994,17,0,True,True,493.5836722222222,-0.3488626385996625
9138,7132808,95,4,0.419101,40,7132905,-1,2000.0,7150483,7150578,17675,95,24,8,True,True,6.628361111111111,-0.419101
9139,7132911,5,4,0.475499,42,7135105,-1,2000.0,7136211,7136216,3300,5,34,6,True,True,0.2570277777777778,-0.475499
9140,7132920,5350,1,0.68883,42,7135105,-1,500.0,7145075,7150425,12155,5350,26,0,True,True,93.39211805555556,-0.6710238832356779
9141,7132949,22,18,0.160689,42,7135105,-1,9000.0,7137311,7137333,4362,22,35,6,True,True,5.08915,-0.16068899999999997
9142,7135100,719,1,0.69669,42,7135105,-1,500.0,7135111,7135830,11,719,37,0,True,True,9.84732638888889,-0.4850035717283928
9143,7135118,16046,32,0.354692,43,7136211,-1,16000.0,7273677,7289723,138559,16046,8,7,True,True,6425.767466666666,-0.3280564425076578
9144,7135521,26,64,0.692901,43,7136211,-1,32000.0,7187274,7187300,51753,26,14,7,True,True,21.567288888888886,-0.692901
9145,7135638,30,13,0.389138,43,7136211,-1,6500.0,7138440,7138470,2802,30,33,1,True,True,5.012041666666667,-0.389138
9146,7135868,11419,94,0.009932,43,7136211,-1,47000.0,7221921,7233340,86053,11419,10,6,True,True,26077.438613888888,-0.009502380242524238
9147,7135905,14386,8,0.783072,43,7136211,-1,4000.0,7225521,7239907,89616,14386,10,0,True,True,2820.8682,-0.7780589686489432
9148,7136048,8,6,0.597129,43,7136211,-1,3000.0,7151583,7151591,15535,8,28,6,True,True,0.8372666666666666,-0.597129
9149,7136179,18,32,0.077809,43,7136211,-1,16000.0,7159367,7159385,23188,18,22,0,True,True,9.3568,-0.077809
9150,7137518,161,8,0.667962,42,7138433,-1,4000.0,7145075,7145236,7557,161,33,1,True,True,19.015888888888888,-0.667962
9151,7137677,35,1,0.616512,42,7138433,-1,500.0,7145040,7145075,7363,35,35,7,True,True,0.5167361111111111,-0.616512
9152,7138185,323,1,0.323733,42,7138433,-1,500.0,7182771,7183094,44586,323,17,0,True,True,4.716697222222222,-0.323733
9153,7138782,8253,1,0.986368,52,7140640,-1,500.0,7156000,7164253,17218,8253,25,0,True,True,134.69720416666667,-0.9733148982634466
9154,7138878,10,16,0.938969,52,7140640,-1,8000.0,7142840,7142850,3962,10,38,7,True,True,2.3622222222222224,-0.938969
9155,7138938,9704,64,0.742836,52,7140640,-1,32000.0,7241595,7251299,102657,9704,9,7,True,True,10438.108977777776,-0.715331295524099
9156,7138958,14911,32,0.736719,52,7140640,-1,16000.0,7294159,7309070,155201,14911,7,7,True,True,8737.912533333334,-0.6173677047239248
9157,7139006,14452,32,0.316515,52,7140640,-1,16000.0,7205254,7219706,66248,14452,14,8,True,True,7229.995111111111,-0.308431028186855
9158,7139240,23347,128,0.150506,52,7140640,-1,64000.0,7402661,7426008,263421,23347,1,7,True,True,42665.545066666666,-0.1498178317782036
9159,7139285,12,1,0.458659,52,7140640,-1,500.0,7159360,7159372,20075,12,28,0,True,True,0.19493333333333335,-0.458659
9160,7139307,18,16,0.147487,52,7140640,-1,8000.0,7159371,7159389,20064,18,27,1,True,True,4.6784,-0.147487
9161,7139721,6,32,0.864301,52,7140640,-1,16000.0,7161571,7161577,21850,6,27,7,True,True,3.141066666666667,-0.864301
9162,7139796,465,4,0.113607,52,7140640,-1,2000.0,7199854,7200319,60058,465,16,0,True,True,29.452266666666667,-0.1091538413096785
9163,7139815,33807,64,0.969976,52,7140640,-1,32000.0,7342361,7376168,202546,33807,3,0,True,True,21316.964,-0.9532150552749147
9164,7140040,275,8,0.406387,52,7140640,-1,4000.0,7153791,7154066,13751,275,40,7,True,True,35.963888888888896,-0.406387
9165,7140102,3,4,0.520692,52,7140640,-1,2000.0,7156000,7156003,15898,3,35,0,True,True,0.19616666666666668,-0.520692
9166,7140866,346,4,0.003677,53,7142840,-1,2000.0,7167071,7167417,26205,346,29,6,True,True,23.218522222222223,-0.003677
9167,7141294,11097,10,0.450559,53,7142840,-1,5000.0,7238840,7249937,97546,11097,13,7,True,True,1959.1694861111112,-0.41924385339608833
9168,7141690,3596,256,0.832511,53,7142840,-1,128000.0,7394665,7398261,252975,3596,2,7,True,True,14664.307555555555,-0.8313681636180431
9169,7141900,30,8,0.125717,53,7142840,-1,4000.0,7191674,7191704,49774,30,22,7,True,True,2.4963333333333333,-0.125717
9170,7143944,103,8,0.449329,56,7145040,-1,4000.0,7145040,7145143,1096,103,52,0,True,True,12.165444444444445,-0.449329
9171,7143981,7296,158,0.969458,56,7145040,-1,79000.0,7315059,7322355,171078,7296,7,7,True,True,27734.468116666667,-0.8529680118412482
9172,7143987,78,16,0.097446,56,7145040,-1,8000.0,7172871,7172949,28884,78,32,2,True,True,21.281866666666666,-0.097446
9173,7144695,42,4,0.218623,56,7145040,-1,2000.0,7145083,7145125,388,42,50,1,True,True,2.4803333333333333,-0.218623
9174,7147554,19,1,0.979032,62,7150483,-1,500.0,7156000,7156019,8446,19,42,0,True,True,0.31059722222222225,-0.979032
9175,7147640,49,1,0.420176,62,7150483,-1,500.0,7164871,7164920,17231,49,35,0,True,True,0.8220430555555556,-0.420176
9176,7147674,11,35,0.546086,62,7150483,-1,17500.0,7159360,7159371,11686,11,40,6,True,True,6.254111111111111,-0.546086
9177,7148673,29,8,0.166101,62,7150483,-1,4000.0,7163771,7163800,15098,29,36,7,True,True,3.795455555555556,-0.166101
9178,7148736,9465,32,0.377557,62,7150483,-1,16000.0,7287259,7296724,138523,9465,13,7,True,True,3912.0074222222224,-0.37154331149494546
9179,7148820,116,32,0.348086,62,7150483,-1,16000.0,7156000,7156116,7180,116,48,0,True,True,60.68088888888889,-0.348086
9180,7149228,9,1,0.952377,62,7150483,-1,500.0,7153791,7153800,4563,9,53,0,True,True,0.147125,-0.952377
9181,7149429,13,6,0.971745,62,7150483,-1,3000.0,7156000,7156013,6571,13,50,7,True,True,1.2750833333333333,-0.971745
9182,7149513,14084,1,0.576836,62,7150483,-1,500.0,7312859,7326943,163346,14084,8,7,True,True,343.2820222222222,-0.5605801302231298
9183,7149817,41,1,0.014371,62,7150483,-1,500.0,7159360,7159401,9543,41,42,0,True,True,0.6660222222222222,-0.014371
9184,7149890,17,1,0.813779,62,7150483,-1,500.0,7157100,7157117,7210,17,46,6,True,True,0.27615555555555554,-0.813779
9185,7150081,4900,36,0.016191,62,7150483,-1,18000.0,7177271,7182171,27190,4900,32,7,True,True,2120.594,-0.01303745826096532
9186,7150250,9583,32,0.896655,62,7150483,-1,16000.0,7199854,7209437,49604,9583,22,0,True,True,4759.345422222222,-0.8746052836611454
9187,7150693,31580,2,0.502085,63,7151583,-1,1000.0,7404861,7436441,254168,31580,1,7,True,True,990.3296666666666,-0.479856724562613
9188,7150700,672,8,0.867758,63,7151583,-1,4000.0,7151591,7152263,891,672,62,1,True,True,93.77386666666668,-0.867758
9189,7154274,8,1,0.699317,60,7156000,-1,500.0,7158260,7158268,3986,8,48,1,True,True,0.12995555555555555,-0.699317
9190,7154312,9,1,0.648912,60,7156000,-1,500.0,7175071,7175080,20759,9,36,7,True,True,0.13542500000000002,-0.648912
9191,7154448,15210,8,0.455997,60,7156000,-1,4000.0,7233340,7248550,78892,15210,19,7,True,True,2380.2174444444445,-0.4453409358696346
9192,7154533,7486,8,0.410387,60,7156000,-1,4000.0,7159367,7166853,4834,7486,47,1,True,True,988.308388888889,-0.40907121990990736
9193,7158859,538,1,0.352211,54,7159360,-1,500.0,7182771,7183309,23912,538,33,0,True,True,7.856294444444444,-0.352211
9194,7158910,10206,4,0.542467,54,7159360,-1,2000.0,7327755,7337961,168845,10206,8,8,True,True,610.65705,-0.47115793648588056
9195,7159012,38,3,0.52317,54,7159360,-1,1500.0,7159367,7159405,355,38,48,0,True,True,1.8518666666666668,-0.52317
9196,7159053,7,8,0.765081,54,7159360,-1,4000.0,7159360,7159367,307,7,52,0,True,True,0.9096888888888888,-0.765081
9197,7159623,5,4,0.11338,57,7161571,-1,2000.0,7185074,7185079,25451,5,33,1,True,True,0.29205555555555557,-0.11338
9198,7159669,206,12,0.175814,57,7161571,-1,6000.0,7179471,7179677,19802,206,38,7,True,True,27.0684,-0.175814
9199,7159767,103,1,0.428384,57,7161571,-1,500.0,7184971,7185074,25204,103,34,7,True,True,1.5040861111111112,-0.428384
9200,7159820,5750,32,0.176895,57,7161571,-1,16000.0,7211108,7216858,51288,5750,24,7,True,True,2838.341244444445,-0.17162845788413814
9201,7160054,37473,32,0.594892,57,7161571,-1,16000.0,7357192,7394665,197138,37473,5,7,True,True,11093.455822222224,-0.5486909250614717
9202,7160100,414,8,0.542763,57,7161571,-1,4000.0,7161571,7161985,1471,414,51,0,True,True,54.183400000000006,-0.542763
9203,7160164,15,1,0.381563,57,7161571,-1,500.0,7164871,7164886,4707,15,49,0,True,True,0.25164583333333335,-0.381563
9204,7160343,14002,5,0.845092,57,7161571,-1,2500.0,7220821,7234823,60478,14002,25,0,True,True,1658.6791319444444,-0.826214380953884
9205,7160436,135,1,0.688551,57,7161571,-1,500.0,7164871,7165006,4435,135,52,0,True,True,2.2648125,-0.688551
9206,7160647,6502,3,0.437494,57,7161571,-1,1500.0,7184971,7191473,24324,6502,37,0,True,True,238.4625125,-0.38560760286324147
9207,7160727,498,9,0.283248,57,7161571,-1,4500.0,7198934,7199432,38207,498,30,1,True,True,73.86585000000001,-0.283248
9208,7162746,14808,8,0.620376,60,7163771,-1,4000.0,7345961,7360769,183215,14808,6,1,True,True,1142.1705444444444,-0.5364862762523046
9209,7162966,1,5,0.925136,60,7163771,-1,2500.0,7164871,7164872,1905,1,56,6,True,True,0.08388194444444445,-0.925136
9210,7162997,11,64,0.856997,60,7163771,-1,32000.0,7199854,7199865,36857,11,29,0,True,True,11.602311111111112,-0.856997
9211,7163649,2114,1,0.995363,60,7163771,-1,500.0,7165971,7168085,2322,2114,54,6,True,True,36.175272222222226,-0.9338064514822915
9212,7163720,4028,4,0.80594,60,7163771,-1,2000.0,7169271,7173299,5551,4028,52,7,True,True,283.9171055555556,-0.784021713898622
9213,7164050,224,7,0.103812,62,7164871,-1,3500.0,7194441,7194665,30391,224,33,7,True,True,18.97062222222222,-0.103812
9214,7164332,124,9,0.649625,62,7164871,-1,4500.0,7184971,7185095,20639,124,42,0,True,True,16.2967,-0.649625
9215,7164528,34,1,0.61626,62,7164871,-1,500.0,7182771,7182805,18243,34,45,0,True,True,0.49649444444444446,-0.61626
9216,7165397,739,32,0.41128,60,7165971,-1,16000.0,7177271,7178010,11874,739,50,0,True,True,355.83671111111113,-0.41128
9217,7165501,74,64,0.496405,60,7165971,-1,32000.0,7225521,7225595,60020,74,24,0,True,True,121.28106666666666,-0.496405
9218,7166578,7417,1,0.751727,60,7167071,-1,500.0,7208908,7216325,42330,7417,29,5,True,True,113.16541805555556,-0.7166082356288115
9219,7170295,121,4,0.927229,59,7172871,-1,2000.0,7175071,7175192,4776,121,55,0,True,True,7.282855555555556,-0.927229
9220,7172868,21,5,0.099702,59,7172871,-1,2500.0,7208854,7208875,35986,21,30,0,True,True,1.60825,-0.09970200000000003
9221,7173828,18,18,0.444103,59,7175071,-1,9000.0,7175071,7175089,1243,18,55,0,True,True,4.8753,-0.444103
9222,7173913,321,1,0.581234,59,7175071,-1,500.0,7199854,7200175,25941,321,32,0,True,True,5.125466666666666,-0.5631285477615302
9223,7184070,13,16,0.032636,49,7184971,-1,8000.0,7189474,7189487,5404,13,42,0,True,True,2.163488888888889,-0.032636
9224,7184899,1013,4,0.289904,49,7184971,-1,2000.0,7198841,7199854,13942,1013,37,7,True,True,66.77921111111111,-0.289904
9225,7185016,16239,4,0.420641,47,7185074,-1,2000.0,7306259,7322498,121243,16239,15,7,True,True,1775.4774888888887,-0.4168568068245353
9226,7186069,16,6,0.222879,49,7187274,-1,3000.0,7211108,7211124,25039,16,29,0,True,True,1.3830666666666667,-0.222879
9227,7186102,2263,4,0.45463,49,7187274,-1,2000.0,7208859,7211122,22757,2263,32,0,True,True,137.47474444444444,-0.45078785323134407
9228,7186416,8496,64,0.38108,49,7187274,-1,32000.0,7302959,7311455,116543,8496,17,7,True,True,14304.364800000001,-0.37603021959566846
9229,7187747,5,8,0.19556,51,7189474,-1,4000.0,7211189,7211194,23442,5,30,0,True,True,0.5762777777777778,-0.19556
9230,7187993,11,4,0.469574,51,7189474,-1,2000.0,7191704,7191715,3711,11,46,1,True,True,0.45766111111111113,-0.469574
9231,7188234,11,5,0.124441,51,7189474,-1,2500.0,7225521,7225532,37287,11,26,0,True,True,1.4084583333333334,-0.124441
9232,7189561,526,8,0.967616,53,7191674,-1,4000.0,7191715,7192241,2154,526,47,0,True,True,43.76904444444445,-0.967616
9233,7189749,30690,64,0.914029,53,7191674,-1,32000.0,7398261,7428951,208512,30690,3,7,True,True,28111.436000000005,-0.9040058844927651
9234,7189791,17197,128,0.412935,53,7191674,-1,64000.0,7322355,7339552,132564,17197,12,7,True,True,36893.39608888889,-0.35590929835810875
9235,7190455,12,1,0.820418,53,7191674,-1,500.0,7191715,7191727,1260,12,50,1,True,True,0.12481666666666667,-0.820418
9236,7191158,93,1,0.703835,53,7191674,-1,500.0,7198841,7198934,7683,93,45,0,True,True,1.5326916666666666,-0.703835
9237,7191735,12789,2,0.741153,50,7192241,-1,1000.0,7199854,7212643,8119,12789,44,3,True,True,392.31631944444445,-0.7202363904191758
9238,7192149,12,32,0.007605,50,7192241,-1,16000.0,7248277,7248289,56128,12,24,8,True,True,6.239466666666667,-0.007605
9239,7192320,16,32,0.374644,60,7194441,-1,16000.0,7208854,7208870,16534,16,39,0,True,True,7.842133333333334,-0.374644
9240,7192416,30,1,0.223937,60,7194441,-1,500.0,7220821,7220851,28405,30,34,1,True,True,0.49504166666666666,-0.223937
9241,7192636,115,1,0.283604,60,7194441,-1,500.0,7271477,7271592,78841,115,24,7,True,True,2.0829375,-0.283604
9242,7192923,2,3,0.879607,60,7194441,-1,1500.0,7196641,7196643,3718,2,52,7,True,True,0.09888333333333332,-0.8796070000000002
9243,7192945,38,12,0.264499,60,7194441,-1,6000.0,7208870,7208908,15925,38,40,0,True,True,6.984400000000001,-0.26449899999999993
9244,7193263,44,1,0.838484,60,7194441,-1,500.0,7194441,7194485,1178,44,54,0,True,True,0.5323388888888889,-0.838484
9245,7193967,9,32,0.795138,60,7194441,-1,16000.0,7242868,7242877,48901,9,26,1,True,True,5.2992,-0.795138
9246,7194119,5,8,0.414717,60,7194441,-1,4000.0,7211189,7211194,17070,5,38,1,True,True,0.5762777777777778,-0.414717
9247,7194371,1835,1,0.241554,60,7194441,-1,500.0,7235540,7237375,41169,1835,29,0,True,True,40.38513194444444,-0.22316053788120446
9248,7194423,7,1,0.900187,60,7194441,-1,500.0,7199854,7199861,5431,7,52,0,True,True,0.11536388888888888,-0.900187
9249,7194433,1000,4,0.414557,60,7194441,-1,2000.0,7249377,7250377,54944,1000,25,6,True,True,64.99444444444444,-0.414557
9250,7195265,56,39,0.01553,60,7196641,-1,19500.0,7235540,7235596,40275,56,31,7,True,True,52.02773333333334,-0.01553
9251,7195429,2,16,0.153375,60,7196641,-1,8000.0,7213389,7213391,17960,2,40,7,True,True,0.4610222222222222,-0.153375
9252,7196751,143,16,0.374406,60,7198841,-1,8000.0,7220678,7220821,23927,143,40,1,True,True,37.755177777777774,-0.374406
9253,7200934,5663,2,0.816707,72,7205254,-1,1000.0,7211136,7216799,10202,5663,44,0,True,True,174.6082861111111,-0.7907802109947982
9254,7201056,70,1,0.820034,72,7205254,-1,500.0,7208854,7208924,7798,70,50,0,True,True,1.0721666666666667,-0.820034
9255,7201163,33,1,0.599946,72,7205254,-1,500.0,7214489,7214522,13326,33,41,6,True,True,0.5540791666666667,-0.599946
9256,7201177,268,4,0.33509,72,7205254,-1,2000.0,7262377,7262645,61200,268,25,7,True,True,18.444355555555553,-0.33509
9257,7201192,24047,1,0.959161,72,7205254,-1,500.0,7308459,7332506,107267,24047,17,7,True,True,598.7567083333333,-0.9461497886946475
9258,7201286,7837,32,0.992829,72,7205254,-1,16000.0,7267077,7274914,65791,7837,26,2,True,True,4508.689555555555,-0.9665666842437834
9259,7201325,14831,4,0.241831,72,7205254,-1,2000.0,7342361,7357192,141036,14831,8,0,True,True,641.3586499999999,-0.23419300652804384
9260,7201383,13,8,0.97349,72,7205254,-1,4000.0,7208859,7208872,7476,13,54,0,True,True,1.5929333333333333,-0.97349
9261,7201427,10394,8,0.19266,72,7205254,-1,4000.0,7296359,7306753,94932,10394,22,7,True,True,1391.8724444444447,-0.18014782834912735
9262,7201607,11188,2,0.644434,72,7205254,-1,1000.0,7282859,7294047,81252,11188,26,1,True,True,260.5709888888889,-0.5855114663401288
9263,7202871,7099,1,0.82855,72,7205254,-1,500.0,7208854,7215953,5983,7099,58,0,True,True,107.74653472222222,-0.7828388633331244
9264,7203063,5,18,0.801332,72,7205254,-1,9000.0,7208854,7208859,5791,5,62,2,True,True,1.3785,-0.801332
9265,7203165,11669,8,0.577854,72,7205254,-1,4000.0,7242877,7254546,39712,11669,33,1,True,True,1476.6911333333333,-0.5349728934993349
9266,7204406,19788,1,0.12887,72,7205254,-1,500.0,7409261,7429049,204855,19788,0,7,True,True,272.6345847222222,-0.12618165262864334
9267,7204441,44,1,0.636273,72,7205254,-1,500.0,7217053,7217097,12612,44,49,6,True,True,0.7387722222222223,-0.636273
9268,7204550,13130,64,0.977356,72,7205254,-1,32000.0,7260177,7273307,55627,13130,32,9,True,True,14004.216088888888,-0.9172836320757761
9269,7204562,171,1,0.173717,72,7205254,-1,500.0,7263477,7263648,58915,171,31,6,True,True,2.94215,-0.173717
9270,7204763,49,4,0.904171,72,7205254,-1,2000.0,7208854,7208903,4091,49,64,0,True,True,3.0020666666666664,-0.904171
9271,7204775,8028,1,0.517277,72,7205254,-1,500.0,7211108,7219136,6333,8028,58,0,True,True,126.6182388888889,-0.4970194614369577
9272,7204795,58272,4,0.437402,72,7205254,-1,2000.0,7428951,7487223,224156,58272,0,0,True,True,4877.348199999999,-0.43668622713665667
9273,7204807,11697,256,0.099578,72,7205254,-1,128000.0,7487223,7498920,282416,11697,0,6,True,True,44918.515199999994,-0.09196719321363887
9274,7207802,4,4,0.801172,75,7208854,-1,2000.0,7208870,7208874,1068,4,63,0,True,True,0.24506666666666668,-0.801172
9275,7208040,42,4,0.504257,75,7208854,-1,2000.0,7269277,7269319,61237,42,32,7,True,True,3.0429,-0.504257
9276,7208206,7328,1,0.631441,75,7208854,-1,500.0,7235540,7242868,27334,7328,44,0,True,True,148.1344222222222,-0.5663479924486784
9277,7208246,81,16,0.784281,75,7208854,-1,8000.0,7211108,7211189,2862,81,61,0,True,True,18.6714,-0.784281
9278,7209531,110,1,0.843031,80,7211108,-1,500.0,7213389,7213499,3858,110,57,0,True,True,1.5847638888888889,-0.843031
9279,7209617,635,32,0.627318,80,7211108,-1,16000.0,7211136,7211771,1519,635,62,1,True,True,292.7491111111111,-0.627318
9280,7209643,25,1,0.26023,80,7211108,-1,500.0,7220653,7220678,11010,25,55,4,True,True,0.4125347222222222,-0.26023
9281,7209667,9,8,0.552906,80,7211108,-1,4000.0,7211189,7211198,1522,9,60,0,True,True,1.0373,-0.552906
9282,7209674,336,32,0.9487,80,7211108,-1,16000.0,7213389,7213725,3715,336,59,0,True,True,154.90346666666667,-0.9487
9283,7209685,26645,16,0.203763,80,7211108,-1,8000.0,7340161,7366806,130476,26645,14,7,True,True,4365.856222222223,-0.19483969850945096
9284,7209720,15299,64,0.093265,80,7211108,-1,32000.0,7279314,7294613,69594,15299,31,7,True,True,11167.680355555556,-0.08672215744254096
9285,7209776,26,1,0.437421,80,7211108,-1,500.0,7274914,7274940,65138,26,32,1,True,True,0.5097805555555555,-0.437421
9286,7210165,12871,16,0.628894,80,7211108,-1,8000.0,7291959,7304830,81794,12871,28,4,True,True,3081.924977777778,-0.5456849196985173
9287,7210313,11079,64,0.593288,80,7211108,-1,32000.0,7298559,7309638,88246,11079,26,7,True,True,14449.777600000001,-0.49972078970894385
9288,7210375,5745,32,0.027818,80,7211108,-1,16000.0,7277114,7282859,66739,5745,34,7,True,True,2118.2569777777776,-0.02473861789196588
9289,7210382,28,16,0.707576,80,7211108,-1,8000.0,7211108,7211136,726,28,74,0,True,True,6.454311111111111,-0.707576
9290,7210418,167,32,0.920594,80,7211108,-1,16000.0,7235540,7235707,25122,167,51,0,True,True,127.30595555555557,-0.920594
9291,7210473,1381,32,0.078773,80,7211108,-1,16000.0,7225521,7226902,15048,1381,56,0,True,True,1131.6834666666666,-0.078773
9292,7210951,22437,1,0.382405,80,7211108,-1,500.0,7400461,7422898,189510,22437,6,7,True,True,329.3202430555555,-0.37286540998860745
9293,7211068,2274,1,0.74234,80,7211108,-1,500.0,7211136,7213410,68,2274,74,0,True,True,32.76139166666667,-0.74234
9294,7211177,56,22,0.130548,73,7211189,-1,11000.0,7215953,7216009,4776,56,66,2,True,True,20.68562222222222,-0.130548
9295,7212319,6,8,0.453706,77,7213389,-1,4000.0,7236640,7236646,24321,6,50,6,True,True,1.0272666666666668,-0.453706
9296,7212722,1338,4,0.631502,77,7213389,-1,2000.0,7220653,7221991,7931,1338,65,0,True,True,92.39052222222222,-0.5705514410540068
9297,7212780,4929,4,0.358121,77,7213389,-1,2000.0,7285059,7289988,72279,4929,33,7,True,True,216.6958,-0.3570251077380735
9298,7212857,57,8,0.239722,77,7213389,-1,4000.0,7225521,7225578,12664,57,62,4,True,True,11.6774,-0.239722
9299,7212939,2,8,0.897909,77,7213389,-1,4000.0,7213389,7213391,450,2,73,0,True,True,0.2305111111111111,-0.897909
9300,7213145,15255,32,0.296923,77,7213389,-1,16000.0,7300759,7316014,87614,15255,27,7,True,True,12318.373066666669,-0.27303710134582343
9301,7213246,15842,225,0.535417,77,7213389,-1,112500.0,7428951,7444793,215705,15842,2,1,True,True,78995.32250000001,-0.5353063578216947
9302,7214147,27,1,0.245254,76,7214489,-1,500.0,7239395,7239422,25248,27,52,1,True,True,0.5778375,-0.245254
9303,7214162,3,4,0.780029,76,7214489,-1,2000.0,7225521,7225524,11359,3,61,0,True,True,0.3073,-0.780029
9304,7214384,351,2,0.786048,76,7214489,-1,1000.0,7220678,7221029,6294,351,70,0,True,True,11.583975,-0.786048
6365,4996152,288,8,0.943162,1,4996152,-1,4000.0,4997252,4997540,1100,288,0,6,True,True,29.104000000000003,-0.943162
6366,4996383,9,1,0.724234,4,4997252,-1,500.0,4999452,4999461,3069,9,0,7,True,True,0.11368750000000001,-0.724234
6367,4996738,11299,256,0.14056,4,4997252,-1,128000.0,5375484,5386783,378746,11299,0,7,True,True,58563.753244444444,-0.13672859076566565
6368,4996862,19,8,0.111932,4,4997252,-1,4000.0,5019580,5019599,22718,19,1,7,True,True,4.087111111111111,-0.111932
6369,4997024,11651,2,0.73448,4,4997252,-1,1000.0,5023035,5034686,26011,11651,1,1,True,True,589.8453194444444,-0.7288421937739542
6370,4998240,68,32,0.932935,5,4999452,-1,16000.0,5001652,5001720,3412,68,3,7,True,True,27.26951111111111,-0.932935
6371,4998380,9,2,0.521958,5,4999452,-1,1000.0,5009352,5009361,10972,9,3,6,True,True,0.33505,-0.521958
6372,5001282,11,1,0.828982,6,5001652,-1,500.0,5003852,5003863,2570,11,4,7,True,True,0.1378513888888889,-0.828982
6373,5001393,8013,2,0.949675,6,5001652,-1,1000.0,5017380,5025393,15987,8013,3,2,True,True,424.1843083333333,-0.9384651405989272
6374,5003634,1429,2,0.931556,8,5003852,-1,1000.0,5006052,5007481,2418,1429,5,7,True,True,40.150930555555554,-0.931556
6375,5003672,396,11,0.251808,8,5003852,-1,5500.0,5026335,5026731,22663,396,1,6,True,True,109.0573,-0.251808
6376,5003800,518,4,0.884565,8,5003852,-1,2000.0,5003852,5004370,52,518,7,0,True,True,28.210855555555554,-0.8572803455264457
6377,5003985,4,16,0.238077,12,5006052,-1,8000.0,5013752,5013756,9767,4,5,0,True,True,1.4131555555555555,-0.238077
6378,5004083,382,8,0.122277,12,5006052,-1,4000.0,5028535,5028917,24452,382,1,7,True,True,76.51035555555555,-0.122277
6379,5004332,179,1,0.806687,12,5006052,-1,500.0,5008252,5008431,3920,179,8,7,True,True,3.3318861111111113,-0.806687
6380,5004346,342,1,0.329286,12,5006052,-1,500.0,5034035,5034377,29689,342,1,7,True,True,8.1035,-0.329286
6381,5004375,7617,128,0.584326,12,5006052,-1,64000.0,5040935,5048552,36560,7617,1,0,True,True,25338.396444444443,-0.5828424817898589
6382,5004770,7207,53,0.389951,12,5006052,-1,26500.0,5036235,5043442,31465,7207,2,7,True,True,9881.90565,-0.3891686780734764
6383,5008217,92,1,0.748374,12,5008252,-1,500.0,5013752,5013844,5535,92,10,7,True,True,2.0314111111111113,-0.748374
6384,5008449,72,16,0.235938,16,5009352,-1,8000.0,5020692,5020764,12243,72,7,1,True,True,30.976,-0.235938
6385,5008526,6200,16,0.422869,16,5009352,-1,8000.0,5013780,5019980,5254,6200,10,2,True,True,2588.4257777777775,-0.4104057937918484
6386,5008573,5,8,0.144278,16,5009352,-1,4000.0,5030735,5030740,22162,5,4,7,True,True,1.0408333333333333,-0.144278
6387,5009035,112,4,0.175154,16,5009352,-1,2000.0,5031835,5031947,22800,112,4,6,True,True,11.657333333333332,-0.175154
6388,5009187,92,16,0.969923,16,5009352,-1,8000.0,5011552,5011644,2365,92,15,7,True,True,32.50257777777778,-0.969923
6389,5011695,36736,16,0.439475,19,5013752,-1,8000.0,5234865,5271601,223170,36736,1,0,True,True,11244.301955555555,-0.42560939543062226
6390,5012350,143,32,0.254306,19,5013752,-1,16000.0,5022892,5023035,10542,143,10,7,True,True,118.51204444444444,-0.254306
6391,5012445,12,8,0.589481,19,5013752,-1,4000.0,5020680,5020692,8235,12,12,6,True,True,2.5813333333333333,-0.589481
6392,5013079,28,4,0.490359,19,5013752,-1,2000.0,5013752,5013780,673,28,16,0,True,True,2.473022222222222,-0.490359
6393,5013666,39,64,0.374705,19,5013752,-1,32000.0,5025235,5025274,11569,39,9,7,True,True,64.64293333333333,-0.374705
6394,5035595,4,1,0.948711,8,5036235,-1,500.0,5040935,5040939,5340,4,3,6,True,True,0.10426666666666667,-0.948711
6395,5035616,49,1,0.31649,8,5036235,-1,500.0,5062914,5062963,27298,49,2,0,True,True,1.2132263888888888,-0.31649
6396,5035632,6541,32,0.423781,8,5036235,-1,16000.0,5081213,5087754,45581,6541,2,1,True,True,3939.119777777778,-0.4032545599828043
6397,5035672,13689,1,0.682738,8,5036235,-1,500.0,5244490,5258179,208818,13689,1,4,True,True,234.05683194444447,-0.6534007493814236
6398,5035701,48,4,0.963315,8,5036235,-1,2000.0,5039835,5039883,4134,48,7,1,True,True,4.9504,-0.963315
6399,5038555,27,25,0.879434,14,5039835,-1,12500.0,5043135,5043162,4580,27,5,7,True,True,17.595,-0.879434
6400,5039384,9,8,0.936972,14,5039835,-1,4000.0,5040935,5040944,1551,9,7,0,True,True,1.8768,-0.936972
6401,5039437,4609,128,0.362998,14,5039835,-1,64000.0,5089773,5094382,50336,4609,3,7,True,True,10951.130311111112,-0.3489643986525286
6402,5039447,15719,8,0.715671,14,5039835,-1,4000.0,5087568,5103287,48121,15719,4,0,True,True,2640.4649777777777,-0.6914110601415784
6403,5039464,2,1,0.821365,14,5039835,-1,500.0,5061814,5061816,22350,2,7,0,True,True,0.04951944444444445,-0.821365
6404,5039486,489,1,0.021074,14,5039835,-1,500.0,5070830,5071319,31344,489,6,0,True,True,11.1756875,-0.021074
6405,5039769,60,1,0.966805,14,5039835,-1,500.0,5052962,5053022,13193,60,9,0,True,True,1.4739166666666668,-0.966805
6406,5039891,10,4,0.605815,25,5040935,-1,2000.0,5061814,5061824,21923,10,8,0,True,True,0.990388888888889,-0.605815
6407,5039964,11,2,0.841473,25,5040935,-1,1000.0,5043162,5043173,3198,11,11,0,True,True,0.5734666666666667,-0.841473
6408,5040154,8196,8,0.662223,25,5040935,-1,4000.0,5064014,5072210,23860,8196,7,0,True,True,1559.421911111111,-0.6469557844972272
6409,5040184,9272,1,0.940848,25,5040935,-1,500.0,5071930,5081202,31746,9272,6,0,True,True,188.87328333333335,-0.8839522618296108
6410,5040190,24297,78,0.690682,25,5040935,-1,39000.0,5297145,5321442,256955,24297,1,7,True,True,37435.523774999994,-0.6769843173005665
6411,5040213,572,8,0.788803,25,5040935,-1,4000.0,5061814,5062386,21601,572,11,0,True,True,113.30048888888889,-0.788803
6412,5040272,2900,64,0.239676,25,5040935,-1,32000.0,5062914,5065814,22642,2900,11,0,True,True,4578.9765333333335,-0.23881919271109492
6413,5040327,32,2,0.552728,25,5040935,-1,1000.0,5065814,5065846,25487,32,9,2,True,True,1.5578666666666665,-0.552728
6414,5040396,7193,1,0.309269,25,5040935,-1,500.0,5104387,5111580,63991,7193,4,0,True,True,193.55188888888887,-0.30827793050244257
6415,5040423,9,8,0.958484,25,5040935,-1,4000.0,5043162,5043171,2739,9,19,1,True,True,1.8768,-0.958484
6416,5040900,48,4,0.362855,25,5040935,-1,2000.0,5048562,5048610,7662,48,18,8,True,True,4.9013333333333335,-0.362855
6417,5040909,7,64,0.81225,25,5040935,-1,32000.0,5061805,5061812,20896,7,17,8,True,True,11.092355555555557,-0.81225
6418,5041154,752,8,0.122054,25,5043135,-1,4000.0,5075230,5075982,34076,752,8,6,True,True,115.43200000000002,-0.122054
6419,5041162,10,1,0.866953,25,5043135,-1,500.0,5043162,5043172,2000,10,21,0,True,True,0.2606666666666667,-0.866953
6420,5041194,39,32,0.857647,25,5043135,-1,16000.0,5069691,5069730,28497,39,11,7,True,True,28.522000000000002,-0.857647
6421,5046220,1,16,0.388471,35,5048562,-1,8000.0,5055305,5055306,9085,1,20,2,True,True,0.4035777777777778,-0.388471
6422,5046284,15625,4,0.909789,35,5048562,-1,2000.0,5127244,5142869,80960,15625,4,0,True,True,1304.9811388888888,-0.8711014851649443
6423,5046317,3,1,0.392976,35,5048562,-1,500.0,5071930,5071933,25613,3,11,0,True,True,0.06856250000000001,-0.392976
6424,5046332,6729,4,0.977993,35,5048562,-1,2000.0,5052962,5059691,6630,6729,23,0,True,True,677.8375833333333,-0.9682211459183666
6425,5046363,260,1,0.255534,35,5048562,-1,500.0,5055162,5055422,8799,260,23,0,True,True,6.558138888888889,-0.255534
6426,5046749,11,9,0.09025,35,5048562,-1,4500.0,5056405,5056416,9656,11,22,0,True,True,2.4971375,-0.09025
6427,5046809,257,1,0.822708,35,5048562,-1,500.0,5048562,5048819,1753,257,27,0,True,True,6.56063888888889,-0.822708
6428,5046913,11,32,0.23546,35,5048562,-1,16000.0,5061814,5061825,14901,11,20,0,True,True,8.715422222222223,-0.23546
6429,5047043,14,4,0.210386,35,5048562,-1,2000.0,5081202,5081216,34159,14,9,0,True,True,1.1555444444444443,-0.210386
6430,5047140,22571,16,0.890247,35,5048562,-1,8000.0,5099882,5122453,52742,22571,6,0,True,True,9863.635955555555,-0.8875091487709668
6431,5047202,6,8,0.915891,35,5048562,-1,4000.0,5048562,5048568,1360,6,30,0,True,True,1.2253333333333334,-0.915891
6432,5047254,11,12,0.631353,35,5048562,-1,6000.0,5052962,5052973,5708,11,29,0,True,True,3.2426166666666667,-0.631353
6433,5048161,10364,23,0.879467,35,5048562,-1,11500.0,5050762,5061126,2601,10364,31,7,True,True,5987.117669444445,-0.867328699138961
6434,5048205,473,2,0.766741,35,5048562,-1,1000.0,5055162,5055635,6957,473,28,7,True,True,23.861536111111114,-0.766741
6435,5048623,20,54,0.406289,44,5050762,-1,27000.0,5154344,5154364,105721,20,4,1,True,True,22.986,-0.406289
6436,5048678,9806,32,0.033882,44,5050762,-1,16000.0,5085368,5095174,36690,9806,10,6,True,True,5830.5489777777775,-0.03326788013584409
6437,5049119,1583,2,0.866445,44,5050762,-1,1000.0,5052962,5054545,3843,1583,31,0,True,True,77.96458611111112,-0.8459022985602944
6438,5049130,11094,128,0.823198,44,5050762,-1,64000.0,5219532,5230626,170402,11094,4,7,True,True,30704.715733333334,-0.8221121860475878
6439,5049135,11,80,0.940495,44,5050762,-1,40000.0,5065814,5065825,16679,11,19,0,True,True,21.420666666666666,-0.940495
6440,5049317,7704,256,0.471091,44,5050762,-1,128000.0,5170402,5178106,121085,7704,5,7,True,True,59559.11111111111,-0.4611877778203242
6441,5049589,6,8,0.412961,44,5050762,-1,4000.0,5062914,5062920,13325,6,25,0,True,True,1.1884666666666668,-0.412961
6442,5049619,15133,8,0.841163,44,5050762,-1,4000.0,5094382,5109515,44763,15133,10,0,True,True,2949.143,-0.7983066211874517
6443,5049809,7295,16,0.717386,44,5050762,-1,8000.0,5071930,5079225,22121,7295,19,0,True,True,2366.396666666667,-0.6627276056291109
6444,5050464,16097,1,0.876761,44,5050762,-1,500.0,5120644,5136741,70180,16097,8,7,True,True,350.05942777777784,-0.8334307549917594
6445,5050620,3608,128,0.820241,44,5050762,-1,64000.0,5081030,5084638,30410,3608,17,0,True,True,9015.508977777778,-0.7762238122064641
6446,5050703,99,4,0.824401,44,5050762,-1,2000.0,5052962,5053061,2259,99,43,7,True,True,9.72785,-0.824401
6447,5050777,49,2,0.698482,55,5052962,-1,1000.0,5055162,5055211,4385,49,37,0,True,True,2.471913888888889,-0.698482
6448,5050915,24920,64,0.506335,55,5052962,-1,32000.0,5114044,5138964,63129,24920,9,1,True,True,37679.38382222222,-0.4850949197944461
6449,5051602,7919,2,0.351856,55,5052962,-1,1000.0,5156544,5164463,104942,7919,6,0,True,True,291.5447638888889,-0.3392700629127234
6450,5051620,4940,16,0.602116,55,5052962,-1,8000.0,5055162,5060102,3542,4940,41,0,True,True,2007.1270222222224,-0.5992536179869258
6451,5051644,11891,128,0.813428,55,5052962,-1,64000.0,5329637,5341528,277993,11891,1,7,True,True,18099.595377777776,-0.7993163331845862
6452,5051662,10,32,0.737786,55,5052962,-1,16000.0,5052962,5052972,1300,10,45,0,True,True,7.86088888888889,-0.737786
6453,5051696,12002,128,0.453262,55,5052962,-1,64000.0,5192630,5204632,140934,12002,6,7,True,True,28459.452444444443,-0.45126458355213434
6454,5051826,9,28,0.027351,55,5052962,-1,14000.0,5096582,5096591,44756,9,15,0,True,True,4.907,-0.027351
6455,5051887,12955,4,0.052099,55,5052962,-1,2000.0,5234865,5247820,182978,12955,5,7,True,True,952.3997777777779,-0.051938115777354195
6456,5051994,549,1,0.641593,55,5052962,-1,500.0,5077430,5077979,25436,549,24,7,True,True,11.59,-0.641593
6457,5052030,7192,8,0.630156,55,5052962,-1,4000.0,5125044,5132236,73014,7192,12,7,True,True,1117.8550222222223,-0.5628741979199656
6458,5052093,9,1,0.791019,55,5052962,-1,500.0,5061805,5061814,9712,9,42,0,True,True,0.22283750000000002,-0.791019
6459,5053167,300,16,0.136092,68,5055162,-1,8000.0,5081030,5081330,27863,300,25,5,True,True,99.04666666666665,-0.136092
6460,5053192,11523,32,0.400662,68,5055162,-1,16000.0,5062914,5074437,9722,11523,39,6,True,True,8498.9012,-0.38991274364138157
6461,5053311,60,4,0.628296,68,5055162,-1,2000.0,5067482,5067542,14171,60,33,0,True,True,5.842,-0.628296
6462,5053321,42,1,0.313722,68,5055162,-1,500.0,5056405,5056447,3084,42,48,6,True,True,1.0593916666666667,-0.313722
6463,5053390,9387,32,0.082232,68,5055162,-1,16000.0,5081202,5090589,27812,9387,24,1,True,True,5643.6116,-0.07967282971716205
6464,5053409,409,1,0.157822,68,5055162,-1,500.0,5065814,5066223,12405,409,36,0,True,True,9.955741666666666,-0.157822
6465,5053471,669,40,0.516366,68,5055162,-1,20000.0,5055162,5055831,1691,669,53,0,True,True,674.9838333333333,-0.516366
6466,5053478,1370,4,0.969665,68,5055162,-1,2000.0,5055162,5056532,1684,1370,53,0,True,True,138.2253888888889,-0.969665
6467,5053524,4,1,0.830621,68,5055162,-1,500.0,5062914,5062918,9390,4,40,0,True,True,0.0990388888888889,-0.830621
6468,5053546,607,1,0.763163,68,5055162,-1,500.0,5067482,5068089,13936,607,34,0,True,True,14.775391666666666,-0.763163
6469,5053558,18448,160,0.84696,68,5055162,-1,80000.0,5357036,5375484,303478,18448,1,0,True,True,53116.632,-0.8164322816688055
6470,5053616,14,16,0.685753,68,5055162,-1,8000.0,5055211,5055225,1595,14,55,2,True,True,5.650088888888889,-0.685753
6471,5053649,94,1,0.792642,68,5055162,-1,500.0,5055211,5055305,1562,94,55,0,True,True,2.371019444444445,-0.792642
6472,5053681,194,8,0.319399,68,5055162,-1,4000.0,5067323,5067517,13642,194,37,0,True,True,37.77826666666667,-0.319399
6473,5053696,1791,8,0.478365,68,5055162,-1,4000.0,5087568,5089359,33872,1791,21,0,True,True,268.3316,-0.478365
6474,5054011,14447,128,0.735172,68,5055162,-1,64000.0,5261015,5275462,207004,14447,4,7,True,True,42175.91662222223,-0.7077825971216805
6475,5054052,7887,29,0.26068,68,5055162,-1,14500.0,5104387,5112274,50335,7887,18,6,True,True,6157.469708333333,-0.26041617709627296
6476,5054099,10840,32,0.687467,68,5055162,-1,16000.0,5118444,5129284,64345,10840,16,7,True,True,8701.404977777778,-0.615276789655547
6477,5054492,21,8,0.826769,68,5055162,-1,4000.0,5055162,5055183,670,21,62,0,True,True,4.237566666666667,-0.826769
6478,5055358,13301,128,0.799529,64,5056405,-1,64000.0,5094382,5107683,39024,13301,23,4,True,True,40833.69848888889,-0.787004654399725
6479,5055377,15508,140,0.198664,64,5056405,-1,70000.0,5341528,5357036,286151,15508,2,0,True,True,26573.526777777777,-0.18016756419175342
6480,5055439,17,16,0.414496,64,5056405,-1,8000.0,5067491,5067508,12052,17,41,1,True,True,6.620933333333333,-0.414496
6481,5055712,8,16,0.181889,64,5056405,-1,8000.0,5067491,5067499,11779,8,41,0,True,True,3.115733333333333,-0.181889
6482,5055757,3,8,0.87639,64,5056405,-1,4000.0,5061812,5061815,6055,3,59,0,True,True,0.5942333333333334,-0.87639
6483,5055783,1034,4,0.944757,64,5056405,-1,2000.0,5061814,5062848,6031,1034,59,1,True,True,102.40621111111112,-0.944757
6484,5056411,109,2,0.884341,86,5061805,-1,1000.0,5062914,5063023,6503,109,54,0,True,True,5.3976194444444445,-0.884341
6485,5056458,266,9,0.224487,86,5061805,-1,4500.0,5081030,5081296,24572,266,33,0,True,True,49.399525,-0.224487
6486,5056472,345,8,0.948109,86,5061805,-1,4000.0,5061805,5062150,5333,345,63,0,True,True,68.33683333333335,-0.948109
6487,5056902,18,10,0.923112,86,5061805,-1,5000.0,5061805,5061823,4903,18,64,0,True,True,4.45675,-0.923112
6488,5057043,9038,32,0.647107,86,5061805,-1,16000.0,5075230,5084268,18187,9038,36,0,True,True,5891.6568,-0.6420942751238369
6489,5058075,16,1,0.626627,86,5061805,-1,500.0,5071930,5071946,13855,16,41,0,True,True,0.3656666666666667,-0.626627
6490,5058146,12,7,0.906845,86,5061805,-1,3500.0,5061814,5061826,3668,12,59,0,True,True,2.079816666666667,-0.906845
6491,5058434,553,4,0.974128,86,5061805,-1,2000.0,5061814,5062367,3380,553,63,0,True,True,54.76850555555556,-0.974128
6492,5058632,386,1,0.198266,86,5061805,-1,500.0,5066223,5066609,7591,386,49,3,True,True,9.395883333333332,-0.198266
6493,5058801,18,16,0.701261,86,5061805,-1,8000.0,5071930,5071948,13129,18,42,0,True,True,6.582000000000001,-0.701261
6494,5058827,10593,1,0.168756,86,5061805,-1,500.0,5232665,5243258,173838,10593,9,7,True,True,203.87565,-0.16399312592783957
6495,5058866,27,16,0.401035,86,5061805,-1,8000.0,5075230,5075257,16364,27,37,0,True,True,8.289,-0.401035
6496,5058919,16733,1,0.428903,86,5061805,-1,500.0,5213732,5230465,154813,16733,11,6,True,True,354.38534583333336,-0.4279854036065278
6497,5058961,39,1,0.260158,86,5061805,-1,500.0,5074130,5074169,15169,39,41,7,True,True,0.7483125,-0.260158
6498,5059497,36,30,0.089061,86,5061805,-1,15000.0,5081330,5081366,21833,36,31,0,True,True,22.2855,-0.089061
6499,5059573,159,16,0.36792,86,5061805,-1,8000.0,5067323,5067482,7750,159,55,6,True,True,61.9252,-0.36792
6500,5059943,270,8,0.947244,86,5061805,-1,4000.0,5061805,5062075,1862,270,77,0,True,True,53.481,-0.947244
6501,5059974,12,1,0.117351,86,5061805,-1,500.0,5108783,5108795,48809,12,21,6,True,True,0.3292333333333333,-0.117351
6502,5060092,437,64,0.718583,86,5061805,-1,32000.0,5061812,5062249,1720,437,76,1,True,True,692.4799111111112,-0.718583
6503,5060119,11,3,0.435159,86,5061805,-1,1500.0,5081202,5081213,21083,11,35,0,True,True,0.6809458333333333,-0.435159
6504,5060145,147,4,0.919989,86,5061805,-1,2000.0,5064014,5064161,3869,147,63,6,True,True,14.558716666666667,-0.919989
6505,5060291,12470,16,0.453708,86,5061805,-1,8000.0,5156544,5169014,96253,12470,15,0,True,True,3788.9576888888887,-0.4385812249525197
6506,5060401,102,1,0.67361,86,5061805,-1,500.0,5070830,5070932,10429,102,52,6,True,True,2.331125,-0.67361
6507,5060515,81,1,0.118512,86,5061805,-1,500.0,5087573,5087654,27058,81,30,0,True,True,1.51695,-0.118512
6508,5064225,9,1,0.713564,78,5065814,-1,500.0,5067482,5067491,3257,9,58,0,True,True,0.219075,-0.713564
6509,5064232,10831,16,0.190544,78,5065814,-1,8000.0,5182837,5193668,118605,10831,13,0,True,True,4811.895888888888,-0.16874388019567554
6510,5064330,156,2,0.861937,78,5065814,-1,1000.0,5067482,5067638,3152,156,58,0,True,True,7.5946,-0.861937
6511,5064361,26471,64,0.782122,78,5065814,-1,32000.0,5111580,5138051,47219,26471,23,2,True,True,40572.99306666667,-0.7334808101395136
6512,5064423,8,16,0.287962,78,5065814,-1,8000.0,5084268,5084276,19845,8,36,1,True,True,2.2837333333333336,-0.287962
6513,5064462,9,1,0.494168,78,5065814,-1,500.0,5150964,5150973,86502,9,18,0,True,True,0.19835000000000003,-0.494168
6514,5064563,1019,21,0.130199,78,5065814,-1,10500.0,5087573,5088592,23010,1019,34,1,True,True,400.7557166666667,-0.130199
6515,5064589,14234,128,0.856338,78,5065814,-1,64000.0,5290545,5304779,225956,14234,5,6,True,True,39154.278755555555,-0.8439996902231424
6516,5064614,13897,4,0.600083,78,5065814,-1,2000.0,5298245,5312142,233631,13897,4,6,True,True,1193.7862722222221,-0.5932135814970879
6517,5064685,14,8,0.995207,78,5065814,-1,4000.0,5067482,5067496,2797,14,68,1,True,True,2.7262666666666666,-0.995207
6518,5064931,36,2,0.282967,78,5065814,-1,1000.0,5120644,5120680,55713,36,23,0,True,True,2.1226,-0.282967
6519,5064959,9070,16,0.677189,78,5065814,-1,8000.0,5087568,5096638,22609,9070,40,7,True,True,2732.4766222222224,-0.6723921813559177
6520,5065030,92,1,0.418331,78,5065814,-1,500.0,5071930,5072022,6900,92,61,6,True,True,2.1025833333333335,-0.418331
6521,5065053,8649,5,0.408524,78,5065814,-1,2500.0,5212632,5221281,147579,8649,14,4,True,True,886.4785833333334,-0.40134492855225884
6522,5065866,10726,1,0.145943,76,5066223,-1,500.0,5156544,5167270,90678,10726,19,0,True,True,199.14914444444443,-0.13488901121168376
6523,5066942,114,32,0.290193,77,5067323,-1,16000.0,5094382,5094496,27440,114,36,0,True,True,71.03466666666667,-0.290193
6524,5067190,7978,1,0.261799,77,5067323,-1,500.0,5120644,5128622,53454,7978,25,0,True,True,195.0585638888889,-0.24162375513571796
6525,5067817,271,1,0.61768,78,5069691,-1,500.0,5075230,5075501,7413,271,56,0,True,True,5.1998125,-0.61768
6526,5067939,8,2,0.907328,78,5069691,-1,1000.0,5069730,5069738,1791,8,69,1,True,True,0.3656666666666667,-0.907328
6527,5068033,7742,128,0.369638,78,5069691,-1,64000.0,5204632,5212374,136599,7742,15,2,True,True,19245.113244444445,-0.3685170051217566
6528,5068245,1090,16,0.684267,78,5069691,-1,8000.0,5070830,5071920,2585,1090,69,0,True,True,398.57666666666665,-0.684267
6529,5068303,4704,1,0.458164,78,5069691,-1,500.0,5107683,5112387,39380,4704,33,0,True,True,128.05040416666665,-0.4580428720983946
6530,5068311,8315,32,0.01032,78,5069691,-1,16000.0,5081770,5090085,13459,8315,49,0,True,True,4968.268888888889,-0.00991511140138249
6531,5068393,5,1,0.133205,78,5069691,-1,500.0,5087568,5087573,19175,5,45,0,True,True,0.0936388888888889,-0.133205
6532,5068451,6988,8,0.323246,78,5069691,-1,4000.0,5154344,5161332,85893,6988,22,0,True,True,1106.7208,-0.30325961162984216
6533,5068510,404,1,0.693024,78,5069691,-1,500.0,5081366,5081770,12856,404,52,0,True,True,8.336427777777777,-0.693024
6534,5068560,16577,16,0.686852,78,5069691,-1,8000.0,5143364,5159941,74804,16577,25,7,True,True,5827.6936444444445,-0.6518352196557908
6535,5070297,55,8,0.713336,81,5070830,-1,4000.0,5070830,5070885,533,55,76,0,True,True,10.055833333333334,-0.713336
6536,5070488,21,16,0.708453,81,5070830,-1,8000.0,5070830,5070851,342,21,76,0,True,True,7.679000000000001,-0.708453
6537,5070530,24,64,0.736104,81,5070830,-1,32000.0,5156544,5156568,86014,24,22,7,True,True,32.1152,-0.736104
6538,5070562,127,3,0.256226,81,5070830,-1,1500.0,5120644,5120771,50082,127,31,0,True,True,11.232091666666665,-0.256226
6539,5070647,163,16,0.095279,81,5070830,-1,8000.0,5081366,5081529,10719,163,56,0,True,True,53.815355555555556,-0.095279
6540,5070842,18,2,0.058752,80,5071930,-1,1000.0,5116244,5116262,45402,18,34,7,True,True,1.0591,-0.058752
6541,5071043,9435,128,0.332863,80,5071930,-1,64000.0,5138964,5148399,67921,9435,27,6,True,True,29714.958933333335,-0.3326851079197652
6542,5071157,12,2,0.234841,80,5071930,-1,1000.0,5107683,5107695,36526,12,39,0,True,True,0.6372666666666668,-0.234841
6543,5071348,14173,32,0.908227,80,5071930,-1,16000.0,5194830,5209003,123482,14173,16,7,True,True,8557.585822222223,-0.9075360646408643
6544,5075723,4,5,0.996739,75,5077430,-1,2500.0,5077430,5077434,1707,4,69,0,True,True,0.4222222222222222,-0.996739
6545,5075965,6144,4,0.939322,75,5077430,-1,2000.0,5084268,5090412,8303,6144,57,0,True,True,451.2654,-0.9269265647469932
6546,5075987,14922,11,0.96721,75,5077430,-1,5500.0,5154344,5169266,78357,14922,25,0,True,True,3174.2808777777773,-0.9235472472618426
6547,5076045,16635,1,0.598232,75,5077430,-1,500.0,5206832,5223467,130787,16635,15,7,True,True,337.74791666666664,-0.5977367220013297
6548,5076650,191,16,0.748242,75,5077430,-1,8000.0,5077430,5077621,780,191,73,0,True,True,64.51555555555555,-0.748242
6549,5077402,8956,1,0.045512,75,5077430,-1,500.0,5209032,5217988,131630,8956,15,0,True,True,179.37124444444444,-0.04507019742463627
6550,5077548,1352,24,0.253657,84,5081030,-1,12000.0,5105487,5106839,27939,1352,45,6,True,True,861.5845333333332,-0.2536570000000001
6551,5077564,570,1,0.619658,84,5081030,-1,500.0,5094382,5094952,16818,570,52,0,True,True,11.099166666666665,-0.619658
6552,5077611,21,1,0.302507,84,5081030,-1,500.0,5145564,5145585,67953,21,30,7,True,True,0.4940541666666666,-0.302507
6553,5078099,8601,32,0.394697,84,5081030,-1,16000.0,5096582,5105183,18483,8601,51,7,True,True,6713.357955555556,-0.3719642302629091
6554,5080001,6699,16,0.370901,84,5081030,-1,8000.0,5150964,5157663,70963,6699,29,0,True,True,2274.1433333333334,-0.3628265493331878
6555,5080498,12679,4,0.968058,84,5081030,-1,2000.0,5099882,5112561,19384,12679,51,7,True,True,1336.9560833333333,-0.9561982058446232
6556,5080698,22,8,0.55956,84,5081030,-1,4000.0,5097682,5097704,16984,22,52,6,True,True,4.224,-0.55956
6557,5080742,9657,4,0.580487,84,5081030,-1,2000.0,5104387,5114044,23645,9657,48,0,True,True,1036.6803333333332,-0.580005611013993
6558,5080766,5194,9,0.260292,84,5081030,-1,4500.0,5084268,5089462,3502,5194,68,0,True,True,855.2560000000001,-0.25803508006238984
6559,5080810,21,1,0.503747,84,5081030,-1,500.0,5103287,5103308,22477,21,51,2,True,True,0.5448333333333334,-0.503747
6560,5080885,14224,7,0.930327,84,5081030,-1,3500.0,5120644,5134868,39759,14224,36,0,True,True,2176.3232555555555,-0.8640103088345477
6561,5080936,29582,64,0.877897,84,5081030,-1,32000.0,5127244,5156826,46308,29582,35,7,True,True,41114.558577777774,-0.8693208623322309
6562,5081138,12826,2,0.13192,82,5081202,-1,1000.0,5156544,5169370,75406,12826,24,0,True,True,488.9949555555555,-0.1285083342496917
6563,5081581,2,1,0.317317,76,5081770,-1,500.0,5099882,5099884,18301,2,55,0,True,True,0.048,-0.317317
6564,5082006,14,128,0.530424,77,5084268,-1,64000.0,5275462,5275476,193456,14,7,1,True,True,46.151466666666664,-0.530424
6565,5083355,53,1,0.141796,77,5084268,-1,500.0,5150964,5151017,67609,53,33,0,True,True,1.1680611111111112,-0.141796
6566,5085337,14785,1,0.116842,75,5085368,-1,500.0,5350228,5365013,264891,14785,2,6,True,True,221.95097361111112,-0.11199747113167381
6567,5086109,6977,1,0.044162,75,5087568,-1,500.0,5143364,5150341,57255,6977,36,0,True,True,164.38234444444444,-0.040996808496667064
6568,5089938,60780,1,0.127871,71,5094382,-1,500.0,5425286,5486066,335348,60780,0,7,True,True,766.6178361111113,-0.12781941093025953
6569,5090018,12981,16,0.87168,71,5094382,-1,8000.0,5112680,5125661,22662,12981,51,6,True,True,5786.9126888888895,-0.8697631289045278
6570,5091684,9524,128,0.834804,71,5094382,-1,64000.0,5281021,5290545,189337,9524,9,7,True,True,26697.0272,-0.7814256458960133
6571,5094406,6929,64,0.747823,70,5096582,-1,32000.0,5217332,5224261,122926,6929,17,3,True,True,9353.347288888888,-0.7394423427001976
6572,5095444,3,1,0.926237,70,5096582,-1,500.0,5096582,5096585,1138,3,67,0,True,True,0.058416666666666665,-0.926237
6573,5095553,8195,223,0.282926,70,5096582,-1,111500.0,5321442,5329637,225889,8195,6,2,True,True,23707.848555555556,-0.2826415326180697
6574,5096599,12262,1,0.876936,70,5097682,-1,500.0,5152064,5164326,55465,12262,36,6,True,True,238.30450833333333,-0.8694892715612471
6575,5096743,32,8,0.612932,70,5097682,-1,4000.0,5109515,5109547,12772,32,57,2,True,True,7.023644444444444,-0.612932
6576,5097070,5,32,0.761564,70,5097682,-1,16000.0,5122844,5122849,25774,5,47,7,True,True,4.04688888888889,-0.761564
6577,5100341,7807,1,0.263758,75,5103287,-1,500.0,5138964,5146771,38623,7807,43,0,True,True,194.44066805555556,-0.26181127752837025
6578,5100628,80,2,0.31301,75,5103287,-1,1000.0,5154264,5154344,53636,80,36,7,True,True,3.4053333333333335,-0.31301
6579,5100698,194,1,0.892672,75,5103287,-1,500.0,5104387,5104581,3689,194,67,0,True,True,5.033222222222222,-0.892672
6580,5100889,10353,16,0.315543,75,5103287,-1,8000.0,5145564,5155917,44675,10353,41,0,True,True,3652.1849333333334,-0.3116116475964815
6581,5100985,72,32,0.994565,75,5103287,-1,16000.0,5107683,5107755,6698,72,65,2,True,True,61.177600000000005,-0.994565
6582,5101113,67,1,0.763675,75,5103287,-1,500.0,5127244,5127311,26131,67,47,0,True,True,1.2194930555555556,-0.763675
6583,5101574,67,1,0.151265,75,5103287,-1,500.0,5150964,5151031,49390,67,41,8,True,True,1.4766055555555555,-0.151265
6584,5101901,4297,16,0.853034,75,5103287,-1,8000.0,5107683,5111980,5782,4297,66,0,True,True,1876.153911111111,-0.8529054988397747
6585,5102944,20125,156,0.657419,75,5103287,-1,78000.0,5240890,5261015,137946,20125,14,8,True,True,55739.54425,-0.6237408595220133
6586,5128242,32,1,0.79822,74,5138964,-1,500.0,5141164,5141196,12922,32,47,0,True,True,0.8677777777777778,-0.79822
6587,5128271,14108,1,0.053222,74,5138964,-1,500.0,5294945,5309053,166674,14108,9,7,True,True,306.09236250000004,-0.053199073994869304
6588,5128407,7,4,0.148621,74,5138964,-1,2000.0,5157644,5157651,29237,7,30,6,True,True,0.5854333333333333,-0.148621
6589,5130887,635,3,0.229861,74,5138964,-1,1500.0,5178137,5178772,47250,635,29,1,True,True,59.57358333333333,-0.229861
6590,5130920,8067,4,0.035862,74,5138964,-1,2000.0,5179237,5187304,48317,8067,29,6,True,True,1064.4121555555555,-0.03579541701004151
6591,5131077,16965,3,0.260224,74,5138964,-1,1500.0,5349128,5366093,218051,16965,4,7,True,True,758.0736375,-0.2541127135943277
6592,5131166,38503,256,0.705963,74,5138964,-1,128000.0,5386783,5425286,255617,38503,1,6,True,True,166198.4078222222,-0.6918335786388267
6593,5131444,11072,64,0.43643,74,5138964,-1,32000.0,5178106,5189178,46662,11072,33,6,True,True,22711.432711111112,-0.43069947211353987
6594,5131824,305,8,0.995202,74,5138964,-1,4000.0,5141164,5141469,9340,305,55,7,True,True,66.16805555555555,-0.995202
6595,5131858,6,2,0.927206,74,5138964,-1,1000.0,5138964,5138970,7106,6,57,0,True,True,0.2682,-0.927206
6596,5132001,31,1,0.040792,74,5138964,-1,500.0,5178106,5178137,46105,31,33,0,True,True,0.9694388888888889,-0.040792
6597,5132627,12,2,0.35652,74,5138964,-1,1000.0,5154344,5154356,21717,12,42,0,True,True,0.5108,-0.35652
6598,5132646,11,32,0.709029,74,5138964,-1,16000.0,5182837,5182848,50191,11,31,0,True,True,11.819866666666668,-0.709029
6599,5132768,63,4,0.4852,74,5138964,-1,2000.0,5141164,5141227,8396,63,58,0,True,True,6.83375,-0.4852
6600,5137437,8,32,0.492989,74,5138964,-1,16000.0,5152064,5152072,14627,8,48,0,True,True,5.448533333333334,-0.492989
6601,5137751,372,4,0.845838,74,5138964,-1,2000.0,5138964,5139336,1213,372,61,0,True,True,33.2568,-0.845838
6602,5137821,23,16,0.866879,74,5138964,-1,8000.0,5138964,5138987,1143,23,62,0,True,True,8.2248,-0.866879
6603,5138159,13620,64,0.123654,74,5138964,-1,32000.0,5185037,5198657,46878,13620,30,7,True,True,20536.391822222224,-0.11712417334617715
6604,5138310,12092,4,0.093578,74,5138964,-1,2000.0,5286944,5299036,148634,12092,13,7,True,True,1012.6095333333333,-0.0923108231928312
6605,5138315,44,8,0.868173,74,5138964,-1,4000.0,5138964,5139008,649,44,67,0,True,True,7.8671999999999995,-0.868173
6606,5138352,14077,1,0.180655,74,5138964,-1,500.0,5346928,5361005,208576,14077,6,8,True,True,195.7863263888889,-0.1689484951092872
6607,5138365,14606,4,0.168295,74,5138964,-1,2000.0,5266415,5281021,128050,14606,17,8,True,True,1428.6572055555557,-0.16682802532070673
6608,5138746,14222,1,0.508738,74,5138964,-1,500.0,5300445,5314667,161699,14222,10,7,True,True,297.0995222222223,-0.49798611806344517
6609,5138845,10425,128,0.272792,74,5138964,-1,64000.0,5230465,5240890,91620,10425,25,7,True,True,26239.25955555556,-0.253591976988946
6610,5138867,11468,128,0.890895,74,5138964,-1,64000.0,5275476,5286944,136609,11468,17,0,True,True,35019.59751111111,-0.8724150147481166
6611,5138915,3,51,0.585677,74,5138964,-1,25500.0,5209032,5209035,70117,3,32,7,True,True,2.9616125,-0.585677
6612,5138991,9793,86,0.583547,77,5141164,-1,43000.0,5182837,5192630,43846,9793,39,0,True,True,24289.60003611111,-0.5296133484294498
6613,5139051,14,8,0.971627,77,5141164,-1,4000.0,5141164,5141178,2113,14,68,0,True,True,3.0372222222222223,-0.971627
6614,5139119,21313,8,0.526015,77,5141164,-1,4000.0,5292745,5314058,153626,21313,14,7,True,True,3594.4962666666665,-0.5242322439118786
6615,5139199,13858,1,0.570788,77,5141164,-1,500.0,5156544,5170402,17345,13858,52,0,True,True,272.79794444444445,-0.49919933399462785
6616,5139261,25,2,0.416419,77,5141164,-1,1000.0,5182837,5182862,43576,25,42,1,True,True,1.6789583333333333,-0.416419
6617,5139386,84,16,0.076835,77,5141164,-1,8000.0,5186137,5186221,46751,84,38,6,True,True,44.27733333333333,-0.076835
6618,5139411,23,2,0.768253,77,5141164,-1,1000.0,5150964,5150987,11553,23,66,0,True,True,1.013788888888889,-0.768253
6619,5139460,37,1,0.676909,77,5141164,-1,500.0,5150964,5151001,11504,37,67,0,True,True,0.8154388888888889,-0.676909
6620,5140670,18710,8,0.887368,77,5141164,-1,4000.0,5289144,5307854,148474,18710,16,7,True,True,3208.434244444444,-0.8853372672837275
8062,6358221,342,32,0.360206,1,6358221,-1,16000.0,6360421,6360763,2200,342,0,7,True,True,136.5112,-0.360206
8063,6358266,92,20,0.045754,9,6360421,-1,10000.0,6405302,6405394,47036,92,0,1,True,True,12.463444444444447,-0.045753999999999996
8064,6358282,6,2,0.807558,9,6360421,-1,1000.0,6362621,6362627,4339,6,1,7,True,True,0.1586,-0.807558
8065,6358418,23,9,0.325525,9,6360421,-1,4500.0,6375222,6375245,16804,23,1,1,True,True,3.1084500000000004,-0.325525
8066,6358437,80,1,0.444306,9,6360421,-1,500.0,6379622,6379702,21185,80,1,7,True,True,0.8867777777777779,-0.444306
8067,6358476,4851,256,0.606763,9,6360421,-1,128000.0,6816454,6821305,457978,4851,0,7,True,True,4343.330133333333,-0.5690835118063589
8068,6360282,60,1,0.400165,9,6360421,-1,500.0,6381892,6381952,21610,60,2,1,True,True,0.6650833333333334,-0.400165
8069,6360357,119,32,0.612592,9,6360421,-1,16000.0,6375103,6375222,14746,119,5,6,True,True,57.18346666666667,-0.612592
8070,6360389,6848,16,0.081369,9,6360421,-1,8000.0,6449567,6456415,89178,6848,1,1,True,True,2454.6392444444446,-0.07761047909974558
8071,6360402,49,8,0.427916,9,6360421,-1,4000.0,6377422,6377471,17020,49,5,7,True,True,4.815611111111111,-0.427916
8072,6360462,15084,128,0.931483,17,6362621,-1,64000.0,6434483,6449567,74021,15084,2,7,True,True,37257.75217777777,-0.9032189903575659
8073,6360498,7,1,0.930845,17,6362621,-1,500.0,6367021,6367028,6523,7,9,0,True,True,0.10348333333333333,-0.930845
8074,6360556,11,8,0.986871,17,6362621,-1,4000.0,6364821,6364832,4265,11,10,7,True,True,1.3009333333333333,-0.986871
8075,6360573,29,16,0.8571,17,6362621,-1,8000.0,6362621,6362650,2048,29,11,0,True,True,6.132533333333333,-0.8571
8076,6360604,29,1,0.905203,17,6362621,-1,500.0,6370621,6370650,10017,29,9,2,True,True,0.5235708333333333,-0.905203
8077,6361175,6398,8,0.734278,17,6362621,-1,4000.0,6367021,6373419,5846,6398,11,7,True,True,853.5189333333334,-0.7320701448621317
8078,6361220,21,4,0.293863,17,6362621,-1,2000.0,6403096,6403117,41876,21,4,0,True,True,0.6930000000000001,-0.293863
8079,6361398,70,10,0.195077,17,6362621,-1,5000.0,6381822,6381892,20424,70,6,7,True,True,7.759305555555556,-0.195077
8080,6361540,15,1,0.143161,17,6362621,-1,500.0,6407502,6407517,45962,15,3,7,True,True,0.10160416666666668,-0.143161
8081,6366417,26,8,0.520054,17,6367021,-1,4000.0,6373950,6373976,7533,26,12,0,True,True,3.123466666666667,-0.520054
8082,6366489,53,2,0.571893,17,6367021,-1,1000.0,6373950,6374003,7461,53,13,7,True,True,1.5917666666666668,-0.571893
8083,6366594,21937,8,0.856803,17,6367021,-1,4000.0,6395096,6417033,28502,21937,6,7,True,True,1391.2679666666666,-0.8424525837607781
8084,6368106,42,1,0.504637,27,6370621,-1,500.0,6390696,6390738,22590,42,7,7,True,True,0.35513333333333336,-0.504637
8085,6368627,17831,40,0.127861,27,6370621,-1,20000.0,6392896,6410727,24269,17831,7,7,True,True,5207.7979444444445,-0.11523318902566553
8086,6368649,17,16,0.796821,27,6370621,-1,8000.0,6371750,6371767,3101,17,17,0,True,True,4.910733333333334,-0.796821
8087,6368969,47,8,0.301348,27,6370621,-1,4000.0,6375222,6375269,6253,47,13,0,True,True,5.646266666666667,-0.301348
8088,6369032,435,8,0.673062,27,6370621,-1,4000.0,6370621,6371056,1589,435,19,0,True,True,62.828500000000005,-0.673062
8089,6369063,6,16,0.548747,27,6370621,-1,8000.0,6371750,6371756,2687,6,19,6,True,True,1.7332000000000003,-0.548747
8090,6369358,62,16,0.874786,27,6370621,-1,8000.0,6370650,6370712,1292,62,20,1,True,True,17.909733333333335,-0.874786
8091,6369380,5642,2,0.168053,27,6370621,-1,1000.0,6414404,6420046,45024,5642,3,1,True,True,73.69308333333333,-0.12159102440262033
8092,6369945,13,1,0.446287,27,6370621,-1,500.0,6377422,6377435,7477,13,13,0,True,True,0.15970138888888888,-0.446287
8093,6370044,10,4,0.115679,27,6370621,-1,2000.0,6390696,6390706,20652,10,9,0,True,True,0.33822222222222226,-0.115679
8094,6370359,41,4,0.662642,27,6370621,-1,2000.0,6374003,6374044,3644,41,19,2,True,True,2.4627333333333334,-0.662642
8095,6370436,80,1,0.240902,27,6370621,-1,500.0,6390696,6390776,20260,80,10,0,True,True,0.6764444444444445,-0.240902
8096,6370648,4,64,0.211641,26,6370650,-1,32000.0,6388492,6388496,17844,4,12,7,True,True,1.9050666666666667,-0.211641
8097,6370678,7258,32,0.753253,28,6371750,-1,16000.0,6375126,6382384,4448,7258,20,1,True,True,2772.372977777778,-0.6596653880772726
8098,6370994,8385,8,0.659745,28,6371750,-1,4000.0,6426783,6435168,55789,8385,3,0,True,True,902.4100666666667,-0.6390450070713933
8099,6371303,23,8,0.089432,28,6371750,-1,4000.0,6375103,6375126,3800,23,22,0,True,True,2.763066666666667,-0.089432
8100,6371759,2185,2,0.434893,27,6373950,-1,1000.0,6384092,6386277,12333,2185,14,7,True,True,39.044736111111106,-0.434893
8101,6376479,24,8,0.715765,27,6377422,-1,4000.0,6379622,6379646,3143,24,17,0,True,True,2.1282666666666668,-0.715765
8102,6376561,701,25,0.160235,27,6377422,-1,12500.0,6386292,6386993,9731,701,14,7,True,True,134.44645833333334,-0.1375839169222179
8103,6376661,203,32,0.928967,27,6377422,-1,16000.0,6377422,6377625,761,203,20,0,True,True,79.80155555555557,-0.928967
8104,6376712,103,5,0.902649,27,6377422,-1,2500.0,6377422,6377525,710,103,22,0,True,True,6.326631944444444,-0.902649
8105,6376806,18812,256,0.766309,27,6377422,-1,128000.0,6585375,6604187,208569,18812,1,7,True,True,100147.64124444444,-0.7143304039129166
8106,6377084,7,2,0.220376,27,6377422,-1,1000.0,6426411,6426418,49327,7,5,8,True,True,0.17721666666666666,-0.220376
8107,6377095,11908,32,0.257629,27,6377422,-1,16000.0,6445268,6457176,68173,11908,3,6,True,True,8293.114488888888,-0.25229179259119106
8108,6377131,47,4,0.476302,27,6377422,-1,2000.0,6388496,6388543,11365,47,16,1,True,True,1.3990333333333334,-0.476302
8109,6378238,10,1,0.897511,29,6379622,-1,500.0,6384092,6384102,5854,10,19,0,True,True,0.08934722222222222,-0.897511
8110,6378720,26,11,0.123098,29,6379622,-1,5500.0,6418811,6418837,40091,26,7,6,True,True,1.6361583333333332,-0.123098
8111,6378935,136,8,0.135756,29,6379622,-1,4000.0,6407502,6407638,28567,136,9,0,True,True,7.36968888888889,-0.135756
8112,6378951,139,64,0.534543,29,6379622,-1,32000.0,6397296,6397435,18345,139,13,7,True,True,45.69084444444444,-0.534543
8113,6379393,5,2,0.725414,29,6379622,-1,1000.0,6379622,6379627,229,5,26,0,True,True,0.11084722222222224,-0.725414
8114,6379472,188,16,0.090442,29,6379622,-1,8000.0,6403096,6403284,23624,188,13,3,True,True,24.816000000000003,-0.090442
8115,6380095,12873,4,0.691785,27,6381822,-1,2000.0,6399496,6412369,19401,12873,14,7,True,True,430.2748388888889,-0.6141744661410973
8116,6391925,24763,3,0.871941,18,6392896,-1,1500.0,6441968,6466731,50043,24763,4,7,True,True,1496.2839166666665,-0.8497140790915629
8117,6393083,6,2,0.93178,18,6395096,-1,1000.0,6405296,6405302,12213,6,13,7,True,True,0.08128333333333335,-0.93178
8118,6402404,10865,16,0.766337,18,6403096,-1,8000.0,6431183,6442048,28779,10865,6,6,True,True,2965.099311111111,-0.7152919987628865
8119,6402494,34078,256,0.600679,18,6403096,-1,128000.0,6859900,6893978,457406,34078,0,7,True,True,96843.76604444445,-0.6003054999192751
8120,6402669,20,1,0.643987,18,6403096,-1,500.0,6417711,6417731,15042,20,11,6,True,True,0.11725000000000001,-0.643987
8121,6404470,327,1,0.37701,18,6405296,-1,500.0,6408602,6408929,4132,327,13,6,True,True,3.4939041666666673,-0.37701
8122,6405043,16695,8,0.717443,18,6405296,-1,4000.0,6467676,6484371,62633,16695,3,6,True,True,1732.9732,-0.6985181065419348
8123,6405474,12420,141,0.736002,20,6407502,-1,70500.0,6532456,6544876,126982,12420,3,6,True,True,34507.99376666667,-0.6248904298417108
8124,6405788,47,4,0.381651,20,6407502,-1,2000.0,6412202,6412249,6414,47,15,4,True,True,2.0343166666666668,-0.381651
8125,6406712,10245,128,0.642102,20,6407502,-1,64000.0,6421011,6431256,14299,10245,12,7,True,True,13642.974400000001,-0.5718729174195677
8126,6406866,2,4,0.5619,20,6407502,-1,2000.0,6414402,6414404,7536,2,16,6,True,True,0.08656666666666667,-0.5619
8127,6409679,62,16,0.856141,19,6412202,-1,8000.0,6413302,6413364,3623,62,17,6,True,True,10.734266666666667,-0.856141
8128,6411880,3461,4,0.808447,19,6412202,-1,2000.0,6416604,6420065,4724,3461,15,7,True,True,80.44361666666666,-0.8013065546496682
8129,6412361,433,2,0.223551,22,6413302,-1,1000.0,6436683,6437116,24322,433,8,7,True,True,16.09698333333333,-0.2082426222805631
8130,6412410,16,2,0.11569,22,6413302,-1,1000.0,6426418,6426434,14008,16,12,1,True,True,0.4050666666666667,-0.11569
8131,6412419,8503,32,0.08768,22,6413302,-1,16000.0,6451767,6460270,39348,8503,5,7,True,True,6413.855288888889,-0.08661877526834579
8132,6412478,35,4,0.089139,22,6413302,-1,2000.0,6444168,6444203,31690,35,8,0,True,True,2.809138888888889,-0.089139
8133,6413657,15493,8,0.740581,25,6414402,-1,4000.0,6452867,6468360,39210,15493,5,0,True,True,2348.040933333333,-0.6975303813480324
8134,6413715,7,1,0.937211,25,6414402,-1,500.0,6416604,6416611,2889,7,20,0,True,True,0.0410375,-0.937211
8135,6413904,35,5,0.744618,25,6414402,-1,2500.0,6418811,6418846,4907,35,18,0,True,True,1.0011458333333334,-0.744618
8136,6414290,126,1,0.116106,25,6414402,-1,500.0,6452867,6452993,38577,126,6,6,True,True,2.8119000000000005,-0.116106
8137,6414603,58,4,0.367737,24,6416604,-1,2000.0,6416611,6416669,2008,58,22,1,True,True,1.3601,-0.367737
8138,6421226,22,8,0.85333,44,6426411,-1,4000.0,6426419,6426441,5193,22,16,1,True,True,2.227866666666667,-0.85333
8139,6421316,4,8,0.954069,44,6426411,-1,4000.0,6426434,6426438,5118,4,16,1,True,True,0.4050666666666667,-0.954069
8140,6421412,60,4,0.576917,44,6426411,-1,2000.0,6427883,6427943,6471,60,15,6,True,True,3.038,-0.576917
8141,6421880,8849,32,0.001678,44,6426411,-1,16000.0,6446368,6455217,24488,8849,9,6,True,True,6048.174577777778,-0.0015664626309251505
8142,6421934,8333,15,0.061885,44,6426411,-1,7500.0,6455067,6463400,33133,8333,5,7,True,True,2771.0870000000004,-0.0608250818686526
8143,6422009,22,1,0.535603,44,6426411,-1,500.0,6426783,6426805,4774,22,18,0,True,True,0.27848333333333336,-0.535603
8144,6422033,20390,32,0.847119,44,6426411,-1,16000.0,6439768,6460158,17735,20390,14,0,True,True,14118.371733333335,-0.8341890077287203
8145,6422764,6751,32,0.979849,44,6426411,-1,16000.0,6430083,6436834,7319,6751,18,7,True,True,3062.941466666667,-0.7896209075223625
8146,6423734,14,1,0.319643,44,6426411,-1,500.0,6444168,6444182,20434,14,13,7,True,True,0.28091388888888885,-0.319643
8147,6423866,23216,101,0.365024,44,6426411,-1,50500.0,6827105,6850321,403239,23216,1,1,True,True,7104.367494444445,-0.3644586842006648
8148,6423995,349,4,0.679302,44,6426411,-1,2000.0,6426434,6426783,2439,349,24,0,True,True,17.671033333333334,-0.679302
8149,6424009,34,8,0.796565,44,6426411,-1,4000.0,6426783,6426817,2774,34,24,0,True,True,3.4430666666666667,-0.796565
8150,6424161,8,1,0.519751,44,6426411,-1,500.0,6426783,6426791,2622,8,25,0,True,True,0.10126666666666667,-0.519751
8151,6424189,31,2,0.601618,44,6426411,-1,1000.0,6426783,6426814,2594,31,24,0,True,True,0.7848166666666667,-0.601618
8152,6424395,7,1,0.222142,44,6426411,-1,500.0,6436683,6436690,12288,7,17,0,True,True,0.10428055555555556,-0.222142
8153,6424449,25172,64,0.395312,44,6426411,-1,32000.0,6560203,6585375,135754,25172,4,1,True,True,20395.285866666665,-0.3797302304898304
8154,6424472,20451,2,0.538293,44,6426411,-1,1000.0,6765640,6786091,341168,20451,3,7,True,True,257.3424277777778,-0.4972278185692916
8155,6424527,15,4,0.460603,44,6426411,-1,2000.0,6432283,6432298,7756,15,22,0,True,True,0.7970833333333334,-0.460603
8156,6425008,71,1,0.144701,44,6426411,-1,500.0,6462976,6463047,37968,71,8,7,True,True,0.8866124999999999,-0.144701
8157,6425300,7485,4,0.94289,44,6426411,-1,2000.0,6432283,6439768,6983,7485,24,6,True,True,500.1442277777778,-0.9121408322706145
8158,6425396,13324,16,0.837217,44,6426411,-1,8000.0,6448568,6461892,23172,13324,14,7,True,True,4887.6272,-0.8362528405389419
8159,6425461,47,1,0.499833,44,6426411,-1,500.0,6439768,6439815,14307,47,21,4,True,True,0.9378458333333333,-0.499833
8160,6425543,224,1,0.455785,44,6426411,-1,500.0,6426783,6427007,1240,224,35,4,True,True,2.8354666666666666,-0.455785
8161,6425595,2,19,0.601465,44,6426411,-1,9500.0,6426434,6426436,839,2,37,0,True,True,0.4810166666666667,-0.601465
8162,6425609,443,1,0.145871,44,6426411,-1,500.0,6457176,6457619,31567,443,9,3,True,True,10.873188888888889,-0.145871
8163,6426025,8,1,0.665351,44,6426411,-1,500.0,6426411,6426419,386,8,42,0,True,True,0.10126666666666667,-0.665351
8164,6426378,7081,128,0.801292,44,6426411,-1,64000.0,6498976,6506057,72598,7081,7,7,True,True,5095.5452444444445,-0.6112983908063134
8165,6426457,11,1,0.702967,38,6426783,-1,500.0,6426783,6426794,326,11,34,0,True,True,0.13924166666666668,-0.702967
8166,6455460,21180,4,0.59888,16,6457176,-1,2000.0,6540156,6561336,84696,21180,6,0,True,True,1723.1466000000003,-0.5918185985838595
8167,6455719,12,32,0.308891,16,6457176,-1,16000.0,6466576,6466588,10857,12,10,4,True,True,4.3968,-0.308891
8168,6455822,29177,128,0.990335,16,6457176,-1,64000.0,6724812,6753989,268990,29177,4,7,True,True,17977.17048888889,-0.9658488514716175
8169,6455887,16,2,0.123464,16,6457176,-1,1000.0,6473476,6473492,17589,16,10,3,True,True,0.40577777777777774,-0.123464
8170,6456027,100,1,0.996849,16,6457176,-1,500.0,6460776,6460876,4749,100,14,4,True,True,2.373611111111111,-0.996849
8171,6456047,127,2,0.706522,16,6457176,-1,1000.0,6460776,6460903,4729,127,14,0,True,True,6.028972222222222,-0.706522
8172,6462804,16,1,0.478283,14,6462976,-1,500.0,6469876,6469892,7072,16,11,7,True,True,0.2772,-0.478283
8173,6468167,12202,32,0.828687,14,6469876,-1,16000.0,6486576,6498778,18409,12202,10,0,True,True,2814.7998222222222,-0.8266183200774679
8174,6468858,69,16,0.495026,14,6469876,-1,8000.0,6469876,6469945,1018,69,12,0,True,True,19.1268,-0.495026
8175,6468963,23944,16,0.70414,14,6469876,-1,8000.0,6607787,6631731,138824,23944,5,1,True,True,7953.888977777779,-0.6702514075838147
8176,6470414,2,40,0.376709,16,6473476,-1,20000.0,6481076,6481078,10662,2,12,7,True,True,1.0994444444444444,-0.376709
8177,6471051,30,4,0.981143,16,6473476,-1,2000.0,6478876,6478906,7825,30,13,0,True,True,1.2431666666666668,-0.981143
8178,6472282,19,8,0.333145,16,6473476,-1,4000.0,6483276,6483295,10994,19,12,7,True,True,2.0889444444444445,-0.333145
8179,6472694,35,2,0.827885,16,6473476,-1,1000.0,6478876,6478911,6182,35,15,8,True,True,0.7251805555555556,-0.827885
8180,6481475,21285,8,0.210613,16,6483276,-1,4000.0,6488776,6510061,7301,21285,11,7,True,True,1217.0199444444445,-0.1910401000211505
8181,6482751,3,1,0.732658,16,6483276,-1,500.0,6486576,6486579,3825,3,13,0,True,True,0.017050000000000003,-0.732658
8182,6482913,22,4,0.810419,16,6483276,-1,2000.0,6484376,6484398,1463,22,14,6,True,True,0.5001333333333334,-0.810419
8183,6483235,9208,8,0.700407,16,6483276,-1,4000.0,6502276,6511484,19041,9208,10,0,True,True,577.5528444444444,-0.6533297806792895
8184,6484147,1,32,0.052566,16,6484376,-1,16000.0,6486576,6486577,2429,1,15,7,True,True,0.18186666666666668,-0.052566
8185,6485258,9,16,0.865432,17,6486576,-1,8000.0,6492376,6492385,7118,9,12,2,True,True,0.9556,-0.865432
8186,6485563,36,20,0.17902,17,6486576,-1,10000.0,6502276,6502312,16713,36,11,6,True,True,3.3100000000000005,-0.17902
8187,6492039,8,26,0.487505,15,6492376,-1,13000.0,6496776,6496784,4737,8,13,7,True,True,1.9058,-0.487505
8188,6492231,31,32,0.391808,15,6492376,-1,16000.0,6494576,6494607,2345,31,14,7,True,True,9.0892,-0.391808
8189,6495591,2,1,0.98439,17,6496776,-1,500.0,6501176,6501178,5585,2,12,7,True,True,0.012072222222222222,-0.98439
8190,6495648,26,8,0.65925,17,6496776,-1,4000.0,6504476,6504502,8828,26,10,7,True,True,0.9562222222222222,-0.65925
8191,6495954,8,1,0.848518,17,6496776,-1,500.0,6501176,6501184,5222,8,13,0,True,True,0.04828888888888889,-0.848518
8192,6496746,14074,4,0.991063,17,6496776,-1,2000.0,6523176,6537250,26430,14074,10,7,True,True,1190.165888888889,-0.9885413987306162
8193,6498268,835,2,0.547943,20,6498976,-1,1000.0,6511076,6511911,12808,835,11,7,True,True,17.161569444444442,-0.547943
8194,6498325,12165,64,0.33741,20,6498976,-1,32000.0,6540156,6552321,41831,12165,9,7,True,True,16356.741333333335,-0.3334705127387919
8195,6498584,9640,64,0.677899,20,6498976,-1,32000.0,6562403,6572043,63819,9640,7,7,True,True,8868.0224,-0.5761866820810099
8196,6498674,14962,32,0.990314,20,6498976,-1,16000.0,6514376,6529338,15702,14962,13,6,True,True,7897.0743999999995,-0.9404556710636306
8197,6501826,1213,32,0.757714,21,6502276,-1,16000.0,6516576,6517789,14750,1213,13,7,True,True,441.8015555555556,-0.757714
8198,6502035,6153,1,0.391063,21,6502276,-1,500.0,6548156,6554309,46121,6153,9,7,True,True,105.6168888888889,-0.28383462281392974
8199,6502111,9289,8,0.527844,21,6502276,-1,4000.0,6506676,6515965,4565,9289,17,7,True,True,740.0469,-0.5274939040499471
8200,6502185,26,1,0.28304,21,6502276,-1,500.0,6548156,6548182,45971,26,9,0,True,True,0.7395555555555555,-0.28304
8201,6502386,77,27,0.696376,21,6504476,-1,13500.0,6508876,6508953,6490,77,18,7,True,True,21.3646125,-0.696376
8202,6504417,98,8,0.195092,21,6504476,-1,4000.0,6513276,6513374,8859,98,17,7,True,True,8.1634,-0.195092
8203,6506506,16072,16,0.856252,23,6506676,-1,8000.0,6523176,6539248,16670,16072,14,0,True,True,5343.167111111111,-0.8562451626456407
8204,6506530,393,2,0.393772,23,6506676,-1,1000.0,6511076,6511469,4546,393,19,0,True,True,8.077241666666666,-0.393772
8205,6506670,9,10,0.130901,23,6506676,-1,5000.0,6518776,6518785,12106,9,16,7,True,True,1.024375,-0.130901
8206,6506850,53,32,0.752266,24,6508876,-1,16000.0,6514376,6514429,7526,53,18,0,True,True,17.659599999999998,-0.752266
8207,6506902,10238,16,0.580384,24,6508876,-1,8000.0,6549256,6559494,42354,10238,9,6,True,True,3077.530355555555,-0.5638426850146135
8208,6514749,11,4,0.805072,23,6516576,-1,2000.0,6520976,6520987,6227,11,17,7,True,True,0.7709166666666667,-0.805072
8209,6515182,17122,16,0.84981,23,6516576,-1,8000.0,6637482,6654604,122300,17122,5,7,True,True,2350.5270666666665,-0.764511472546677
8210,6515205,5924,65,0.709588,23,6516576,-1,32500.0,6663114,6669038,147909,5924,5,7,True,True,1855.0842916666666,-0.7093976408688467
8211,6515302,21,4,0.457533,23,6516576,-1,2000.0,6524276,6524297,8974,21,17,6,True,True,1.5897,-0.457533
8212,6515336,13,4,0.163694,23,6516576,-1,2000.0,6556456,6556469,41120,13,11,4,True,True,1.165161111111111,-0.163694
8213,6518831,318,1,0.137561,24,6520976,-1,500.0,6540156,6540474,21325,318,15,0,True,True,5.606958333333333,-0.137561
8214,6519316,9030,256,0.695956,24,6520976,-1,128000.0,6934384,6943414,415068,9030,0,7,True,True,38243.332266666665,-0.633482633353339
8215,6520167,30595,8,0.291082,24,6520976,-1,4000.0,6829305,6859900,309138,30595,2,7,True,True,748.7396111111111,-0.29083254195261526
8216,6521012,76,8,0.144823,26,6523176,-1,4000.0,6545956,6546032,24944,76,17,7,True,True,17.294222222222224,-0.144823
8217,6521112,549,11,0.218136,26,6523176,-1,5500.0,6562403,6562952,41291,549,11,0,True,True,111.40664027777778,-0.2147800502100321
8218,6521118,54,4,0.748383,26,6523176,-1,2000.0,6526476,6526530,5358,54,23,7,True,True,4.0878,-0.748383
8219,6523224,6,4,0.735319,32,6524276,-1,2000.0,6535756,6535762,12532,6,22,0,True,True,0.5039333333333333,-0.735319
8220,6523228,25123,128,0.009133,32,6524276,-1,64000.0,6686314,6711437,163086,25123,7,8,True,True,68758.23697777778,-0.008895923309416628
8221,6523268,45,32,0.725958,32,6524276,-1,16000.0,6545956,6546001,22688,45,19,0,True,True,40.96000000000001,-0.725958
8222,6523290,5278,1,0.575682,32,6524276,-1,500.0,6607787,6613065,84497,5278,10,0,True,True,127.86808611111111,-0.540435725519643
8223,6523551,26792,8,0.678318,32,6524276,-1,4000.0,6789662,6816454,266111,26792,5,7,True,True,1370.8278666666665,-0.6772826304143584
8224,6523577,26,32,0.988484,32,6524276,-1,16000.0,6552856,6552882,29279,26,18,4,True,True,14.051555555555554,-0.988484
8225,6523687,13863,2,0.147605,32,6524276,-1,1000.0,6677314,6691177,153627,13863,9,6,True,True,540.8578277777779,-0.13755107640335673
8226,6523887,47,32,0.950398,32,6524276,-1,16000.0,6535756,6535803,11869,47,29,7,True,True,31.579822222222226,-0.950398
8227,6525544,23,3,0.427111,37,6526476,-1,1500.0,6537956,6537979,12412,23,28,7,True,True,1.216604166666667,-0.427111
8228,6525619,311,2,0.84166,37,6526476,-1,1000.0,6531356,6531667,5737,311,32,1,True,True,13.634758333333334,-0.84166
8229,6525992,180,14,0.925985,37,6526476,-1,7000.0,6531176,6531356,5184,180,33,6,True,True,55.24050000000001,-0.925985
8230,6526033,15294,16,0.096048,37,6526476,-1,8000.0,6604187,6619481,78154,15294,14,6,True,True,6019.505222222222,-0.09449416669359778
8231,6526045,205,1,0.974159,37,6526476,-1,500.0,6530076,6530281,4031,205,35,4,True,True,4.660048611111111,-0.974159
8232,6526122,1222,1,0.179633,37,6526476,-1,500.0,6626469,6627691,100347,1222,12,0,True,True,20.007018055555555,-0.17758562587254742
8233,6526796,10402,8,0.052472,41,6530076,-1,4000.0,6670714,6681116,143918,10402,10,7,True,True,579.2508444444444,-0.05046724911153305
8234,6526905,17,2,0.980277,41,6530076,-1,1000.0,6530076,6530093,3171,17,37,0,True,True,0.772886111111111,-0.980277
8235,6526907,11573,6,0.650098,41,6530076,-1,3000.0,6638582,6650155,111675,11573,12,6,True,True,637.5942666666665,-0.6471761062356682
8236,6526938,14957,64,0.593392,41,6530076,-1,32000.0,6617472,6632429,90534,14957,15,7,True,True,17451.772533333333,-0.5742973322973295
8237,6527026,8,13,0.969727,41,6530076,-1,6500.0,6533556,6533564,6530,8,36,6,True,True,2.2797666666666667,-0.969727
8238,6531734,19,16,0.626973,39,6532456,-1,8000.0,6543756,6543775,12022,19,30,3,True,True,5.882822222222223,-0.626973
8239,6531754,102,4,0.403994,39,6532456,-1,2000.0,6545956,6546058,14202,102,28,0,True,True,11.605333333333334,-0.403994
8240,6533797,30,16,0.033993,38,6535756,-1,8000.0,6560203,6560233,26406,30,22,0,True,True,8.802,-0.033993
8241,6537960,162,32,0.240855,38,6540156,-1,16000.0,6620927,6621089,82967,162,15,7,True,True,109.3968,-0.240855
8242,6537985,38206,4,0.488626,38,6540156,-1,2000.0,6896178,6934384,358193,38206,1,7,True,True,1415.2397666666666,-0.451602548903258
8243,6539007,11,16,0.687984,38,6540156,-1,8000.0,6540156,6540167,1149,11,37,0,True,True,3.1032222222222225,-0.687984
8244,6547958,81,1,0.954555,33,6548156,-1,500.0,6558656,6558737,10698,81,26,0,True,True,1.8149625,-0.954555
8245,6547981,6,8,0.652797,33,6548156,-1,4000.0,6562403,6562409,14422,6,23,0,True,True,0.8802000000000001,-0.652797
8246,6548054,15766,1,0.375372,33,6548156,-1,500.0,6763440,6779206,215386,15766,8,7,True,True,90.72392500000001,-0.36589454568048746
8247,6548764,1472,6,0.691795,33,6549256,-1,3000.0,6564603,6566075,15839,1472,23,7,True,True,165.47733333333335,-0.691795
8248,6549100,15973,4,0.795325,33,6549256,-1,2000.0,6643003,6658976,93903,15973,14,1,True,True,486.8162111111111,-0.7805651282374911
8249,6549404,11,16,0.658519,39,6552856,-1,8000.0,6552856,6552867,3452,11,32,0,True,True,2.9724444444444447,-0.658519
8250,6549461,127,2,0.777731,39,6552856,-1,1000.0,6558656,6558783,9195,127,30,0,True,True,5.691363888888889,-0.777731
8251,6549590,12228,128,0.864896,39,6552856,-1,64000.0,6893978,6906206,344388,12228,2,7,True,True,20921.46417777778,-0.6967296104420209
8252,6550270,447,16,0.650311,39,6552856,-1,8000.0,6559756,6560203,9486,447,31,6,True,True,131.1498,-0.650311
8253,6550672,574,8,0.275216,39,6552856,-1,4000.0,6633069,6633643,82397,574,18,7,True,True,52.023533333333326,-0.275216
8254,6550906,17,1,0.653195,39,6552856,-1,500.0,6566075,6566092,15169,17,26,0,True,True,0.31851388888888893,-0.653195
8255,6551317,9,4,0.367323,39,6552856,-1,2000.0,6558656,6558665,7339,9,36,7,True,True,0.8066500000000001,-0.367323
8256,6555872,21,16,0.12,38,6556456,-1,8000.0,6628669,6628690,72797,21,19,7,True,True,4.712866666666667,-0.12
8257,6556914,38837,32,0.082637,41,6558656,-1,16000.0,6688514,6727351,131600,38837,11,7,True,True,22493.12026666667,-0.07511012416330792
8258,6556980,7,1,0.489218,41,6558656,-1,500.0,6566075,6566082,9095,7,29,1,True,True,0.13115277777777778,-0.489218
8259,6557207,20,8,0.668792,41,6558656,-1,4000.0,6618727,6618747,61520,20,23,0,True,True,3.971333333333334,-0.668792
8260,6557226,30122,16,0.509748,41,6558656,-1,8000.0,6670714,6700836,113488,30122,14,0,True,True,8381.604800000001,-0.4778644603569322
8261,6560365,24923,8,0.023027,37,6562403,-1,4000.0,6821305,6846228,260940,24923,6,7,True,True,588.659,-0.022336379903862467
8262,6561375,4,4,0.572982,37,6562403,-1,2000.0,6635282,6635286,73907,4,21,6,True,True,0.19704444444444444,-0.572982
8263,6584225,8636,32,0.572631,35,6585375,-1,16000.0,6668514,6677150,84289,8636,17,8,True,True,1407.3800888888888,-0.5675427312946197
8264,6584326,115,1,0.273725,35,6585375,-1,500.0,6646603,6646718,62277,115,19,2,True,True,1.3135555555555554,-0.273725
8265,6584470,5285,1,0.745359,35,6585375,-1,500.0,6608887,6614172,24417,5285,30,0,True,True,123.78276805555555,-0.6690154424062313
8266,6584524,17,8,0.794344,35,6585375,-1,4000.0,6608887,6608904,24363,17,31,6,True,True,3.711477777777778,-0.794344
8267,6586397,15006,2,0.181097,71,6604187,-1,1000.0,6652214,6667220,65817,15006,19,7,True,True,163.1566,-0.1719135624872544
8268,6595995,36,1,0.484191,71,6604187,-1,500.0,6608887,6608923,12892,36,31,0,True,True,0.98245,-0.484191
8269,6598188,13,2,0.644597,71,6604187,-1,1000.0,6634169,6634182,35981,13,25,6,True,True,0.2945583333333333,-0.644597
8270,6598204,29295,1,0.433656,71,6604187,-1,500.0,6823505,6852800,225301,29295,6,7,True,True,87.89810416666667,-0.4295832608425847
8271,6598230,8526,1,0.571423,71,6604187,-1,500.0,6663114,6671640,64884,8526,19,0,True,True,41.30195833333333,-0.5554963870371407
8272,6598245,6341,32,0.099441,71,6604187,-1,16000.0,6660914,6667255,62669,6341,21,8,True,True,977.172,-0.09944025373575235
8273,6598319,6,32,0.063498,71,6604187,-1,16000.0,6628669,6628675,30350,6,30,0,True,True,2.6930666666666667,-0.063498
8274,6598385,98,4,0.908881,71,6604187,-1,2000.0,6607787,6607885,9402,98,40,0,True,True,10.697788888888889,-0.908881
8275,6598409,63,4,0.795225,71,6604187,-1,2000.0,6608887,6608950,10478,63,38,0,True,True,6.877150000000001,-0.795225
8276,6598586,39,1,0.18489,71,6604187,-1,500.0,6623127,6623166,24541,39,33,7,True,True,0.8230083333333333,-0.18489
8277,6598637,103,32,0.812868,71,6604187,-1,16000.0,6640782,6640885,42145,103,25,7,True,True,29.178755555555558,-0.812868
8278,6601227,155,32,0.019746,71,6604187,-1,16000.0,6618572,6618727,17345,155,37,6,True,True,123.11133333333333,-0.019746
8279,6601244,6,11,0.55606,71,6604187,-1,5500.0,6615272,6615278,14028,6,39,6,True,True,1.5535666666666665,-0.5560600000000001
8280,6601275,10,1,0.536417,71,6604187,-1,500.0,6624269,6624279,22994,10,34,1,True,True,0.1656111111111111,-0.536417
8281,6601296,8,1,0.812196,71,6604187,-1,500.0,6607787,6607795,6491,8,45,0,True,True,0.21832222222222222,-0.812196
8282,6601430,4,2,0.488563,71,6604187,-1,1000.0,6614172,6614176,12742,4,41,2,True,True,0.1883111111111111,-0.488563
8283,6601507,326,2,0.518901,71,6604187,-1,1000.0,6630869,6631195,29362,326,31,0,True,True,9.145205555555554,-0.518901
8284,6601557,3,8,0.584722,71,6604187,-1,4000.0,6648803,6648806,47246,3,23,7,True,True,0.27413333333333334,-0.584722
8285,6601724,7,16,0.713749,71,6604187,-1,8000.0,6608887,6608894,7163,7,44,0,True,True,3.056511111111111,-0.713749
8286,6601793,12,2,0.790068,71,6604187,-1,1000.0,6630869,6630881,29076,12,33,7,True,True,0.33663333333333334,-0.790068
8287,6602243,16242,8,0.124089,71,6604187,-1,4000.0,6735612,6751854,133369,16242,12,9,True,True,588.9864666666666,-0.12049406195947124
8288,6602328,45256,3,0.752988,71,6604187,-1,1500.0,6680914,6726170,78586,45256,16,0,True,True,2599.328433333334,-0.7458166315170272
8289,6602357,1768,4,0.965681,71,6604187,-1,2000.0,6626469,6628237,24112,1768,39,7,True,True,110.66170555555556,-0.9124295105268416
8290,6602381,3627,16,0.897602,71,6604187,-1,8000.0,6611087,6614714,8706,3627,48,0,True,True,1335.0650888888888,-0.8775229460379083
8291,6602432,111,70,0.180664,71,6604187,-1,35000.0,6649903,6650014,47471,111,25,6,True,True,48.30349999999999,-0.180664
8292,6602439,5630,63,0.599103,71,6604187,-1,31500.0,6680914,6686544,78475,5630,17,4,True,True,7244.4071,-0.4937338609014561
8293,6602850,587,4,0.179938,71,6604187,-1,2000.0,6618727,6619314,15877,587,46,0,True,True,58.27931666666667,-0.179938
8294,6602886,1,8,0.554722,71,6604187,-1,4000.0,6615272,6615273,12386,1,49,0,True,True,0.1883111111111111,-0.554722
8295,6602918,561,8,0.800513,71,6604187,-1,4000.0,6607787,6608348,4869,561,60,0,True,True,122.47876666666666,-0.800513
8296,6602928,8,1,0.123045,71,6604187,-1,500.0,6628669,6628677,25741,8,39,0,True,True,0.11221111111111111,-0.123045
8297,6602934,6208,3,0.128816,71,6604187,-1,1500.0,6676214,6682422,73280,6208,19,7,True,True,195.4764166666667,-0.08486219011187122
8298,6603044,9451,256,0.20623,71,6604187,-1,128000.0,6753989,6763440,150945,9451,12,8,True,True,13348.460088888889,-0.20410579087315026
8299,6603431,3571,256,0.16121,71,6604187,-1,128000.0,6786091,6789662,182660,3571,10,7,True,True,7682.265600000001,-0.16111707181432636
8300,6603479,6939,4,0.562496,71,6604187,-1,2000.0,6650014,6656953,46535,6939,29,1,True,True,172.05138888888888,-0.5591214389550652
8301,6603637,8,1,0.85145,71,6604187,-1,500.0,6607787,6607795,4150,8,63,0,True,True,0.21832222222222222,-0.85145
8302,6603653,369,2,0.035005,71,6604187,-1,1000.0,6655514,6655883,51861,369,28,6,True,True,4.615575,-0.035005
8303,6603719,80,8,0.979928,71,6604187,-1,4000.0,6607787,6607867,4068,80,69,0,True,True,17.46577777777778,-0.979928
8304,6604464,116,12,0.506148,84,6607787,-1,6000.0,6615272,6615388,10808,116,55,0,True,True,32.76613333333333,-0.506148
8305,6604573,1322,28,0.36356,84,6607787,-1,14000.0,6654414,6655736,49841,1322,29,7,True,True,231.50423333333333,-0.36356
8306,6604621,9127,32,0.544427,84,6607787,-1,16000.0,6641882,6651009,37261,9127,36,6,True,True,2635.5384888888884,-0.5067375006146118
8307,6604631,7934,1,0.423051,84,6607787,-1,500.0,6671814,6679748,67183,7934,22,6,True,True,51.597655555555555,-0.3494634720333639
8308,6606881,33034,2,0.945228,84,6607787,-1,1000.0,6898378,6931412,291497,33034,1,7,True,True,632.1043277777777,-0.9171651614228573
8309,6606899,42,16,8.6e-05,84,6607787,-1,8000.0,6624227,6624269,17328,42,53,6,True,True,11.129066666666667,-8.6e-05
8310,6606945,21,64,0.3006,84,6607787,-1,32000.0,6642982,6643003,36037,21,38,6,True,True,10.808,-0.3006
8311,6606974,17,16,0.946215,84,6607787,-1,8000.0,6608887,6608904,1913,17,68,0,True,True,7.422955555555556,-0.946215
8312,6607002,13375,128,0.519443,84,6607787,-1,64000.0,6711437,6724812,104435,13375,17,7,True,True,27334.01937777778,-0.5024301898387221
8313,6607032,18378,32,0.782802,84,6607787,-1,16000.0,6611087,6629465,4055,18378,67,7,True,True,12276.732977777778,-0.7575583371263127
8314,6607069,163,13,0.659158,84,6607787,-1,6500.0,6618727,6618890,11658,163,60,1,True,True,52.59534583333333,-0.6591579999999999
8315,6607310,9106,128,0.44492,84,6607787,-1,64000.0,6674014,6683120,66704,9106,24,7,True,True,11550.200888888889,-0.334985101093738
8316,6607654,318,16,0.577071,84,6607787,-1,8000.0,6607787,6608105,133,318,76,0,True,True,138.85293333333334,-0.577071
8317,6607660,14,1,0.695101,84,6607787,-1,500.0,6634182,6634196,26522,14,46,1,True,True,0.15860833333333332,-0.695101
4463,3615840,28,1,0.996973,1,3615840,-1,500.0,3615880,3615868,40,28,0,0,True,True,0.12911111111111112,-0.996973
4464,3615880,7607,32,0.625132,1,3615880,-1,16000.0,3618080,3625687,2200,7607,0,7,True,True,1217.9665333333332,-0.6244338362175138
4465,3615923,14759,32,0.059775,2,3618080,-1,16000.0,3627860,3638639,11937,14759,0,7,True,True,2220.1170666666667,-0.057016461499588354
4466,3615992,10,32,0.644575,2,3618080,-1,16000.0,3621680,3621690,5688,10,1,1,True,True,1.7124444444444447,-0.644575
4467,3627860,12820,256,0.701328,1,3627860,-1,128000.0,3638639,3651459,10779,12820,0,1,True,True,28806.753066666668,-0.5318548989482503
4468,3628129,6,4,0.791466,7,3638639,-1,2000.0,3655859,3655865,27730,6,0,7,True,True,0.42993333333333333,-0.791466
4469,3628218,19,32,0.125827,7,3638639,-1,16000.0,3665686,3665705,37468,19,0,8,True,True,10.663644444444445,-0.125827
4470,3628580,26,4,0.232675,7,3638639,-1,2000.0,3672286,3672312,43706,26,0,0,True,True,1.6034777777777778,-0.232675
4471,3628688,27,16,0.981676,7,3638639,-1,8000.0,3660259,3660286,31571,27,2,6,True,True,6.981599999999999,-0.981676
4472,3628874,34,4,0.788562,7,3638639,-1,2000.0,3651459,3651493,22585,34,4,8,True,True,2.6761777777777778,-0.788562
4473,3628952,22,8,0.756698,7,3638639,-1,4000.0,3660286,3660308,31334,22,2,2,True,True,2.8443555555555555,-0.756698
4474,3628991,27,1,0.805525,7,3638639,-1,500.0,3660259,3660286,31268,27,3,0,True,True,0.43634999999999996,-0.805525
4475,3641283,24,10,0.438719,10,3651459,-1,5000.0,3659159,3659183,17876,24,5,7,True,True,3.8786666666666667,-0.438719
4476,3641363,6696,4,0.192965,10,3651459,-1,2000.0,3690879,3697575,49516,6696,0,4,True,True,391.0894166666667,-0.18663637931984634
4477,3643034,67,1,0.68925,10,3651459,-1,500.0,3653659,3653726,10625,67,8,7,True,True,1.318411111111111,-0.68925
4478,3643821,17,8,0.358167,10,3651459,-1,4000.0,3656959,3656976,13138,17,7,6,True,True,2.4362888888888885,-0.358167
4479,3659990,2,4,0.134732,7,3660259,-1,2000.0,3686258,3686260,26268,2,1,1,True,True,0.12068888888888889,-0.134732
4480,3660044,204,25,0.898663,7,3660259,-1,12500.0,3667886,3668090,7842,204,3,6,True,True,89.44833333333332,-0.898663
4481,3660260,7004,128,0.485302,6,3660286,-1,64000.0,3700833,3707837,40573,7004,0,7,True,True,6983.360533333334,-0.4807713932658314
4482,3660679,5,16,0.4375,45,3665686,-1,8000.0,3678239,3678244,17560,5,3,0,True,True,1.2071111111111112,-0.4375
4483,3660746,5,1,0.294715,45,3665686,-1,500.0,3672286,3672291,11540,5,4,0,True,True,0.07709027777777779,-0.294715
4484,3660784,140,34,0.697038,45,3665686,-1,17000.0,3678233,3678373,17449,140,4,0,True,True,71.8231111111111,-0.697038
4485,3660860,9450,32,0.189776,45,3665686,-1,16000.0,3679346,3688796,18486,9450,3,0,True,True,4558.215733333333,-0.18203166342091492
4486,3661028,773,1,0.186627,45,3665686,-1,500.0,3686265,3687038,25237,773,2,0,True,True,13.544550000000001,-0.18129391085303634
4487,3661037,3,2,0.347665,45,3665686,-1,1000.0,3672286,3672289,11249,3,9,0,True,True,0.09250833333333335,-0.347665
4488,3661057,9,16,0.732402,45,3665686,-1,8000.0,3666786,3666795,5729,9,11,6,True,True,2.5256000000000003,-0.732402
4489,3661097,2714,1,0.275324,45,3665686,-1,500.0,3678246,3680960,17149,2714,5,1,True,True,37.282133333333334,-0.2506557790152626
4490,3661187,11,16,0.83135,45,3665686,-1,8000.0,3672286,3672297,11099,11,10,0,True,True,2.713577777777778,-0.83135
4491,3661202,4,6,0.914474,45,3665686,-1,3000.0,3671186,3671190,9984,4,12,6,True,True,0.39316666666666666,-0.914474
4492,3661241,8,1,0.55452,45,3665686,-1,500.0,3667886,3667894,6645,8,13,0,True,True,0.1403111111111111,-0.55452
4493,3661274,20842,1,0.068877,45,3665686,-1,500.0,3938073,3958915,276799,20842,0,7,True,True,178.3849361111111,-0.06783479697168728
4494,3661337,35594,16,0.155025,45,3665686,-1,8000.0,3793542,3829136,132205,35594,1,7,True,True,10191.748444444445,-0.14826765818737292
4495,3661440,101,8,0.295673,45,3665686,-1,4000.0,3676033,3676134,14593,101,10,2,True,True,12.191822222222223,-0.295673
4496,3661501,63,1,0.263349,45,3665686,-1,500.0,3676033,3676096,14532,63,10,0,True,True,0.9506000000000001,-0.263349
4497,3662111,8148,64,0.367113,45,3665686,-1,32000.0,3678233,3686381,16122,8148,10,7,True,True,7387.4764444444445,-0.35033334931030446
4498,3662159,5579,4,0.00072,45,3665686,-1,2000.0,3676033,3681612,13874,5579,11,0,True,True,316.61024444444445,-0.0007118814439549272
4499,3662220,11570,1,0.638026,45,3665686,-1,500.0,3687365,3698935,25145,11570,4,0,True,True,173.96240277777778,-0.6127413371140503
4500,3663788,609,1,0.379044,45,3665686,-1,500.0,3711944,3712553,48156,609,2,0,True,True,3.439158333333333,-0.379044
4501,3663875,76,8,0.185534,45,3665686,-1,4000.0,3672286,3672362,8411,76,20,0,True,True,9.374177777777778,-0.185534
4502,3663967,14665,10,0.01872,45,3665686,-1,5000.0,3766055,3780720,102088,14665,2,1,True,True,1447.7102083333332,-0.01854819166935716
4503,3664153,27,2,0.856829,45,3665686,-1,1000.0,3672286,3672313,8133,27,22,6,True,True,0.832575,-0.856829
4504,3664169,5448,2,0.776017,45,3665686,-1,1000.0,3678233,3683681,14064,5448,12,0,True,True,149.3936388888889,-0.7051899379492984
4505,3664201,8450,4,0.238787,45,3665686,-1,2000.0,3869329,3877779,205128,8450,1,6,True,True,437.6974833333333,-0.23312136896007818
4506,3664343,84,16,0.721004,45,3665686,-1,8000.0,3670086,3670170,5743,84,26,7,True,True,22.017333333333333,-0.721004
4507,3664361,91,1,0.658289,45,3665686,-1,500.0,3672286,3672377,7925,91,21,0,True,True,1.4030430555555555,-0.658289
4508,3664393,22,2,0.538957,45,3665686,-1,1000.0,3678233,3678255,13840,22,15,0,True,True,0.6639111111111111,-0.538957
4509,3664433,6,13,0.387491,45,3665686,-1,6500.0,3678233,3678239,13800,6,15,0,True,True,1.1769333333333334,-0.387491
4510,3664610,111,4,0.52407,45,3665686,-1,2000.0,3680446,3680557,15836,111,10,0,True,True,5.7738499999999995,-0.52407
4511,3664644,4,32,0.497549,45,3665686,-1,16000.0,3672286,3672290,7642,4,24,0,True,True,1.9735111111111112,-0.497549
4512,3664668,188,32,0.551468,45,3665686,-1,16000.0,3686258,3686446,21590,188,9,0,True,True,95.1024888888889,-0.48331250039237267
4513,3664712,4,8,0.613039,45,3665686,-1,4000.0,3672286,3672290,7574,4,28,0,True,True,0.4933777777777778,-0.613039
4514,3664784,6124,1,0.3226,45,3665686,-1,500.0,3736746,3742870,71962,6124,4,0,True,True,139.8254638888889,-0.3225624553081097
4515,3664816,16150,121,0.640904,45,3665686,-1,60500.0,3844310,3860460,179494,16150,2,8,True,True,27439.773319444444,-0.5890588918236082
4516,3665011,232,32,0.110464,45,3665686,-1,16000.0,3686256,3686488,21245,232,13,6,True,True,120.31040000000002,-0.09924522685019238
4517,3665100,33,4,0.523201,45,3665686,-1,2000.0,3693079,3693112,27979,33,8,0,True,True,2.1395,-0.523201
4518,3665246,165,101,0.06668,45,3665686,-1,50500.0,3678233,3678398,12987,165,23,0,True,True,251.45633333333333,-0.06668
4519,3665281,7,64,0.835193,45,3665686,-1,32000.0,3688665,3688672,23384,7,10,5,True,True,8.0808,-0.835193
4520,3665449,6317,8,0.129774,45,3665686,-1,4000.0,3768263,3774580,102814,6317,4,7,True,True,587.2597222222222,-0.12948183316253759
4521,3665460,328,4,0.873493,45,3665686,-1,2000.0,3672286,3672614,6826,328,33,0,True,True,20.22848888888889,-0.873493
4522,3665924,9014,74,0.202079,49,3666786,-1,37000.0,3773228,3782242,107304,9014,4,1,True,True,5408.878094444444,-0.19875722246105523
4523,3665959,15066,4,0.48537,49,3666786,-1,2000.0,3832907,3847973,166948,15066,3,6,True,True,968.3212166666667,-0.4359953681248114
4524,3665973,7608,3,0.098754,49,3666786,-1,1500.0,3693079,3700687,27106,7608,11,0,True,True,285.29069583333336,-0.08357447004718373
4525,3666177,10056,113,0.571012,49,3666786,-1,56500.0,3766063,3776119,99886,10056,7,1,True,True,12301.479293055556,-0.5707860991897068
4526,3666436,7,1,0.8363,49,3666786,-1,500.0,3670086,3670093,3650,7,45,0,True,True,0.11467361111111112,-0.8363
4527,3667058,8,8,0.657921,50,3667886,-1,4000.0,3670086,3670094,3028,8,45,0,True,True,1.0484444444444445,-0.657921
4528,3667074,37,8,0.525821,50,3667886,-1,4000.0,3678239,3678276,11165,37,24,0,True,True,4.466311111111112,-0.525821
4529,3668186,12,8,0.701314,62,3670086,-1,4000.0,3672286,3672298,4100,12,39,0,True,True,1.4801333333333335,-0.701314
4530,3668196,39839,1,0.255939,62,3670086,-1,500.0,3935873,3975712,267677,39839,1,7,True,True,288.68478055555556,-0.25350371926259824
4531,3668426,38,4,0.366354,62,3670086,-1,2000.0,3678246,3678284,9820,38,24,0,True,True,2.293511111111111,-0.366354
4532,3668615,13,64,0.605954,62,3670086,-1,32000.0,3680446,3680459,11831,13,22,0,True,True,10.819466666666665,-0.605954
4533,3668830,23991,4,0.070874,62,3670086,-1,2000.0,3686258,3710249,17428,23991,20,0,True,True,1127.8918555555554,-0.0636058071563345
4534,3668847,12081,256,0.930211,62,3670086,-1,128000.0,3921592,3933673,252745,12081,2,0,True,True,36713.296,-0.923018587812292
4535,3668865,5,1,0.208738,62,3670086,-1,500.0,3707544,3707549,38679,5,13,0,True,True,0.04697916666666667,-0.208738
4536,3669374,4541,184,0.491406,62,3670086,-1,92000.0,3735641,3740182,66267,4541,12,7,True,True,19021.04651111111,-0.49104931552763526
4537,3669407,7819,4,0.889767,62,3670086,-1,2000.0,3680456,3688275,11049,7819,26,0,True,True,474.44831666666664,-0.8290778329665386
4538,3669434,2,4,0.079957,62,3670086,-1,2000.0,3703033,3703035,33599,2,15,7,True,True,0.04993333333333333,-0.079957
4539,3669546,5723,2,0.80102,62,3670086,-1,1000.0,3685156,3690879,15610,5723,27,4,True,True,195.89849444444445,-0.7897637089153556
4540,3669588,33704,64,0.0607,62,3670086,-1,32000.0,3714144,3747848,44556,33704,13,0,True,True,32231.703466666666,-0.05601275241567482
4541,3669597,10,1,0.55802,62,3670086,-1,500.0,3674486,3674496,4889,10,46,7,True,True,0.15418055555555557,-0.55802
4542,3670045,612,43,0.938244,62,3670086,-1,21500.0,3703033,3703645,32988,612,16,0,True,True,164.2557,-0.938244
4543,3670118,3,16,0.415953,64,3671186,-1,8000.0,3678246,3678249,8128,3,35,0,True,True,0.7242666666666667,-0.415953
4544,3670126,12,8,0.369069,64,3671186,-1,4000.0,3697496,3697508,27370,12,19,7,True,True,1.0174666666666667,-0.369069
4545,3670158,26577,128,0.708434,64,3671186,-1,64000.0,3933673,3960250,263515,26577,2,0,True,True,28267.060444444443,-0.6739486831240286
4546,3670351,9,2,0.823643,64,3671186,-1,1000.0,3672286,3672295,1935,9,55,0,True,True,0.277525,-0.823643
4547,3670440,3747,1,0.265816,64,3671186,-1,500.0,3672286,3676033,1846,3747,57,0,True,True,57.628925,-0.26538247554068506
4548,3672786,28250,128,0.040653,58,3674486,-1,64000.0,3893342,3921592,220556,28250,4,0,True,True,57846.994844444445,-0.04018549744068502
4549,3672822,13457,128,0.070388,58,3674486,-1,64000.0,3782242,3795699,109420,13457,9,7,True,True,15316.364444444445,-0.06828639986919814
4550,3673201,21313,16,0.303905,58,3674486,-1,8000.0,3896642,3917955,223441,21313,4,7,True,True,5670.3936,-0.29781330076828
4551,3673565,89,1,0.944603,58,3674486,-1,500.0,3676033,3676122,2468,89,52,0,True,True,1.3429111111111112,-0.944603
4552,3673625,16711,4,0.960587,58,3674486,-1,2000.0,3688672,3705383,15047,16711,27,0,True,True,807.4396166666667,-0.8327465035344203
4553,3673741,75,2,0.097119,58,3674486,-1,1000.0,3733441,3733516,59700,75,17,0,True,True,3.3762499999999998,-0.097119
4554,3673762,201,1,0.725172,58,3674486,-1,500.0,3678246,3678447,4484,201,43,0,True,True,3.0328666666666666,-0.725172
4555,3673920,5,1,0.531661,58,3674486,-1,500.0,3686258,3686263,12338,5,33,0,True,True,0.07543055555555556,-0.531661
4556,3674946,25,1,0.18946,74,3676033,-1,500.0,3733441,3733466,58495,25,18,6,True,True,0.5627083333333333,-0.18946
4557,3674980,12598,32,0.526192,74,3676033,-1,16000.0,3750066,3762664,75086,12598,15,6,True,True,5974.46408888889,-0.48271347833463596
4558,3675045,21116,45,0.248763,74,3676033,-1,22500.0,3872629,3893745,197584,21116,6,7,True,True,9009.267499999998,-0.20712855208964365
4559,3675284,288,3,0.625325,74,3676033,-1,1500.0,3678233,3678521,2949,288,52,0,True,True,13.0368,-0.625325
4560,3675406,1649,5,0.178898,74,3676033,-1,2500.0,3686265,3687914,10859,1649,35,0,True,True,146.727,-0.17650154823499153
4561,3675425,101,1,0.749194,74,3676033,-1,500.0,3678244,3678345,2819,101,50,1,True,True,1.5239777777777779,-0.749194
4562,3675572,12,2,0.415185,74,3676033,-1,1000.0,3709744,3709756,34172,12,23,0,True,True,0.13233333333333336,-0.415185
4563,3675590,8667,16,0.105514,74,3676033,-1,8000.0,3805899,3814566,130309,8667,10,7,True,True,1646.4444666666666,-0.1026432987479565
4564,3675622,29,12,0.638624,74,3676033,-1,6000.0,3680446,3680475,4824,29,45,0,True,True,4.525449999999999,-0.638624
4565,3675637,7754,128,0.357963,74,3676033,-1,64000.0,3693079,3700833,17442,7754,32,7,True,True,12352.066133333334,-0.3032359215602287
4566,3675654,189,32,0.458721,74,3676033,-1,16000.0,3680446,3680635,4792,189,49,0,True,True,78.6492,-0.458721
4567,3675688,10761,1,0.665242,74,3676033,-1,500.0,3766041,3776802,90353,10761,17,0,True,True,114.89822916666667,-0.661476376867318
4568,3675741,8744,4,0.882824,74,3676033,-1,2000.0,3678239,3686983,2498,8744,57,0,True,True,504.5651388888889,-0.7812146663879043
4569,3675872,9308,1,0.166809,74,3676033,-1,500.0,3876229,3885537,200357,9308,6,1,True,True,62.10190416666666,-0.1331386293033758
4570,3675903,11829,72,0.180397,74,3676033,-1,36000.0,3761399,3773228,85496,11829,19,1,True,True,10508.8436,-0.1691652532255003
4571,3676012,238,1,0.401557,74,3676033,-1,500.0,3703144,3703382,27132,238,29,0,True,True,1.4855166666666666,-0.401557
4572,3676024,33,8,0.337513,74,3676033,-1,4000.0,3680456,3680489,4432,33,50,1,True,True,3.4331,-0.337513
4573,3676082,23,5,0.158176,83,3678233,-1,2500.0,3680456,3680479,4374,23,49,0,True,True,1.4954791666666667,-0.158176
4574,3676130,45,1,0.998434,83,3678233,-1,500.0,3678233,3678278,2103,45,71,0,True,True,0.679,-0.998434
4575,3676133,2356,2,0.443012,83,3678233,-1,1000.0,3695279,3697635,19146,2356,34,0,True,True,62.2564,-0.42401773140640076
4576,3676184,230,8,0.352324,83,3678233,-1,4000.0,3679346,3679576,3162,230,58,6,True,True,23.927666666666664,-0.352324
4577,3677867,53,45,0.315155,83,3678233,-1,22500.0,3686258,3686311,8391,53,46,0,True,True,35.980375,-0.315155
4578,3677893,32,1,0.991463,83,3678233,-1,500.0,3678239,3678271,346,32,68,1,True,True,0.48284444444444446,-0.991463
4579,3677973,1043,1,0.324654,83,3678233,-1,500.0,3704244,3705287,26271,1043,29,6,True,True,9.307804166666667,-0.3083531451114281
4580,3677995,13208,38,0.37172,83,3678233,-1,19000.0,3800099,3813307,122104,13208,12,7,True,True,5375.451869444444,-0.34777773417040686
4581,3678079,1889,4,0.764184,83,3678233,-1,2000.0,3681556,3683445,3477,1889,53,6,True,True,103.6309,-0.6947330489471895
4582,3678090,14913,128,0.430588,83,3678233,-1,64000.0,3878429,3893342,200339,14913,6,7,True,True,16580.993244444446,-0.376207968920705
4583,3678108,13165,16,0.725868,83,3678233,-1,8000.0,3693079,3706244,14971,13165,38,0,True,True,2177.4473333333335,-0.5865279464803942
4584,3678125,7,4,0.608413,83,3678233,-1,2000.0,3678239,3678246,114,7,73,0,True,True,0.42248888888888886,-0.608413
4585,3678176,6,37,0.563145,83,3678233,-1,18500.0,3680450,3680456,2274,6,59,1,True,True,2.8869249999999997,-0.563145
4586,3678377,8869,256,0.213928,70,3679346,-1,128000.0,3860460,3869329,182083,8869,10,7,True,True,30370.656,-0.1983777175926424
4587,3678440,12027,210,0.765708,70,3679346,-1,105000.0,3960250,3972277,281810,12027,0,7,True,True,14059.170125,-0.7499526047311885
4588,3679211,14,64,0.926147,70,3679346,-1,32000.0,3688665,3688679,9454,14,46,0,True,True,16.1616,-0.926147
4589,3679280,44,128,0.254089,70,3679346,-1,64000.0,3730123,3730167,50843,44,29,7,True,True,82.10204444444445,-0.254089
4590,3679312,4,1,0.961652,70,3679346,-1,500.0,3680446,3680450,1134,4,68,6,True,True,0.05201666666666666,-0.961652
4591,3679372,7906,32,0.4475,71,3680446,-1,16000.0,3698608,3706514,19236,7906,39,6,True,True,2098.0783111111114,-0.3841028070398604
4592,3680172,1984,32,0.397091,71,3680446,-1,16000.0,3695296,3697280,15124,1984,41,2,True,True,868.1927111111111,-0.3933728108688808
4593,3680281,13,14,0.726313,71,3680446,-1,7000.0,3680456,3680469,175,13,63,0,True,True,2.3667583333333333,-0.726313
4594,3680922,11742,86,0.982956,67,3681556,-1,43000.0,3707544,3719286,26622,11742,34,7,True,True,6183.7096,-0.7662436869626432
4595,3681024,1300,8,0.595763,67,3681556,-1,4000.0,3687365,3688665,6341,1300,53,0,True,True,187.59,-0.595763
4596,3681070,19,1,0.517609,67,3681556,-1,500.0,3705344,3705363,24274,19,35,6,True,True,0.17852083333333335,-0.517609
4597,3681095,23,32,0.993412,67,3681556,-1,16000.0,3687365,3687388,6270,23,55,6,True,True,13.2756,-0.993412
4598,3681213,5,32,0.301842,67,3681556,-1,16000.0,3686260,3686265,5047,5,58,1,True,True,2.413777777777778,-0.301842
4599,3681391,13,8,0.300334,67,3681556,-1,4000.0,3711944,3711957,30553,13,32,7,True,True,0.587311111111111,-0.300334
4600,3681904,3459,4,0.221887,75,3685156,-1,2000.0,3746603,3750062,64699,3459,25,1,True,True,269.57099999999997,-0.20272412513764493
4601,3682096,13849,4,0.85572,75,3685156,-1,2000.0,3697508,3711357,15412,13849,44,1,True,True,438.78301111111114,-0.8436750953767346
4602,3682167,19827,32,0.021701,75,3685156,-1,16000.0,3714168,3733995,32001,19827,31,1,True,True,6225.505866666666,-0.017554325339735197
4603,3682283,6,1,0.82194,75,3685156,-1,500.0,3686260,3686266,3977,6,62,0,True,True,0.09051666666666668,-0.82194
4604,3682525,22,32,0.689719,75,3685156,-1,16000.0,3688672,3688694,6147,22,55,1,True,True,12.698400000000001,-0.689719
4605,3682574,13,1,0.275957,75,3685156,-1,500.0,3695279,3695292,12705,13,49,6,True,True,0.17945416666666666,-0.275957
4606,3682589,3,4,0.553663,75,3685156,-1,2000.0,3687365,3687368,4776,3,61,0,True,True,0.21645000000000003,-0.553663
4607,3683826,2914,1,0.556323,75,3685156,-1,500.0,3708644,3711558,24818,2914,36,0,True,True,16.06747222222222,-0.556323
4608,3685104,2,1,0.925922,75,3685156,-1,500.0,3686256,3686258,1152,2,73,0,True,True,0.030172222222222222,-0.925922
4609,3688341,561,1,0.154715,62,3688665,-1,500.0,3741282,3741843,52941,561,26,6,True,True,12.796254166666666,-0.154715
4610,3688365,19295,64,0.037736,62,3688665,-1,32000.0,3894442,3913737,206077,19295,6,6,True,True,20102.99511111111,-0.03528819939100607
4611,3688398,12603,8,0.355656,62,3688665,-1,4000.0,3898842,3911445,210444,12603,5,7,True,True,1609.2508666666668,-0.33773890063214895
4612,3688772,56,1,0.138408,67,3690879,-1,500.0,3732323,3732379,43551,56,33,7,True,True,0.8163555555555555,-0.138408
4613,3688871,53,8,0.367083,67,3690879,-1,4000.0,3719764,3719817,30893,53,35,4,True,True,3.493288888888889,-0.367083
4614,3688977,11,8,0.582156,67,3690879,-1,4000.0,3703144,3703155,14167,11,46,0,True,True,0.5492666666666667,-0.582156
4615,3689104,7367,16,0.232994,67,3690879,-1,8000.0,3766041,3773408,76937,7367,25,0,True,True,1336.2144222222223,-0.2328795657293359
4616,3689453,19,1,0.811074,67,3690879,-1,500.0,3693079,3693098,3626,19,59,0,True,True,0.30795833333333333,-0.811074
4617,3690701,14513,16,0.091905,67,3690879,-1,8000.0,3773228,3787741,82527,14513,20,0,True,True,1953.315133333333,-0.08677277399508641
4618,3690792,149,32,0.399798,67,3690879,-1,16000.0,3709744,3709893,18952,149,43,6,True,True,26.290222222222226,-0.399798
4619,3690846,16952,256,0.917882,67,3690879,-1,128000.0,4015222,4032174,324376,16952,0,7,True,True,74189.04533333333,-0.9153687364334672
4620,3690876,21615,64,0.734266,67,3690879,-1,32000.0,3815507,3837122,124631,21615,17,7,True,True,38036.74471111111,-0.7302980541009115
4621,3690903,30,8,0.723581,75,3693079,-1,4000.0,3693079,3693109,2176,30,66,0,True,True,3.89,-0.723581
4622,3691207,140,16,0.792904,75,3693079,-1,8000.0,3694179,3694319,2972,140,62,0,True,True,30.921333333333333,-0.792904
4623,3691710,20607,32,0.172902,75,3693079,-1,16000.0,3742895,3763502,51185,20607,32,1,True,True,11105.734622222222,-0.16037919728533997
4624,3691896,6844,35,0.825705,75,3693079,-1,17500.0,3741843,3748687,49947,6844,33,1,True,True,5121.838166666666,-0.7986620091867915
4625,3692532,17,8,0.689595,75,3693079,-1,4000.0,3695279,3695296,2747,17,62,0,True,True,1.8773666666666666,-0.689595
4626,3692654,1207,32,0.576232,75,3693079,-1,16000.0,3693079,3694286,425,1207,67,0,True,True,573.2544,-0.5276539105977769
4627,3692800,10,1,0.907656,75,3693079,-1,500.0,3693079,3693089,279,10,67,0,True,True,0.16208333333333336,-0.907656
4628,3692903,3,12,0.595231,75,3693079,-1,6000.0,3694179,3694182,1276,3,66,0,True,True,0.49695,-0.595231
4629,3693006,11,21,0.300393,75,3693079,-1,10500.0,3694179,3694190,1173,11,67,6,True,True,3.1887624999999997,-0.300393
4630,3699045,8653,32,0.730789,65,3700833,-1,16000.0,3789142,3797795,90097,8653,21,0,True,True,2480.964,-0.7299338838912426
4631,3699066,22116,32,0.576284,65,3700833,-1,16000.0,3779053,3801169,79987,22116,23,6,True,True,6060.537733333334,-0.5633589653070886
4632,3699271,21,1,0.078477,65,3700833,-1,500.0,3742874,3742895,43603,21,35,1,True,True,0.4790041666666667,-0.078477
4633,3699282,111,18,0.055923,65,3700833,-1,9000.0,3703033,3703144,3751,111,59,0,True,True,12.47085,-0.055923
4634,3699352,13,4,0.770902,65,3700833,-1,2000.0,3708644,3708657,9292,13,52,6,True,True,0.2867222222222222,-0.770902
4635,3699478,11,4,0.34793,65,3700833,-1,2000.0,3732341,3732352,32863,11,42,1,True,True,0.6414222222222222,-0.34793
4636,3699527,13020,12,0.817142,65,3700833,-1,6000.0,3703144,3716164,3617,13020,60,0,True,True,1057.4388666666669,-0.7804155975022927
4637,3700163,6,11,0.416522,65,3700833,-1,5500.0,3708644,3708650,8481,6,52,0,True,True,0.3639166666666667,-0.416522
4638,3701086,44,32,0.867831,67,3703033,-1,16000.0,3721964,3722008,20878,44,45,7,True,True,11.600355555555556,-0.867831
4639,3701224,130,1,0.869787,67,3703033,-1,500.0,3703033,3703163,1809,130,63,0,True,True,0.8114166666666666,-0.869787
4640,3701346,187,32,0.226718,67,3703033,-1,16000.0,3714144,3714331,12798,187,49,7,True,True,33.79297777777778,-0.226718
4641,3712058,24,36,0.652779,51,3714144,-1,18000.0,3714144,3714168,2086,24,48,0,True,True,4.8792,-0.652779
4642,3712151,13959,64,0.602302,51,3714144,-1,32000.0,3716164,3730123,4013,13959,47,6,True,True,7660.403555555556,-0.4975136142002926
4643,3714914,7407,9,0.011434,51,3716164,-1,4500.0,3759166,3766573,44252,7407,32,6,True,True,878.8570374999999,-0.01115247444805762
4644,3715223,18,16,0.777419,51,3716164,-1,8000.0,3724164,3724182,8941,18,46,7,True,True,1.844,-0.777419
4645,3715324,18,16,0.382487,51,3716164,-1,8000.0,3732323,3732341,16999,18,44,0,True,True,4.1983999999999995,-0.382487
4646,3715542,5,8,0.304783,51,3716164,-1,4000.0,3736741,3736746,21199,5,40,6,True,True,0.9003333333333334,-0.304783
4647,3720730,18,16,0.041182,52,3721964,-1,8000.0,3748948,3748966,28218,18,34,6,True,True,5.3964,-0.041182
4648,3720939,56,4,0.53993,52,3721964,-1,2000.0,3740182,3740238,19243,56,40,1,True,True,5.119022222222222,-0.53993
4649,3721655,12,1,0.14958,52,3721964,-1,500.0,3761545,3761557,39890,12,31,3,True,True,0.15286666666666668,-0.14958
4650,3723113,108,2,0.502402,56,3724164,-1,1000.0,3746495,3746603,23382,108,37,1,True,True,4.606199999999999,-0.502402
4651,3723509,38,1,0.220797,56,3724164,-1,500.0,3789142,3789180,65633,38,21,0,True,True,0.3243194444444445,-0.220797
4652,3723658,819,1,0.05052,56,3724164,-1,500.0,3766063,3766882,42405,819,28,0,True,True,7.7975625,-0.05052
4653,3723949,12732,20,0.731579,56,3724164,-1,10000.0,3748948,3761680,24999,12732,37,0,True,True,3878.6081111111107,-0.7022960439174999
4654,3724018,394,4,0.392883,56,3724164,-1,2000.0,3747703,3748097,23685,394,39,6,True,True,29.530299999999997,-0.392883
4655,3733006,4,16,0.445616,53,3733441,-1,8000.0,3742870,3742874,9864,4,44,1,True,True,1.4598222222222221,-0.445616
4656,3733414,122,4,0.595132,53,3733441,-1,2000.0,3733441,3733563,27,122,52,0,True,True,10.984066666666667,-0.595132
4657,3736777,71,3,0.504729,53,3740182,-1,1500.0,3748966,3749037,12189,71,37,1,True,True,3.9910874999999995,-0.504729
4658,3736867,291,2,0.222086,53,3740182,-1,1000.0,3746603,3746894,9736,291,41,0,True,True,12.411149999999997,-0.222086
4659,3737473,40,1,0.289783,53,3740182,-1,500.0,3755866,3755906,18393,40,36,2,True,True,0.6228888888888889,-0.289783
4660,3737586,14,4,0.394322,53,3740182,-1,2000.0,3766041,3766055,28455,14,33,4,True,True,0.5331666666666667,-0.394322
4661,3737606,16503,3,0.132189,53,3740182,-1,1500.0,3831807,3848310,94201,16503,17,7,True,True,818.280275,-0.12513930143199078
4662,3737796,274,12,0.082545,53,3740182,-1,6000.0,3766063,3766337,28267,274,30,0,True,True,31.304499999999997,-0.082545
4663,3740770,18193,1,0.571441,57,3741282,-1,500.0,3747848,3766041,7078,18193,44,1,True,True,275.1017875,-0.5667322022220417
4664,3740870,2,4,0.049311,57,3741282,-1,2000.0,3788042,3788044,47172,2,24,0,True,True,0.06827777777777778,-0.049311
4665,3740946,4650,1,0.399191,57,3741282,-1,500.0,3838910,3843560,97964,4650,16,7,True,True,67.64198611111111,-0.37581934791319316
4666,3741105,22,1,0.085079,57,3741282,-1,500.0,3766041,3766063,24936,22,35,0,True,True,0.20945833333333333,-0.085079
4667,3741132,20,4,0.501823,57,3741282,-1,2000.0,3748948,3748968,7816,20,45,0,True,True,1.499,-0.501823
4668,3741765,21010,1,0.773825,59,3741843,-1,500.0,3870429,3891439,128664,21010,13,6,True,True,201.09818055555553,-0.7529095136251954
4669,3741794,1379,32,0.130375,59,3741843,-1,16000.0,3747848,3749227,6054,1379,49,0,True,True,826.8484,-0.130375
4670,3741818,8052,16,0.134871,59,3741843,-1,8000.0,3777928,3785980,36110,8052,29,0,True,True,1015.5622222222221,-0.12318195552459706
4671,3742130,11773,256,0.559296,60,3742870,-1,128000.0,3975712,3987485,233582,11773,1,7,True,True,17146.9856,-0.5500921401514431
4672,3742226,27737,2,0.487861,60,3742870,-1,1000.0,3987485,4015222,245259,27737,1,0,True,True,642.3460138888889,-0.45873318242828165
4673,3744910,24,1,0.652248,67,3746495,-1,500.0,3747848,3747872,2938,24,52,0,True,True,0.44970000000000004,-0.652248
4674,3745166,37,4,0.196099,67,3746495,-1,2000.0,3777928,3777965,32762,37,32,0,True,True,1.1696111111111112,-0.196099
4675,3745225,5,16,0.615997,67,3746495,-1,8000.0,3747848,3747853,2623,5,55,0,True,True,1.499,-0.615997
4676,3745556,5180,2,0.735668,67,3746495,-1,1000.0,3747848,3753028,2292,5180,54,0,True,True,180.3444888888889,-0.7281222845900504
4677,3745892,345,7,0.246246,67,3746495,-1,3500.0,3788042,3788387,42150,345,29,7,True,True,20.61135416666667,-0.246246
4678,3745926,7556,18,0.071644,67,3746495,-1,9000.0,3835107,3842663,89181,7556,20,7,True,True,2256.099775,-0.06784326923311162
4679,3746126,1346,1,0.776772,67,3746495,-1,500.0,3746603,3747949,477,1346,61,0,True,True,27.8004125,-0.7523340232080117
4680,3746157,12869,5,0.323412,67,3746495,-1,2500.0,3811399,3824268,65242,12869,24,7,True,True,1528.1801666666668,-0.27511451440878537
4681,3746241,9785,64,0.924138,67,3746495,-1,32000.0,3752266,3762051,6025,9785,51,7,True,True,8997.969688888888,-0.8809036240142352
4682,3746249,7103,1,0.089595,67,3746495,-1,500.0,3829607,3836710,83358,7103,23,6,True,True,162.20224305555556,-0.07560397716738189
4683,3755003,82,3,0.671748,59,3755866,-1,1500.0,3761366,3761448,6363,82,50,0,True,True,3.1337666666666664,-0.6717479999999999
4684,3755163,75,16,0.423541,59,3755866,-1,8000.0,3758066,3758141,2903,75,52,7,True,True,18.686666666666667,-0.423541
4685,3755216,149,15,0.348308,59,3755866,-1,7500.0,3777953,3778102,22737,149,35,1,True,True,17.662708333333335,-0.348308
4686,3755303,664,1,0.320738,59,3755866,-1,500.0,3791342,3792006,36039,664,29,7,True,True,6.0682222222222215,-0.320738
4687,3755563,12,7,0.593877,59,3755866,-1,3500.0,3755866,3755878,303,12,55,0,True,True,1.3080666666666667,-0.593877
4688,3755616,5197,2,0.024207,59,3755866,-1,1000.0,3815507,3820704,59891,5197,24,0,True,True,254.84503888888887,-0.01850097882438289
4689,3755685,162,1,0.304819,59,3755866,-1,500.0,3789142,3789304,33457,162,33,6,True,True,1.382625,-0.304819
4690,3755779,25,4,0.987652,59,3755866,-1,2000.0,3761545,3761570,5766,25,52,0,True,True,1.2738888888888888,-0.987652
4691,3755886,133,1,0.616221,71,3758066,-1,500.0,3761545,3761678,5659,133,53,0,True,True,1.6942722222222224,-0.616221
4692,3756006,65,1,0.990159,71,3758066,-1,500.0,3761366,3761431,5360,65,57,7,True,True,0.8280277777777777,-0.990159
4693,3756031,311,16,0.44221,71,3758066,-1,8000.0,3763745,3764056,7714,311,52,7,True,True,72.26948888888889,-0.44221
4694,3756055,4751,128,0.145818,71,3758066,-1,64000.0,3809199,3813950,53144,4751,27,7,True,True,7625.728711111111,-0.14572050133353762
4695,3756222,13626,35,0.044878,71,3758066,-1,17500.0,3826307,3839933,70085,13626,24,9,True,True,11144.574631944446,-0.03856396845799019
4696,3756261,33,32,0.818172,71,3758066,-1,16000.0,3761366,3761399,5105,33,59,0,True,True,13.452266666666667,-0.818172
4697,3756506,69,2,0.199685,71,3758066,-1,1000.0,3803699,3803768,47193,69,30,4,True,True,1.3136833333333333,-0.199685
4698,3756759,40,8,0.373821,71,3758066,-1,4000.0,3766063,3766103,9304,40,49,0,True,True,3.046666666666667,-0.373821
4699,3756843,17162,1,0.757734,71,3758066,-1,500.0,3793542,3810704,36699,17162,32,0,True,True,166.76463333333334,-0.7218626772494919
4700,3756862,6542,32,0.852764,71,3758066,-1,16000.0,3795699,3802241,38837,6542,32,1,True,True,1832.4745777777778,-0.8047342744195848
4701,3756895,3,1,0.112372,71,3758066,-1,500.0,3776828,3776831,19933,3,46,5,True,True,0.023708333333333335,-0.112372
4702,3756915,8,32,0.054538,71,3758066,-1,16000.0,3763745,3763753,6830,8,59,0,True,True,3.7180444444444443,-0.054538
4703,3757054,179,8,0.948941,71,3758066,-1,4000.0,3761366,3761545,4312,179,65,0,True,True,18.24208888888889,-0.948941
4704,3757085,210,1,0.92673,71,3758066,-1,500.0,3761366,3761576,4281,210,68,0,True,True,2.6751666666666667,-0.92673
4705,3762278,398,1,0.868752,65,3763745,-1,500.0,3766041,3766439,3763,398,58,0,True,True,3.7892916666666667,-0.868752
4706,3762315,1072,16,0.820134,65,3763745,-1,8000.0,3763745,3764817,1430,1072,60,0,True,True,249.10897777777774,-0.820134
4707,3762596,873,2,0.013733,65,3763745,-1,1000.0,3813307,3814180,50711,873,27,1,True,True,21.91715,-0.013733
4708,3762738,3561,13,0.693795,65,3763745,-1,6500.0,3766041,3769602,3303,3561,56,0,True,True,460.24382083333325,-0.5205259754805381
4709,3763357,38,8,0.111278,65,3763745,-1,4000.0,3806999,3807037,43642,38,30,6,True,True,3.2059333333333337,-0.111278
4710,3763829,30,16,0.450062,70,3766041,-1,8000.0,3768263,3768293,4434,30,51,0,True,True,4.569999999999999,-0.450062
4711,3763901,3,1,0.022748,70,3766041,-1,500.0,3828507,3828510,64606,3,24,7,True,True,0.09047916666666668,-0.022748
4712,3764374,127,1,0.20901,70,3766041,-1,500.0,3795699,3795826,31325,127,35,0,True,True,1.1401777777777777,-0.20901
4713,3764568,25,1,0.538005,70,3766041,-1,500.0,3777928,3777953,13360,25,50,6,True,True,0.19756944444444444,-0.538005
4714,3765006,404,1,0.203801,70,3766041,-1,500.0,3836710,3837114,71704,404,20,1,True,True,7.8005666666666675,-0.203801
4715,3765081,180,8,0.523266,70,3766041,-1,4000.0,3797899,3798079,32818,180,36,7,True,True,12.609366666666666,-0.5103691876701733
4716,3765135,8,64,0.258658,70,3766041,-1,32000.0,3795699,3795707,30564,8,38,0,True,True,4.596622222222222,-0.258658
4717,3765185,10,13,0.483026,70,3766041,-1,6500.0,3779053,3779063,13868,10,49,0,True,True,1.0273611111111112,-0.483026
4718,3766817,15506,16,0.729924,60,3768263,-1,8000.0,3785842,3801348,19025,15506,48,1,True,True,2202.9646666666667,-0.7139706150265305
2412,2106290,17,16,0.418239,1,2106290,-1,8000.0,2111690,2111707,5400,17,0,8,True,True,9.4452,-0.418239
2413,2106514,39,2,0.137867,11,2111690,-1,1000.0,2123727,2123766,17213,39,0,0,True,True,1.408225,-0.137867
2414,2107603,2989,8,0.38371,11,2111690,-1,4000.0,2141831,2144820,34228,2989,0,0,True,True,775.8669222222222,-0.38167867188248533
2415,2108333,8303,4,0.185754,11,2111690,-1,2000.0,2122627,2130930,14294,8303,2,6,True,True,581.0519833333333,-0.18280356139401308
2416,2108437,24111,8,0.635502,11,2111690,-1,4000.0,2171120,2195231,62683,24111,0,1,True,True,5556.108844444445,-0.624907798368281
2417,2108484,12,32,0.693433,11,2111690,-1,16000.0,2119307,2119319,10823,12,4,0,True,True,7.398933333333333,-0.693433
2418,2108758,197,16,0.64526,11,2111690,-1,8000.0,2111690,2111887,2932,197,5,0,True,True,109.4532,-0.64526
2419,2108788,39,8,0.9999,11,2111690,-1,4000.0,2111690,2111729,2902,39,6,0,True,True,10.834200000000001,-0.9999
2420,2108947,3,8,0.554913,11,2111690,-1,4000.0,2111707,2111710,2760,3,5,1,True,True,0.8334000000000001,-0.554913
2421,2108974,32,32,0.489642,11,2111690,-1,16000.0,2117107,2117139,8133,32,5,0,True,True,19.73048888888889,-0.489642
2422,2109516,18,16,0.140297,11,2111690,-1,8000.0,2117107,2117125,7591,18,6,8,True,True,5.5492,-0.140297
2423,2111377,14909,1,0.31458,11,2111690,-1,500.0,2314837,2329746,203460,14909,0,6,True,True,219.5128486111111,-0.2804935995969939
2424,2112022,3,1,0.451001,25,2117107,-1,500.0,2142931,2142934,30909,3,2,6,True,True,0.09785833333333334,-0.451001
2425,2112643,18751,1,0.053611,25,2117107,-1,500.0,2191875,2210626,79232,18751,1,6,True,True,579.0141680555557,-0.05219094539022254
2426,2113179,13130,1,0.359039,25,2117107,-1,500.0,2374838,2387968,261659,13130,0,8,True,True,214.83069166666667,-0.33687356212935043
2427,2113265,28,16,0.009583,25,2117107,-1,8000.0,2123727,2123755,10462,28,6,0,True,True,8.088266666666668,-0.009583
2428,2113530,9,2,0.136535,25,2117107,-1,1000.0,2146231,2146240,32701,9,4,0,True,True,0.53825,-0.136535
2429,2113630,12319,142,0.815216,25,2117107,-1,71000.0,2146456,2158775,32826,12319,4,5,True,True,56927.28623611112,-0.8131350987299336
2430,2113724,4,14,0.963829,25,2117107,-1,7000.0,2119307,2119311,5583,4,12,7,True,True,1.079011111111111,-0.963829
2431,2113880,30,1,0.505438,25,2117107,-1,500.0,2123727,2123757,9847,30,10,0,True,True,0.541625,-0.505438
2432,2113923,63,1,0.49497,25,2117107,-1,500.0,2117107,2117170,3184,63,14,0,True,True,1.2138875,-0.49497
2433,2114019,3743,64,0.684697,25,2117107,-1,32000.0,2175900,2179643,61881,3743,3,7,True,True,6219.774666666666,-0.6513664930856968
2434,2114322,7782,32,0.41563,25,2117107,-1,16000.0,2181843,2189625,67521,7782,3,0,True,True,8221.236133333334,-0.4121709385013694
2435,2114423,162,1,0.839892,25,2117107,-1,500.0,2117107,2117269,2684,162,18,0,True,True,3.1214249999999995,-0.839892
2436,2114439,8491,1,0.4887,25,2117107,-1,500.0,2123727,2132218,9288,8491,12,0,True,True,148.84234027777777,-0.47064914587383516
2437,2114630,20986,16,0.082671,25,2117107,-1,8000.0,2313737,2334723,199107,20986,2,0,True,True,5134.0362444444445,-0.08008110226348965
2438,2114633,6696,8,0.030861,25,2117107,-1,4000.0,2139627,2146323,24994,6696,11,6,True,True,1673.6649000000002,-0.030743308905154067
2439,2115210,34,1,0.761057,25,2117107,-1,500.0,2119307,2119341,4097,34,18,0,True,True,0.6551138888888889,-0.761057
2440,2115263,60,1,0.29209,25,2117107,-1,500.0,2142931,2142991,27668,60,9,0,True,True,1.9571666666666667,-0.29209
2441,2115285,85,1,0.274853,25,2117107,-1,500.0,2121507,2121592,6222,85,18,6,True,True,1.5346041666666668,-0.274853
2442,2117492,9,14,0.537609,32,2119307,-1,7000.0,2120407,2120416,2915,9,19,6,True,True,2.2748250000000003,-0.537609
2443,2117508,17722,1,0.168209,32,2119307,-1,500.0,2129127,2146849,11619,17722,13,8,True,True,439.3774486111111,-0.15748811004753352
2444,2117559,200,4,0.457321,32,2119307,-1,2000.0,2123727,2123927,6168,200,14,0,True,True,14.443333333333333,-0.457321
2445,2117770,10177,85,0.742518,32,2119307,-1,42500.0,2145131,2155308,27361,10177,9,7,True,True,28284.57048611111,-0.7204694944081707
2446,2117824,8,32,0.76592,32,2119307,-1,16000.0,2121507,2121515,3683,8,21,0,True,True,4.621866666666667,-0.76592
2447,2117897,13108,8,0.549726,32,2119307,-1,4000.0,2155881,2168989,37984,13108,7,0,True,True,2696.8298777777777,-0.5018955804295241
2448,2117914,7364,8,0.113211,32,2119307,-1,4000.0,2190775,2198139,72861,7364,4,0,True,True,1931.2531444444444,-0.1119302559292461
2449,2117989,8629,5,0.114207,32,2119307,-1,2500.0,2152256,2160885,34267,8629,9,0,True,True,1348.0527430555558,-0.10626417840411045
2450,2118041,4874,32,0.775113,32,2119307,-1,16000.0,2121527,2126401,3486,4874,24,1,True,True,2791.648844444445,-0.7719688284699476
2451,2118061,719,4,0.823283,32,2119307,-1,2000.0,2119307,2120026,1246,719,30,0,True,True,55.41492777777777,-0.823283
2452,2118189,8698,1,0.366862,32,2119307,-1,500.0,2171111,2179809,52922,8698,8,0,True,True,200.4749208333333,-0.34695958308891195
2453,2119686,8688,2,0.822611,32,2120407,-1,1000.0,2121527,2130215,1841,8688,25,0,True,True,305.93317222222225,-0.816279553098612
2454,2119735,139,1,0.041611,32,2120407,-1,500.0,2146231,2146370,26496,139,13,0,True,True,4.1564861111111115,-0.041611
2455,2119857,8904,106,0.71898,32,2120407,-1,53000.0,2331946,2340850,212089,8904,1,7,True,True,13150.160955555555,-0.6103321858499949
2456,2120189,19141,1,0.546353,32,2120407,-1,500.0,2329746,2348887,209557,19141,2,2,True,True,254.08824722222224,-0.5162631234132884
2457,2120488,210,59,0.989776,37,2121507,-1,29500.0,2123727,2123937,3239,210,27,6,True,True,223.69112500000003,-0.989776
2458,2120501,11,4,0.102416,37,2121507,-1,2000.0,2145131,2145142,24630,11,16,0,True,True,1.4352555555555557,-0.102416
2459,2120528,857,1,0.830071,37,2121507,-1,500.0,2123727,2124584,3199,857,28,0,True,True,15.288298611111111,-0.8201931328731596
2460,2120571,19559,9,0.751345,37,2121507,-1,4500.0,2155856,2175415,35285,19559,12,4,True,True,4220.385225,-0.6617331935746925
2461,2120598,31,4,0.297709,37,2121507,-1,2000.0,2141831,2141862,21233,31,21,0,True,True,3.6660944444444445,-0.297709
2462,2121350,12,1,0.999313,37,2121507,-1,500.0,2121515,2121527,165,12,35,1,True,True,0.21665000000000004,-0.999313
2463,2121572,14650,128,0.449732,34,2122627,-1,64000.0,2322271,2336921,200699,14650,3,5,True,True,32817.6448,-0.4483248517065224
2464,2121578,235,1,0.348577,34,2122627,-1,500.0,2132727,2132962,11149,235,25,5,True,True,4.351090277777778,-0.348577
2465,2124500,112,2,0.816729,36,2129127,-1,1000.0,2136327,2136439,11827,112,25,2,True,True,4.745377777777778,-0.816729
2466,2124543,239,4,0.43907,36,2129127,-1,2000.0,2146231,2146470,21688,239,16,0,True,True,28.587055555555555,-0.43907
2467,2124689,6917,15,0.993958,36,2129127,-1,7500.0,2136327,2143244,11638,6917,26,0,True,True,2863.9427708333333,-0.8806387932527662
2468,2124740,12,1,0.775632,36,2129127,-1,500.0,2129127,2129139,4387,12,29,0,True,True,0.20401666666666668,-0.775632
2469,2124925,6261,128,0.236946,36,2129127,-1,64000.0,2171111,2177372,46186,6261,11,0,True,True,17875.337244444447,-0.22700705592081155
2470,2124997,143,4,0.810703,36,2129127,-1,2000.0,2136327,2136470,11330,143,27,0,True,True,12.117661111111111,-0.810703
2471,2125054,13211,4,0.587924,36,2129127,-1,2000.0,2190775,2203986,65721,13211,7,0,True,True,1706.1676722222223,-0.580412973703918
2472,2125176,104,4,0.350631,36,2129127,-1,2000.0,2145131,2145235,19955,104,21,0,True,True,13.569688888888889,-0.350631
2473,2125179,31,1,0.710754,36,2129127,-1,500.0,2136327,2136358,11148,31,31,0,True,True,0.6567263888888889,-0.710754
2474,2125414,19212,16,0.632771,36,2129127,-1,8000.0,2145131,2164343,19717,19212,21,0,True,True,9317.314044444443,-0.6037573521540059
2475,2132350,15615,1,0.165982,35,2132727,-1,500.0,2369438,2385053,237088,15615,1,4,True,True,275.02413611111115,-0.1641734958078948
2476,2132729,25,64,0.139235,49,2136327,-1,32000.0,2155856,2155881,23127,25,16,0,True,True,52.782222222222224,-0.139235
2477,2132819,14871,256,0.20662,49,2136327,-1,128000.0,2450724,2465595,317905,14871,0,0,True,True,102807.408,-0.2013073558663565
2478,2134008,14246,1,0.206943,49,2136327,-1,500.0,2177372,2191618,43364,14246,12,1,True,True,435.5162472222222,-0.19934873360050148
2479,2134043,15,2,0.059358,49,2136327,-1,1000.0,2150056,2150071,16013,15,21,5,True,True,1.0589583333333334,-0.059358
2480,2134317,25475,128,0.350815,49,2136327,-1,64000.0,2179643,2205118,45326,25475,12,1,True,True,103593.71786666666,-0.34766292630477835
2481,2134804,225,8,0.281085,49,2136327,-1,4000.0,2146231,2146456,11427,225,27,0,True,True,53.825,-0.281085
2482,2134927,18621,64,0.538769,49,2136327,-1,32000.0,2289316,2307937,154389,18621,8,8,True,True,16901.491644444442,-0.47755815163706733
2483,2134934,7127,2,0.323654,49,2136327,-1,1000.0,2141831,2148958,6897,7127,36,0,True,True,445.6801194444445,-0.3235711796526063
2484,2134970,77,1,0.704054,49,2136327,-1,500.0,2138527,2138604,3557,77,39,7,True,True,2.2765263888888887,-0.704054
2485,2135214,3631,41,0.289333,49,2136327,-1,20500.0,2170011,2173642,34797,3631,19,8,True,True,2766.2896458333325,-0.24681565877121514
2486,2135239,16457,1,0.267343,49,2136327,-1,500.0,2348638,2365095,213399,16457,3,7,True,True,325.8001527777778,-0.26694677240795317
2487,2135398,391,8,0.858017,49,2136327,-1,4000.0,2139627,2140018,4229,391,40,0,True,True,92.48018888888889,-0.858017
2488,2135495,20,64,0.985488,49,2136327,-1,32000.0,2159191,2159211,23696,20,21,1,True,True,39.34755555555556,-0.985488
2489,2135551,18,1,0.679299,49,2136327,-1,500.0,2136327,2136345,776,18,47,0,True,True,0.381325,-0.679299
2490,2135886,4,32,0.095225,49,2136327,-1,16000.0,2141827,2141831,5941,4,41,7,True,True,3.7843555555555555,-0.095225
2491,2136844,10695,140,0.962772,45,2138527,-1,70000.0,2217452,2228147,80608,10695,10,0,True,True,39403.020416666666,-0.9561127745101702
2492,2139597,62,2,0.785691,45,2139627,-1,1000.0,2139627,2139689,30,62,44,0,True,True,3.6660944444444445,-0.785691
2493,2139648,15967,16,0.918769,49,2141827,-1,8000.0,2155881,2171848,16233,15967,24,1,True,True,6322.373866666667,-0.8367158236734255
2494,2139768,17844,2,0.992486,49,2141827,-1,1000.0,2155856,2173700,16088,17844,26,0,True,True,857.4452444444446,-0.8960723615290676
2495,2139994,19,10,0.867048,49,2141827,-1,5000.0,2141831,2141850,1837,19,43,0,True,True,5.6174027777777775,-0.867048
2496,2140004,18,1,0.126888,49,2141827,-1,500.0,2171111,2171129,31107,18,19,0,True,True,0.31829999999999997,-0.126888
2497,2140073,70,32,0.866079,49,2141827,-1,16000.0,2141831,2141901,1758,70,46,1,True,True,66.22622222222222,-0.866079
2498,2140389,2,16,0.249677,49,2141827,-1,8000.0,2146231,2146233,5842,2,36,6,True,True,0.9568888888888889,-0.249677
2499,2140483,10688,1,0.711395,49,2141827,-1,500.0,2184043,2194731,43560,10688,14,0,True,True,353.15100555555557,-0.7073916002647367
2500,2147589,73,8,0.828482,35,2150056,-1,4000.0,2152256,2152329,4667,73,31,7,True,True,20.61438888888889,-0.828482
2501,2148088,63,16,0.761474,35,2150056,-1,8000.0,2155856,2155919,7768,63,29,0,True,True,33.25280000000001,-0.761474
2502,2148106,8109,128,0.676235,35,2150056,-1,64000.0,2381930,2390039,233824,8109,1,8,True,True,16470.873422222223,-0.6572321199348541
2503,2148766,53,2,0.489459,35,2150056,-1,1000.0,2159211,2159264,10445,53,25,1,True,True,3.2584694444444446,-0.489459
2504,2150347,22243,64,0.577426,39,2152256,-1,32000.0,2199620,2221863,49273,22243,12,6,True,True,39509.858488888894,-0.572759939570518
2505,2150391,9,1,0.268717,39,2152256,-1,500.0,2184043,2184052,33652,9,17,7,True,True,0.2998,-0.268717
2506,2150734,417,32,0.414225,39,2152256,-1,16000.0,2158081,2158498,7347,417,29,7,True,True,410.19826666666665,-0.414225
2507,2150755,1489,1,0.451992,39,2152256,-1,500.0,2164611,2166100,13856,1489,27,8,True,True,35.12799166666667,-0.451992
2508,2151909,206,1,0.633628,39,2152256,-1,500.0,2159191,2159397,7282,206,29,0,True,True,6.332497222222223,-0.633628
2509,2155978,12334,64,0.880125,35,2158081,-1,32000.0,2205118,2217452,49140,12334,12,0,True,True,21331.35217777778,-0.8652277403987548
2510,2156228,71,1,0.093095,35,2158081,-1,500.0,2158081,2158152,1853,71,32,0,True,True,2.1825597222222224,-0.093095
2511,2156396,10,2,0.515613,35,2158081,-1,1000.0,2159181,2159191,2785,10,32,6,True,True,0.6148055555555556,-0.515613
2512,2156730,10,2,0.278226,35,2158081,-1,1000.0,2185143,2185153,28413,10,17,0,True,True,0.6662222222222223,-0.278226
2513,2159566,9504,4,0.936336,34,2164611,-1,2000.0,2184043,2193547,24477,9504,19,0,True,True,1256.3423333333333,-0.9304154992751931
2514,2159629,64,2,0.369071,34,2164611,-1,1000.0,2173700,2173764,14071,64,25,4,True,True,2.2634666666666665,-0.369071
2515,2160021,9,16,0.950254,34,2164611,-1,8000.0,2171111,2171120,11090,9,30,6,True,True,2.5463999999999998,-0.950254
2516,2160104,10,1,0.327289,34,2164611,-1,500.0,2185143,2185153,25039,10,18,6,True,True,0.33311111111111114,-0.327289
2517,2160248,10513,32,0.002473,34,2164611,-1,16000.0,2181843,2192356,21595,10513,23,7,True,True,11137.822755555555,-0.0024716415790438893
2518,2168533,11303,32,0.774135,34,2170011,-1,16000.0,2181843,2193146,13310,11303,23,0,True,True,11972.456177777778,-0.7718023215957228
2519,2170528,45,1,0.732724,34,2171111,-1,500.0,2179643,2179688,9115,45,25,0,True,True,1.0846875,-0.732724
2520,2171776,42,1,0.730932,31,2173700,-1,500.0,2181843,2181885,10067,42,23,0,True,True,1.3990666666666667,-0.730932
2521,2172033,50,32,0.458449,31,2173700,-1,16000.0,2189625,2189675,17592,50,17,7,True,True,53.397777777777776,-0.458449
2522,2177531,42,1,0.664144,31,2179643,-1,500.0,2181843,2181885,4312,42,23,0,True,True,1.3990666666666667,-0.664144
2523,2177773,9989,34,0.358223,31,2179643,-1,17000.0,2205118,2215107,27345,9989,12,0,True,True,9248.227233333335,-0.3496306801015939
2524,2178120,19,1,0.063331,31,2179643,-1,500.0,2194075,2194094,15955,19,15,7,True,True,0.6268944444444444,-0.063331
2525,2179651,3,2,0.534424,39,2181843,-1,1000.0,2185153,2185156,5502,3,20,2,True,True,0.1998666666666667,-0.534424
2526,2179836,44885,1,0.21783,39,2181843,-1,500.0,2465595,2510480,285759,44885,0,6,True,True,1138.7241180555554,-0.21354579731711285
2527,2180791,11359,1,0.429643,39,2181843,-1,500.0,2351946,2363305,171155,11359,5,1,True,True,240.8781277777778,-0.4282084425699387
2528,2180801,34,4,0.211851,39,2181843,-1,2000.0,2217452,2217486,36651,34,13,0,True,True,3.5548888888888888,-0.211851
2529,2180879,7170,1,0.268537,39,2181843,-1,500.0,2282181,2289351,101302,7170,13,7,True,True,141.0099,-0.2663854118837885
2530,2181396,263,8,0.828344,39,2181843,-1,4000.0,2184043,2184306,2647,263,29,0,True,True,70.08657777777778,-0.828344
2531,2181471,25629,33,0.337755,39,2181843,-1,16500.0,2222165,2247794,40694,25629,14,0,True,True,23297.916033333335,-0.3254114011070424
2532,2181633,26487,1,0.577934,39,2181843,-1,500.0,2392239,2418726,210606,26487,2,7,True,True,522.1404625,-0.5772634848552919
2533,2181686,17746,1,0.566142,39,2181843,-1,500.0,2234313,2252059,52627,17746,15,0,True,True,544.0603194444444,-0.5486066693419305
2534,2181740,275,8,0.485338,39,2181843,-1,4000.0,2181843,2182118,103,275,36,0,True,True,73.28444444444445,-0.485338
2535,2183780,63,32,0.34374,34,2184043,-1,16000.0,2203901,2203964,20121,63,21,6,True,True,57.38880000000001,-0.34374
2536,2186989,42441,32,0.682552,37,2189625,-1,16000.0,2245747,2288188,58758,42441,15,7,True,True,32854.17062222222,-0.6436141376417635
2537,2187170,35360,128,0.048409,37,2189625,-1,64000.0,2228147,2263507,40977,35360,17,6,True,True,129925.36248888889,-0.04789607465979054
2538,2187180,3613,4,0.099575,37,2189625,-1,2000.0,2228147,2231760,40967,3613,17,0,True,True,349.23897222222223,-0.09201106385362345
2539,2187316,13,42,0.78389,37,2189625,-1,21000.0,2194116,2194129,6800,13,26,0,True,True,18.014966666666666,-0.78389
2540,2187337,81,16,0.459582,37,2189625,-1,8000.0,2194094,2194175,6757,81,27,0,True,True,42.760799999999996,-0.459582
2541,2187483,4,1,0.124237,37,2189625,-1,500.0,2228147,2228151,40664,4,17,0,True,True,0.10463888888888889,-0.124237
2542,2187802,222,4,0.857652,37,2189625,-1,2000.0,2189675,2189897,1873,222,33,1,True,True,29.635766666666665,-0.857652
2543,2187819,142,16,0.441286,37,2189625,-1,8000.0,2190775,2190917,2956,142,33,6,True,True,75.82484444444444,-0.441286
2544,2187867,9,1,0.000676,37,2189625,-1,500.0,2221057,2221066,33190,9,21,0,True,True,0.2303625,-0.000676
2545,2188238,603,1,0.958032,37,2189625,-1,500.0,2189625,2190228,1387,603,36,0,True,True,20.1242875,-0.958032
2546,2189734,3130,32,0.202318,40,2190775,-1,16000.0,2194075,2197205,4341,3130,30,0,True,True,3265.413777777778,-0.19991142181373248
2547,2189831,55185,1,0.688592,40,2190775,-1,500.0,2395539,2450724,205708,55185,2,7,True,True,1169.84185,-0.6798223387261136
2548,2190353,4,32,0.131913,40,2190775,-1,16000.0,2198516,2198520,8163,4,29,7,True,True,4.0927999999999995,-0.131913
2549,2190388,645,6,0.649997,40,2190775,-1,3000.0,2190775,2191420,387,645,35,0,True,True,129.15587499999998,-0.649997
2550,2190559,1,8,0.158977,40,2190775,-1,4000.0,2190775,2190776,216,1,36,0,True,True,0.2669888888888889,-0.158977
2551,2190639,2713,2,0.932726,40,2190775,-1,1000.0,2194116,2196829,3477,2713,31,0,True,True,177.33761666666666,-0.9239199415629734
2552,2190992,4281,32,0.274019,38,2191875,-1,16000.0,2198520,2202801,7528,4281,29,1,True,True,4406.923066666666,-0.2738129604863458
2553,2191522,74,1,0.654588,38,2191875,-1,500.0,2196316,2196390,4794,74,31,7,True,True,2.36615,-0.654588
2554,2191699,664,1,0.250389,38,2191875,-1,500.0,2243547,2244211,51848,664,17,0,True,True,24.08383333333333,-0.250389
2555,2192292,119,8,0.371844,49,2194075,-1,4000.0,2203964,2204083,11672,119,28,0,True,True,27.100266666666666,-0.371844
2556,2192359,69,1,0.9038,49,2194075,-1,500.0,2194094,2194163,1735,69,37,1,True,True,2.2766166666666665,-0.9038
2557,2192404,5243,16,0.165525,49,2194075,-1,8000.0,2313737,2318980,121333,5243,14,2,True,True,911.7501111111112,-0.1529835479494115
2558,2192462,6613,128,0.396342,49,2194075,-1,64000.0,2354146,2360759,161684,6613,7,7,True,True,19089.66008888889,-0.3947257611820446
2559,2193211,15,4,0.305509,49,2194075,-1,2000.0,2231766,2231781,38555,15,21,2,True,True,1.4409166666666666,-0.305509
2560,2193371,9234,32,0.699441,49,2194075,-1,16000.0,2234313,2243547,40942,9234,21,5,True,True,7748.456,-0.6160235376507668
2561,2193805,9,1,0.234144,49,2194075,-1,500.0,2255303,2255312,61498,9,18,0,True,True,0.29533750000000003,-0.234144
2562,2193848,46,8,0.655485,49,2194075,-1,4000.0,2194116,2194162,268,46,41,1,True,True,12.141955555555557,-0.655485
2563,2193938,41,1,0.703698,49,2194075,-1,500.0,2194075,2194116,137,41,44,0,True,True,1.3527722222222223,-0.703698
2564,2193984,79,1,0.001086,49,2194075,-1,500.0,2243547,2243626,49563,79,21,2,True,True,2.865395833333333,-0.001086
2565,2193987,10037,32,0.476807,49,2194075,-1,16000.0,2249372,2259409,55385,10037,19,6,True,True,10199.906044444444,-0.4387666110738732
2566,2193998,237,32,0.1327,49,2194075,-1,16000.0,2205064,2205301,11066,237,35,6,True,True,215.8912,-0.1327
2567,2194621,25,1,0.226191,54,2196316,-1,500.0,2203964,2203989,9343,25,37,1,True,True,0.7116666666666667,-0.226191
2568,2194663,77,1,0.679983,54,2196316,-1,500.0,2203964,2204041,9301,77,37,0,True,True,2.1919333333333335,-0.679983
2569,2194709,10,32,0.009287,54,2196316,-1,16000.0,2241145,2241155,46436,10,23,6,True,True,8.058666666666667,-0.009287
2570,2194764,859,1,0.695597,54,2196316,-1,500.0,2196316,2197175,1552,859,44,0,True,True,27.466525,-0.695597
2571,2194836,28342,1,0.817109,54,2196316,-1,500.0,2393339,2421681,198503,28342,3,6,True,True,555.3048194444445,-0.8153877672066202
2572,2194945,9,8,0.988155,54,2196316,-1,4000.0,2196316,2196325,1371,9,45,0,True,True,2.3022,-0.988155
2573,2194955,18693,16,0.422314,54,2196316,-1,8000.0,2310137,2328830,115182,18693,17,7,True,True,4113.0002444444435,-0.4062550294839967
2574,2195011,19,1,0.132175,54,2196316,-1,500.0,2223265,2223284,28254,19,32,6,True,True,0.5165888888888889,-0.132175
2575,2195223,77,16,0.070828,54,2196316,-1,8000.0,2196316,2196393,1093,77,48,0,True,True,39.3932,-0.070828
2576,2195238,15430,32,0.38307,54,2196316,-1,16000.0,2283916,2299346,88678,15430,19,0,True,True,8356.451377777777,-0.3756374433670271
2577,2195505,32,4,0.730763,54,2196316,-1,2000.0,2202801,2202833,7296,32,45,1,True,True,4.126044444444444,-0.730763
2578,2195658,10815,128,0.102427,54,2196316,-1,64000.0,2273101,2283916,77443,10815,21,7,True,True,25153.03413333333,-0.10072701110667898
2579,2195893,78,4,0.313351,54,2196316,-1,2000.0,2228157,2228235,32264,78,31,0,True,True,8.161833333333334,-0.313351
2580,2206570,9594,128,0.880989,92,2217452,-1,64000.0,2263507,2273101,56937,9594,22,1,True,True,26229.12746666667,-0.8422909913924639
2581,2206573,16617,3,0.137129,92,2217452,-1,1500.0,2365838,2382455,159265,16617,8,1,True,True,923.4347041666666,-0.1359952286610012
2582,2206646,72,32,0.77346,92,2217452,-1,16000.0,2243547,2243619,36901,72,27,0,True,True,83.568,-0.77346
2583,2206689,13325,2,0.753158,92,2217452,-1,1000.0,2283916,2297241,77227,13325,21,0,True,True,462.0869055555555,-0.7381479365429907
2584,2206734,10,1,0.133146,92,2217452,-1,500.0,2250903,2250913,44169,10,26,1,True,True,0.3559027777777778,-0.133146
2585,2206764,18494,1,0.99294,92,2217452,-1,500.0,2253103,2271597,46339,18494,26,7,True,True,457.50651388888883,-0.9014043236181678
2586,2206779,1110,4,0.142853,92,2217452,-1,2000.0,2277506,2278616,70727,1110,23,1,True,True,83.33633333333333,-0.142853
2587,2206857,26637,32,0.530508,92,2217452,-1,16000.0,2277781,2304418,70924,26637,23,1,True,True,13853.183911111111,-0.5068868349740449
2588,2207013,25,32,0.008475,92,2217452,-1,16000.0,2223265,2223290,16252,25,43,0,True,True,21.751111111111108,-0.008475
2589,2207065,18862,128,0.65002,92,2217452,-1,64000.0,2413409,2432271,206344,18862,2,6,True,True,44050.20497777777,-0.6288292461589724
2590,2207184,21992,4,0.440099,92,2217452,-1,2000.0,2343846,2365838,136662,21992,13,9,True,True,1589.4520666666665,-0.4116394200328252
2591,2207357,15,2,0.722432,92,2217452,-1,1000.0,2221057,2221072,13700,15,49,1,True,True,0.767875,-0.722432
2592,2208090,232,1,0.62808,92,2217452,-1,500.0,2237613,2237845,29523,232,38,0,True,True,5.8773333333333335,-0.62808
2593,2208115,17,13,0.151374,92,2217452,-1,6500.0,2228147,2228164,20032,17,45,0,True,True,5.781298611111111,-0.151374
2594,2208129,286,16,0.41171,92,2217452,-1,8000.0,2250903,2251189,42774,286,31,0,True,True,162.86111111111111,-0.41171
2595,2208414,12148,4,0.686566,92,2217452,-1,2000.0,2222165,2234313,13751,12148,51,6,True,True,1247.651138888889,-0.6750101234967136
2596,2208490,9,1,0.859963,92,2217452,-1,500.0,2221052,2221061,12562,9,54,0,True,True,0.2303625,-0.859963
2597,2208498,3658,1,0.086688,92,2217452,-1,500.0,2234313,2237971,25815,3658,41,0,True,True,93.25027083333333,-0.0857281576977054
2598,2208577,29,29,0.100465,92,2217452,-1,14500.0,2246072,2246101,37495,29,34,0,True,True,30.50377083333333,-0.100465
2599,2208764,14,2,0.752446,92,2217452,-1,1000.0,2222165,2222179,13401,14,52,0,True,True,0.7612888888888888,-0.752446
2600,2208837,20,45,0.589574,92,2217452,-1,22500.0,2277781,2277801,68944,20,25,0,True,True,16.8925,-0.589574
2601,2208985,23370,128,0.384032,92,2217452,-1,64000.0,2390039,2413409,181054,23370,6,0,True,True,58936.22915555555,-0.38108126434971107
2602,2208989,13,16,0.963249,92,2217452,-1,8000.0,2221052,2221065,12063,13,60,4,True,True,5.323933333333333,-0.963249
2603,2209089,77,2,0.314504,92,2217452,-1,1000.0,2231760,2231837,22671,77,47,0,True,True,3.6983527777777776,-0.314504
2604,2209115,20024,16,0.13983,92,2217452,-1,8000.0,2374838,2394862,165723,20024,8,0,True,True,5399.1508,-0.13270053484172015
2605,2209312,12,8,0.276968,92,2217452,-1,4000.0,2240045,2240057,30733,12,43,7,True,True,2.4176,-0.276968
2606,2209681,7,8,0.084249,92,2217452,-1,4000.0,2246072,2246079,36391,7,38,1,True,True,2.0311666666666666,-0.084249
2607,2209843,7,4,0.553397,92,2217452,-1,2000.0,2221057,2221064,11214,7,61,0,True,True,0.7166833333333332,-0.553397
2608,2209869,14334,200,0.600008,92,2217452,-1,100000.0,2307937,2322271,98068,14334,23,7,True,True,33746.99333333333,-0.5473281979202206
2609,2210022,15128,16,0.607593,92,2217452,-1,8000.0,2255303,2270431,45281,15128,33,0,True,True,5758.289199999999,-0.5744382725801226
2610,2210067,27,1,0.77897,92,2217452,-1,500.0,2221057,2221084,10990,27,65,0,True,True,0.6910875,-0.77897
2611,2210090,13392,4,0.690476,92,2217452,-1,2000.0,2333046,2346438,122956,13392,16,6,True,True,638.9578333333333,-0.6773589978933399
2612,2210114,5508,64,0.847892,92,2217452,-1,32000.0,2346438,2351946,136324,5508,15,1,True,True,5130.472533333334,-0.7125831850151927
2613,2210138,12475,95,0.658405,92,2217452,-1,47500.0,2365159,2377634,155021,12475,12,7,True,True,23005.941,-0.6510771157999866
2614,2210185,85,1,0.301649,92,2217452,-1,500.0,2242245,2242330,32060,85,48,6,True,True,2.1405833333333333,-0.301649
2615,2210269,8658,16,0.517749,92,2217452,-1,8000.0,2242245,2250903,31976,8658,48,0,True,True,4829.596333333333,-0.5051311226135687
2616,2210293,1166,14,0.509523,92,2217452,-1,7000.0,2224365,2225531,14072,1166,63,6,True,True,433.2989305555555,-0.49743159213030647
2617,2210526,487,5,0.747844,92,2217452,-1,2500.0,2221057,2221544,10531,487,72,0,True,True,65.06590972222222,-0.7349775851128103
2618,2210579,16,2,0.295542,92,2217452,-1,1000.0,2224365,2224381,13786,16,63,0,True,True,0.8700444444444444,-0.295542
2619,2210710,57968,83,0.054569,92,2217452,-1,41500.0,2384130,2442098,173420,57968,7,7,True,True,93915.2603722222,-0.053575613783848924
2620,2210889,7752,64,0.897913,92,2217452,-1,32000.0,2283916,2291668,73027,7752,31,1,True,True,9467.318044444444,-0.8782125758413781
2621,2210918,5,2,0.954672,92,2217452,-1,1000.0,2221052,2221057,10134,5,78,0,True,True,0.25595833333333334,-0.954672
2622,2211017,122,4,0.494888,92,2217452,-1,2000.0,2237613,2237735,26596,122,54,0,True,True,12.362666666666668,-0.494888
2623,2211488,280,3,0.112744,92,2217452,-1,1500.0,2277501,2277781,66013,280,36,0,True,True,15.766333333333332,-0.112744
2624,2211789,27,2,0.499583,92,2217452,-1,1000.0,2221057,2221084,9268,27,76,0,True,True,1.382175,-0.499583
2625,2211797,10983,64,0.59393,92,2217452,-1,32000.0,2349738,2360721,137941,10983,16,6,True,True,14535.906133333334,-0.5767129083853296
2626,2211812,15454,1,0.528287,92,2217452,-1,500.0,2415609,2431063,203797,15454,2,0,True,True,276.51813888888887,-0.5067589804854893
2627,2211845,4,4,0.977697,92,2217452,-1,2000.0,2217452,2217456,5607,4,86,0,True,True,0.4182222222222222,-0.977697
2628,2211964,343,32,0.986883,92,2217452,-1,16000.0,2222165,2222508,10201,343,73,0,True,True,298.42524444444444,-0.986883
2629,2211969,76,4,0.933924,92,2217452,-1,2000.0,2221052,2221128,9083,76,84,0,True,True,7.781133333333333,-0.933924
2630,2211985,12454,1,0.131983,92,2217452,-1,500.0,2362959,2375413,150974,12454,15,7,True,True,243.8740541666667,-0.13164193593047552
2631,2212785,6,32,0.860814,92,2217452,-1,16000.0,2231760,2231766,18975,6,65,5,True,True,4.6109333333333336,-0.860814
2632,2217450,13,4,0.56838,92,2217452,-1,2000.0,2228157,2228170,10707,13,67,0,True,True,1.3603055555555554,-0.56838
2633,2217922,28,64,0.365412,101,2221052,-1,32000.0,2275301,2275329,57379,28,40,7,True,True,33.63484444444444,-0.365412
2634,2218080,3,8,0.682942,101,2221052,-1,4000.0,2221065,2221068,2985,3,81,0,True,True,0.6143000000000001,-0.682942
2635,2218177,21171,128,0.762726,101,2221052,-1,64000.0,2360759,2381930,142582,21171,16,1,True,True,50787.06026666667,-0.7358611371178841
2636,2218200,4916,16,0.954453,101,2221052,-1,8000.0,2221057,2225973,2857,4916,88,0,True,True,2115.608933333333,-0.9538712934632689
2637,2218257,19,32,0.770367,101,2221052,-1,16000.0,2228157,2228176,9900,19,70,2,True,True,15.905111111111111,-0.770367
2638,2218294,549,1,0.016689,101,2221052,-1,500.0,2250472,2251021,32178,549,49,0,True,True,19.5390625,-0.016689
2639,2218364,346,27,0.067533,101,2221052,-1,13500.0,2237613,2237959,19249,346,63,6,True,True,236.664,-0.067533
2640,2218378,6,1,0.262185,101,2221052,-1,500.0,2248272,2248278,29894,6,51,7,True,True,0.2086,-0.262185
2641,2218446,1149,8,0.039827,101,2221052,-1,4000.0,2255303,2256452,36857,1149,46,7,True,True,301.63803333333334,-0.039827
2642,2220087,297,16,0.060469,101,2221052,-1,8000.0,2237613,2237910,17526,297,64,0,True,True,120.38400000000001,-0.060469
2643,2220171,31,13,0.78929,101,2221052,-1,6500.0,2221065,2221096,894,31,88,0,True,True,10.315120833333333,-0.78929
2644,2220465,52,4,0.506611,101,2221052,-1,2000.0,2228164,2228216,7699,52,73,0,True,True,5.441222222222222,-0.506611
2645,2223616,112,7,0.628571,87,2224365,-1,3500.0,2228157,2228269,4541,112,76,0,True,True,20.50922222222222,-0.628571
2646,2223755,4483,1,0.501049,87,2224365,-1,500.0,2250903,2255386,27148,4483,48,0,True,True,154.59506527777776,-0.49305705859085186
2647,2223976,4,6,0.415432,87,2224365,-1,3000.0,2231760,2231764,7784,4,72,0,True,True,0.5763666666666666,-0.415432
2648,2224069,34,3,0.701811,87,2224365,-1,1500.0,2231766,2231800,7697,34,71,0,True,True,2.4495583333333335,-0.701811
2649,2224162,9841,64,0.082428,87,2224365,-1,32000.0,2262482,2272323,38320,9841,44,6,True,True,13690.892355555554,-0.08036108864469192
2650,2224894,3827,1,0.536565,95,2228147,-1,500.0,2242245,2246072,17351,3827,62,0,True,True,132.65491666666665,-0.5222477148784034
2651,2224911,713,4,0.616047,95,2228147,-1,2000.0,2231766,2232479,6855,713,73,0,True,True,71.88182777777779,-0.6021725860099593
2652,2224927,116,8,0.277468,95,2228147,-1,4000.0,2255303,2255419,30376,116,45,0,True,True,30.45257777777778,-0.277468
2653,2226269,118,8,0.309907,95,2228147,-1,4000.0,2228157,2228275,1888,118,84,0,True,True,24.69477777777778,-0.309907
2654,2226296,4979,17,0.511305,95,2228147,-1,8500.0,2257503,2262482,31207,4979,45,7,True,True,1947.9403722222223,-0.5092096371016156
2655,2226375,73,4,0.203197,95,2228147,-1,2000.0,2228235,2228308,1860,73,81,4,True,True,7.638638888888888,-0.203197
2656,2226742,2595,16,0.80806,95,2228147,-1,8000.0,2228147,2230742,1405,2595,88,0,True,True,1005.7950444444443,-0.7482773985957557
2657,2226774,23165,1,0.53639,95,2228147,-1,500.0,2415609,2438774,188835,23165,3,7,True,True,458.7967513888889,-0.5227018848203494
2658,2227829,24,4,0.390732,95,2228147,-1,2000.0,2241145,2241169,13316,24,67,0,True,True,2.4176,-0.390732
2659,2228113,10,8,0.634294,95,2228147,-1,4000.0,2228147,2228157,34,10,94,0,True,True,2.0927777777777776,-0.634294
2660,2228175,6,16,0.834526,84,2228235,-1,8000.0,2243547,2243553,15372,6,62,0,True,True,3.4819999999999998,-0.834526
2661,2228383,432,32,0.681056,90,2231760,-1,16000.0,2250472,2250904,22089,432,56,6,True,True,492.0,-0.681056
2662,2228637,7092,1,0.066115,90,2231760,-1,500.0,2324471,2331563,95834,7092,27,7,True,True,136.8096402777778,-0.06395478044699826
2663,2229278,185,1,0.698676,90,2231760,-1,500.0,2237845,2238030,8567,185,73,2,True,True,4.6866666666666665,-0.698676
2664,2229642,11216,1,0.729958,90,2231760,-1,500.0,2328071,2339287,98429,11216,27,4,True,True,183.8332763888889,-0.655735990162794
2665,2229695,804,2,0.846468,90,2231760,-1,1000.0,2236513,2237317,6818,804,79,7,True,True,40.736,-0.846468
2666,2229769,19826,32,0.057906,90,2231760,-1,16000.0,2279981,2299807,50212,19826,40,7,True,True,10765.884355555556,-0.05730088564481708
2667,2229799,5,1,0.086213,90,2231760,-1,500.0,2277501,2277506,47702,5,45,7,True,True,0.09384722222222222,-0.086213
5518,4447222,5,1,0.647793,1,4447222,-1,500.0,4449422,4449427,2200,5,0,7,True,True,0.08452083333333334,-0.647793
5519,4447274,9180,256,0.176618,16,4449422,-1,128000.0,4802462,4811642,355188,9180,0,7,True,True,43250.09351111111,-0.16820710859053775
5520,4447328,14,32,0.039331,16,4449422,-1,16000.0,4454971,4454985,7643,14,1,1,True,True,7.308622222222222,-0.039331
5521,4447560,21273,4,0.384164,16,4449422,-1,2000.0,4741477,4762750,293917,21273,1,7,True,True,1338.3378722222224,-0.38383719138445405
5522,4447584,229,4,0.191003,16,4449422,-1,2000.0,4475111,4475340,27527,229,2,7,True,True,19.82758333333333,-0.191003
5523,4447982,25979,118,0.695882,16,4449422,-1,59000.0,4452727,4478706,4745,25979,4,6,True,True,62477.125175,-0.6707697739428073
5524,4448069,22,1,0.896461,16,4449422,-1,500.0,4451627,4451649,3558,22,5,7,True,True,0.37262500000000004,-0.896461
5525,4448097,102,16,0.630617,16,4449422,-1,8000.0,4449422,4449524,1325,102,6,0,True,True,27.5876,-0.630617
5526,4448179,5,15,0.359261,16,4449422,-1,7500.0,4451627,4451632,3448,5,5,0,True,True,1.2703125000000002,-0.35926100000000005
5527,4448207,22666,32,0.084862,16,4449422,-1,16000.0,4491994,4514660,43787,22666,2,1,True,True,13497.952888888889,-0.08159162806281894
5528,4448248,31,4,0.632791,16,4449422,-1,2000.0,4449422,4449453,1174,31,9,0,True,True,2.0961166666666666,-0.632791
5529,4448319,7814,128,0.735324,16,4449422,-1,64000.0,4516594,4524408,68275,7814,2,0,True,True,14309.952000000001,-0.732901024159706
5530,4448730,31,16,0.139943,16,4449422,-1,8000.0,4454927,4454958,6197,31,6,0,True,True,8.09168888888889,-0.139943
5531,4448774,16,4,0.193093,16,4449422,-1,2000.0,4472911,4472927,24137,16,5,7,True,True,1.3662222222222222,-0.193093
5532,4448838,33,2,0.719739,16,4449422,-1,1000.0,4449427,4449460,589,33,11,1,True,True,1.115675,-0.719739
5533,4449247,7918,1,0.592945,16,4449422,-1,500.0,4459484,4467402,10237,7918,6,7,True,True,169.92586944444443,-0.5880835800899351
5534,4449408,16395,12,0.489233,16,4449422,-1,6000.0,4503594,4519989,54186,16395,3,3,True,True,3183.3196499999995,-0.4559980348410999
5535,4449879,56,1,0.062993,24,4451627,-1,500.0,4489784,4489840,39905,56,5,1,True,True,1.144111111111111,-0.062993
5536,4449895,2398,16,0.540552,24,4451627,-1,8000.0,4459484,4461882,9589,2398,8,0,True,True,722.9573777777778,-0.5131577454325553
5537,4450351,3163,1,0.307731,24,4451627,-1,500.0,4494194,4497357,43843,3163,4,0,True,True,65.19779861111111,-0.30315752217501163
5538,4450360,14342,4,0.53394,24,4451627,-1,2000.0,4610817,4625159,160457,14342,2,0,True,True,1123.2549888888889,-0.5138481573816621
5539,4450400,39,8,0.83425,24,4451627,-1,4000.0,4451627,4451666,1227,39,15,0,True,True,5.2845,-0.83425
5540,4450560,13230,1,0.449307,24,4451627,-1,500.0,4672622,4685852,222062,13230,2,0,True,True,219.32258611111112,-0.4405224864660709
5541,4450635,25896,1,0.995834,24,4451627,-1,500.0,4498894,4524790,48259,25896,6,0,True,True,423.98695833333335,-0.960126080691486
5542,4450670,16527,32,0.037043,24,4451627,-1,16000.0,4476211,4492738,25541,16527,10,6,True,True,11438.593111111111,-0.03686614892255491
5543,4450960,155,9,0.056054,24,4451627,-1,4500.0,4455045,4455200,4085,155,15,0,True,True,22.757875,-0.056054000000000014
5544,4451396,7764,4,0.787779,24,4451627,-1,2000.0,4478411,4486175,27015,7764,10,7,True,True,694.7019055555555,-0.787721139702013
5545,4451584,107,82,0.042815,24,4451627,-1,41000.0,4457284,4457391,5700,107,16,7,True,True,151.04684722222223,-0.042815
5546,4451620,44,32,0.118187,24,4451627,-1,16000.0,4454927,4454971,3307,44,20,7,True,True,22.969955555555554,-0.118187
5547,4451634,8215,9,0.807104,22,4452727,-1,4500.0,4470711,4478926,19077,8215,14,1,True,True,1596.45055,-0.7851404659429263
5548,4452803,26155,4,0.667316,40,4454927,-1,2000.0,4521782,4547937,68979,26155,4,0,True,True,1428.0370166666667,-0.6628893810328643
5549,4452848,156,2,0.45837,40,4454927,-1,1000.0,4472911,4473067,20063,156,14,0,True,True,6.660333333333333,-0.45837
5550,4453339,29,8,0.678078,40,4454927,-1,4000.0,4455084,4455113,1745,29,20,1,True,True,3.784822222222222,-0.678078
5551,4453369,15,7,0.874255,40,4454927,-1,3500.0,4454958,4454973,1589,15,23,0,True,True,1.7129583333333334,-0.874255
5552,4453378,6,32,0.148954,40,4454927,-1,16000.0,4460923,4460929,7545,6,17,1,True,True,3.8109333333333333,-0.148954
5553,4453717,113,1,0.579346,40,4454927,-1,500.0,4454971,4455084,1254,113,23,0,True,True,1.8434694444444444,-0.579346
5554,4453925,74,8,0.924816,40,4454927,-1,4000.0,4454971,4455045,1046,74,24,0,True,True,9.657822222222222,-0.924816
5555,4453933,9,1,0.036878,40,4454927,-1,500.0,4487528,4487537,33595,9,11,2,True,True,0.19002500000000003,-0.036878
5556,4453955,12221,8,0.14159,40,4454927,-1,4000.0,4672622,4684843,218667,12221,3,7,True,True,1627.3682111111111,-0.13860989621119313
5557,4454014,19588,16,0.653832,40,4454927,-1,8000.0,4499994,4519582,45980,19588,8,6,True,True,5238.0728,-0.6109583578884414
5558,4454143,24945,32,0.47122,40,4454927,-1,16000.0,4548331,4573276,94188,24945,5,0,True,True,14539.233022222219,-0.4575562944450605
5559,4454163,5965,16,0.918019,40,4454927,-1,8000.0,4454958,4460923,795,5965,31,1,True,True,1638.496111111111,-0.8381152502427665
5560,4454391,10287,188,0.045802,40,4454927,-1,94000.0,4592301,4602588,137910,10287,5,1,True,True,33296.8492,-0.04362906275107481
5561,4454436,55,16,0.701297,40,4454927,-1,8000.0,4454971,4455026,535,55,30,0,True,True,14.356222222222222,-0.701297
5562,4454459,501,64,0.130538,40,4454927,-1,32000.0,4482070,4482571,27611,501,16,1,True,True,726.7394666666667,-0.130538
5563,4454483,14827,128,0.172249,40,4454927,-1,64000.0,4542742,4557569,88259,14827,7,3,True,True,30749.060266666667,-0.1720641213216508
5564,4454632,15,32,0.049958,40,4454927,-1,16000.0,4472911,4472926,18279,15,21,0,True,True,10.246666666666666,-0.049958
5565,4454811,9,1,0.307337,40,4454927,-1,500.0,4470702,4470711,15891,9,25,7,True,True,0.200475,-0.307337
5566,4454844,13049,16,0.793697,40,4454927,-1,8000.0,4455045,4468094,201,13049,32,4,True,True,4169.2756,-0.7442905570219315
5567,4455102,16479,32,0.456185,39,4457284,-1,16000.0,4483170,4499649,28068,16479,17,6,True,True,11027.302,-0.4519355208180045
5568,4455208,4,32,0.170689,39,4457284,-1,16000.0,4468502,4468506,13294,4,27,0,True,True,2.8512,-0.170689
5569,4455263,5,16,0.591042,39,4457284,-1,8000.0,4462023,4462028,6760,5,28,6,True,True,1.587888888888889,-0.591042
5570,4455308,375,2,0.8178,39,4457284,-1,1000.0,4460923,4461298,5615,375,29,0,True,True,14.886458333333334,-0.8178
5571,4455339,34906,1,0.106331,39,4457284,-1,500.0,4642647,4677553,187308,34906,4,7,True,True,693.6763597222222,-0.1054174507926426
5572,4455394,18,4,0.497143,39,4457284,-1,2000.0,4462023,4462041,6629,18,29,0,True,True,1.4291,-0.497143
5573,4455785,17910,1,0.799175,39,4457284,-1,500.0,4472911,4490821,17126,17910,23,0,True,True,389.1578333333334,-0.7960923309670677
5574,4455800,37228,37,0.220573,39,4457284,-1,18500.0,4692947,4730175,237147,37228,2,7,True,True,22809.353205555555,-0.21854233885618687
5575,4455844,11896,34,0.804454,39,4457284,-1,17000.0,4464223,4476119,8379,11896,31,7,True,True,9101.282727777776,-0.8004417871742731
5576,4455958,137,1,0.426211,39,4457284,-1,500.0,4487391,4487528,31433,137,19,1,True,True,2.8926027777777783,-0.426211
5577,4457648,36,1,0.811521,39,4459484,-1,500.0,4467402,4467438,9754,36,32,1,True,True,0.87515,-0.811521
5578,4463451,4177,64,0.982193,37,4464223,-1,32000.0,4508294,4512471,44843,4177,12,4,True,True,4513.558666666666,-0.9241341729671553
5579,4463634,4,1,0.678398,37,4464223,-1,500.0,4468502,4468506,4868,4,33,6,True,True,0.0891,-0.678398
5580,4463694,276,4,0.324235,37,4464223,-1,2000.0,4468502,4468778,4808,276,32,0,True,True,24.591599999999996,-0.324235
5581,4463947,536,24,0.975853,37,4464223,-1,12000.0,4472911,4473447,8964,536,27,0,True,True,274.61066666666665,-0.975853
5582,4464265,6,8,0.575967,45,4467402,-1,4000.0,4467402,4467408,3137,6,36,0,True,True,1.1668666666666667,-0.575967
5583,4464805,14525,1,0.137329,45,4467402,-1,500.0,4679441,4693966,214636,14525,3,7,True,True,240.0971736111111,-0.13593015831749916
5584,4464867,73,1,0.836427,45,4467402,-1,500.0,4468502,4468575,3635,73,34,0,True,True,1.626075,-0.836427
5585,4464895,499,4,0.793102,45,4467402,-1,2000.0,4470711,4471210,5816,499,32,0,True,True,44.423788888888886,-0.7924400049336734
5586,4465011,103,8,0.764228,45,4467402,-1,4000.0,4468502,4468605,3491,103,38,0,True,True,18.3546,-0.764228
5587,4465046,13,2,0.593085,45,4467402,-1,1000.0,4472911,4472924,7865,13,30,0,True,True,0.5550277777777777,-0.593085
5588,4465557,56,8,0.335504,45,4467402,-1,4000.0,4489728,4489784,24171,56,20,7,True,True,9.152888888888889,-0.335504
5589,4465601,18274,1,0.120745,45,4467402,-1,500.0,4636481,4654755,170880,18274,7,7,True,True,362.3748722222222,-0.11685086029386998
5590,4465636,78,2,0.141237,45,4467402,-1,1000.0,4498894,4498972,33258,78,18,4,True,True,3.1037500000000002,-0.141237
5591,4476701,15193,1,0.415154,33,4478411,-1,500.0,4526196,4541389,49495,15193,12,6,True,True,203.8379097222222,-0.4129575714364354
5592,4476870,237,1,0.696296,33,4478411,-1,500.0,4486175,4486412,9305,237,26,0,True,True,5.003991666666667,-0.696296
5593,4476890,59,2,0.553408,33,4478411,-1,1000.0,4482011,4482070,5121,59,29,4,True,True,2.674502777777778,-0.553408
5594,4477000,18387,1,0.438661,33,4478411,-1,500.0,4528396,4546783,51396,18387,12,7,True,True,249.00466944444446,-0.43388826533958724
5595,4477331,7032,32,0.925676,33,4478411,-1,16000.0,4495294,4502326,17963,7032,21,0,True,True,4440.223644444444,-0.8944102114911207
5596,4477589,2634,1,0.040699,33,4478411,-1,500.0,4504694,4507328,27105,2634,17,6,True,True,49.78066111111111,-0.04065558815438467
5597,4479098,38,36,0.099968,42,4482011,-1,18000.0,4487391,4487429,8293,38,28,0,True,True,28.8838,-0.099968
5598,4479574,116,32,0.847367,42,4482011,-1,16000.0,4487275,4487391,7701,116,30,6,True,True,78.37475555555555,-0.847367
5599,4479759,23,1,0.612442,42,4482011,-1,500.0,4482070,4482093,2311,23,33,0,True,True,0.5213013888888889,-0.612442
5600,4479965,23122,85,0.777662,42,4482011,-1,42500.0,4617325,4640447,137360,23122,8,8,True,True,41905.429131944446,-0.7739954564849607
5601,4479974,874,1,0.01563,42,4482011,-1,500.0,4498894,4499768,18920,874,22,0,True,True,17.388958333333335,-0.01563
5602,4480013,903,2,0.486967,42,4482011,-1,1000.0,4495294,4496197,15281,903,25,6,True,True,37.78804166666667,-0.486967
5603,4480707,9507,16,0.00635,42,4482011,-1,8000.0,4516712,4526219,36005,9507,16,0,True,True,2165.6542444444444,-0.006345387513930875
5604,4480767,60,1,0.179413,42,4482011,-1,500.0,4486175,4486235,5408,60,36,1,True,True,1.2668333333333335,-0.179413
5605,4480810,29,1,0.089141,42,4482011,-1,500.0,4516712,4516741,35902,29,17,4,True,True,0.39585,-0.089141
5606,4480861,9072,3,0.651756,42,4482011,-1,1500.0,4482070,4491142,1209,9072,40,0,True,True,587.0837083333333,-0.6512354279673492
5607,4482498,10,121,0.886915,39,4483170,-1,60500.0,4491984,4491994,9486,10,30,7,True,True,24.720972222222223,-0.886915
5608,4483981,53,28,0.416222,40,4486175,-1,14000.0,4494194,4494247,10213,53,29,7,True,True,31.05063888888889,-0.416222
5609,4485144,20673,1,0.807412,40,4486175,-1,500.0,4546126,4566799,60982,20673,12,0,True,True,361.1843333333333,-0.7863528709212028
5610,4487909,4,1,0.772563,36,4489728,-1,500.0,4495294,4495298,7385,4,28,0,True,True,0.08369444444444445,-0.772563
5611,4487985,15,64,0.692358,36,4489728,-1,32000.0,4511894,4511909,23909,15,20,1,True,True,13.876,-0.692358
5612,4510866,85,16,0.20616,28,4511894,-1,8000.0,4516597,4516682,5731,85,19,1,True,True,18.564,-0.20616
5613,4510882,3,3,0.639826,28,4511894,-1,1500.0,4516594,4516597,5712,3,21,0,True,True,0.12285,-0.639826
5614,4511154,16606,8,0.523087,28,4511894,-1,4000.0,4559131,4575737,47977,16606,11,0,True,True,2506.5838555555556,-0.5105648807725711
5615,4511179,215,32,0.412031,28,4511894,-1,16000.0,4512994,4513209,1815,215,23,6,True,True,99.44466666666666,-0.412031
5616,4511310,19035,8,0.93809,28,4511894,-1,4000.0,4592229,4611264,80919,19035,11,0,True,True,2646.2013333333334,-0.9079240095309085
5617,4511499,4827,1,0.610538,28,4511894,-1,500.0,4529496,4534323,17997,4827,16,6,True,True,66.6782125,-0.6019680609859344
5618,4511753,13257,16,0.037621,28,4511894,-1,8000.0,4533896,4547153,22143,13257,16,0,True,True,2839.0017555555555,-0.03701882516490481
5619,4511871,26313,256,0.18,28,4511894,-1,128000.0,4811642,4837955,299771,26313,0,7,True,True,100190.7623111111,-0.1693324564774836
5620,4511897,9,1,0.499888,34,4512994,-1,500.0,4519582,4519591,7685,9,22,2,True,True,0.13241250000000002,-0.499888
5621,4512052,29,1,0.950298,34,4512994,-1,500.0,4516594,4516623,4542,29,28,3,True,True,0.39585,-0.950298
5622,4512336,7,4,0.627192,34,4512994,-1,2000.0,4516597,4516604,4261,7,25,0,True,True,0.3822,-0.627192
5623,4512344,10183,128,0.782583,34,4512994,-1,64000.0,4695147,4705330,182803,10183,3,7,True,True,19632.472177777778,-0.77751742297168
5624,4512484,6867,1,0.347854,34,4512994,-1,500.0,4559122,4565989,46638,6867,15,1,True,True,125.39277222222222,-0.3411204871008638
5625,4512523,10641,4,0.00457,34,4512994,-1,2000.0,4585322,4595963,72799,10641,14,3,True,True,841.4313777777778,-0.00437486383163747
5626,4512568,9408,20,0.235639,34,4512994,-1,10000.0,4550531,4559939,37963,9408,17,7,True,True,3481.9546388888884,-0.23130860376011858
5627,4513133,10312,256,0.117508,40,4516594,-1,128000.0,4792150,4802462,279017,10312,2,7,True,True,33372.386844444445,-0.09851538318909075
5628,4513172,278,8,0.530199,40,4516594,-1,4000.0,4533896,4534174,20724,278,23,7,True,True,28.896555555555555,-0.530199
5629,4513229,131,1,0.095684,40,4516594,-1,500.0,4531696,4531827,18467,131,24,0,True,True,1.8807597222222223,-0.095684
5630,4513502,29923,8,0.361901,40,4516594,-1,4000.0,4664622,4694545,151120,29923,9,7,True,True,3956.5169555555553,-0.3470215811958255
5631,4513893,115,4,0.761128,40,4516594,-1,2000.0,4516597,4516712,2704,115,33,0,True,True,6.279,-0.761128
5632,4513961,12531,206,0.539723,40,4516594,-1,103000.0,4737077,4749608,223116,12531,4,8,True,True,38561.87273055555,-0.5390807996539599
5633,4514005,12786,1,0.219276,40,4516594,-1,500.0,4600017,4612803,86012,12786,15,6,True,True,222.2964125,-0.2096794684169636
5634,4516809,8,128,0.770331,43,4519582,-1,64000.0,4531696,4531704,14887,8,28,0,True,True,14.701511111111111,-0.770331
5635,4516825,14,2,0.659327,43,4519582,-1,1000.0,4523982,4523996,7157,14,32,7,True,True,0.39526666666666666,-0.659327
5636,4516932,25708,1,0.276427,43,4519582,-1,500.0,4674822,4700530,157890,25708,8,7,True,True,416.0438472222222,-0.27552869561826404
5637,4517075,17,1,0.193719,43,4519582,-1,500.0,4588922,4588939,71847,17,19,0,True,True,0.3566458333333334,-0.193719
5638,4517257,2,1,0.796613,43,4519582,-1,500.0,4520682,4520684,3425,2,36,6,True,True,0.029425000000000003,-0.796613
5639,4517345,1051,16,0.685244,43,4519582,-1,8000.0,4530596,4531647,13251,1051,31,6,True,True,241.4263777777778,-0.685244
5640,4517516,8846,64,0.968574,43,4519582,-1,32000.0,4533896,4542742,16380,8846,28,0,True,True,7332.731911111112,-0.966609243656978
5641,4517639,67,16,0.474413,43,4519582,-1,8000.0,4521782,4521849,4143,67,38,6,True,True,15.133066666666666,-0.474413
5642,4518334,13,4,0.176324,43,4519582,-1,2000.0,4533896,4533909,15562,13,28,0,True,True,0.6756388888888888,-0.176324
5643,4518433,41,4,0.670143,43,4519582,-1,2000.0,4531696,4531737,13263,41,32,0,True,True,2.354538888888889,-0.670143
5644,4519280,15706,216,0.043116,43,4519582,-1,108000.0,4677241,4692947,157961,15706,8,1,True,True,56242.884900000005,-0.04300314890292015
5645,4520412,26,4,0.644861,43,4520682,-1,2000.0,4520682,4520708,270,26,42,0,True,True,1.5301,-0.644861
5646,4521523,8,1,0.285065,43,4521782,-1,500.0,4559114,4559122,37591,8,24,0,True,True,0.14635555555555554,-0.285065
5647,4521690,260,24,0.434672,43,4521782,-1,12000.0,4531696,4531956,10006,260,34,0,True,True,89.58733333333333,-0.434672
5648,4521909,11,2,0.334295,50,4523982,-1,1000.0,4531696,4531707,9787,11,33,0,True,True,0.3158527777777778,-0.334295
5649,4522729,3,1,0.805154,50,4523982,-1,500.0,4533896,4533899,11167,3,30,0,True,True,0.03897916666666667,-0.805154
5650,4522899,35,3,0.758408,50,4523982,-1,1500.0,4531696,4531731,8797,35,39,6,True,True,1.5074791666666667,-0.758408
5651,4522924,5,1,0.043317,50,4523982,-1,500.0,4560231,4560236,37307,5,22,0,True,True,0.09147222222222222,-0.043317
5652,4522944,39,8,0.740417,50,4523982,-1,4000.0,4523996,4524035,1052,39,45,1,True,True,4.4044,-0.740417
5653,4522957,35,16,0.924861,50,4523982,-1,8000.0,4523982,4524017,1025,35,46,0,True,True,7.905333333333333,-0.924861
5654,4523140,9578,16,0.175888,50,4523982,-1,8000.0,4572595,4582173,49455,9578,22,1,True,True,3063.686488888889,-0.17584161683629576
5655,4523250,9,1,0.785492,50,4523982,-1,500.0,4525096,4525105,1846,9,46,6,True,True,0.12705,-0.785492
5656,4523363,12532,2,0.485061,50,4523982,-1,1000.0,4670422,4682954,147059,12532,12,5,True,True,417.9198944444444,-0.47749702940568883
5657,4524246,9,3,0.116065,49,4525096,-1,1500.0,4559123,4559132,34877,9,26,0,True,True,0.49395,-0.116065
5658,4524794,22,8,0.895079,49,4525096,-1,4000.0,4526196,4526218,1402,22,47,0,True,True,2.4158444444444447,-0.895079
5659,4526009,18052,32,0.721403,50,4526196,-1,16000.0,4598917,4616969,72908,18052,19,6,True,True,10212.924933333332,-0.7002051182667534
5660,4526106,312,1,0.592707,50,4526196,-1,500.0,4533909,4534221,7803,312,34,2,True,True,4.053833333333333,-0.592707
5661,4526425,95,4,0.325972,49,4528396,-1,2000.0,4546126,4546221,19701,95,33,0,True,True,5.494166666666667,-0.325972
5662,4528509,10985,7,0.198751,54,4529496,-1,3500.0,4610825,4621810,82316,10985,17,0,True,True,1452.3704999999998,-0.19182022175626184
5663,4528532,13,2,0.676853,54,4529496,-1,1000.0,4529496,4529509,964,13,49,0,True,True,0.37328055555555556,-0.676853
5664,4528542,6902,256,0.325685,54,4529496,-1,128000.0,4730175,4737077,201633,6902,5,6,True,True,25160.812444444447,-0.29090735847040966
5665,4528627,58,1,0.778975,54,4529496,-1,500.0,4529496,4529554,869,58,51,0,True,True,0.8327027777777778,-0.778975
5666,4528643,5,16,0.326132,54,4529496,-1,8000.0,4531696,4531701,3053,5,48,0,True,True,1.1485555555555556,-0.326132
5667,4528671,7501,2,0.098064,54,4529496,-1,1000.0,4581722,4589223,53051,7501,26,1,True,True,313.875825,-0.09753682861651898
5668,4529621,14,2,0.737748,56,4530596,-1,1000.0,4530596,4530610,975,14,51,0,True,True,0.40199444444444443,-0.737748
5669,4529931,4,6,0.869886,56,4530596,-1,3000.0,4530596,4530600,665,4,51,0,True,True,0.34456666666666663,-0.869886
5670,4530007,7692,8,0.375532,56,4530596,-1,4000.0,4535180,4542872,5173,7692,38,4,True,True,796.6569333333333,-0.37416526248942755
5671,4530554,17,10,0.220663,56,4530596,-1,5000.0,4559114,4559131,28560,17,32,0,True,True,3.1100555555555554,-0.220663
5672,4530578,845,1,0.47099,56,4530596,-1,500.0,4533896,4534741,3318,845,45,0,True,True,10.979131944444443,-0.47099
5673,4530844,8764,4,0.484408,60,4531696,-1,2000.0,4576195,4584959,45351,8764,27,4,True,True,712.5432222222223,-0.478821763883313
5674,4531169,3,32,0.890489,60,4531696,-1,16000.0,4559105,4559108,27936,3,35,0,True,True,1.7562666666666669,-0.890489
5675,4531344,21,1,0.144941,60,4531696,-1,500.0,4533896,4533917,2552,21,44,0,True,True,0.2728541666666667,-0.144941
5676,4531526,20,16,0.927887,60,4531696,-1,8000.0,4531696,4531716,170,20,55,0,True,True,4.594222222222222,-0.927887
5677,4531638,26,1,0.454991,60,4531696,-1,500.0,4565989,4566015,34351,26,29,0,True,True,0.4918333333333333,-0.454991
5678,4531659,557,1,0.38733,60,4531696,-1,500.0,4559114,4559671,27455,557,35,0,True,True,10.190005555555556,-0.38733
5679,4531671,7658,4,0.136405,60,4531696,-1,2000.0,4572593,4580251,40922,7658,29,0,True,True,613.1849777777777,-0.13622253365577902
5680,4531782,62,1,0.719821,57,4533896,-1,500.0,4533896,4533958,2114,62,48,0,True,True,0.8055694444444444,-0.719821
5681,4531933,1006,32,0.632021,57,4533896,-1,16000.0,4534174,4535180,2241,1006,45,4,True,True,418.27244444444443,-0.632021
5682,4532622,14,1,0.975556,57,4533896,-1,500.0,4533896,4533910,1274,14,47,0,True,True,0.18190277777777777,-0.975556
5683,4532680,5732,128,0.202211,57,4533896,-1,64000.0,4628549,4634281,95869,5732,17,4,True,True,17277.83502222222,-0.197944121987313
5684,4532800,98,8,0.127212,57,4533896,-1,4000.0,4559117,4559215,26317,98,36,1,True,True,14.342844444444443,-0.127212
5685,4534150,9493,16,0.692211,49,4534174,-1,8000.0,4559114,4568607,24964,9493,39,0,True,True,2801.2925777777778,-0.6791068907877585
5686,4534165,11917,32,0.059652,49,4534174,-1,16000.0,4557569,4569486,23404,11917,42,0,True,True,7044.589955555555,-0.05617848679536859
5687,4534238,47,1,0.136501,56,4535180,-1,500.0,4551034,4551081,16796,47,43,0,True,True,0.7383569444444444,-0.136501
5688,4534246,13,16,0.851651,56,4535180,-1,8000.0,4536280,4536293,2034,13,49,6,True,True,2.6785777777777775,-0.851651
5689,4534395,78,41,0.458579,56,4535180,-1,20500.0,4567089,4567167,32694,78,31,6,True,True,60.4955,-0.458579
5690,4534431,2356,32,0.171201,56,4535180,-1,16000.0,4569289,4571645,34858,2356,31,0,True,True,1432.6574222222223,-0.171201
5691,4534672,3,4,0.343576,56,4535180,-1,2000.0,4561331,4561334,26659,3,34,6,True,True,0.21628333333333336,-0.343576
5692,4534701,127,1,0.886409,56,4535180,-1,500.0,4542742,4542869,8041,127,51,0,True,True,1.6522347222222222,-0.886409
5693,4534756,8,1,0.603636,56,4535180,-1,500.0,4548331,4548339,13575,8,48,0,True,True,0.11003333333333333,-0.603636
5694,4534783,7493,13,0.789547,56,4535180,-1,6500.0,4539880,4547373,5097,7493,54,4,True,True,1340.604398611111,-0.7726629163375688
5695,4535473,14324,32,0.637999,56,4536280,-1,16000.0,4563531,4577855,28058,14324,34,7,True,True,8841.91991111111,-0.6313671742692141
5696,4536952,7,2,0.611528,86,4539880,-1,1000.0,4551034,4551041,14082,7,47,0,True,True,0.2199361111111111,-0.611528
5697,4537101,22782,64,0.169935,86,4539880,-1,32000.0,4640447,4663229,103346,22782,16,0,True,True,31027.75448888889,-0.16502314082396435
5698,4537167,10152,2,0.970136,86,4539880,-1,1000.0,4569289,4579441,32122,10152,33,0,True,True,400.8988361111111,-0.9584184366333207
5699,4537238,12,4,0.855004,86,4539880,-1,2000.0,4543842,4543854,6604,12,56,6,True,True,0.6940000000000001,-0.855004
5700,4537337,23,4,0.086474,86,4539880,-1,2000.0,4571489,4571512,34152,23,32,7,True,True,1.7482555555555557,-0.086474
5701,4537344,189,1,0.856974,86,4539880,-1,500.0,4548331,4548520,10987,189,55,0,True,True,2.5995375,-0.856974
5702,4537367,11498,256,0.489213,86,4539880,-1,128000.0,4837955,4849453,300588,11498,0,0,True,True,54831.18293333334,-0.4845977593619437
5703,4537480,15,12,0.995664,86,4539880,-1,6000.0,4544942,4544957,7462,15,59,6,True,True,2.6025,-0.995664
5704,4537510,203,32,0.591581,86,4539880,-1,16000.0,4546126,4546329,8616,203,59,2,True,True,93.92133333333334,-0.591581
5705,4537875,9,1,0.836989,86,4539880,-1,500.0,4546126,4546135,8251,9,57,0,True,True,0.130125,-0.836989
5706,4537929,4,4,0.279171,86,4539880,-1,2000.0,4572589,4572593,34660,4,33,6,True,True,0.31691111111111114,-0.279171
5707,4537994,9,2,0.730018,86,4539880,-1,1000.0,4548326,4548335,10332,9,58,0,True,True,0.24757500000000002,-0.730018
5708,4538286,7597,2,0.736179,86,4539880,-1,1000.0,4571489,4579086,33203,7597,34,0,True,True,303.0879555555556,-0.7354989215970175
5709,4538325,12320,1,0.246654,86,4539880,-1,500.0,4636481,4648801,98156,12320,18,0,True,True,228.31584444444442,-0.2305577703954874
5710,4538828,2,16,0.327296,86,4539880,-1,8000.0,4572593,4572595,33765,2,34,1,True,True,0.6338222222222223,-0.327296
5711,4538836,3,4,0.579467,86,4539880,-1,2000.0,4559114,4559117,20278,3,50,0,True,True,0.21953333333333336,-0.579467
5712,4539024,19,4,0.891823,86,4539880,-1,2000.0,4542742,4542761,3718,19,69,0,True,True,0.988738888888889,-0.891823
5713,4539041,7308,2,0.591772,86,4539880,-1,1000.0,4591122,4598430,52081,7308,28,7,True,True,264.36763333333334,-0.5783669314143823
5714,4539072,11767,4,0.14897,86,4539880,-1,2000.0,4591129,4602896,52057,11767,28,1,True,True,820.2179111111111,-0.14564217906634538
5715,4539154,266,4,0.573701,86,4539880,-1,2000.0,4551034,4551300,11880,266,60,1,True,True,16.715144444444444,-0.573701
5716,4539197,12,32,0.005078,86,4539880,-1,16000.0,4539880,4539892,683,12,75,0,True,True,4.995733333333334,-0.005078
5717,4539250,24,1,0.980184,86,4539880,-1,500.0,4548326,4548350,9076,24,66,7,True,True,0.3301,-0.980184
5718,4539326,9,1,0.040059,86,4539880,-1,500.0,4591129,4591138,51803,9,28,0,True,True,0.1777,-0.040059
5719,4539362,12486,128,0.470653,86,4539880,-1,64000.0,4658822,4671308,119460,12486,16,7,True,True,32057.954133333336,-0.461271777438599
5720,4539386,549,16,0.768606,86,4539880,-1,8000.0,4548326,4548875,8940,549,67,0,True,True,120.8166,-0.768606
5721,4539400,38,11,0.033621,86,4539880,-1,5500.0,4559122,4559160,19722,38,51,0,True,True,7.647077777777778,-0.033621
5722,4539428,6673,11,0.531122,86,4539880,-1,5500.0,4559114,4565787,19686,6673,54,0,True,True,1338.8975722222222,-0.5200104288049869
5723,4539570,29,1,0.479269,86,4539880,-1,500.0,4548331,4548360,8761,29,69,1,True,True,0.39887083333333334,-0.479269
5724,4539617,41,4,0.798018,86,4539880,-1,2000.0,4542742,4542783,3125,41,79,0,True,True,2.133594444444445,-0.798018
5725,4539651,11,4,0.821291,86,4539880,-1,2000.0,4546042,4546053,6391,11,77,0,True,True,0.6361666666666667,-0.821291
5726,4539700,12,8,0.452441,86,4539880,-1,4000.0,4559105,4559117,19405,12,61,0,True,True,1.7562666666666669,-0.452441
5727,4539973,16323,2,0.240511,93,4542742,-1,1000.0,4699847,4716170,159874,16323,7,6,True,True,504.8826694444445,-0.22753601573663826
5728,4540032,20468,8,0.558487,93,4542742,-1,4000.0,4698747,4719215,158715,20468,8,4,True,True,2575.9420666666665,-0.5539496100510863
5729,4540119,7,1,0.012423,93,4542742,-1,500.0,4591122,4591129,51003,7,33,0,True,True,0.1382111111111111,-0.012423
5730,4540204,452,2,0.731786,93,4542742,-1,1000.0,4559114,4559566,18910,452,63,2,True,True,16.53817777777778,-0.731786
5731,4540698,84,4,0.949934,93,4542742,-1,2000.0,4546042,4546126,5344,84,83,6,True,True,4.858,-0.949934
5732,4540838,16624,128,0.132712,93,4542742,-1,64000.0,4611925,4628549,71087,16624,25,6,True,True,43193.91555555555,-0.13055968585656907
5733,4541331,1361,16,0.29579,93,4542742,-1,8000.0,4559105,4560466,17774,1361,66,0,True,True,398.3798222222222,-0.29579
5734,4542711,39803,32,0.64764,93,4542742,-1,16000.0,4559114,4598917,16403,39803,62,0,True,True,24630.881866666667,-0.6460128205390027
5735,4542733,93,16,0.09073,93,4542742,-1,8000.0,4585322,4585415,42589,93,37,0,True,True,31.527,-0.09073
5736,4542757,20619,20,0.479783,92,4543842,-1,10000.0,4621810,4642429,79053,20619,24,7,True,True,8853.39,-0.47699542318503063
5737,4542826,24541,128,0.304837,92,4543842,-1,64000.0,4634281,4658822,91455,24541,23,7,True,True,64358.263822222216,-0.29132931921362837
5738,4542922,7192,32,0.703304,92,4543842,-1,16000.0,4543842,4551034,920,7192,91,0,True,True,3271.7668444444444,-0.6628090286809559
5739,4545593,10098,1,0.857922,92,4546042,-1,500.0,4551034,4561132,5441,10098,75,0,True,True,188.0210138888889,-0.8571207677580199
5740,4545652,134,1,0.747287,92,4546042,-1,500.0,4548331,4548465,2679,134,81,0,True,True,1.8430583333333332,-0.747287
5741,4545678,8,3,0.024413,92,4546042,-1,1500.0,4610817,4610825,65139,8,30,9,True,True,0.49853333333333333,-0.024413
5742,4546241,62,1,0.454841,94,4548326,-1,500.0,4565989,4566051,19748,62,54,2,True,True,1.1728333333333332,-0.454841
5743,4546266,5,8,0.771835,94,4548326,-1,4000.0,4548326,4548331,2060,5,87,0,True,True,0.5501666666666667,-0.771835
5744,4546278,312,1,0.874199,94,4548326,-1,500.0,4548331,4548643,2053,312,81,0,True,True,4.291300000000001,-0.874199
5745,4546309,18,2,0.40536,94,4548326,-1,1000.0,4559105,4559123,12796,18,71,0,True,True,0.6586,-0.40536
5746,4546313,22560,16,0.789859,94,4548326,-1,8000.0,4610825,4633385,64512,22560,29,1,True,True,7613.165999999999,-0.7650300147672136
5747,4546388,15476,256,0.37042,94,4548326,-1,128000.0,4849453,4864929,303065,15476,0,7,True,True,50204.40675555555,-0.3417552920834787
5748,4547692,5567,32,0.464296,94,4548326,-1,16000.0,4553538,4559105,5846,5567,78,1,True,True,3571.2329777777777,-0.459380583955647
5749,4547799,23,32,0.633402,94,4548326,-1,16000.0,4559123,4559146,11324,23,61,0,True,True,13.464711111111113,-0.633402
5750,4548559,15,2,0.860383,91,4550531,-1,1000.0,4551300,4551315,2741,15,80,4,True,True,0.47129166666666666,-0.860383
5751,4548601,49,1,0.070699,91,4550531,-1,500.0,4559122,4559171,10521,49,64,0,True,True,0.8964277777777777,-0.070699
5752,4548870,23,4,0.893434,91,4550531,-1,2000.0,4553515,4553538,4645,23,81,7,True,True,1.4452944444444444,-0.893434
5753,4548920,25,8,0.332906,91,4550531,-1,4000.0,4555738,4555763,6818,25,80,6,True,True,4.267222222222222,-0.332906
5754,4548991,127,32,0.032714,91,4550531,-1,16000.0,4581595,4581722,32604,127,45,8,True,True,80.8228,-0.032714
5755,4549079,9,1,0.425902,91,4550531,-1,500.0,4588922,4588931,39843,9,42,2,True,True,0.18881250000000002,-0.425902
5756,4549091,7,8,0.269789,91,4550531,-1,4000.0,4569289,4569296,20198,7,56,7,True,True,1.0641555555555555,-0.269789
5757,4550800,140,2,0.946095,92,4551034,-1,1000.0,4551034,4551174,234,140,89,0,True,True,4.398722222222222,-0.946095
5758,4550857,10170,8,0.542435,92,4551034,-1,4000.0,4600017,4610187,49160,10170,33,0,True,True,1368.6058,-0.508806476989653
5759,4551076,11945,4,0.794479,89,4551300,-1,2000.0,4559114,4571059,8038,11945,76,0,True,True,886.7023888888889,-0.789735655760299
5760,4551090,221,8,0.787692,89,4551300,-1,4000.0,4551315,4551536,225,221,88,1,True,True,27.77478888888889,-0.787692
5761,4551512,47,1,0.080959,93,4553515,-1,500.0,4594501,4594548,42989,47,36,7,True,True,0.8137527777777778,-0.080959
5762,4551543,9,2,0.880847,93,4553515,-1,1000.0,4559105,4559114,7562,9,85,1,True,True,0.3293,-0.880847
5763,4551700,51326,1,0.735761,93,4553515,-1,500.0,4666822,4718148,115122,51326,18,7,True,True,821.8481972222222,-0.7281291114610833
5764,4551709,72,4,0.054812,93,4553515,-1,2000.0,4554638,4554710,2929,72,89,6,True,True,6.1448,-0.054812
5765,4551801,1050,2,0.945322,93,4553515,-1,1000.0,4553515,4554565,1714,1050,91,0,True,True,39.34823611111111,-0.8301765750075945
5766,4551830,14819,1,0.674653,93,4553515,-1,500.0,4662422,4677241,110592,14819,20,1,True,True,260.3422486111111,-0.6596205739934432
5767,4553656,7380,16,0.887978,94,4554638,-1,8000.0,4554638,4562018,982,7380,90,0,True,True,2300.814,-0.8751168126536647
5768,4554141,18,6,0.110967,94,4554638,-1,3000.0,4559123,4559141,4982,18,70,1,True,True,1.9758,-0.110967
5769,4554431,72,1,0.365591,94,4554638,-1,500.0,4592229,4592301,37798,72,41,6,True,True,1.4216,-0.365591
5770,4554453,5978,128,0.619133,94,4554638,-1,64000.0,4572589,4578567,18136,5978,56,0,True,True,15317.361777777778,-0.6177442395368138
5771,4554771,52873,10,0.365571,95,4555738,-1,5000.0,4739277,4792150,184506,52873,6,7,True,True,8572.124152777778,-0.3631493322723787
5772,4554882,283,32,0.175267,95,4555738,-1,16000.0,4560231,4560514,5349,283,70,6,True,True,165.6744888888889,-0.175267
5773,4554941,70,8,0.55879,95,4555738,-1,4000.0,4561331,4561401,6390,70,68,0,True,True,10.093222222222224,-0.55879
862,803344,420,32,0.443679,1,803344,-1,16000.0,804444,804864,1100,420,0,6,True,True,288.1386666666667,-0.443679
863,803495,6902,4,0.694001,3,804444,-1,2000.0,804444,811346,949,6902,0,0,True,True,582.1370222222222,-0.6745481996726874
864,803568,20120,2,0.903424,3,804444,-1,1000.0,857460,877580,53892,20120,0,7,True,True,1124.570888888889,-0.8973461387453396
865,803679,7452,128,0.045991,3,804444,-1,64000.0,804864,812316,1185,7452,1,1,True,True,20198.38293333333,-0.04499135752814242
866,804449,15046,128,0.796143,3,804864,-1,64000.0,811346,826392,6897,15046,1,7,True,True,43405.71875555556,-0.7846506716593713
867,804482,33606,16,0.293368,3,804864,-1,8000.0,855260,888866,50778,33606,1,5,True,True,13591.942222222222,-0.29299808236058894
868,805102,62,32,0.374841,7,811346,-1,16000.0,822246,822308,17144,62,2,8,True,True,42.471377777777775,-0.374841
869,805220,10332,32,0.14557,7,811346,-1,16000.0,838662,848994,33442,10332,2,7,True,True,8399.076533333333,-0.1400080509641482
870,805230,29,1,0.531166,7,811346,-1,500.0,824446,824475,19216,29,3,7,True,True,0.6977319444444444,-0.531166
871,805243,4,1,0.565928,7,811346,-1,500.0,814646,814650,9403,4,5,7,True,True,0.09343333333333334,-0.565928
872,805292,77,5,0.792519,7,811346,-1,2500.0,812446,812523,7154,77,6,6,True,True,8.442194444444445,-0.792519
873,811926,8,12,0.169984,9,812446,-1,6000.0,832046,832054,20120,8,3,0,True,True,2.6167999999999996,-0.169984
874,812010,19832,32,0.078968,9,812446,-1,16000.0,848360,868192,36350,19832,2,4,True,True,16175.53671111111,-0.06895077303897314
875,812082,21614,3,0.87084,9,812446,-1,1500.0,851660,873274,39578,21614,2,6,True,True,1702.7624416666667,-0.8295863830865562
876,812749,20,16,0.61971,13,814646,-1,8000.0,816846,816866,4097,20,8,7,True,True,7.474666666666668,-0.61971
877,812915,14297,64,0.24083,13,814646,-1,32000.0,839762,854059,26847,14297,4,6,True,True,22877.3648,-0.2380955462124048
878,813568,1417,1,0.912829,13,814646,-1,500.0,814646,816063,1078,1417,10,0,True,True,33.098758333333336,-0.912829
879,813725,9665,1,0.143118,13,814646,-1,500.0,850560,860225,36835,9665,3,7,True,True,188.47930555555556,-0.1384311839319308
880,813919,40458,1,0.46115,13,814646,-1,500.0,1137321,1177779,323402,40458,0,7,True,True,779.3067208333333,-0.4479657598814669
881,822832,22853,1,0.253977,16,824446,-1,500.0,1198139,1220992,375307,22853,0,9,True,True,319.47577361111115,-0.24622688150185185
882,822838,110,64,0.255327,16,824446,-1,32000.0,836462,836572,13624,110,9,6,True,True,166.47644444444444,-0.255327
883,822900,33,32,0.009397,16,824446,-1,16000.0,829846,829879,6946,33,11,8,True,True,27.285866666666667,-0.009397
884,822952,4,8,0.804633,16,824446,-1,4000.0,834246,834250,11294,4,10,7,True,True,0.8722666666666666,-0.804633
885,822990,16,1,0.901209,16,824446,-1,500.0,835346,835362,12356,16,10,6,True,True,0.37835555555555556,-0.901209
886,823196,6103,1,0.677611,16,824446,-1,500.0,844162,850265,20966,6103,7,7,True,True,172.99901250000002,-0.6766923533771322
887,823236,17,8,0.157976,16,824446,-1,4000.0,846362,846379,23126,17,7,7,True,True,4.299300000000001,-0.157976
888,825223,23,6,0.44173,23,829846,-1,3000.0,846362,846385,21139,23,7,0,True,True,4.362525000000001,-0.44173
889,825864,1998,1,0.345566,23,829846,-1,500.0,846362,848360,20498,1998,8,0,True,True,63.16177500000001,-0.345566
890,825996,5,1,0.587572,23,829846,-1,500.0,835362,835367,9366,5,14,1,True,True,0.11823611111111111,-0.587572
891,826016,18972,12,0.638939,23,829846,-1,6000.0,1087424,1106396,261408,18972,2,0,True,True,5052.473533333333,-0.6321904530375301
892,826170,219,16,0.424309,23,829846,-1,8000.0,841962,842181,15792,219,12,7,True,True,77.4238,-0.424309
893,826200,20,1,0.250098,23,829846,-1,500.0,846362,846382,20162,20,9,0,True,True,0.6322500000000001,-0.250098
894,826364,216,7,0.845304,23,829846,-1,3500.0,832046,832262,5682,216,21,7,True,True,41.2146,-0.845304
895,826367,752,1,0.199217,23,829846,-1,500.0,872660,873412,46293,752,3,7,True,True,20.4074,-0.199217
896,849581,23,1,0.384693,8,850560,-1,500.0,851660,851683,2079,23,6,0,True,True,0.5460902777777777,-0.384693
897,855437,12693,16,0.483208,14,857460,-1,8000.0,1028781,1041474,173344,12693,3,6,True,True,3269.5868666666665,-0.44809843646344527
898,855480,6,16,0.237206,14,857460,-1,8000.0,877580,877586,22100,6,4,2,True,True,2.2245333333333335,-0.237206
899,855897,7,2,0.571923,14,857460,-1,1000.0,906395,906402,50498,7,4,7,True,True,0.2856583333333333,-0.571923
900,855953,8,6,0.574812,14,857460,-1,3000.0,881980,881988,26027,8,5,7,True,True,1.0970666666666666,-0.574812
901,856547,12,3,0.992692,14,857460,-1,1500.0,857460,857472,913,12,8,0,True,True,0.667,-0.992692
902,856672,8973,256,0.295231,14,857460,-1,128000.0,1106396,1115369,249724,8973,2,0,True,True,42411.30560000001,-0.2847471903631925
903,856901,5276,1,0.977944,14,857460,-1,500.0,873760,879036,16859,5276,8,6,True,True,126.17913333333334,-0.903791402137136
904,857055,2147,1,0.65823,14,857460,-1,500.0,859660,861807,2605,2147,10,7,True,True,57.13213888888889,-0.5675636236651145
905,857294,280,4,0.27448,14,857460,-1,2000.0,883080,883360,25786,280,6,6,True,True,24.885777777777776,-0.27448
906,857423,10533,256,0.565929,14,857460,-1,128000.0,1270238,1280771,412815,10533,0,1,True,True,47281.23626666667,-0.5638703450715723
907,857764,2,16,0.685799,20,859660,-1,8000.0,863260,863262,5496,2,12,5,True,True,0.9875555555555555,-0.685799
908,857872,23,32,0.744669,20,859660,-1,16000.0,863260,863283,5388,23,12,0,True,True,22.71377777777778,-0.744669
909,857926,13543,41,0.049044,20,859660,-1,20500.0,906572,920115,48646,13543,6,5,True,True,11473.299233333333,-0.048934470677340434
910,858044,130,2,0.606406,20,859660,-1,1000.0,870460,870590,12416,130,13,5,True,True,8.11886111111111,-0.606406
911,858080,14815,32,0.496727,20,859660,-1,16000.0,1017481,1032296,159401,14815,6,7,True,True,9099.011644444445,-0.46541694394287725
912,858233,4292,256,0.904155,20,859660,-1,128000.0,1220992,1225284,362759,4292,1,8,True,True,14090.791822222225,-0.9003665420619552
913,858316,633,8,0.286194,20,859660,-1,4000.0,873760,874393,15444,633,13,0,True,True,137.4243,-0.286194
914,858633,5104,16,0.79886,20,859660,-1,8000.0,866860,871964,8227,5104,17,5,True,True,2532.221688888889,-0.7474492798033876
915,869045,28,4,0.607065,17,870460,-1,2000.0,874862,874890,5817,28,13,6,True,True,2.5952888888888888,-0.607065
916,872125,2,4,0.352321,18,872660,-1,2000.0,916848,916850,44723,2,8,7,True,True,0.1651111111111111,-0.352321
917,872597,2,8,0.636618,18,872660,-1,4000.0,873760,873762,1163,2,15,0,True,True,0.4342,-0.636618
918,872822,7,1,0.620891,18,873760,-1,500.0,873762,873769,940,7,15,1,True,True,0.18996249999999998,-0.620891
919,874005,8,3,0.677764,18,874862,-1,1500.0,885280,885288,11275,8,11,7,True,True,0.5332666666666666,-0.677764
920,874367,121,4,0.720928,18,874862,-1,2000.0,875962,876083,1595,121,15,6,True,True,11.215355555555556,-0.720928
921,874462,30081,118,0.659182,18,874862,-1,59000.0,1135121,1165202,260659,30081,4,0,True,True,63152.95149166667,-0.6427501982662484
922,874661,25,8,0.838337,18,874862,-1,4000.0,874862,874887,201,25,17,0,True,True,4.634444444444444,-0.838337
923,875287,124,1,0.628248,18,875962,-1,500.0,879780,879904,4493,124,15,7,True,True,2.834088888888889,-0.628248
924,875915,116,1,0.903404,18,875962,-1,500.0,879780,879896,3865,116,15,0,True,True,2.6512444444444445,-0.903404
925,876833,31818,22,0.646341,18,877580,-1,11000.0,954882,986700,78049,31818,9,7,True,True,10604.056283333335,-0.6231734435068943
926,879025,6633,4,0.308933,20,879780,-1,2000.0,938282,944915,59257,6633,10,4,True,True,493.6836166666667,-0.2866944618254143
927,879294,29,1,0.440823,20,879780,-1,500.0,910248,910277,30954,29,12,0,True,True,0.6043277777777777,-0.440823
928,879729,170,1,0.579574,20,879780,-1,500.0,906402,906572,26673,170,14,0,True,True,3.4687083333333333,-0.579574
929,880101,14947,8,0.73236,25,881980,-1,4000.0,932482,947429,52381,14947,11,6,True,True,2241.384433333333,-0.7309780076406546
930,880390,8887,73,0.090133,25,881980,-1,36500.0,910211,919098,29821,8887,14,1,True,True,13364.285605555555,-0.08924316370526604
931,880414,11490,32,0.29511,25,881980,-1,16000.0,897287,908777,16873,11490,18,7,True,True,7236.8423999999995,-0.289139607859695
932,880813,36514,15,0.747481,25,881980,-1,7500.0,1033181,1069695,152368,36514,7,7,True,True,11767.681437500001,-0.7142607604279693
933,881078,5,8,0.17564,25,881980,-1,4000.0,917962,917967,36884,5,13,1,True,True,0.8255555555555556,-0.17564
934,881223,28,16,0.13216,25,881980,-1,8000.0,900887,900915,19664,28,20,1,True,True,8.656355555555555,-0.13216
935,881791,19419,2,0.539408,25,881980,-1,1000.0,997948,1017367,116157,19419,10,0,True,True,897.0573611111112,-0.5371959031188267
936,882069,133,32,0.97149,25,883080,-1,16000.0,895080,895213,13011,133,23,0,True,True,78.45226666666667,-0.97149
937,883386,108,31,0.530852,29,885280,-1,15500.0,887480,887588,4094,108,24,7,True,True,68.727,-0.530852
938,883775,287,2,0.913487,29,885280,-1,1000.0,904187,904474,20412,287,21,0,True,True,11.711991666666666,-0.913487
939,883852,219,2,0.830473,29,885280,-1,1000.0,892880,893099,9028,219,25,8,True,True,8.0738,-0.830473
940,883929,246,8,0.25697,29,885280,-1,4000.0,917965,918211,34036,246,14,0,True,True,40.97368888888889,-0.25659981365585033
941,884401,10356,1,0.82469,29,885280,-1,500.0,917965,928321,33564,10356,14,0,True,True,211.58144583333333,-0.8139652944462332
942,886266,17,42,0.481848,31,887480,-1,21000.0,912448,912465,26182,17,18,6,True,True,14.598325,-0.481848
943,886308,10,16,0.806488,31,887480,-1,8000.0,895087,895097,8779,10,27,1,True,True,2.9493333333333336,-0.806488
944,887364,49,8,0.746559,31,887480,-1,4000.0,903087,903136,15723,49,25,7,True,True,7.574311111111111,-0.746559
945,887483,4,16,0.338715,35,892880,-1,8000.0,910248,910252,22765,4,20,1,True,True,1.333688888888889,-0.338715
946,888404,19181,64,0.11517,35,892880,-1,32000.0,985109,1004290,96705,19181,11,1,True,True,23530.898666666668,-0.11497335892733927
947,888428,7,4,0.962893,35,892880,-1,2000.0,895080,895087,6652,7,32,7,True,True,0.5161333333333333,-0.962893
948,890340,32,8,0.140757,35,892880,-1,4000.0,928046,928078,37706,32,15,7,True,True,5.056355555555556,-0.140757
949,890943,933,1,0.9665,35,892880,-1,500.0,914648,915581,23705,933,20,0,True,True,19.256083333333333,-0.9665
950,898449,8685,8,0.860141,39,900887,-1,4000.0,910248,918933,11799,8685,23,0,True,True,1430.8889333333334,-0.8512523865228048
951,898487,4,31,0.724217,39,900887,-1,15500.0,924742,924746,26255,4,16,0,True,True,2.5542277777777778,-0.724217
952,899563,16,16,0.979942,39,900887,-1,8000.0,904187,904203,4624,16,31,6,True,True,5.223466666666667,-0.979942
953,899573,6726,4,0.96727,39,900887,-1,2000.0,924742,931468,25169,6726,16,0,True,True,535.9968555555556,-0.9475203698039532
954,899742,37,1,0.804588,39,900887,-1,500.0,910211,910248,10469,37,27,0,True,True,0.7710388888888888,-0.804588
955,900455,21812,4,0.365775,39,900887,-1,2000.0,1140921,1162733,240466,21812,3,0,True,True,1647.447961111111,-0.36521249095623304
956,900532,88,64,0.790682,39,900887,-1,32000.0,959510,959598,58978,88,13,1,True,True,87.8592,-0.790682
957,900557,1004,1,0.013919,39,900887,-1,500.0,906395,907399,5838,1004,33,0,True,True,20.57229305555556,-0.01368618686205591
958,900601,3,2,0.536572,39,900887,-1,1000.0,906402,906405,5801,3,33,1,True,True,0.122425,-0.536572
959,900967,2394,2,0.454786,52,903087,-1,1000.0,917948,920342,16981,2394,23,0,True,True,99.80784444444444,-0.4546859789713203
960,900973,1191,16,0.672828,52,903087,-1,8000.0,910211,911402,9238,1191,30,0,True,True,393.31995555555557,-0.6664134208792014
961,901023,7663,1,0.672341,52,903087,-1,500.0,934682,942345,33659,7663,16,7,True,True,153.98877361111113,-0.6625094626406269
962,901302,88,4,0.58456,52,903087,-1,2000.0,912448,912536,11146,88,27,0,True,True,7.196933333333334,-0.58456
963,901346,11,2,0.822417,52,903087,-1,1000.0,906402,906413,5056,11,37,0,True,True,0.4488916666666667,-0.822417
964,901612,8,1,0.940292,52,903087,-1,500.0,904187,904195,2575,8,42,0,True,True,0.16323333333333334,-0.940292
965,901663,23878,7,0.108346,52,903087,-1,3500.0,1127121,1150999,225458,23878,6,6,True,True,2182.379072222222,-0.10411658865278156
966,902461,19,2,0.233822,52,903087,-1,1000.0,920342,920361,17881,19,22,0,True,True,0.7923,-0.233822
967,902471,1293,1,0.025025,52,903087,-1,500.0,906402,907695,3931,1293,40,0,True,True,26.597775,-0.02470280727150254
968,902499,7017,42,0.884235,52,903087,-1,21000.0,917948,924965,15449,7017,27,6,True,True,6108.797041666667,-0.883411796215878
969,902511,126,8,0.561407,52,903087,-1,4000.0,919065,919191,16554,126,23,6,True,True,21.016800000000003,-0.561407
970,902522,52,1,0.915256,52,903087,-1,500.0,911348,911400,8826,52,33,6,True,True,1.0631833333333334,-0.915256
971,902557,23,32,0.221367,52,903087,-1,16000.0,904187,904210,1630,23,48,0,True,True,15.017466666666667,-0.221367
972,902661,93,1,0.063217,52,903087,-1,500.0,952682,952775,50021,93,16,9,True,True,1.3407499999999999,-0.063217
973,903095,8782,32,0.823855,61,904187,-1,16000.0,910248,919030,7153,8782,37,0,True,True,5788.274133333334,-0.8155269623185669
974,903110,860,16,0.909388,61,904187,-1,8000.0,904195,905055,1085,860,49,1,True,True,280.76133333333337,-0.909388
975,903135,6,16,0.30219,61,904187,-1,8000.0,924742,924748,21607,6,21,0,True,True,1.977466666666667,-0.30219
976,903148,44954,1,0.408296,61,904187,-1,500.0,1225284,1270238,322136,44954,1,6,True,True,666.3224777777779,-0.406650268637824
977,903524,11752,256,0.139777,61,904187,-1,128000.0,1115369,1127121,211845,11752,8,8,True,True,33234.145422222224,-0.12235060511078652
978,903601,92,1,0.946262,61,904187,-1,500.0,906402,906494,2801,92,46,0,True,True,1.8771833333333334,-0.946262
979,903638,68,1,0.304365,61,904187,-1,500.0,972813,972881,69175,68,16,7,True,True,1.0241555555555555,-0.304365
980,903680,4122,32,0.492625,61,904187,-1,16000.0,919098,923220,15418,4122,28,2,True,True,2737.1664,-0.4910404190212436
981,903718,45,8,0.097192,61,904187,-1,4000.0,925846,925891,22128,45,24,0,True,True,7.110500000000001,-0.097192
982,904017,60,2,0.887259,61,904187,-1,1000.0,914648,914708,10631,60,38,0,True,True,2.4766666666666666,-0.887259
983,904225,19,1,0.135664,65,906395,-1,500.0,920342,920361,16117,19,29,5,True,True,0.39615,-0.135664
984,904339,39,33,0.453644,65,906395,-1,16500.0,910172,910211,5833,39,50,4,True,True,26.819650000000003,-0.453644
985,905570,22716,12,0.670486,65,906395,-1,6000.0,1028781,1051497,123211,22716,12,0,True,True,4608.57165,-0.6247084215454644
986,905590,9,4,0.74314,65,906395,-1,2000.0,910248,910257,4658,9,46,0,True,True,0.7502,-0.74314
987,905623,13136,1,0.945974,65,906395,-1,500.0,917965,931101,12342,13136,34,0,True,True,267.1486486111111,-0.9348669912217743
988,906078,9022,64,0.419127,65,906395,-1,32000.0,993540,1002562,87462,9022,16,0,True,True,11584.801066666667,-0.39878938285893906
989,906231,66,8,0.742269,65,906395,-1,4000.0,906402,906468,171,66,60,0,True,True,10.7734,-0.742269
990,906267,19,2,0.154523,65,906395,-1,1000.0,968413,968432,62146,19,19,6,True,True,0.52725,-0.154523
991,906314,10719,32,0.414885,65,906395,-1,16000.0,991340,1002059,85026,10719,17,0,True,True,6619.615733333333,-0.3907129451874995
992,906561,65,1,0.099022,58,906572,-1,500.0,961710,961775,55149,65,21,7,True,True,0.8943819444444443,-0.099022
993,906605,6836,4,0.489347,76,910172,-1,2000.0,919098,925934,12493,6836,35,0,True,True,563.2768777777777,-0.48624661297832417
994,906648,38,16,0.408116,76,910172,-1,8000.0,924742,924780,18094,38,33,6,True,True,12.523955555555556,-0.408116
995,907346,10685,256,0.951522,76,910172,-1,128000.0,1187339,1198024,279993,10685,4,7,True,True,47747.458844444445,-0.9249187242224016
996,907418,22137,186,0.032716,76,910172,-1,93000.0,1165202,1187339,257784,22137,5,7,True,True,83963.57853333333,-0.032088982151665134
997,907611,11406,130,0.37053,76,910172,-1,65000.0,1045581,1056987,137970,11406,13,7,True,True,30025.123375,-0.3545423221175672
998,907659,13541,8,0.443383,76,910172,-1,4000.0,1041181,1054722,133522,13541,14,4,True,True,2029.8797555555557,-0.44197884414375016
999,908719,13369,32,0.950555,76,910172,-1,16000.0,921442,934811,12723,13369,38,0,True,True,8613.02711111111,-0.9369639323255325
1000,908991,87,16,0.85545,76,910172,-1,8000.0,910248,910335,1257,87,59,0,True,True,29.00773333333333,-0.85545
1001,909120,27,4,0.099355,76,910172,-1,2000.0,957082,957109,47962,27,27,7,True,True,1.65285,-0.099355
1002,909179,43100,1,0.68568,76,910172,-1,500.0,1140921,1184021,231742,43100,7,4,True,True,856.6138277777778,-0.6839872887616992
1003,909201,123,2,0.544466,76,910172,-1,1000.0,917962,918085,8761,123,49,0,True,True,5.1130555555555555,-0.5427628445752882
1004,909536,33,1,0.977843,76,910172,-1,500.0,910248,910281,712,33,60,0,True,True,0.6876833333333333,-0.977843
1005,909593,16765,128,0.358674,76,910172,-1,64000.0,974575,991340,64982,16765,24,1,True,True,35967.71911111111,-0.35468383703050455
1006,909608,12,4,0.39814,76,910172,-1,2000.0,919065,919077,9457,12,46,0,True,True,1.0008000000000001,-0.39814
1007,909629,54,39,0.189809,76,910172,-1,19500.0,928078,928132,18449,54,35,1,True,True,41.596424999999996,-0.189809
1008,909664,402,8,0.12216,76,910172,-1,4000.0,917952,918354,8288,402,54,0,True,True,66.97253333333333,-0.12201231062910865
1009,909671,508,32,0.848033,76,910172,-1,16000.0,910211,910719,540,508,70,0,True,True,338.75697777777776,-0.848033
1010,909734,7262,128,0.454717,76,910172,-1,64000.0,967313,974575,57579,7262,27,7,True,True,13247.866133333333,-0.44816421605006623
1011,910051,9,1,0.662769,76,910172,-1,500.0,910248,910257,197,9,66,0,True,True,0.18755,-0.662769
1012,910264,145,32,0.641704,64,911348,-1,16000.0,914648,914793,4384,145,61,7,True,True,95.76444444444445,-0.641704
1013,912627,17,11,0.597146,75,914648,-1,5500.0,917948,917965,5321,17,56,0,True,True,3.859472222222222,-0.597146
1014,913063,10,8,0.021357,75,914648,-1,4000.0,917962,917972,4899,10,54,0,True,True,1.6511111111111112,-0.021357
1015,913159,10,2,0.786795,75,914648,-1,1000.0,917952,917962,4793,10,57,1,True,True,0.4127777777777778,-0.786795
1016,913181,4,32,0.243569,75,914648,-1,16000.0,917948,917952,4767,4,59,0,True,True,2.6417777777777776,-0.243569
1017,913189,52,2,0.125924,75,914648,-1,1000.0,919098,919150,5909,52,46,0,True,True,2.1684,-0.125924
1018,913206,10652,32,0.564578,75,914648,-1,16000.0,924742,935394,11536,10652,40,0,True,True,6811.580177777778,-0.5571637786706819
1019,913376,10586,4,0.06861,75,914648,-1,2000.0,941882,952468,28506,10586,33,1,True,True,644.5971888888889,-0.0633154693485749
1020,913679,13,1,0.765157,75,914648,-1,500.0,917962,917975,4283,13,58,0,True,True,0.2683055555555555,-0.765157
1021,913776,5090,128,0.207157,75,914648,-1,64000.0,1037581,1042671,123805,5090,16,7,True,True,11281.027911111112,-0.20256661706416768
1022,913837,8334,86,0.215951,75,914648,-1,43000.0,976775,985109,62938,8334,25,7,True,True,11699.745180555557,-0.21425385514759523
1023,913856,34,1,0.869695,75,914648,-1,500.0,917948,917982,4092,34,64,0,True,True,0.7017222222222222,-0.869695
1024,913878,12987,102,0.32856,75,914648,-1,51000.0,1135121,1148108,221243,12987,10,7,True,True,18692.447891666667,-0.3250645678135141
1025,914416,1453,8,0.147554,75,914648,-1,4000.0,917965,919418,3549,1453,59,1,True,True,242.3012888888889,-0.14751801193887745
1026,914447,10233,26,0.900531,75,914648,-1,13000.0,919098,929331,4651,10233,51,0,True,True,5409.731924999999,-0.8922880191192991
1027,917303,12378,32,0.002836,75,917948,-1,16000.0,959282,971660,41979,12378,33,7,True,True,5554.9856,-0.0027801326843359445
1028,917615,29897,224,0.858406,75,917948,-1,112000.0,1228884,1258781,311269,29897,1,1,True,True,94868.01395555555,-0.8435370098189396
1029,917671,30,8,0.144688,75,917948,-1,4000.0,929182,929212,11511,30,42,0,True,True,4.809,-0.144688
1030,917677,24,1,0.129992,75,917948,-1,500.0,917952,917976,275,24,69,0,True,True,0.49533333333333335,-0.129992
1031,918317,103,8,0.250654,62,919065,-1,4000.0,965010,965113,46693,103,32,7,True,True,11.193811111111112,-0.250654
1032,918364,38,2,0.174497,62,919065,-1,1000.0,965113,965151,46749,38,32,1,True,True,1.032438888888889,-0.174497
1033,918775,3,9,0.661058,62,919065,-1,4500.0,921442,921445,2667,3,54,6,True,True,0.5629500000000001,-0.661058
1034,919307,9385,1,0.02578,60,920342,-1,500.0,965113,974498,45806,9385,32,0,True,True,132.2256375,-0.025466643718057028
1035,919364,89,32,0.01486,60,920342,-1,16000.0,931382,931471,12018,89,45,0,True,True,57.0668,-0.01486
1036,919452,3,64,0.789985,60,920342,-1,32000.0,930282,930285,10830,3,46,6,True,True,3.8472000000000004,-0.789985
1037,920324,34,8,0.237932,60,920342,-1,4000.0,976775,976809,56451,34,27,0,True,True,4.294955555555555,-0.237932
1038,920891,48,2,0.323771,63,921442,-1,1000.0,929182,929230,8291,48,49,1,True,True,1.9236000000000002,-0.323771
1039,920971,97,16,0.174246,63,921442,-1,8000.0,929178,929275,8207,97,50,0,True,True,31.098200000000002,-0.174246
1040,921010,137,32,0.052399,63,921442,-1,16000.0,931382,931519,10372,137,47,6,True,True,87.84440000000001,-0.052399
1041,921138,19,32,0.741718,63,921442,-1,16000.0,923642,923661,2504,19,60,7,True,True,12.523955555555556,-0.741718
1042,921155,4,16,0.526086,63,921442,-1,8000.0,929178,929182,8023,4,52,6,True,True,1.2824,-0.526086
1043,921476,16,2,0.745665,66,923642,-1,1000.0,924742,924758,3266,16,59,0,True,True,0.6591555555555556,-0.745665
1044,922091,7318,1,0.476246,66,923642,-1,500.0,1021881,1029199,99790,7318,22,0,True,True,141.99500416666666,-0.44553895776811786
1045,922453,8,32,0.778017,66,923642,-1,16000.0,924746,924754,2293,8,57,0,True,True,5.273244444444445,-0.778017
1046,923100,8145,4,0.513238,66,923642,-1,2000.0,938282,946427,15182,8145,44,0,True,True,589.5192166666667,-0.47633024816081415
1047,923295,14,4,0.109054,66,923642,-1,2000.0,962810,962824,39515,14,37,6,True,True,0.7705444444444444,-0.109054
1048,924235,1805,4,0.503839,70,924742,-1,2000.0,957082,958887,32847,1805,41,0,True,True,112.01903333333333,-0.5010970038322443
1049,924270,4,4,0.945416,70,924742,-1,2000.0,924746,924750,476,4,61,1,True,True,0.3295777777777778,-0.945416
1050,924347,478,32,0.043365,70,924742,-1,16000.0,924742,925220,395,478,64,0,True,True,314.5341333333333,-0.04329037216375628
1051,924458,5852,24,0.783227,70,924742,-1,12000.0,925846,931698,1388,5852,60,6,True,True,2793.942666666667,-0.7818780228479981
1052,924597,126,1,0.866981,70,924742,-1,500.0,924746,924872,149,126,62,0,True,True,2.595425,-0.866981
1053,924998,6,8,0.521451,62,925846,-1,4000.0,929178,929184,4180,6,56,0,True,True,0.9618000000000001,-0.521451
1054,925011,39,16,0.458043,62,925846,-1,8000.0,929178,929217,4167,39,57,0,True,True,12.503400000000001,-0.458043
1055,936420,9172,256,0.964026,48,938282,-1,128000.0,1078252,1087424,141832,9172,16,0,True,True,60012.10453333333,-0.9518381839771848
1056,940082,17,1,0.060825,47,941882,-1,500.0,995748,995765,55666,17,26,0,True,True,0.2946902777777778,-0.060825
1057,946443,136,4,0.478982,53,952682,-1,2000.0,970613,970749,24170,136,34,0,True,True,7.548000000000001,-0.478982
1058,947436,101,4,0.401617,53,952682,-1,2000.0,969513,969614,22077,101,35,6,True,True,5.6055,-0.401617
1059,948335,228,2,0.686097,53,952682,-1,1000.0,959282,959510,10947,228,44,0,True,True,7.1136,-0.686097
1060,948427,60,128,0.490269,53,952682,-1,64000.0,1030981,1031041,82554,60,21,7,True,True,112.384,-0.490269
1061,950872,20,1,0.909701,53,952682,-1,500.0,962810,962830,11938,20,42,0,True,True,0.27519444444444446,-0.909701
1062,951596,93,6,0.073491,53,952682,-1,3000.0,994644,994737,43048,93,28,1,True,True,9.672775,-0.073491
1063,952049,4,1,0.08079,53,952682,-1,500.0,994640,994644,42591,4,29,6,True,True,0.0693388888888889,-0.08079
1064,954290,6001,1,0.608297,54,954882,-1,500.0,995748,1001749,41458,6001,27,0,True,True,124.60225833333334,-0.571585863424501
1065,954364,14892,1,0.065682,54,954882,-1,500.0,995748,1010640,41384,14892,27,0,True,True,331.06935000000004,-0.0643735399798529
1066,958951,49,2,0.275016,53,959282,-1,1000.0,974575,974624,15624,49,37,0,True,True,1.4759888888888888,-0.275016
1067,959062,1,16,0.633077,53,959282,-1,8000.0,968413,968414,9351,1,42,0,True,True,0.222,-0.633077
1068,960718,5,1,0.548356,53,961710,-1,500.0,965113,965118,4395,5,46,0,True,True,0.06792361111111112,-0.548356
1069,961037,26,1,0.325185,53,961710,-1,500.0,1009881,1009907,48844,26,26,0,True,True,0.6329555555555555,-0.325185
1070,961492,11010,4,0.994628,53,961710,-1,2000.0,991340,1002350,29848,11010,35,0,True,True,853.4576666666666,-0.944849788775344
1071,962758,3023,14,0.530557,53,962810,-1,7000.0,970613,973636,7855,3023,43,0,True,True,614.3844388888889,-0.5113862667385406
1072,964846,8,16,0.453715,52,965010,-1,8000.0,968413,968421,3567,8,45,0,True,True,1.776,-0.453715
1073,965817,8624,1,0.605427,49,967313,-1,500.0,1000157,1008781,34340,8624,27,7,True,True,196.38575833333334,-0.5873657631937648
1074,967377,34871,32,0.099178,51,968413,-1,16000.0,1043381,1078252,76004,34871,18,7,True,True,27203.581244444442,-0.09723739067507509
1075,967509,1078,4,0.701779,51,968413,-1,2000.0,969513,970591,2004,1078,46,0,True,True,59.82900000000001,-0.701779
1076,968389,9,5,0.852793,51,968413,-1,2500.0,968413,968422,24,9,49,0,True,True,0.6243750000000001,-0.852793
1077,968414,72,16,0.650917,48,969513,-1,8000.0,970613,970685,2199,72,46,6,True,True,15.984000000000002,-0.650917
1078,969769,154,39,0.768963,47,970613,-1,19500.0,974575,974729,4806,154,41,0,True,True,90.45703333333333,-0.768963
1079,971202,34,2,0.72084,52,972813,-1,1000.0,994644,994678,23442,34,33,0,True,True,1.1787611111111111,-0.72084
1080,971335,38,5,0.215023,52,972813,-1,2500.0,1009881,1009919,38546,38,28,6,True,True,4.625444444444445,-0.215023
1081,971395,4,1,0.451555,52,972813,-1,500.0,995744,995748,24349,4,34,0,True,True,0.0693388888888889,-0.451555
1082,971409,19,16,0.228494,52,972813,-1,8000.0,1004557,1004576,33148,19,29,7,True,True,7.0063555555555554,-0.228494
1083,972347,8440,4,0.338932,52,972813,-1,2000.0,1035381,1043821,63034,8440,21,7,True,True,578.6649222222222,-0.33802231611788586
1084,972419,46,64,0.453499,52,972813,-1,32000.0,995748,995794,23329,46,36,1,True,True,51.03342222222223,-0.453499
1085,972472,202,7,0.41599,52,972813,-1,3500.0,1002357,1002559,29885,202,31,7,True,True,31.591116666666668,-0.41599
1086,972562,9,16,0.095086,52,972813,-1,8000.0,997948,997957,25386,9,34,7,True,True,3.1292000000000004,-0.095086
1087,973330,8268,1,0.426764,52,974575,-1,500.0,1025481,1033749,52151,8268,26,0,True,True,136.89765416666668,-0.37624689310238607
1088,976350,1795,8,0.665108,50,976775,-1,4000.0,997957,999752,21607,1795,34,0,True,True,312.0507777777778,-0.665108
1089,977243,39,1,0.374301,77,985109,-1,500.0,1005657,1005696,28414,39,31,6,True,True,0.8988416666666666,-0.374301
1090,977252,11,1,0.152639,77,985109,-1,500.0,997948,997959,20696,11,37,0,True,True,0.23903611111111114,-0.152639
1091,977766,685,12,0.922985,77,985109,-1,6000.0,991340,992025,13574,685,50,4,True,True,138.57549999999998,-0.922985
1092,977881,13472,8,0.067133,77,985109,-1,4000.0,1089624,1103096,111743,13472,15,7,True,True,2397.969688888889,-0.06529440114706103
1093,977908,132,1,0.831772,77,985109,-1,500.0,988709,988841,10801,132,52,0,True,True,2.4533666666666667,-0.831772
1094,978328,59,16,0.09323,77,985109,-1,8000.0,1008781,1008840,30453,59,32,1,True,True,22.981155555555556,-0.09323
1095,978363,3,8,0.096564,77,985109,-1,4000.0,1021881,1021884,43518,3,29,7,True,True,0.5087333333333334,-0.096564
1096,978418,13818,1,0.738796,77,985109,-1,500.0,1019681,1033499,41263,13818,30,0,True,True,253.31094166666668,-0.712298338788192
1097,978486,10996,1,0.811769,77,985109,-1,500.0,994644,1005640,16158,10996,48,0,True,True,231.54610555555558,-0.7671052007979191
1098,978991,526,1,0.556371,77,985109,-1,500.0,994640,995166,15649,526,51,0,True,True,9.118063888888889,-0.556371
1099,980530,24,4,0.586465,77,985109,-1,2000.0,988709,988733,8179,24,58,0,True,True,1.7842666666666667,-0.586465
1100,980556,14205,5,0.561586,77,985109,-1,2500.0,1132921,1147126,152365,14205,12,1,True,True,931.993451388889,-0.5291869213586903
1101,980782,174,1,0.329646,77,985109,-1,500.0,997957,998131,17175,174,41,1,True,True,3.7811166666666667,-0.329646
1102,981035,110,1,0.122231,77,985109,-1,500.0,1027681,1027791,46646,110,28,7,True,True,1.9822916666666666,-0.122231
1103,981285,15835,1,0.353598,77,985109,-1,500.0,1019681,1035516,38396,15835,33,7,True,True,285.5269138888889,-0.3445454310717433
1104,981445,6,1,0.665341,77,985109,-1,500.0,995748,995754,14303,6,47,0,True,True,0.10400833333333334,-0.665341
1105,982056,602,32,0.750284,77,985109,-1,16000.0,994644,995246,12588,602,54,0,True,True,333.9360888888889,-0.750284
1106,982101,37,4,0.868092,77,985109,-1,2000.0,993540,993577,11439,37,60,7,True,True,2.495033333333333,-0.868092
1107,982123,110,8,0.721061,77,985109,-1,4000.0,988709,988819,6586,110,66,2,True,True,16.355777777777778,-0.721061
1108,982164,7,8,0.968399,77,985109,-1,4000.0,994640,994647,12476,7,58,0,True,True,0.9707444444444444,-0.968399
1109,982252,5,1,0.60041,77,985109,-1,500.0,995744,995749,13492,5,53,6,True,True,0.08667361111111112,-0.60041
1110,982290,4761,32,0.351646,77,985109,-1,16000.0,1015281,1020042,32991,4761,35,8,True,True,3434.636,-0.35116309190851597
1111,982603,17270,32,0.577919,77,985109,-1,16000.0,1007857,1025127,25254,17270,39,7,True,True,12521.746888888889,-0.5654321878510933
1112,982610,6,1,0.212739,77,985109,-1,500.0,1027681,1027687,45071,6,28,0,True,True,0.10812500000000001,-0.212739
1113,982622,638,32,0.656736,77,985109,-1,16000.0,1004557,1005195,21935,638,42,0,True,True,470.5320888888889,-0.656736
1114,982989,235,32,0.224245,77,985109,-1,16000.0,993540,993775,10551,235,66,0,True,True,129.44244444444445,-0.22267155743964867
1115,983056,39,1,0.108218,77,985109,-1,500.0,1025481,1025520,42425,39,31,4,True,True,0.7945708333333333,-0.108218
1116,983155,9737,1,0.845373,77,985109,-1,500.0,1021881,1031618,38726,9737,32,0,True,True,178.751425,-0.7734485714634924
1117,983164,29666,2,0.367561,77,985109,-1,1000.0,1129321,1158987,146157,29666,13,7,True,True,894.1802888888889,-0.3604335162061322
8108,6377131,47,4,0.476302,1,6377131,-1,2000.0,6379331,6379378,2200,47,0,7,True,True,2.040061111111111,-0.476302
8109,6378238,10,1,0.897511,4,6379331,-1,500.0,6379331,6379341,1093,10,0,0,True,True,0.10851388888888888,-0.897511
8110,6378720,26,11,0.123098,4,6379331,-1,5500.0,6387031,6387057,8311,26,0,7,True,True,3.505486111111111,-0.123098
8111,6378935,136,8,0.135756,4,6379331,-1,4000.0,6381531,6381667,2596,136,1,7,True,True,11.80631111111111,-0.135756
8112,6378951,139,64,0.534543,4,6379331,-1,32000.0,6384831,6384970,5880,139,1,7,True,True,112.2008,-0.534543
8113,6379393,5,2,0.725414,5,6381531,-1,1000.0,6381531,6381536,2138,5,2,0,True,True,0.10851388888888888,-0.725414
8114,6379472,188,16,0.090442,5,6381531,-1,8000.0,6382631,6382819,3159,188,2,6,True,True,33.17635555555555,-0.07908968088152254
8115,6380095,12873,4,0.691785,5,6381531,-1,2000.0,6391925,6401004,11830,12873,0,6,True,True,866.8406777777778,-0.6288480444667183
8116,6391925,24763,3,0.871941,1,6391925,-1,1500.0,6394125,6418888,2200,24763,0,7,True,True,1199.5775250000002,-0.871121288750364
8117,6393083,6,2,0.93178,1,6394125,-1,1000.0,6402404,6394131,9321,6,0,0,True,True,0.21865,-0.93178
8118,6402404,10865,16,0.766337,1,6402404,-1,8000.0,6403504,6414369,1100,10865,0,6,True,True,2705.177733333333,-0.7264328589990234
8119,6402494,34078,256,0.600679,2,6403504,-1,128000.0,6821883,6855961,419389,34078,0,8,True,True,337622.3150222222,-0.5903988287313446
8120,6402669,20,1,0.643987,2,6403504,-1,500.0,6404604,6404624,1935,20,1,6,True,True,0.31636111111111115,-0.643987
8121,6404470,327,1,0.37701,2,6404604,-1,500.0,6406804,6407131,2334,327,1,7,True,True,5.172504166666667,-0.37701
8122,6405043,16695,8,0.717443,5,6406804,-1,4000.0,6412604,6429299,7561,16695,1,5,True,True,2036.4366555555557,-0.7142436764686734
8123,6405474,12420,141,0.736002,5,6406804,-1,70500.0,6431405,6443825,25931,12420,1,0,True,True,33421.208458333334,-0.7183304096386411
8124,6405788,47,4,0.381651,5,6406804,-1,2000.0,6409004,6409051,3216,47,3,0,True,True,2.864911111111111,-0.381651
8125,6406712,10245,128,0.642102,5,6406804,-1,64000.0,6409004,6419249,2292,10245,4,7,True,True,19404.19111111111,-0.6386978976424107
8126,6406866,2,4,0.5619,5,6409004,-1,2000.0,6409004,6409006,2138,2,4,0,True,True,0.12191111111111111,-0.5619
8127,6409679,62,16,0.856141,8,6412604,-1,8000.0,6413704,6413766,4025,62,2,6,True,True,14.667822222222222,-0.856141
8128,6411880,3461,4,0.808447,8,6412604,-1,2000.0,6418888,6422349,7008,3461,2,2,True,True,197.79615,-0.808447
8129,6412361,433,2,0.223551,8,6412604,-1,1000.0,6434716,6435149,22355,433,1,7,True,True,15.727522222222222,-0.223551
8130,6412410,16,2,0.11569,8,6412604,-1,1000.0,6422549,6422565,10139,16,3,7,True,True,0.5173333333333333,-0.11569
8131,6412419,8503,32,0.08768,8,6412604,-1,16000.0,6455316,6463819,42897,8503,1,7,True,True,3561.970888888889,-0.08682512117950741
8132,6412478,35,4,0.089139,8,6412604,-1,2000.0,6414804,6414839,2326,35,6,6,True,True,2.0700555555555553,-0.089139
8133,6413657,15493,8,0.740581,8,6413704,-1,4000.0,6477886,6493379,64229,15493,1,0,True,True,1812.835488888889,-0.7336030229253729
8134,6413715,7,1,0.937211,11,6414804,-1,500.0,6417004,6417011,3289,7,7,7,True,True,0.10186944444444444,-0.937211
8135,6413904,35,5,0.744618,11,6414804,-1,2500.0,6419249,6419284,5345,35,6,1,True,True,2.5003125,-0.7446179999999999
8136,6414290,126,1,0.116106,11,6414804,-1,500.0,6447716,6447842,33426,126,3,9,True,True,1.7953250000000003,-0.116106
8137,6414603,58,4,0.367737,11,6414804,-1,2000.0,6420349,6420407,5746,58,7,6,True,True,3.3147,-0.367737
8138,6421226,22,8,0.85333,13,6422549,-1,4000.0,6425849,6425871,4623,22,6,6,True,True,2.8453333333333335,-0.85333
8139,6421316,4,8,0.954069,13,6422549,-1,4000.0,6424749,6424753,3433,4,7,7,True,True,0.5173333333333333,-0.954069
8140,6421412,60,4,0.576917,13,6422549,-1,2000.0,6457516,6457576,36104,60,2,6,True,True,3.122333333333333,-0.576917
8141,6421880,8849,32,0.001678,13,6422549,-1,16000.0,6456416,6465265,34536,8849,3,6,True,True,3730.1787999999997,-0.0016734656190462438
8142,6421934,8333,15,0.061885,13,6422549,-1,7500.0,6467986,6476319,46052,8333,2,7,True,True,1797.8763541666667,-0.06182801235191663
8143,6422009,22,1,0.535603,13,6422549,-1,500.0,6429183,6429205,7174,22,9,7,True,True,0.36107500000000003,-0.535603
8144,6422033,20390,32,0.847119,13,6422549,-1,16000.0,6465786,6486176,43753,20390,3,7,True,True,9159.787466666668,-0.8413555116204843
8145,6422764,6751,32,0.979849,23,6424749,-1,16000.0,6426983,6433734,4219,6751,11,0,True,True,4107.5054666666665,-0.9461191344294101
8146,6423734,14,1,0.319643,23,6424749,-1,500.0,6461386,6461400,37652,14,4,6,True,True,0.181125,-0.319643
8147,6423866,23216,101,0.365024,23,6424749,-1,50500.0,6496376,6519592,72510,23216,1,7,True,True,59955.40004444444,-0.35907463243209553
8148,6423995,349,4,0.679302,23,6424749,-1,2000.0,6426983,6427332,2988,349,14,0,True,True,22.91185,-0.679302
8149,6424009,34,8,0.796565,23,6424749,-1,4000.0,6426949,6426983,2940,34,15,6,True,True,4.4642,-0.796565
8150,6424161,8,1,0.519751,23,6424749,-1,500.0,6431405,6431413,7244,8,11,0,True,True,0.16824444444444442,-0.519751
8151,6424189,31,2,0.601618,23,6424749,-1,1000.0,6436916,6436947,12727,31,10,7,True,True,1.2561027777777778,-0.601618
8152,6424395,7,1,0.222142,23,6424749,-1,500.0,6459059,6459066,34664,7,6,1,True,True,0.0905625,-0.222142
8153,6424449,25172,64,0.395312,23,6424749,-1,32000.0,6480086,6505258,55637,25172,2,7,True,True,27906.0496,-0.38740599603967985
8154,6424472,20451,2,0.538293,23,6424749,-1,1000.0,6735798,6756249,311326,20451,1,0,True,True,1637.9478749999998,-0.532971096888578
8155,6424527,15,4,0.460603,23,6424749,-1,2000.0,6432516,6432531,7989,15,15,1,True,True,1.2618333333333331,-0.460603
8156,6425008,71,1,0.144701,29,6425849,-1,500.0,6460286,6460357,35278,71,8,1,True,True,0.9185625,-0.144701
8157,6425300,7485,4,0.94289,29,6425849,-1,2000.0,6426983,6434468,1683,7485,22,1,True,True,566.7592055555555,-0.9165132114462671
8158,6425396,13324,16,0.837217,29,6425849,-1,8000.0,6431405,6444729,6009,13324,19,7,True,True,4020.8577555555553,-0.8124883828784222
8159,6425461,47,1,0.499833,29,6425849,-1,500.0,6429183,6429230,3722,47,20,0,True,True,0.7713875,-0.499833
8160,6425543,224,1,0.455785,29,6425849,-1,500.0,6453116,6453340,27573,224,13,8,True,True,3.077511111111111,-0.455785
8161,6425595,2,19,0.601465,29,6425849,-1,9500.0,6429205,6429207,3610,2,21,1,True,True,0.623675,-0.601465
8162,6425609,443,1,0.145871,29,6425849,-1,500.0,6458616,6459059,33007,443,10,6,True,True,5.7313125000000005,-0.145871
8163,6426025,8,1,0.665351,31,6426949,-1,500.0,6426983,6426991,958,8,26,0,True,True,0.1313,-0.665351
8164,6426378,7081,128,0.801292,31,6426949,-1,64000.0,6482286,6489367,55908,7081,3,7,True,True,13511.960533333333,-0.7915025207697017
8165,6426457,11,1,0.702967,31,6426949,-1,500.0,6432505,6432516,6048,11,20,6,True,True,0.2313361111111111,-0.702967
8166,6455460,21180,4,0.59888,19,6456416,-1,2000.0,6502176,6523356,46716,21180,2,7,True,True,2243.0838000000003,-0.5961819455778026
8167,6455719,12,32,0.308891,19,6456416,-1,16000.0,6463586,6463598,7867,12,9,7,True,True,5.196266666666667,-0.308891
8168,6455822,29177,128,0.990335,19,6456416,-1,64000.0,6701005,6730182,245183,29177,2,1,True,True,60503.257600000004,-0.9638003958347817
8169,6455887,16,2,0.123464,19,6456416,-1,1000.0,6475686,6475702,19799,16,8,7,True,True,0.4604888888888889,-0.123464
8170,6456027,100,1,0.996849,19,6456416,-1,500.0,6456416,6456516,389,100,17,0,True,True,1.3009722222222222,-0.996849
8171,6456047,127,2,0.706522,19,6456416,-1,1000.0,6460159,6460286,4112,127,14,6,True,True,3.286125,-0.706522
8172,6462804,16,1,0.478283,12,6463586,-1,500.0,6470186,6470202,7382,16,9,7,True,True,0.23735555555555557,-0.478283
8173,6468167,12202,32,0.828687,12,6470186,-1,16000.0,6486176,6498378,18009,12202,5,7,True,True,6742.724266666667,-0.7703218693967422
8174,6468858,69,16,0.495026,12,6470186,-1,8000.0,6471286,6471355,2428,69,10,6,True,True,16.377533333333332,-0.495026
8175,6468963,23944,16,0.70414,12,6470186,-1,8000.0,6525653,6549597,56690,23944,3,7,True,True,5634.857866666667,-0.6838208960035567
8176,6470414,2,40,0.376709,13,6471286,-1,20000.0,6477886,6477888,7472,2,10,7,True,True,1.033111111111111,-0.376709
8177,6471051,30,4,0.981143,13,6471286,-1,2000.0,6473486,6473516,2435,30,12,7,True,True,1.7268333333333332,-0.981143
8178,6472282,19,8,0.333145,14,6473486,-1,4000.0,6477886,6477905,5604,19,9,0,True,True,1.9629111111111113,-0.333145
8179,6472694,35,2,0.827885,14,6473486,-1,1000.0,6473486,6473521,792,35,13,0,True,True,1.0073194444444444,-0.827885
8180,6481475,21285,8,0.210613,8,6482286,-1,4000.0,6583822,6605107,102347,21285,3,4,True,True,7571.730822222223,-0.20969555824194072
8181,6482751,3,1,0.732658,13,6486176,-1,500.0,6505776,6505779,23025,3,5,4,True,True,0.05081666666666667,-0.732658
8182,6482913,22,4,0.810419,13,6486176,-1,2000.0,6491976,6491998,9063,22,8,7,True,True,1.3222,-0.810419
8183,6483235,9208,8,0.700407,13,6486176,-1,4000.0,6494176,6503384,10941,9208,8,7,True,True,1512.1277333333333,-0.6964487540659198
8184,6484147,1,32,0.052566,13,6486176,-1,16000.0,6499976,6499977,15829,1,7,0,True,True,0.6371555555555556,-0.052566
8185,6485258,9,16,0.865432,13,6486176,-1,8000.0,6489776,6489785,4518,9,11,2,True,True,2.2128,-0.865432
8186,6485563,36,20,0.17902,13,6486176,-1,10000.0,6514653,6514689,29090,36,5,7,True,True,28.712000000000003,-0.17902
8187,6492039,8,26,0.487505,12,6494176,-1,13000.0,6510253,6510261,18214,8,6,6,True,True,4.539311111111111,-0.487505
8188,6492231,31,32,0.391808,12,6494176,-1,16000.0,6499976,6500007,7745,31,9,0,True,True,19.751822222222224,-0.391808
8189,6495591,2,1,0.98439,14,6496376,-1,500.0,6499976,6499978,4385,2,11,3,True,True,0.039822222222222224,-0.98439
8190,6495648,26,8,0.65925,14,6496376,-1,4000.0,6512453,6512479,16805,26,6,7,True,True,8.294577777777777,-0.65925
8191,6495954,8,1,0.848518,14,6496376,-1,500.0,6506876,6506884,10922,8,8,6,True,True,0.1355111111111111,-0.848518
8192,6496746,14074,4,0.991063,18,6499976,-1,2000.0,6510253,6524327,13507,14074,7,0,True,True,1699.4902555555554,-0.9791302999661842
8193,6498268,835,2,0.547943,18,6499976,-1,1000.0,6514653,6515488,16385,835,5,0,True,True,66.5958888888889,-0.547943
8194,6498325,12165,64,0.33741,18,6499976,-1,32000.0,6516853,6529018,18528,12165,5,7,True,True,18216.221333333335,-0.3182990335588821
8195,6498584,9640,64,0.677899,18,6499976,-1,32000.0,6548318,6557958,49734,9640,4,1,True,True,8553.229688888889,-0.6766222726607224
8196,6498674,14962,32,0.990314,18,6499976,-1,16000.0,6534552,6549514,35878,14962,5,6,True,True,6664.448088888888,-0.97914600843205
8197,6501826,1213,32,0.757714,18,6502176,-1,16000.0,6519053,6520266,17227,1213,7,7,True,True,1133.0822222222223,-0.6018188540546219
8198,6502035,6153,1,0.391063,18,6502176,-1,500.0,6554265,6560418,52230,6153,4,0,True,True,95.73781666666666,-0.3152810791367946
8199,6502111,9289,8,0.527844,18,6502176,-1,4000.0,6571458,6580747,69347,9289,4,0,True,True,2646.7262333333333,-0.49690924211887977
8200,6502185,26,1,0.28304,20,6505776,-1,500.0,6531179,6531205,28994,26,8,0,True,True,0.3714388888888889,-0.28304
8201,6502386,77,27,0.696376,20,6505776,-1,13500.0,6509076,6509153,6690,77,17,7,True,True,45.3712875,-0.696376
8202,6504417,98,8,0.195092,20,6505776,-1,4000.0,6521253,6521351,16836,98,10,7,True,True,18.016755555555555,-0.195092
8203,6506506,16072,16,0.856252,23,6506876,-1,8000.0,6553165,6569237,46659,16072,6,1,True,True,6013.205555555555,-0.8131839322081683
8204,6506530,393,2,0.393772,23,6506876,-1,1000.0,6514653,6515046,8123,393,15,0,True,True,31.343933333333332,-0.393772
8205,6506670,9,10,0.130901,23,6506876,-1,5000.0,6523453,6523462,16783,9,11,0,True,True,1.5506250000000001,-0.130901
8206,6506850,53,32,0.752266,23,6506876,-1,16000.0,6509153,6509206,2303,53,21,1,True,True,37.01284444444444,-0.752266
8207,6506902,10238,16,0.580384,23,6509076,-1,8000.0,6580222,6590460,73320,10238,4,1,True,True,6948.455066666666,-0.5689657226276142
8208,6514749,11,4,0.805072,20,6516853,-1,2000.0,6523453,6523464,8704,11,13,7,True,True,0.7580833333333333,-0.805072
8209,6515182,17122,16,0.84981,20,6516853,-1,8000.0,6531196,6548318,16014,17122,10,1,True,True,3842.7958666666664,-0.8470074263992337
8210,6515205,5924,65,0.709588,20,6516853,-1,32500.0,6531252,6537176,16047,5924,10,0,True,True,5697.988111111112,-0.7063282186382347
8211,6515302,21,4,0.457533,20,6516853,-1,2000.0,6531252,6531273,15950,21,11,1,True,True,1.2000333333333333,-0.457533
8212,6515336,13,4,0.163694,20,6516853,-1,2000.0,6560865,6560878,45529,13,6,0,True,True,1.1971555555555555,-0.163694
8213,6518831,318,1,0.137561,20,6519053,-1,500.0,6533452,6533770,14621,318,11,0,True,True,4.542983333333333,-0.137561
8214,6519316,9030,256,0.695956,24,6521253,-1,128000.0,6812853,6821883,293537,9030,1,8,True,True,70943.73546666667,-0.6930009354659205
8215,6520167,30595,8,0.291082,24,6521253,-1,4000.0,6577258,6607853,57091,30595,6,1,True,True,10403.619022222223,-0.2854164028273242
8216,6521012,76,8,0.144823,24,6521253,-1,4000.0,6531224,6531300,10212,76,16,1,True,True,8.685955555555555,-0.144823
8217,6521112,549,11,0.218136,24,6521253,-1,5500.0,6550518,6551067,29406,549,11,0,True,True,83.6820875,-0.218136
8218,6521118,54,4,0.748383,24,6521253,-1,2000.0,6530053,6530107,8935,54,20,7,True,True,3.7895999999999996,-0.748383
8219,6523224,6,4,0.735319,27,6523453,-1,2000.0,6527853,6527859,4629,6,21,7,True,True,0.42106666666666664,-0.735319
8220,6523228,25123,128,0.009133,27,6523453,-1,64000.0,6573658,6598781,50430,25123,7,7,True,True,129420.38453333333,-0.009127796705849709
8221,6523268,45,32,0.725958,27,6523453,-1,16000.0,6531179,6531224,7911,45,21,6,True,True,20.572000000000003,-0.725958
8222,6523290,5278,1,0.575682,27,6523453,-1,500.0,6547952,6553230,24662,5278,14,7,True,True,73.30472222222222,-0.5715710814984013
8223,6523551,26792,8,0.678318,31,6525653,-1,4000.0,6533452,6560244,9901,26792,17,7,True,True,3060.0719111111107,-0.6333265975618726
8224,6523577,26,32,0.988484,31,6525653,-1,16000.0,6530053,6530079,6476,26,24,0,True,True,14.596977777777777,-0.988484
8225,6523687,13863,2,0.147605,31,6525653,-1,1000.0,6567465,6581328,43778,13863,9,7,True,True,1034.5595833333332,-0.1373757780236674
8226,6523887,47,32,0.950398,31,6525653,-1,16000.0,6531205,6531252,7318,47,22,1,True,True,21.486311111111114,-0.950398
8227,6525544,23,3,0.427111,31,6525653,-1,1500.0,6541052,6541075,15508,23,16,8,True,True,0.9406041666666668,-0.42711099999999996
8228,6525619,311,2,0.84166,31,6525653,-1,1000.0,6530079,6530390,4460,311,27,1,True,True,10.912644444444444,-0.84166
8229,6525992,180,14,0.925985,39,6527853,-1,7000.0,6531179,6531359,5187,180,26,0,True,True,36.001000000000005,-0.925985
8230,6526033,15294,16,0.096048,39,6527853,-1,8000.0,6583822,6599116,57789,15294,4,0,True,True,10694.232,-0.0941343369810439
8231,6526045,205,1,0.974159,39,6527853,-1,500.0,6530079,6530284,4034,205,29,0,True,True,3.5966111111111108,-0.974159
8232,6526122,1222,1,0.179633,39,6527853,-1,500.0,6554265,6555487,28143,1222,13,6,True,True,17.1691,-0.179633
8233,6526796,10402,8,0.052472,39,6527853,-1,4000.0,6583822,6594224,57026,10402,5,0,True,True,3650.2256444444442,-0.0522962642136563
8234,6526905,17,2,0.980277,39,6527853,-1,1000.0,6531179,6531196,4274,17,29,0,True,True,0.48572777777777776,-0.980277
8235,6526907,11573,6,0.650098,39,6527853,-1,3000.0,6534552,6546125,7645,11573,20,0,True,True,969.9402416666668,-0.6425082841853247
8236,6526938,14957,64,0.593392,39,6527853,-1,32000.0,6565265,6580222,38327,14957,12,7,True,True,35276.37084444444,-0.5917776868674399
8237,6527026,8,13,0.969727,39,6527853,-1,6500.0,6530079,6530087,3053,8,35,0,True,True,1.8246222222222221,-0.9697270000000002
8238,6531734,19,16,0.626973,26,6533452,-1,8000.0,6533452,6533471,1718,19,24,0,True,True,4.342977777777778,-0.626973
8239,6531754,102,4,0.403994,26,6533452,-1,2000.0,6535652,6535754,3898,102,21,6,True,True,6.2180333333333335,-0.403994
8240,6533797,30,16,0.033993,24,6534552,-1,8000.0,6542152,6542182,8355,30,20,6,True,True,6.3966666666666665,-0.033993
8241,6537960,162,32,0.240855,24,6541052,-1,16000.0,6556465,6556627,18505,162,14,7,True,True,70.47359999999999,-0.240855
8242,6537985,38206,4,0.488626,24,6541052,-1,2000.0,6665150,6703356,127165,38206,4,0,True,True,5328.090166666668,-0.47276517809829766
8243,6539007,11,16,0.687984,24,6541052,-1,8000.0,6545752,6545763,6745,11,22,4,True,True,2.4114444444444447,-0.687984
8244,6547958,81,1,0.954555,23,6548318,-1,500.0,6550518,6550599,2560,81,20,7,True,True,1.1224124999999998,-0.954555
8245,6547981,6,8,0.652797,23,6548318,-1,4000.0,6550518,6550524,2537,6,20,0,True,True,0.6651333333333334,-0.652797
8246,6548054,15766,1,0.375372,23,6548318,-1,500.0,6694530,6710296,146476,15766,4,0,True,True,268.923675,-0.36356092646354676
8247,6548764,1472,6,0.691795,28,6550518,-1,3000.0,6552718,6554190,3954,1472,20,0,True,True,124.0896,-0.691795
8248,6549100,15973,4,0.795325,28,6550518,-1,2000.0,6583822,6599795,34722,15973,6,0,True,True,2800.36125,-0.7829586283473163
8249,6549404,11,16,0.658519,28,6550518,-1,8000.0,6556465,6556476,7061,11,17,0,True,True,2.392622222222222,-0.658519
8250,6549461,127,2,0.777731,28,6550518,-1,1000.0,6554265,6554392,4804,127,20,0,True,True,3.5686999999999998,-0.777731
8251,6549590,12228,128,0.864896,28,6550518,-1,64000.0,6598781,6611009,49191,12228,6,0,True,True,67447.54613333334,-0.8177469594759474
8252,6550270,447,16,0.650311,28,6550518,-1,8000.0,6552718,6553165,2448,447,25,7,True,True,100.48559999999999,-0.650311
8253,6550672,574,8,0.275216,28,6552718,-1,4000.0,6569237,6569811,18565,574,15,0,True,True,179.02422222222222,-0.275216
8254,6550906,17,1,0.653195,28,6552718,-1,500.0,6558665,6558682,7759,17,19,7,True,True,0.23110555555555554,-0.653195
8255,6551317,9,4,0.367323,28,6552718,-1,2000.0,6563065,6563074,11748,9,18,7,True,True,0.9919,-0.367323
8256,6555872,21,16,0.12,23,6556465,-1,8000.0,6571437,6571458,15565,21,15,7,True,True,14.878266666666667,-0.12
8257,6556914,38837,32,0.082637,25,6558665,-1,16000.0,6679703,6718540,122789,38837,5,4,True,True,30090.9572,-0.07961326417669762
8258,6556980,7,1,0.489218,25,6558665,-1,500.0,6569237,6569244,12257,7,18,1,True,True,0.27290277777777777,-0.489218
8259,6557207,20,8,0.668792,25,6558665,-1,4000.0,6560865,6560885,3658,20,23,7,True,True,3.6835555555555555,-0.668792
8260,6557226,30122,16,0.509748,25,6558665,-1,8000.0,6702105,6732227,144879,30122,3,6,True,True,7937.639866666667,-0.44688827604956294
8261,6560365,24923,8,0.023027,25,6560865,-1,4000.0,6604581,6629504,44216,24923,8,3,True,True,4820.4522,-0.020628322637290204
8262,6561375,4,4,0.572982,24,6563065,-1,2000.0,6571458,6571462,10083,4,18,1,True,True,0.7084888888888888,-0.572982
8263,6584225,8636,32,0.572631,24,6598781,-1,16000.0,6600981,6609617,16756,8636,9,7,True,True,12616.835244444444,-0.5665538972869557
8264,6584326,115,1,0.273725,24,6598781,-1,500.0,6610053,6610168,25727,115,8,7,True,True,2.4795277777777778,-0.273725
8265,6584470,5285,1,0.745359,24,6598781,-1,500.0,6598781,6604066,14311,5285,11,0,True,True,245.67380972222222,-0.7451882663569227
8266,6584524,17,8,0.794344,24,6598781,-1,4000.0,6598781,6598798,14257,17,11,0,True,True,5.864811111111111,-0.794344
8267,6586397,15006,2,0.181097,24,6598781,-1,1000.0,6656850,6671856,70453,15006,8,4,True,True,1383.2685333333334,-0.1803166745389614
8268,6595995,36,1,0.484191,24,6598781,-1,500.0,6628830,6628866,32835,36,9,3,True,True,0.49424999999999997,-0.484191
8269,6598188,13,2,0.644597,24,6598781,-1,1000.0,6605688,6605701,7500,13,11,0,True,True,1.1982388888888889,-0.644597
8270,6598204,29295,1,0.433656,24,6598781,-1,500.0,6783558,6812853,185354,29295,2,6,True,True,737.3916666666667,-0.4260140152280933
8271,6598230,8526,1,0.571423,24,6598781,-1,500.0,6634524,6643050,36294,8526,10,7,True,True,117.945575,-0.5575208915728472
8272,6598245,6341,32,0.099441,24,6598781,-1,16000.0,6632324,6638665,34079,6341,11,1,True,True,2774.8190666666665,-0.09644321428513285
8273,6598319,6,32,0.063498,24,6598781,-1,16000.0,6613940,6613946,15621,6,13,6,True,True,3.214666666666667,-0.063498
8274,6598385,98,4,0.908881,24,6598781,-1,2000.0,6598781,6598879,396,98,19,0,True,True,18.03064444444444,-0.8954298911734617
8275,6598409,63,4,0.795225,24,6598781,-1,2000.0,6611740,6611803,13331,63,14,0,True,True,5.433400000000001,-0.795225
8276,6598586,39,1,0.18489,24,6598781,-1,500.0,6623030,6623069,24444,39,13,0,True,True,0.6065041666666667,-0.18489
8277,6598637,103,32,0.812868,24,6598781,-1,16000.0,6612840,6612943,14203,103,15,6,True,True,71.06542222222222,-0.812868
8278,6601227,155,32,0.019746,47,6604581,-1,16000.0,6611740,6611895,10513,155,17,0,True,True,106.94311111111112,-0.019746
8279,6601244,6,11,0.55606,47,6604581,-1,5500.0,6611740,6611746,10496,6,16,0,True,True,1.4230333333333334,-0.55606
8280,6601275,10,1,0.536417,47,6604581,-1,500.0,6614007,6614017,12732,10,14,0,True,True,0.16743055555555555,-0.536417
8281,6601296,8,1,0.812196,47,6604581,-1,500.0,6610632,6610640,9336,8,20,1,True,True,0.17248888888888889,-0.812196
8282,6601430,4,2,0.488563,47,6604581,-1,1000.0,6611740,6611744,10310,4,17,0,True,True,0.17248888888888889,-0.488563
8283,6601507,326,2,0.518901,47,6604581,-1,1000.0,6611740,6612066,10233,326,17,0,True,True,14.057844444444445,-0.518901
8284,6601557,3,8,0.584722,47,6604581,-1,4000.0,6612840,6612843,11283,3,16,0,True,True,0.5174666666666667,-0.584722
8285,6601724,7,16,0.713749,47,6604581,-1,8000.0,6605681,6605688,3957,7,26,0,True,True,5.161644444444444,-0.713749
8286,6601793,12,2,0.790068,47,6604581,-1,1000.0,6610640,6610652,8847,12,23,1,True,True,0.5174666666666667,-0.790068
8287,6602243,16242,8,0.124089,47,6604581,-1,4000.0,6691230,6707472,88987,16242,7,5,True,True,2424.1978,-0.10964571290758351
8288,6602328,45256,3,0.752988,47,6604581,-1,1500.0,6645250,6690506,42922,45256,11,0,True,True,5659.866883333334,-0.7443697036307371
8289,6602357,1768,4,0.965681,47,6604581,-1,2000.0,6605688,6607456,3331,1768,28,0,True,True,319.1910222222222,-0.9457406136672257
8290,6602381,3627,16,0.897602,47,6604581,-1,8000.0,6607853,6611480,5472,3627,28,4,True,True,1904.4571111111113,-0.6581584854908422
8291,6602432,111,70,0.180664,47,6604581,-1,35000.0,6614007,6614118,11575,111,17,1,True,True,130.09354166666665,-0.180664
8292,6602439,5630,63,0.599103,47,6604581,-1,31500.0,6605688,6611318,3249,5630,32,0,True,True,13429.7639,-0.4967010811283793
8293,6602850,587,4,0.179938,47,6604581,-1,2000.0,6620830,6621417,17980,587,16,7,True,True,36.51466111111111,-0.179938
8294,6602886,1,8,0.554722,47,6604581,-1,4000.0,6618629,6618630,15743,1,17,1,True,True,0.15466666666666665,-0.554722
8295,6602918,561,8,0.800513,47,6604581,-1,4000.0,6610053,6610614,7135,561,30,0,True,True,96.76626666666667,-0.800513
8296,6602928,8,1,0.123045,47,6604581,-1,500.0,6635769,6635777,32841,8,12,1,True,True,0.10707777777777779,-0.123045
8297,6602934,6208,3,0.128816,47,6604581,-1,1500.0,6605696,6611904,2762,6208,34,1,True,True,676.3109333333333,-0.1025822307735301
8298,6603044,9451,256,0.20623,47,6604581,-1,128000.0,6774107,6783558,171063,9451,3,7,True,True,94053.25013333333,-0.19602673019393999
8299,6603431,3571,256,0.16121,47,6604581,-1,128000.0,6732227,6735798,128796,3571,5,7,True,True,31194.114133333336,-0.12577509530755632
8300,6603479,6939,4,0.562496,47,6604581,-1,2000.0,6628830,6635769,25351,6939,17,0,True,True,384.31168333333335,-0.5605487006652246
8301,6603637,8,1,0.85145,47,6604581,-1,500.0,6605688,6605696,2051,8,39,0,True,True,0.3686888888888889,-0.85145
8302,6603653,369,2,0.035005,47,6604581,-1,1000.0,6611740,6612109,8087,369,31,0,True,True,15.9121,-0.035005
8303,6603719,80,8,0.979928,47,6604581,-1,4000.0,6605681,6605761,1962,80,44,6,True,True,29.49511111111111,-0.979928
8304,6604464,116,12,0.506148,47,6604581,-1,6000.0,6611740,6611856,7276,116,28,0,True,True,30.013066666666667,-0.506148
8305,6604573,1322,28,0.36356,47,6604581,-1,14000.0,6617307,6618629,12734,1322,22,7,True,True,715.6426666666666,-0.36356
8306,6604621,9127,32,0.544427,48,6605681,-1,16000.0,6645250,6654377,40629,9127,14,7,True,True,9680.991288888888,-0.4583417353189118
8307,6604631,7934,1,0.423051,48,6605681,-1,500.0,6615107,6623041,10476,7934,24,6,True,True,139.0172111111111,-0.4162466342846089
8308,6606881,33034,2,0.945228,53,6607853,-1,1000.0,6680803,6713837,73922,33034,10,6,True,True,1651.7767944444445,-0.8827920525113387
8309,6606899,42,16,8.6e-05,53,6607853,-1,8000.0,6645250,6645292,38351,42,14,0,True,True,9.586266666666667,-8.6e-05
8310,6606945,21,64,0.3006,53,6607853,-1,32000.0,6625230,6625251,18285,21,22,7,True,True,32.02826666666667,-0.3006
8311,6606974,17,16,0.946215,53,6607853,-1,8000.0,6611740,6611757,4766,17,34,0,True,True,5.864622222222223,-0.946215
8312,6607002,13375,128,0.519443,53,6607853,-1,64000.0,6687630,6701005,80628,13375,10,8,True,True,41702.4,-0.42807473185970263
8313,6607032,18378,32,0.782802,53,6607853,-1,16000.0,6613946,6632324,6914,18378,31,1,True,True,10379.960266666667,-0.7755435618939119
8314,6607069,163,13,0.659158,53,6607853,-1,6500.0,6611740,6611903,4671,163,41,0,True,True,45.68799444444444,-0.659158
8315,6607310,9106,128,0.44492,53,6607853,-1,64000.0,6737998,6747104,130688,9106,4,7,True,True,51380.145066666664,-0.43596661763911926
8316,6607654,318,16,0.577071,53,6607853,-1,8000.0,6620830,6621148,13176,318,26,0,True,True,79.12546666666667,-0.577071
8317,6607660,14,1,0.695101,53,6607853,-1,500.0,6610640,6610654,2980,14,46,0,True,True,0.30185555555555554,-0.695101
8318,6607677,12718,2,0.522666,53,6607853,-1,1000.0,6632324,6645042,24647,12718,21,0,True,True,354.5317944444444,-0.519046905827596
8319,6607681,77,32,0.98602,53,6607853,-1,16000.0,6613946,6614023,6265,77,34,0,True,True,41.254888888888885,-0.98602
8320,6608094,151,1,0.352117,64,6610053,-1,500.0,6628830,6628981,20736,151,23,0,True,True,2.0731041666666665,-0.352117
8321,6608243,24,4,0.538209,64,6610053,-1,2000.0,6611740,6611764,3497,24,42,0,True,True,2.069866666666667,-0.538209
8322,6608269,17286,72,0.20984,64,6610053,-1,36000.0,6651050,6668336,42781,17286,16,0,True,True,57747.60799999999,-0.20758042493476103
8323,6608636,12173,33,0.099009,64,6610053,-1,16500.0,6651050,6663223,42414,12173,17,7,True,True,18824.718641666666,-0.09857739148837266
8324,6608641,7850,2,0.819763,64,6610053,-1,1000.0,6620830,6628680,12189,7850,31,0,True,True,299.83080555555557,-0.8155006622904845
8325,6608689,14,16,0.2371,64,6610053,-1,8000.0,6620830,6620844,12141,14,31,0,True,True,3.483511111111111,-0.2371
8326,6609037,2902,32,0.188074,64,6610053,-1,16000.0,6618630,6621532,9593,2902,34,1,True,True,1658.3735111111112,-0.17372286710453355
8327,6609647,18,32,0.299709,64,6610053,-1,16000.0,6610614,6610632,967,18,58,0,True,True,12.419200000000002,-0.299709
8328,6609672,8,1,0.832628,64,6610053,-1,500.0,6610640,6610648,968,8,55,0,True,True,0.17248888888888889,-0.832628
8329,6609718,136,8,0.957423,64,6610053,-1,4000.0,6611740,6611876,2022,136,55,6,True,True,23.45848888888889,-0.957423
8330,6609805,11572,2,0.602144,64,6610053,-1,1000.0,6692330,6703902,82525,11572,10,6,True,True,421.52347222222227,-0.4781914260618879
8331,6609811,28668,16,0.21604,64,6610053,-1,8000.0,6675003,6703671,65192,28668,15,7,True,True,14359.93,-0.21208552693549895
8332,6610311,17,16,0.359065,65,6610614,-1,8000.0,6611740,6611757,1429,17,54,0,True,True,5.864622222222223,-0.359065
8333,6610437,18881,16,0.128492,65,6610614,-1,8000.0,6648850,6667731,38413,18881,20,4,True,True,13690.367333333332,-0.12536242929145014
8334,6610602,61,2,0.622313,65,6610614,-1,1000.0,6613946,6614007,3344,61,44,0,True,True,2.042652777777778,-0.622313
8335,6610813,6518,1,0.07436,62,6611740,-1,500.0,6653250,6659768,42437,6518,18,7,True,True,320.28725,-0.07431977440319454
8336,6611122,34,5,0.254967,62,6611740,-1,2500.0,6628830,6628864,17708,34,29,0,True,True,2.3339583333333334,-0.254967
8337,6615704,17343,3,0.381782,45,6617307,-1,1500.0,6657950,6675293,42246,17343,17,6,True,True,2368.8395,-0.3777200780052403
8338,6615735,16,22,0.90366,45,6617307,-1,11000.0,6623030,6623046,7295,16,36,7,True,True,5.474088888888889,-0.90366
8339,6616571,166,1,0.400059,45,6617307,-1,500.0,6639069,6639235,22498,166,26,6,True,True,2.347286111111111,-0.400059
8340,6616591,14827,128,0.083254,45,6617307,-1,64000.0,6672803,6687630,56212,14827,16,4,True,True,79634.63004444444,-0.07991223761084024
8341,6617362,14120,2,0.254179,51,6618629,-1,1000.0,6679703,6693823,62341,14120,14,0,True,True,1055.2229555555555,-0.24282124304262018
8342,6617493,51,13,0.425343,51,6618629,-1,6500.0,6629934,6629985,12441,51,33,0,True,True,9.102437499999999,-0.425343
8343,6618406,2,4,0.694515,51,6618629,-1,2000.0,6620830,6620832,2424,2,42,0,True,True,0.12441111111111111,-0.694515
8344,6618418,23,16,0.535904,51,6618629,-1,8000.0,6620830,6620853,2412,23,41,0,True,True,5.722911111111111,-0.535904
8345,6618438,11672,2,0.070558,51,6618629,-1,1000.0,6676103,6687775,57665,11672,16,6,True,True,965.76825,-0.06759237064481619
8346,6618468,4,1,0.732675,51,6618629,-1,500.0,6628830,6628834,10362,4,38,0,True,True,0.05491666666666666,-0.732675
8347,6618580,26,32,0.995359,51,6618629,-1,16000.0,6629934,6629960,11354,26,34,0,True,True,11.422666666666666,-0.995359
8348,6619963,33909,64,0.696803,52,6620830,-1,32000.0,6740198,6774107,120235,33909,4,7,True,True,87281.696,-0.6853494955323393
8349,6619988,15803,16,0.192627,52,6620830,-1,8000.0,6632134,6647937,12146,15803,35,7,True,True,3829.0981111111114,-0.1837913168415655
8350,6620056,9,1,0.372142,52,6620830,-1,500.0,6637969,6637978,17913,9,31,0,True,True,0.12046250000000001,-0.372142
8351,6622312,5,1,0.657318,50,6623030,-1,500.0,6628834,6628839,6522,5,39,1,True,True,0.06864583333333334,-0.657318
8352,6622397,12,8,0.820508,50,6623030,-1,4000.0,6623030,6623042,633,12,47,0,True,True,1.4929333333333334,-0.820508
8353,6622983,8,1,0.604945,50,6623030,-1,500.0,6629934,6629942,6951,8,39,6,True,True,0.10983333333333332,-0.604945
8354,6622999,19984,1,0.419686,50,6623030,-1,500.0,6694530,6714514,71531,19984,11,7,True,True,334.99358333333333,-0.4076953684103436
8355,6630985,28,1,0.153491,40,6632134,-1,500.0,6679703,6679731,48718,28,16,0,True,True,1.0204833333333334,-0.153491
8356,6632064,10,2,0.992449,40,6632134,-1,1000.0,6632324,6632334,260,10,37,0,True,True,0.28094444444444444,-0.992449
8357,6632105,2358,32,0.433627,40,6632134,-1,16000.0,6643050,6645408,10945,2358,32,2,True,True,1076.4008,-0.433627
8358,6632456,13,1,0.02591,40,6634524,-1,500.0,6661550,6661563,29094,13,23,5,True,True,0.5968805555555555,-0.02591
8359,6632537,232,1,0.603607,40,6634524,-1,500.0,6661550,6661782,29013,232,23,0,True,True,10.652022222222222,-0.603607
8360,6633392,16,64,0.077525,40,6634524,-1,32000.0,6641269,6641285,7877,16,35,7,True,True,14.479644444444444,-0.077525
8361,6633783,55,8,0.124621,40,6634524,-1,4000.0,6637969,6638024,4186,55,38,7,True,True,5.889277777777778,-0.124621
8362,6635342,7653,128,0.10999,41,6635769,-1,64000.0,6665150,6672803,29808,7653,23,5,True,True,43773.53528888889,-0.10922915727387666
8363,6635459,66,1,0.548369,41,6635769,-1,500.0,6648850,6648916,13391,66,31,0,True,True,1.452275,-0.548369
6249,4878338,11,32,0.304912,1,4878338,-1,16000.0,4880538,4880549,2200,11,0,7,True,True,6.985733333333333,-0.304912
6250,4879071,26,2,0.337594,14,4880538,-1,1000.0,4919691,4919717,40620,26,0,0,True,True,0.37057222222222225,-0.337594
6251,4879130,60,2,0.019712,14,4880538,-1,1000.0,4928832,4928892,49702,60,0,7,True,True,0.6726666666666666,-0.019712
6252,4879180,6680,256,0.326117,14,4880538,-1,128000.0,5208622,5215302,329442,6680,0,6,True,True,33181.15911111111,-0.273238005867087
6253,4879208,137,1,0.460909,14,4880538,-1,500.0,4890438,4890575,11230,137,3,0,True,True,3.0613791666666668,-0.460909
6254,4879296,7,1,0.863369,14,4880538,-1,500.0,4887138,4887145,7842,7,4,7,True,True,0.14930416666666665,-0.863369
6255,4879534,312,1,0.568049,14,4880538,-1,500.0,4882738,4883050,3204,312,5,7,True,True,6.480933333333334,-0.568049
6256,4879804,7273,2,0.90141,14,4880538,-1,1000.0,4893791,4901064,13987,7273,3,0,True,True,349.09801944444445,-0.8705384998094745
6257,4879828,53,5,0.266619,14,4880538,-1,2500.0,4890438,4890491,10610,53,5,0,True,True,5.921645833333333,-0.266619
6258,4879844,274,4,0.695958,14,4880538,-1,2000.0,4884938,4885212,5094,274,7,7,True,True,22.79308888888889,-0.6785811221511956
6259,4879850,72,16,0.587989,14,4880538,-1,8000.0,4890438,4890510,10588,72,6,0,True,True,25.7424,-0.587989
6260,4880161,38027,32,0.985765,14,4880538,-1,16000.0,4987861,5025888,107700,38027,1,7,True,True,10527.59017777778,-0.7958409652280996
6261,4880191,17280,16,0.377738,14,4880538,-1,8000.0,4913891,4931171,33700,17280,4,7,True,True,1944.9978222222223,-0.2944659399551178
6262,4880221,16,8,0.390301,14,4880538,-1,4000.0,4921891,4921907,41670,16,3,7,True,True,0.7322666666666666,-0.390301
6263,4880293,160,16,0.572539,14,4880538,-1,8000.0,4888238,4888398,7945,160,10,6,True,True,54.602666666666664,-0.572539
6264,4887016,13116,4,0.808327,12,4887138,-1,2000.0,4928892,4942008,41876,13116,2,1,True,True,445.28746666666666,-0.7585147055055755
6265,4887503,7015,8,0.100057,16,4888238,-1,4000.0,4893791,4900806,6288,7015,8,0,True,True,1354.576011111111,-0.09698309826719935
6266,4887513,78,16,0.675111,16,4888238,-1,8000.0,4890438,4890516,2925,78,12,7,True,True,27.8876,-0.675111
6267,4887636,911,32,0.335967,16,4888238,-1,16000.0,4919691,4920602,32055,911,6,2,True,True,207.7484888888889,-0.335967
6268,4887999,37,1,0.502769,16,4888238,-1,500.0,4893791,4893828,5792,37,10,6,True,True,0.9142597222222222,-0.502769
6269,4888110,373,16,0.764904,16,4888238,-1,8000.0,4892691,4893064,4581,373,11,7,True,True,147.46762222222222,-0.764904
6270,4888363,310,8,0.339539,22,4890438,-1,4000.0,4921891,4922201,33528,310,4,0,True,True,14.187666666666665,-0.339539
6271,4888651,28881,256,0.614828,22,4890438,-1,128000.0,4958980,4987861,70329,28881,2,7,True,True,95701.46595555556,-0.5621573980702741
6272,4888977,17,4,0.363334,22,4890438,-1,2000.0,4908391,4908408,19414,17,10,0,True,True,1.3466833333333335,-0.363334
6273,4889116,13,16,0.435991,22,4890438,-1,8000.0,4905091,4905104,15975,13,11,6,True,True,2.658644444444444,-0.435991
6274,4890037,71,32,0.496952,22,4890438,-1,16000.0,4890491,4890562,454,71,16,1,True,True,50.76973333333333,-0.496952
6275,4890192,3313,1,0.847334,22,4890438,-1,500.0,4908391,4911704,18199,3313,11,0,True,True,59.69792638888889,-0.770967145036818
6276,4890349,18465,16,0.78715,22,4890438,-1,8000.0,4940515,4958980,50166,18465,3,1,True,True,5555.601111111111,-0.7853547565758443
6277,4890532,7,16,0.84038,31,4892691,-1,8000.0,4900691,4900698,10159,7,14,6,True,True,2.2690888888888887,-0.84038
6278,4890539,85,1,0.535834,31,4892691,-1,500.0,4903991,4904076,13452,85,14,0,True,True,1.0864652777777777,-0.535834
6279,4890755,96,32,0.287356,31,4892691,-1,16000.0,4919691,4919787,28936,96,9,0,True,True,21.892266666666668,-0.287356
6280,4890793,21669,4,0.047531,31,4892691,-1,2000.0,4933315,4954984,42522,21669,4,1,True,True,1376.3600333333334,-0.04448488217734072
6281,4891211,34,16,0.996228,31,4892691,-1,8000.0,4893791,4893825,2580,34,19,0,True,True,13.44208888888889,-0.996228
6282,4891255,335,1,0.402027,31,4892691,-1,500.0,4899591,4899926,8336,335,18,2,True,True,6.830431944444444,-0.32677534848271234
6283,4891280,34,1,0.225886,31,4892691,-1,500.0,4933292,4933326,42012,34,5,7,True,True,0.26095,-0.225886
6284,4891308,16879,123,0.742888,31,4892691,-1,61500.0,4990061,5006940,98753,16879,1,0,True,True,22886.344525000004,-0.7002632609936397
6285,4891483,14135,2,0.091958,31,4892691,-1,1000.0,4941615,4955750,50132,14135,4,6,True,True,558.2261666666666,-0.09113205582515851
6286,4891580,37,14,0.844187,31,4892691,-1,7000.0,4893791,4893828,2211,37,23,0,True,True,12.799636111111111,-0.844187
6287,4891601,32005,16,0.094734,31,4892691,-1,8000.0,5233202,5265207,341601,32005,0,7,True,True,6244.384355555555,-0.08998936925024126
6288,4891744,15533,256,0.336838,31,4892691,-1,128000.0,5272138,5287671,380394,15533,0,4,True,True,71195.83395555556,-0.3358178255347964
6289,4891751,25,1,0.06727,31,4892691,-1,500.0,4923007,4923032,31256,25,12,0,True,True,0.14302083333333332,-0.06727
6290,4891772,333,1,0.801186,31,4892691,-1,500.0,4913891,4914224,22119,333,18,0,True,True,4.064591666666667,-0.6404464231693946
6291,4892703,136,1,0.475268,41,4893791,-1,500.0,4923007,4923143,30304,136,13,6,True,True,0.7780333333333332,-0.475268
6292,4892784,23,1,0.209739,41,4893791,-1,500.0,4933292,4933315,40508,23,9,0,True,True,0.17652500000000002,-0.209739
6293,4892987,5403,13,0.795652,41,4893791,-1,6500.0,4895991,4901394,3004,5403,28,7,True,True,1649.3532791666669,-0.7485506550320064
6294,4893037,9824,2,0.651537,41,4893791,-1,1000.0,4926632,4936456,33595,9824,13,4,True,True,126.51604444444445,-0.6156171967465109
6295,4893058,119,4,0.301847,41,4893791,-1,2000.0,4908391,4908510,15333,119,25,0,True,True,9.426783333333333,-0.301847
6296,4893092,3,4,0.804127,41,4893791,-1,2000.0,4905091,4905094,11999,3,26,0,True,True,0.15338333333333334,-0.804127
6297,4893139,107,2,0.43291,41,4893791,-1,1000.0,4908391,4908498,15252,107,24,0,True,True,4.238091666666667,-0.43291
6298,4893163,21,32,0.539948,41,4893791,-1,16000.0,4908391,4908412,15228,21,23,0,True,True,13.3084,-0.539948
6299,4893256,25,16,0.200077,41,4893791,-1,8000.0,4919691,4919716,26435,25,18,0,True,True,2.8505555555555557,-0.200077
6300,4893306,12864,64,0.402301,41,4893791,-1,32000.0,4936915,4949779,43609,12864,8,3,True,True,14057.050844444442,-0.39682969643495675
6301,4893349,211,8,0.624964,41,4893791,-1,4000.0,4921907,4922118,28558,211,17,1,True,True,9.656766666666666,-0.624964
6302,4894139,371,1,0.453229,44,4895991,-1,500.0,4914991,4915362,20852,371,24,6,True,True,3.9753680555555557,-0.453229
6303,4894205,48,32,0.763442,44,4895991,-1,16000.0,4913891,4913939,19686,48,25,0,True,True,23.453866666666666,-0.763442
6304,4894231,44,8,0.180601,44,4895991,-1,4000.0,4923032,4923076,28801,44,15,1,True,True,2.013733333333333,-0.180601
6305,4895612,10,32,0.018603,44,4895991,-1,16000.0,4931092,4931102,35480,10,12,7,True,True,1.793777777777778,-0.018603
6306,4895622,11994,8,0.703332,44,4895991,-1,4000.0,4919691,4931685,24069,11994,25,0,True,True,554.4237666666667,-0.6685294821407263
6307,4895882,3,1,0.86271,44,4895991,-1,500.0,4906191,4906194,10309,3,36,6,True,True,0.038345833333333336,-0.86271
6308,4895968,23,2,0.576843,44,4895991,-1,1000.0,4916091,4916114,20123,23,27,6,True,True,0.49290277777777786,-0.576843
6309,4895984,8,16,0.212953,44,4895991,-1,8000.0,4902891,4902899,6907,8,41,7,True,True,2.5932444444444447,-0.212953
6310,4895993,11,8,0.962117,48,4899591,-1,4000.0,4903991,4904002,7998,11,41,6,True,True,1.1248111111111112,-0.962117
6311,4896003,16,41,0.742208,48,4899591,-1,20500.0,4910591,4910607,14588,16,32,7,True,True,10.016755555555555,-0.742208
6312,4896291,3098,16,0.467295,48,4899591,-1,8000.0,4911691,4914789,15400,3098,32,6,True,True,699.3840222222223,-0.43179957275524905
6313,4896671,17362,128,0.937163,48,4899591,-1,64000.0,5035146,5052508,138475,17362,3,7,True,True,36081.92533333333,-0.857081239214646
6314,4896798,333,2,0.532719,48,4899591,-1,1000.0,4908391,4908724,11593,333,40,7,True,True,13.189575,-0.532719
6315,4964811,8,1,0.614422,46,4987861,-1,500.0,4991161,4991169,26350,8,4,0,True,True,0.2246,-0.614422
6316,4964818,13609,128,0.769119,46,4987861,-1,64000.0,5080642,5094251,115824,13609,3,2,True,True,16075.410666666667,-0.5996500592982411
6317,4964905,4,16,0.433724,46,4987861,-1,8000.0,5001435,5001439,36530,4,5,6,True,True,0.36808888888888885,-0.433724
6318,4965079,16,7,0.566116,46,4987861,-1,3500.0,4991168,4991184,26089,16,6,1,True,True,3.1443999999999996,-0.566116
6319,4965091,8164,1,0.626758,46,4987861,-1,500.0,5048346,5056510,83255,8164,4,7,True,True,104.89505555555556,-0.6022837808464088
6320,4965152,13,1,0.52227,46,4987861,-1,500.0,4995622,4995635,30470,13,7,0,True,True,0.1742361111111111,-0.52227
6321,4965209,19140,13,0.364275,46,4987861,-1,6500.0,5189482,5208622,224273,19140,3,7,True,True,3602.6615805555557,-0.3503616857533922
6322,4965225,5348,8,0.147744,46,4987861,-1,4000.0,5006135,5011483,40910,5348,7,0,True,True,156.73471111111112,-0.14753089471956962
6323,4965337,26,32,0.150473,46,4987861,-1,16000.0,5029646,5029672,64309,26,7,7,True,True,22.945866666666664,-0.150473
6324,4965341,44,16,0.685307,46,4987861,-1,8000.0,4990061,4990105,24720,44,14,6,True,True,19.7648,-0.685307
6325,4965528,13,1,0.300276,46,4987861,-1,500.0,5092753,5092766,127225,13,4,7,True,True,0.1875611111111111,-0.300276
6326,4965570,9,1,0.435389,46,4987861,-1,500.0,4995622,4995631,30052,9,12,7,True,True,0.120625,-0.435389
6327,4966013,54,4,0.318653,46,4987861,-1,2000.0,4993368,4993422,27355,54,13,7,True,True,2.895,-0.318653
6328,4966019,111,29,0.830214,46,4987861,-1,14500.0,4988961,4989072,22942,111,18,6,True,True,69.17720416666666,-0.830214
6329,4966028,14475,1,0.064428,46,4987861,-1,500.0,5237602,5252077,271574,14475,1,7,True,True,156.91550972222223,-0.06251622341367705
6330,4967530,350,16,0.203558,46,4987861,-1,8000.0,4999235,4999585,31705,350,12,5,True,True,29.05,-0.203558
6331,4967600,6113,1,0.412438,46,4987861,-1,500.0,5121964,5128077,154364,6113,5,0,True,True,134.14134027777777,-0.3844847423259035
6332,4968036,187,16,0.823711,46,4987861,-1,8000.0,4991161,4991348,23125,187,19,6,True,True,84.0004,-0.823711
6333,4968040,16106,16,0.646043,46,4987861,-1,8000.0,5065878,5081984,97838,16106,8,0,True,True,4105.464711111112,-0.6435536827568545
6334,4968931,5,1,0.256447,46,4987861,-1,500.0,5071685,5071690,102754,5,8,1,True,True,0.08547222222222223,-0.256447
6335,4969066,8270,24,0.601232,46,4987861,-1,12000.0,4995635,5003905,26569,8270,16,2,True,True,1306.7485000000001,-0.4393734332989401
6336,4969076,22,1,0.405866,46,4987861,-1,500.0,5016843,5016865,47767,22,13,1,True,True,0.07978055555555556,-0.405866
6337,4972025,54,16,0.113559,46,4987861,-1,8000.0,5007414,5007468,35389,54,14,1,True,True,3.03,-0.113559
6338,4972673,518,8,0.191916,46,4987861,-1,4000.0,5005035,5005553,32362,518,16,0,True,True,14.53277777777778,-0.191916
6339,4972718,376,1,0.245587,46,4987861,-1,500.0,5024864,5025240,52146,376,13,0,True,True,2.236677777777778,-0.245587
6340,4975919,5657,2,0.827229,46,4987861,-1,1000.0,4991161,4996818,15242,5657,26,0,True,True,211.17659999999998,-0.6789959102002204
6341,4976027,259,4,0.46416,46,4987861,-1,2000.0,5005035,5005294,29008,259,18,0,True,True,3.633194444444445,-0.46416
6342,4976257,34,8,0.559825,46,4987861,-1,4000.0,4987861,4987895,11604,34,32,0,True,True,5.845355555555555,-0.559825
6343,4976907,30,2,0.436133,46,4987861,-1,1000.0,5005035,5005065,28128,30,19,0,True,True,0.21041666666666667,-0.436133
6344,4977065,26811,64,0.646922,46,4987861,-1,32000.0,5025240,5052051,48175,26811,13,2,True,True,31753.268799999998,-0.6436714996197987
6345,4978639,12,2,0.037004,46,4987861,-1,1000.0,5019043,5019055,40404,12,15,7,True,True,0.16780000000000003,-0.037004
6346,4978779,16654,94,0.159358,46,4987861,-1,47000.0,5071699,5088353,92920,16654,8,0,True,True,19852.73981388889,-0.13722546529227492
6347,4978840,91,32,0.136431,46,4987861,-1,16000.0,5027446,5027537,48606,91,14,1,True,True,49.49995555555555,-0.136431
6348,4986046,13928,256,0.258397,46,4987861,-1,128000.0,5310972,5324900,324926,13928,0,0,True,True,78676.25671111111,-0.2575546516088204
6349,4986058,7,8,0.803538,46,4987861,-1,4000.0,4991161,4991168,5103,7,33,0,True,True,1.5721999999999998,-0.803538
6350,4986134,20,4,0.658671,46,4987861,-1,2000.0,5016843,5016863,30709,20,19,0,True,True,0.2901111111111111,-0.658671
6351,4986480,6,53,0.175985,46,4987861,-1,26500.0,5027440,5027446,40960,6,16,7,True,True,5.4055583333333335,-0.175985
6352,4987189,67,64,0.852521,46,4987861,-1,32000.0,4993422,4993489,6233,67,32,1,True,True,57.47111111111111,-0.852521
6353,4987212,14787,128,0.963787,46,4987861,-1,64000.0,5135694,5150481,148482,14787,6,8,True,True,25009.716800000002,-0.8754027094759093
6354,4987740,78,1,0.485842,46,4987861,-1,500.0,5016843,5016921,29103,78,22,0,True,True,0.2828583333333333,-0.485842
6355,4987840,365,4,0.019909,46,4987861,-1,2000.0,5037346,5037711,49506,365,14,7,True,True,26.093444444444447,-0.019909
6356,4989169,109,8,0.859584,47,4990061,-1,4000.0,4991161,4991270,1992,109,39,0,True,True,24.481399999999997,-0.859584
6357,4989371,31,8,0.08393,47,4990061,-1,4000.0,5007414,5007445,18043,31,25,0,True,True,0.8697222222222222,-0.08393
6358,4989557,10336,8,0.6016,47,4990061,-1,4000.0,5061196,5071532,71639,10336,13,0,True,True,1200.3735555555554,-0.5890734134568811
6359,4989575,14084,1,0.867172,47,4990061,-1,500.0,5000335,5014419,10760,14084,33,6,True,True,58.12414166666667,-0.7828254211785111
6360,4990729,108,2,0.900575,47,4991161,-1,1000.0,4995622,4995730,4893,108,37,0,True,True,2.895,-0.900575
6361,4990830,666,2,0.407007,47,4991161,-1,1000.0,5032946,5033612,42116,666,17,0,True,True,32.66545,-0.407007
6362,4991259,16734,1,0.363434,44,4993368,-1,500.0,5231002,5247736,239743,16734,4,7,True,True,196.42383055555555,-0.3622161355646632
6363,4991313,1000,3,0.657431,44,4993368,-1,1500.0,5019064,5020064,27751,1000,24,0,True,True,20.975,-0.657431
6364,4991342,21,8,0.090306,44,4993368,-1,4000.0,5022664,5022685,31322,21,24,5,True,True,0.9993666666666666,-0.090306
6365,4996152,288,8,0.943162,45,4999235,-1,4000.0,5005035,5005323,8883,288,34,0,True,True,8.08,-0.943162
6366,4996383,9,1,0.724234,45,4999235,-1,500.0,5019064,5019073,22681,9,26,0,True,True,0.06292500000000001,-0.724234
6367,4996738,11299,256,0.14056,45,4999235,-1,128000.0,5287671,5298970,290933,11299,1,8,True,True,52926.851200000005,-0.1405521819338534
6368,4996862,19,8,0.111932,45,4999235,-1,4000.0,5029646,5029665,32784,19,20,0,True,True,4.192033333333334,-0.111932
6369,4997024,11651,2,0.73448,45,4999235,-1,1000.0,5049815,5061466,52791,11651,16,0,True,True,292.1374472222222,-0.6870961594176568
6370,4998240,68,32,0.932935,45,4999235,-1,16000.0,5031846,5031914,33606,68,21,7,True,True,60.01226666666666,-0.932935
6371,4998380,9,2,0.521958,45,4999235,-1,1000.0,5019055,5019064,20675,9,31,1,True,True,0.12585000000000002,-0.521958
6372,5001282,11,1,0.828982,45,5001435,-1,500.0,5005035,5005046,3753,11,43,4,True,True,0.03857638888888889,-0.828982
6373,5001393,8013,2,0.949675,45,5001435,-1,1000.0,5011014,5019027,9621,8013,36,3,True,True,60.80151666666667,-0.6938729045098323
6374,5003634,1429,2,0.931556,53,5005035,-1,1000.0,5015414,5016843,11780,1429,36,7,True,True,10.364219444444444,-0.931556
6375,5003672,396,11,0.251808,53,5005035,-1,5500.0,5027446,5027842,23774,396,24,0,True,True,74.04595,-0.251808
6376,5003800,518,4,0.884565,53,5005035,-1,2000.0,5006135,5006653,2335,518,42,6,True,True,7.26638888888889,-0.884565
6377,5003985,4,16,0.238077,53,5005035,-1,8000.0,5013214,5013218,9229,4,38,7,True,True,0.21804444444444446,-0.238077
6378,5004083,382,8,0.122277,53,5005035,-1,4000.0,5016843,5017225,12760,382,34,0,True,True,11.082244444444445,-0.122277
6379,5004332,179,1,0.806687,53,5005035,-1,500.0,5007235,5007414,2903,179,43,6,True,True,0.6277430555555555,-0.806687
6380,5004346,342,1,0.329286,53,5005035,-1,500.0,5052015,5052357,47669,342,16,7,True,True,4.41465,-0.329286
6381,5004375,7617,128,0.584326,53,5005035,-1,64000.0,5128077,5135694,123702,7617,9,1,True,True,19463.475733333333,-0.5739778729720317
6382,5004770,7207,53,0.389951,53,5005035,-1,26500.0,5115064,5122271,110294,7207,11,6,True,True,9194.213130555556,-0.37088303450511184
6383,5008217,92,1,0.748374,49,5011014,-1,500.0,5024864,5024956,16647,92,32,7,True,True,0.5472722222222223,-0.748374
6384,5008449,72,16,0.235938,49,5011014,-1,8000.0,5032946,5033018,24497,72,24,6,True,True,28.2512,-0.235938
6385,5008526,6200,16,0.422869,49,5011014,-1,8000.0,5046146,5052346,37620,6200,21,6,True,True,1397.464711111111,-0.41244544757562596
6386,5008573,5,8,0.144278,49,5011014,-1,4000.0,5049815,5049820,41242,5,19,0,True,True,0.5808333333333333,-0.144278
6387,5009035,112,4,0.175154,49,5011014,-1,2000.0,5048603,5048715,39568,112,21,3,True,True,6.505333333333333,-0.175154
6388,5009187,92,16,0.969923,49,5011014,-1,8000.0,5016843,5016935,7656,92,43,0,True,True,5.338044444444445,-0.969923
6389,5011695,36736,16,0.439475,52,5013214,-1,8000.0,5235402,5272138,223707,36736,4,7,True,True,7631.519244444444,-0.425238582945641
6390,5012350,143,32,0.254306,52,5013214,-1,16000.0,5019064,5019207,6714,143,41,1,True,True,31.99386666666667,-0.254306
6391,5012445,12,8,0.589481,52,5013214,-1,4000.0,5019064,5019076,6619,12,40,0,True,True,0.6712000000000001,-0.589481
6392,5013079,28,4,0.490359,52,5013214,-1,2000.0,5031846,5031874,18767,28,29,0,True,True,3.0888666666666666,-0.490359
6393,5013666,39,64,0.374705,52,5015414,-1,32000.0,5058996,5059035,45330,39,19,2,True,True,33.422133333333335,-0.374705
6394,5035595,4,1,0.948711,31,5037346,-1,500.0,5041746,5041750,6151,4,26,0,True,True,0.06762777777777779,-0.948711
6395,5035616,49,1,0.31649,31,5037346,-1,500.0,5113964,5114013,78348,49,13,1,True,True,0.38158749999999997,-0.31649
6396,5035632,6541,32,0.423781,31,5037346,-1,16000.0,5099653,5106194,64021,6541,14,7,True,True,1836.4356444444445,-0.3232479196870127
6397,5035672,13689,1,0.682738,31,5037346,-1,500.0,5187282,5200971,151610,13689,9,0,True,True,126.47532916666667,-0.6043947888038063
6398,5035701,48,4,0.963315,31,5037346,-1,2000.0,5039546,5039594,3845,48,30,7,True,True,3.431466666666667,-0.963315
6399,5038555,27,25,0.879434,36,5039546,-1,12500.0,5043946,5043973,5391,27,29,0,True,True,9.676874999999999,-0.879434
6400,5039384,9,8,0.936972,36,5039546,-1,4000.0,5039546,5039555,162,9,31,0,True,True,1.2868000000000002,-0.936972
6401,5039437,4609,128,0.362998,36,5039546,-1,64000.0,5217502,5222111,178065,4609,7,7,True,True,9842.103822222221,-0.3583333737796685
6402,5039447,15719,8,0.715671,36,5039546,-1,4000.0,5101853,5117572,62406,15719,16,7,True,True,1128.5759,-0.5677024644211456
6403,5039464,2,1,0.821365,36,5039546,-1,500.0,5040646,5040648,1182,2,33,6,True,True,0.03381388888888889,-0.821365
6404,5039486,489,1,0.021074,36,5039546,-1,500.0,5121964,5122453,82478,489,14,2,True,True,12.052491666666667,-0.021074
6405,5039769,60,1,0.966805,45,5040646,-1,500.0,5045046,5045106,5277,60,32,6,True,True,0.8601666666666666,-0.966805
6406,5039891,10,4,0.605815,45,5040646,-1,2000.0,5046146,5046156,6255,10,31,0,True,True,0.5734444444444444,-0.605815
6407,5039964,11,2,0.841473,45,5040646,-1,1000.0,5040646,5040657,682,11,36,0,True,True,0.3719527777777778,-0.841473
6408,5040154,8196,8,0.662223,45,5040646,-1,4000.0,5049815,5058011,9661,8196,28,0,True,True,798.442511111111,-0.5831595094919974
6409,5040184,9272,1,0.940848,45,5040646,-1,500.0,5048346,5057618,8162,9272,31,0,True,True,116.86299444444444,-0.9077389547951787
6410,5040190,24297,78,0.690682,45,5040646,-1,39000.0,5225202,5249499,185012,24297,7,7,True,True,23288.925075,-0.6701907350838097
6411,5040213,572,8,0.788803,45,5040646,-1,4000.0,5049815,5050387,9602,572,28,0,True,True,66.44733333333333,-0.788803
6412,5040272,2900,64,0.239676,45,5040646,-1,32000.0,5096353,5099253,56081,2900,20,4,True,True,2579.992088888889,-0.2308776532088547
6413,5040327,32,2,0.552728,45,5040646,-1,1000.0,5062566,5062598,22239,32,26,0,True,True,0.8603555555555557,-0.552728
6414,5040396,7193,1,0.309269,45,5040646,-1,500.0,5126053,5133246,85657,7193,14,5,True,True,147.35699027777775,-0.29792872379498664
6415,5040423,9,8,0.958484,45,5040646,-1,4000.0,5041746,5041755,1323,9,43,6,True,True,1.2173,-0.958484
6416,5040900,48,4,0.362855,48,5041746,-1,2000.0,5062566,5062614,21666,48,28,0,True,True,2.581066666666667,-0.362855
6417,5040909,7,64,0.81225,48,5041746,-1,32000.0,5102953,5102960,62044,7,19,6,True,True,3.5472888888888887,-0.81225
6418,5041154,752,8,0.122054,48,5041746,-1,4000.0,5058651,5059403,17497,752,32,7,True,True,80.55591111111112,-0.122054
6419,5041162,10,1,0.866953,48,5041746,-1,500.0,5043946,5043956,2784,10,45,7,True,True,0.1433611111111111,-0.866953
6420,5041194,39,32,0.857647,48,5041746,-1,16000.0,5046146,5046185,4952,39,42,0,True,True,17.891466666666666,-0.857647
6421,5046220,1,16,0.388471,54,5048346,-1,8000.0,5052051,5052052,5831,1,33,1,True,True,0.20653333333333332,-0.388471
6422,5046284,15625,4,0.909789,54,5048346,-1,2000.0,5048715,5064340,2431,15625,39,1,True,True,802.6796388888889,-0.8753004303959924
6423,5046317,3,1,0.392976,54,5048346,-1,500.0,5055351,5055354,9034,3,33,6,True,True,0.032404166666666664,-0.392976
6424,5046332,6729,4,0.977993,54,5048346,-1,2000.0,5048346,5055075,2014,6729,43,0,True,True,357.58025,-0.9434800652948908
6425,5046363,260,1,0.255534,54,5048346,-1,500.0,5049815,5050075,3452,260,40,6,True,True,3.775416666666666,-0.255534
6426,5046749,11,9,0.09025,54,5048346,-1,4500.0,5084136,5084147,37387,11,24,0,True,True,0.6117375,-0.09025
6427,5046809,257,1,0.822708,54,5048346,-1,500.0,5048346,5048603,1537,257,44,0,True,True,3.7318541666666665,-0.822708
6428,5046913,11,32,0.23546,54,5048346,-1,16000.0,5113953,5113964,67040,11,19,7,True,True,2.7412,-0.23546
6429,5047043,14,4,0.210386,54,5048346,-1,2000.0,5110653,5110667,63610,14,20,7,True,True,0.33421111111111107,-0.210386
6430,5047140,22571,16,0.890247,54,5048346,-1,8000.0,5122453,5145024,75313,22571,15,1,True,True,6677.209377777777,-0.8122516105803712
6431,5047202,6,8,0.915891,54,5048346,-1,4000.0,5048346,5048352,1144,6,47,0,True,True,0.6970000000000001,-0.915891
6432,5047254,11,12,0.631353,54,5048346,-1,6000.0,5048346,5048357,1092,11,49,0,True,True,1.91675,-0.631353
6433,5048161,10364,23,0.879467,54,5048346,-1,11500.0,5070278,5080642,22117,10364,31,7,True,True,4016.1016833333333,-0.8500044741247081
6434,5048205,473,2,0.766741,54,5048346,-1,1000.0,5048715,5049188,510,473,46,0,True,True,13.736708333333333,-0.766741
6435,5048623,20,54,0.406289,49,5048715,-1,27000.0,5071679,5071699,23056,20,31,1,True,True,18.462,-0.406289
6436,5048678,9806,32,0.033882,49,5048715,-1,16000.0,5065878,5075684,17200,9806,33,0,True,True,4798.457244444445,-0.03381667524683046
6437,5049119,1583,2,0.866445,54,5049815,-1,1000.0,5049815,5051398,696,1583,44,0,True,True,44.04440833333334,-0.8300979262999717
6438,5049130,11094,128,0.823198,54,5049815,-1,64000.0,5152994,5164088,103864,11094,12,9,True,True,16011.512177777777,-0.7683172324892812
6439,5049135,11,80,0.940495,54,5049815,-1,40000.0,5141094,5141105,91959,11,13,8,True,True,11.418000000000001,-0.940495
6440,5049317,7704,256,0.471091,54,5049815,-1,128000.0,5324900,5332604,275583,7704,0,7,True,True,45121.35964444445,-0.470386738477426
6441,5049589,6,8,0.412961,54,5049815,-1,4000.0,5071679,5071685,22090,6,34,0,True,True,0.8205333333333333,-0.412961
6442,5049619,15133,8,0.841163,54,5049815,-1,4000.0,5142194,5157327,92575,15133,14,6,True,True,1414.6518999999998,-0.7996100380555022
6443,5049809,7295,16,0.717386,54,5049815,-1,8000.0,5054251,5061546,4442,7295,46,7,True,True,1412.6442666666667,-0.661833355113311
6444,5050464,16097,1,0.876761,61,5052015,-1,500.0,5219702,5235799,169238,16097,9,7,True,True,237.6776861111111,-0.8322711514566676
6445,5050620,3608,128,0.820241,61,5052015,-1,64000.0,5215302,5218910,164682,3608,11,7,True,True,7806.1728,-0.7657439925867956
6446,5050703,99,4,0.824401,61,5052015,-1,2000.0,5055351,5055450,4648,99,47,0,True,True,4.27735,-0.824401
6447,5050777,49,2,0.698482,61,5052015,-1,1000.0,5058996,5059045,8219,49,45,0,True,True,1.3122472222222221,-0.698482
6448,5050915,24920,64,0.506335,61,5052015,-1,32000.0,5173974,5198894,123059,24920,15,7,True,True,17173.451022222223,-0.48393948610206083
6449,5051602,7919,2,0.351856,61,5052015,-1,1000.0,5171774,5179693,120172,7919,16,0,True,True,164.63445277777777,-0.31752653987153134
6450,5051620,4940,16,0.602116,61,5052015,-1,8000.0,5083942,5088882,32322,4940,36,0,True,True,436.49013333333335,-0.5776331524503068
6451,5051644,11891,128,0.813428,61,5052015,-1,64000.0,5111753,5123644,60109,11891,29,6,True,True,29488.13848888889,-0.6944102435781421
6452,5051662,10,32,0.737786,61,5052015,-1,16000.0,5056451,5056461,4789,10,52,0,True,True,3.456444444444444,-0.737786
6453,5051696,12002,128,0.453262,61,5052015,-1,64000.0,5298970,5310972,247274,12002,2,7,True,True,28651.811200000004,-0.4246423737765565
6454,5051826,9,28,0.027351,61,5052015,-1,14000.0,5064766,5064775,12940,9,47,6,True,True,3.3876500000000007,-0.027351
6455,5051887,12955,4,0.052099,61,5052015,-1,2000.0,5054251,5067206,2364,12955,57,0,True,True,660.0525222222223,-0.049420238552465384
6456,5051994,549,1,0.641593,61,5052015,-1,500.0,5054251,5054800,2257,549,58,0,True,True,6.2438972222222215,-0.5652920093693053
6457,5052030,7192,8,0.630156,61,5052051,-1,4000.0,5082842,5090034,30812,7192,39,7,True,True,332.7294444444445,-0.3943234563184847
6458,5052093,9,1,0.791019,79,5054251,-1,500.0,5062566,5062575,10473,9,51,6,True,True,0.12098750000000001,-0.791019
6459,5053167,300,16,0.136092,79,5054251,-1,8000.0,5061466,5061766,8299,300,52,1,True,True,64.4135111111111,-0.13585334570926746
6460,5053192,11523,32,0.400662,79,5054251,-1,16000.0,5122271,5133794,69079,11523,25,1,True,True,7764.435288888889,-0.37906368723257977
6461,5053311,60,4,0.628296,79,5054251,-1,2000.0,5065875,5065935,12564,60,49,0,True,True,3.3026666666666666,-0.628296
6462,5053321,42,1,0.313722,79,5054251,-1,500.0,5068078,5068120,14757,42,47,0,True,True,0.5779666666666666,-0.313722
6463,5053390,9387,32,0.082232,79,5054251,-1,16000.0,5090553,5099940,37163,9387,38,7,True,True,4192.4816,-0.08115400680405661
6464,5053409,409,1,0.157822,79,5054251,-1,500.0,5110653,5111062,57244,409,32,0,True,True,2.440934722222222,-0.157822
6465,5053471,669,40,0.516366,79,5054251,-1,20000.0,5105153,5105822,51682,669,34,0,True,True,125.92066666666666,-0.516366
6466,5053478,1370,4,0.969665,79,5054251,-1,2000.0,5056451,5057821,2973,1370,64,0,True,True,59.19161111111111,-0.969665
6467,5053524,4,1,0.830621,79,5054251,-1,500.0,5054251,5054255,727,4,68,0,True,True,0.05163333333333333,-0.830621
6468,5053546,607,1,0.763163,79,5054251,-1,500.0,5054251,5054858,705,607,68,0,True,True,6.870377777777777,-0.6691740049356035
6469,5053558,18448,160,0.84696,79,5054251,-1,80000.0,5187282,5205730,133724,18448,16,4,True,True,34988.60488888888,-0.6239593387835972
6470,5053616,14,16,0.685753,79,5054251,-1,8000.0,5062566,5062580,8950,14,58,0,True,True,3.0112444444444444,-0.685753
6471,5053649,94,1,0.792642,79,5054251,-1,500.0,5064775,5064869,11126,94,55,1,True,True,1.2636472222222224,-0.792642
6472,5053681,194,8,0.319399,79,5054251,-1,4000.0,5083942,5084136,30261,194,44,6,True,True,9.590066666666667,-0.319399
6473,5053696,1791,8,0.478365,79,5054251,-1,4000.0,5061196,5062987,7500,1791,63,0,True,True,192.44152222222223,-0.47794135870920534
6474,5054011,14447,128,0.735172,79,5054251,-1,64000.0,5157327,5171774,103316,14447,19,7,True,True,16505.214755555557,-0.6825310118190205
6475,5054052,7887,29,0.26068,79,5054251,-1,14500.0,5117264,5125151,63212,7887,30,7,True,True,5529.693698611111,-0.2517783095008623
6476,5054099,10840,32,0.687467,79,5054251,-1,16000.0,5223002,5233842,168903,10840,10,6,True,True,5077.221244444445,-0.6463461541291032
6477,5054492,21,8,0.826769,75,5055351,-1,4000.0,5056451,5056472,1959,21,73,6,True,True,1.8146333333333333,-0.826769
6478,5055358,13301,128,0.799529,80,5056451,-1,64000.0,5228802,5242103,173444,13301,9,1,True,True,21288.93368888889,-0.7754694613980401
6479,5055377,15508,140,0.198664,80,5056451,-1,70000.0,5171774,5187282,116397,15508,21,2,True,True,25509.70061111111,-0.1940546138000669
6480,5055439,17,16,0.414496,80,5056451,-1,8000.0,5064775,5064792,9336,17,61,0,True,True,3.6565111111111115,-0.414496
6481,5055712,8,16,0.181889,80,5056451,-1,8000.0,5068078,5068086,12366,8,58,7,True,True,1.7614222222222222,-0.181889
6482,5055757,3,8,0.87639,80,5056451,-1,4000.0,5065875,5065878,10118,3,62,0,True,True,0.3302666666666667,-0.87639
6483,5055783,1034,4,0.944757,80,5056451,-1,2000.0,5061196,5062230,5413,1034,73,7,True,True,55.515188888888886,-0.9433077808921705
6484,5056411,109,2,0.884341,80,5056451,-1,1000.0,5056451,5056560,40,109,77,0,True,True,2.354702777777778,-0.884341
6485,5056458,266,9,0.224487,84,5058651,-1,4500.0,5065875,5066141,9417,266,63,6,True,True,32.9441,-0.224487
6486,5056472,345,8,0.948109,84,5058651,-1,4000.0,5058651,5058996,2179,345,77,0,True,True,36.957166666666666,-0.948109
6487,5056902,18,10,0.923112,84,5058651,-1,5000.0,5063666,5063684,6764,18,67,0,True,True,2.4197500000000005,-0.923112
6488,5057043,9038,32,0.647107,84,5058651,-1,16000.0,5088353,5097391,31310,9038,47,7,True,True,3396.9707555555556,-0.6363601247993602
6489,5058075,16,1,0.626627,84,5058651,-1,500.0,5107353,5107369,49278,16,40,7,True,True,0.07528888888888889,-0.626627
6490,5058146,12,7,0.906845,84,5058651,-1,3500.0,5058651,5058663,505,12,80,0,True,True,1.1247833333333332,-0.906845
6491,5058434,553,4,0.974128,84,5058651,-1,2000.0,5062566,5063119,4132,553,72,0,True,True,29.736038888888892,-0.974128
6492,5058632,386,1,0.198266,84,5058651,-1,500.0,5118364,5118750,59732,386,33,6,True,True,10.037072222222221,-0.198266
6493,5058801,18,16,0.701261,86,5058996,-1,8000.0,5065878,5065896,7077,18,64,1,True,True,3.9632,-0.701261
6494,5058827,10593,1,0.168756,86,5058996,-1,500.0,5221902,5232495,163075,10593,12,7,True,True,158.9817875,-0.1622905211300577
6495,5058866,27,16,0.401035,86,5058996,-1,8000.0,5063666,5063693,4800,27,72,0,True,True,5.8074,-0.401035
6496,5058919,16733,1,0.428903,86,5058996,-1,500.0,5176174,5192907,117255,16733,20,7,True,True,199.4103486111111,-0.4168707047629242
6497,5058961,39,1,0.260158,86,5058996,-1,500.0,5105153,5105192,46192,39,45,7,True,True,0.1835166666666667,-0.260158
6498,5059497,36,30,0.089061,91,5061196,-1,15000.0,5097453,5097489,37956,36,49,6,True,True,14.2545,-0.089061
6499,5059573,159,16,0.36792,91,5061196,-1,8000.0,5065878,5066037,6305,159,67,0,True,True,35.008266666666664,-0.36792
6500,5059943,270,8,0.947244,91,5061196,-1,4000.0,5063666,5063936,3723,270,78,6,True,True,29.037,-0.947244
6501,5059974,12,1,0.117351,91,5061196,-1,500.0,5108453,5108465,48479,12,43,6,True,True,0.07161666666666668,-0.117351
6502,5060092,437,64,0.718583,91,5061196,-1,32000.0,5071532,5071969,11440,437,64,1,True,True,478.09742222222224,-0.718583
6503,5060119,11,3,0.435159,91,5061196,-1,1500.0,5062566,5062577,2447,11,81,0,True,True,0.44362083333333335,-0.435159
6504,5060145,147,4,0.919989,91,5061196,-1,2000.0,5071532,5071679,11387,147,64,0,True,True,10.051533333333333,-0.919989
