job_id,submit_time,request_time,request_processors,carbon_consideration,queue_length_at_submission,submission_timestamp,user_id,power,scheduled_time,completion_time,wait_time,actual_runtime,action1,action2,scheduled,completed,carbon_emissions,carbon_reward
7599,6084716,8396,8,0.537604,1,6084716,-1,4000.0,6086916,6095312,2200,8396,0,7,True,True,1216.096,-0.5138414238102761
7600,6085683,12,4,0.32608,4,6086916,-1,2000.0,12111417,12111429,6025734,12,0,7,True,True,1.7019333333333333,-0.32608
7601,6085768,291,64,0.02324,4,6086916,-1,32000.0,15213590,15213881,9127822,291,0,12,True,True,294.3440888888889,-0.018701259368398445
7602,6085843,31,32,0.785358,4,6086916,-1,16000.0,6762852,6762883,677009,31,2,2,True,True,20.19822222222222,-0.785358
7603,6085865,8087,26,0.922144,4,6086916,-1,13000.0,6130116,6138203,44251,8087,3,11,True,True,2636.74645,-0.8806624431491732
7604,6093970,4,2,0.153691,106,6130116,-1,1000.0,13811417,13811421,7717447,4,1,12,True,True,0.15005555555555558,-0.153691
7605,6094137,1277,1,0.952638,106,6130116,-1,500.0,6806052,6807329,711915,1277,3,11,True,True,21.370240277777775,-0.952638
7606,6094181,836,16,0.330251,106,6130116,-1,8000.0,13546817,13547653,7452636,836,2,12,True,True,441.2593777777778,-0.330251
7607,6094592,4818,1,0.629839,106,6130116,-1,500.0,7802160,7806978,1707568,4818,4,2,True,True,81.26460833333334,-0.6112941037487287
7608,6094727,8,8,0.603003,106,6130116,-1,4000.0,7380642,7380650,1285915,8,5,7,True,True,1.2796444444444446,-0.603003
7609,6094907,18787,2,0.607837,106,6130116,-1,1000.0,7793160,7811947,1698253,18787,5,12,True,True,783.8528194444445,-0.5838236503642724
7610,6094978,10,4,0.866945,106,6130116,-1,2000.0,7488642,7488652,1393664,10,6,10,True,True,0.8074444444444445,-0.866945
7611,6095254,11,44,0.980172,106,6130116,-1,22000.0,7107142,7107153,1011888,11,8,11,True,True,7.936255555555556,-0.9801719999999999
7612,6095273,34,1,0.204205,106,6130116,-1,500.0,7287642,7287676,1192369,34,8,10,True,True,0.5083472222222223,-0.204205
7613,6095276,750,8,0.390636,106,6130116,-1,4000.0,8252196,8252946,2156920,750,4,1,True,True,131.04166666666669,-0.390636
7614,6095281,697,1,0.534491,106,6130116,-1,500.0,9889675,9890372,3794394,697,4,7,True,True,14.417251388888891,-0.534491
7615,6095288,87,1,0.188339,106,6130116,-1,500.0,12853417,12853504,6758129,87,3,0,True,True,2.8678583333333334,-0.188339
7616,6095300,5354,8,0.108638,106,6130116,-1,4000.0,14867990,14873344,8772690,5354,1,12,True,True,248.0412,-0.10562612100020827
7617,6095363,19008,8,0.569515,106,6130116,-1,4000.0,11588617,11607625,5493254,19008,6,12,True,True,2171.8580555555554,-0.5419263644746648
7618,6095534,31,4,0.451535,106,6130116,-1,2000.0,11072675,11072706,4977141,31,7,7,True,True,1.5494833333333333,-0.451535
7619,6095582,113,2,0.894744,106,6130116,-1,1000.0,6132316,6132429,36734,113,18,7,True,True,2.8968805555555557,-0.894744
7620,6095896,137,32,0.093242,106,6130116,-1,16000.0,15396190,15396327,9300294,137,0,12,True,True,32.95915555555556,-0.093242
7621,6095972,9,2,0.104313,106,6130116,-1,1000.0,10375675,10375684,4279703,9,9,8,True,True,0.313475,-0.104313
7622,6095994,6961,17,0.552907,106,6130116,-1,8500.0,6941052,6948013,845058,6961,18,8,True,True,1850.2481722222221,-0.47613521862001335
7623,6096053,39045,8,0.032059,106,6130116,-1,4000.0,15568990,15608035,9472937,39045,0,12,True,True,2090.5922777777782,-0.030612679222494655
7624,6096103,12315,4,0.689025,106,6130116,-1,2000.0,7050085,7062400,953982,12315,19,8,True,True,703.7695000000001,-0.6777433140985019
7625,6096127,23680,2,0.488613,106,6130116,-1,1000.0,6257761,6281441,161634,23680,23,7,True,True,707.1598944444445,-0.48575553260116017
7626,6096190,11,1,0.186692,106,6130116,-1,500.0,12370617,12370628,6274427,11,7,12,True,True,0.06797083333333334,-0.186692
7627,6096215,699,18,0.069491,106,6130116,-1,9000.0,12983017,12983716,6886802,699,6,11,True,True,272.347875,-0.069491
7628,6096769,50,1,0.962995,106,6130116,-1,500.0,6759252,6759302,662483,50,25,2,True,True,0.94375,-0.962995
7629,6096778,13995,36,0.283818,106,6130116,-1,18000.0,13725017,13739012,7628239,13995,5,11,True,True,6561.1267,-0.25318210757990917
7630,6096933,51,1,0.233039,106,6130116,-1,500.0,9575885,9575936,3478952,51,15,2,True,True,0.9820333333333332,-0.233039
7631,6096961,72,4,0.65957,106,6130116,-1,2000.0,6530874,6530946,433913,72,28,7,True,True,3.8160000000000003,-0.65957
7632,6097020,8852,128,0.069979,106,6130116,-1,64000.0,15482590,15491442,9385570,8852,1,12,True,True,4010.6933333333336,-0.06256000409144874
7633,6097126,33,8,0.057453,106,6130116,-1,4000.0,13071617,13071650,6974491,33,8,12,True,True,2.1461,-0.057453
7634,6097130,279,4,0.518532,106,6130116,-1,2000.0,7266042,7266321,1168912,279,24,6,True,True,10.623700000000001,-0.518532
7635,6097184,6985,8,0.171826,106,6130116,-1,4000.0,9017996,9024981,2920812,6985,18,12,True,True,533.7145,-0.15887419996044289
7636,6097211,410,4,0.859707,106,6130116,-1,2000.0,6130116,6130526,32905,410,35,0,True,True,22.463444444444445,-0.859707
7637,6097271,3,8,0.410861,106,6130116,-1,4000.0,10111075,10111078,4013804,3,16,11,True,True,0.4026333333333334,-0.410861
7638,6097277,278,2,0.157035,106,6130116,-1,1000.0,10197475,10197753,4100198,278,16,12,True,True,7.810255555555555,-0.157035
7639,6097332,23,4,0.110744,106,6130116,-1,2000.0,13114817,13114840,7017485,23,8,11,True,True,0.7664111111111112,-0.110744
7640,6097351,23,32,0.536453,106,6130116,-1,16000.0,6135916,6135939,38565,23,37,2,True,True,8.907644444444445,-0.536453
7641,6098046,203,8,0.478251,106,6130116,-1,4000.0,9149985,9150188,3051939,203,21,6,True,True,21.601455555555557,-0.478251
7642,6098145,19,1,0.068763,106,6130116,-1,500.0,11850017,11850036,5751872,19,14,12,True,True,0.4235416666666667,-0.068763
7643,6098202,1062,2,0.955097,106,6130116,-1,1000.0,6266061,6267123,167859,1062,38,3,True,True,29.948399999999996,-0.955097
7644,6098431,6,1,0.865699,106,6130116,-1,500.0,6619546,6619552,521115,6,37,7,True,True,0.09210833333333333,-0.865699
7645,6098546,4961,16,0.129932,106,6130116,-1,8000.0,10062475,10067436,3963929,4961,20,12,True,True,1337.4273333333335,-0.12320447662587264
7646,6098955,14,1,0.205677,106,6130116,-1,500.0,15127190,15127204,9028235,14,4,12,True,True,0.27902777777777776,-0.1805729550321199
7647,6100368,8,26,0.432201,106,6130116,-1,13000.0,9666075,9666083,3565707,8,23,7,True,True,6.085155555555555,-0.432201
7648,6100373,624,1,0.709672,106,6130116,-1,500.0,8648596,8649220,2548223,624,27,7,True,True,8.614666666666668,-0.709672
7649,6100434,3,2,0.47478,106,6130116,-1,1000.0,9757875,9757878,3657441,3,23,12,True,True,0.09278333333333334,-0.47478
7650,6100512,20254,16,0.603709,106,6130116,-1,8000.0,11078075,11098329,4977563,20254,17,8,True,True,3306.065911111111,-0.5912522155499009
7651,6100987,28,2,0.939154,106,6130116,-1,1000.0,6431374,6431402,330387,28,45,7,True,True,0.8516666666666667,-0.939154
7652,6101020,9091,128,0.587492,106,6130116,-1,64000.0,14347390,14356481,8246370,9091,6,12,True,True,6485.114133333334,-0.5264313979822172
7653,6101026,128,16,0.502475,106,6130116,-1,8000.0,6475674,6475802,374648,128,46,6,True,True,22.23217777777778,-0.502475
7654,6101073,7,1,0.684836,106,6130116,-1,500.0,9671475,9671482,3570402,7,26,8,True,True,0.1931125,-0.684836
7655,6106453,89,16,0.275441,106,6130116,-1,8000.0,13287617,13287706,7181164,89,10,12,True,True,21.852466666666665,-0.275441
7656,6106775,9486,8,0.007443,106,6130116,-1,4000.0,14260990,14270476,8154215,9486,7,6,True,True,732.0832666666666,-0.00688796701828121
7657,6106898,10,16,0.142692,106,6130116,-1,8000.0,14087090,14087100,7980192,10,8,12,True,True,2.2466666666666666,-0.142692
7658,6107010,66,32,0.06397,106,6130116,-1,16000.0,14433790,14433856,8326780,66,6,12,True,True,16.831466666666667,-0.06397
7659,6107212,15,1,0.399237,106,6130116,-1,500.0,8740396,8740411,2633184,15,35,8,True,True,0.13008333333333333,-0.399237
7660,6107349,5513,1,0.807566,106,6130116,-1,500.0,7061591,7067104,954242,5513,45,2,True,True,74.12247916666666,-0.7995150574957985
7661,6107760,42,4,0.525857,106,6130116,-1,2000.0,9484785,9484827,3377025,42,33,11,True,True,3.725633333333333,-0.525857
7662,6107783,6,4,0.910303,106,6130116,-1,2000.0,7804360,7804366,1696577,6,39,7,True,True,0.43266666666666675,-0.910303
7663,6108059,58,1,0.879239,106,6130116,-1,500.0,6617346,6617404,509287,58,54,12,True,True,0.8903805555555555,-0.879239
7664,6108112,537,1,0.460205,106,6130116,-1,500.0,9143485,9144022,3035373,537,35,10,True,True,7.159080555555556,-0.45957143892333524
7665,6108162,11,4,0.576133,106,6130116,-1,2000.0,7178542,7178553,1070380,11,47,11,True,True,0.6534000000000001,-0.576133
7666,6108299,73,1,0.737291,106,6130116,-1,500.0,9023396,9023469,2915097,73,36,8,True,True,0.8095902777777777,-0.737291
7667,6109439,8251,8,0.287912,106,6130116,-1,4000.0,11634017,11642268,5524578,8251,21,7,True,True,1367.8029000000001,-0.28774353638295735
7668,6110021,745,2,0.880994,106,6130116,-1,1000.0,6138116,6138861,28095,745,64,7,True,True,17.09775,-0.880994
7669,6110292,24,16,0.456307,106,6130116,-1,8000.0,7038652,7038676,928360,24,53,8,True,True,5.473066666666667,-0.456307
7670,6110560,683,2,0.700317,106,6130116,-1,1000.0,6225261,6225944,114701,683,65,12,True,True,18.70091944444444,-0.700317
7671,6110618,475,1,0.711648,106,6130116,-1,500.0,6474574,6475049,363956,475,62,11,True,True,5.1563888888888885,-0.711648
7672,6111648,10744,4,0.297449,106,6130116,-1,2000.0,9392985,9403729,3281337,10744,35,12,True,True,655.5703055555556,-0.2944863715443352
7673,6111677,29494,4,0.613028,106,6130116,-1,2000.0,9120596,9150090,3008919,29494,38,12,True,True,1714.9157888888888,-0.6080152735827202
7674,6112290,396,7,0.809985,106,6130116,-1,3500.0,8251800,8252196,2139510,396,44,12,True,True,60.54125,-0.809985
7675,6112402,206,1,0.175126,106,6130116,-1,500.0,12109217,12109423,5996815,206,20,12,True,True,7.022025,-0.175126
7676,6112602,13650,14,0.249135,106,6130116,-1,7000.0,7867060,7880710,1754458,13650,46,9,True,True,4802.69338888889,-0.2481030039510441
7677,6112924,20785,193,0.899965,106,6130116,-1,96500.0,10894075,10914860,4781151,20785,26,12,True,True,63979.52680555555,-0.8924750813865573
7678,6116203,5,8,0.733244,106,6130116,-1,4000.0,6384874,6384879,268671,5,70,9,True,True,0.4658888888888889,-0.733244
7679,6116352,1695,8,0.457828,106,6130116,-1,4000.0,9663875,9665570,3547523,1695,35,12,True,True,363.72816666666665,-0.457828
7680,6116390,8,4,0.910833,106,6130116,-1,2000.0,6483274,6483282,366884,8,68,7,True,True,0.34328888888888887,-0.910833
7681,6116853,16547,64,0.183444,106,6130116,-1,32000.0,15655390,15671937,9538537,16547,0,12,True,True,8974.193244444445,-0.17977561823078847
7682,6117029,5,2,0.568615,106,6130116,-1,1000.0,12022817,12022822,5905788,5,22,12,True,True,0.29691666666666666,-0.568615
7683,6118255,11693,41,0.393551,106,6130116,-1,20500.0,12767017,12778710,6648762,11693,19,12,True,True,15247.022770833333,-0.3764262205838016
7684,6118441,9726,24,0.945687,106,6130116,-1,12000.0,6630352,6640078,511911,9726,68,9,True,True,5499.383199999999,-0.9288492628545287
7685,6118880,394,1,0.239695,106,6130116,-1,500.0,11445275,11445669,5326395,394,27,12,True,True,5.125283333333333,-0.239695
7686,6118914,18,1,0.87054,106,6130116,-1,500.0,6138861,6138879,19947,18,81,2,True,True,0.20655,-0.87054
7687,6118928,95,1,0.273776,106,6130116,-1,500.0,8132860,8132955,2013932,95,52,12,True,True,2.2098055555555556,-0.273776
7688,6119064,23817,2,0.628083,106,6130116,-1,1000.0,10067875,10091692,3948811,23817,34,8,True,True,793.1318694444444,-0.5885559398613683
7689,6119108,9,4,0.29189,106,6130116,-1,2000.0,12551017,12551026,6431909,9,20,7,True,True,0.23095,-0.29189
7690,6123749,14,4,0.916296,106,6130116,-1,2000.0,6619552,6619566,495803,14,73,1,True,True,0.8596777777777778,-0.916296
7691,6123915,18,4,0.698044,106,6130116,-1,2000.0,7869260,7869278,1745345,18,55,7,True,True,1.8223,-0.698044
7692,6124059,81,1,0.722409,106,6130116,-1,500.0,9419985,9420066,3295926,81,44,8,True,True,1.4180625,-0.722409
7693,6124598,92,2,0.217255,106,6130116,-1,1000.0,12543417,12543509,6418819,92,21,12,True,True,1.6997000000000002,-0.217255
7694,6124770,8,1,0.493488,106,6130116,-1,500.0,11070475,11070483,4945705,8,32,12,True,True,0.09996666666666666,-0.493488
7695,6125092,2,5,0.99239,106,6130116,-1,2500.0,6227461,6227463,102369,2,88,7,True,True,0.13690277777777776,-0.99239
7696,6125214,4,4,0.552824,106,6130116,-1,2000.0,10634875,10634879,4509661,4,34,12,True,True,0.15344444444444444,-0.552824
7697,6125511,10193,16,0.995316,106,6130116,-1,8000.0,6330874,6341067,205363,10193,87,1,True,True,2151.9648888888887,-0.9138804491940163
7698,6125774,15531,128,0.076534,106,6130116,-1,64000.0,8839796,8855327,2714022,15531,54,7,True,True,19817.137777777774,-0.07429903679119718
7699,6126004,10,16,0.105225,106,6130116,-1,8000.0,15215790,15215800,9089786,10,4,7,True,True,2.506888888888889,-0.105225
7700,6126999,20414,256,0.766539,106,6130116,-1,128000.0,11481803,11502217,5354804,20414,30,7,True,True,51537.02222222223,-0.7403539147280843
7701,6127255,15208,4,0.326013,106,6130116,-1,2000.0,11502217,11517425,5374962,15208,30,0,True,True,586.7606222222222,-0.32139540922429133
7702,6127551,151,16,0.450936,106,6130116,-1,8000.0,7063791,7063942,936240,151,74,7,True,True,33.471666666666664,-0.450936
7703,6128779,3,1,0.252767,106,6130116,-1,500.0,10897675,10897678,4768896,3,36,1,True,True,0.04449166666666667,-0.252767
7704,6128835,200,32,0.506065,106,6130116,-1,16000.0,11631817,11632017,5502982,200,29,11,True,True,118.96000000000001,-0.506065
7705,6128855,154,2,0.462167,106,6130116,-1,1000.0,9572285,9572439,3443430,154,51,6,True,True,6.238655555555556,-0.4545578302071547
7706,6129010,26,32,0.073195,106,6130116,-1,16000.0,10462075,10462101,4333065,26,40,12,True,True,14.184444444444443,-0.073195
7707,6130829,3,5,0.694486,105,6132316,-1,2500.0,7833560,7833563,1702731,3,69,10,True,True,0.3574791666666667,-0.694486
7708,6132809,32539,37,0.749736,112,6135916,-1,18500.0,7289842,7322381,1157033,32539,75,7,True,True,19492.708766666667,-0.7432279680978509
7709,6133298,352,1,0.381156,112,6135916,-1,500.0,12457017,12457369,6323719,352,23,12,True,True,3.4662222222222225,-0.381156
7710,6133568,34,106,0.745957,112,6135916,-1,53000.0,7292042,7292076,1158474,34,76,7,True,True,58.760216666666665,-0.7459570000000001
7711,6133731,53,4,0.855773,112,6135916,-1,2000.0,6695152,6695205,561421,53,90,11,True,True,3.359022222222222,-0.855773
7712,6133928,6435,4,0.396674,112,6135916,-1,2000.0,9801075,9807510,3667147,6435,48,10,True,True,572.12275,-0.388133171031563
7713,6134348,3,8,0.010737,112,6135916,-1,4000.0,15040790,15040793,8906442,3,7,12,True,True,0.6237666666666667,-0.010737
7714,6134461,109,4,0.114683,112,6135916,-1,2000.0,13676417,13676526,7541956,109,15,11,True,True,7.719622222222223,-0.114683
7715,6134542,144,8,0.917137,112,6135916,-1,4000.0,6374074,6374218,239532,144,104,11,True,True,15.0144,-0.917137
7716,6157938,30,8,0.32711,224,6225261,-1,4000.0,9414585,9414615,3256647,30,59,10,True,True,2.8506666666666667,-0.32711
7717,6158059,72,1,0.748676,224,6225261,-1,500.0,8559996,8560068,2401937,72,69,12,True,True,2.1039,-0.748676
7718,6158070,1194,32,0.484759,224,6225261,-1,16000.0,8160000,8161194,2001930,1194,72,1,True,True,586.7581333333333,-0.484759
7719,6158142,61,8,0.068237,224,6225261,-1,4000.0,14520190,14520251,8362048,61,9,12,True,True,3.0154333333333336,-0.068237
7720,6166540,36,1,0.548429,224,6225261,-1,500.0,9441585,9441621,3275045,36,59,10,True,True,0.8754500000000001,-0.548429
7721,6166801,8740,64,0.242294,224,6225261,-1,32000.0,8343996,8352736,2177195,8740,72,12,True,True,11010.031288888888,-0.21662298675519673
7722,6167111,15477,8,0.950018,224,6225261,-1,4000.0,6255561,6271038,88450,15477,114,6,True,True,1708.9291333333333,-0.9476065767288429
7723,6167127,12518,64,0.140256,224,6225261,-1,32000.0,10548475,10560993,4381348,12518,44,12,True,True,12833.801066666667,-0.13962114175104298
7724,6167151,6896,1,0.820427,224,6225261,-1,500.0,7809760,7816656,1642609,6896,81,8,True,True,190.8705111111111,-0.7911169336382712
7725,6167179,4606,42,0.841563,224,6225261,-1,21000.0,7056985,7061591,889806,4606,95,7,True,True,2613.491883333333,-0.8207751979601909
7726,6167293,35,32,0.170589,224,6225261,-1,16000.0,12985217,12985252,6817924,35,21,7,True,True,19.082,-0.170589
7727,6167321,2351,32,0.018066,224,6225261,-1,16000.0,9306585,9308936,3139264,2351,65,11,True,True,1201.7267111111112,-0.018066
7728,6167402,3,64,0.100515,224,6225261,-1,32000.0,13897817,13897820,7730415,3,14,12,True,True,4.8432,-0.100515
7729,6168363,50,16,0.294145,224,6225261,-1,8000.0,13681817,13681867,7513454,50,17,8,True,True,17.54222222222222,-0.294145
7730,6170285,6,15,0.534654,224,6225261,-1,7500.0,7038652,7038658,868367,6,101,0,True,True,1.28275,-0.534654
7731,6170812,28303,8,0.39085,224,6225261,-1,4000.0,12939817,12968120,6769005,28303,25,12,True,True,7402.617899999999,-0.38260696508434294
7732,6170820,852,1,0.077585,224,6225261,-1,500.0,6892452,6893304,721632,852,105,12,True,True,14.418916666666666,-0.077585
7733,6171254,11,32,0.763589,224,6225261,-1,16000.0,6309261,6309272,138007,11,122,11,True,True,3.2980444444444443,-0.763589
7734,6171266,6290,1,0.677383,224,6225261,-1,500.0,9571185,9577475,3399919,6290,63,12,True,True,123.40589583333332,-0.6574664865434949
7735,6171277,10237,3,0.153496,224,6225261,-1,1500.0,14259890,14270127,8088613,10237,13,12,True,True,306.02725416666664,-0.15131677918303152
7736,6171329,8,10,0.358087,224,6225261,-1,5000.0,6935652,6935660,764323,8,107,11,True,True,1.460888888888889,-0.358087
7737,6171796,29,4,0.216672,224,6225261,-1,2000.0,9577475,9577504,3405679,29,62,2,True,True,2.2856833333333335,-0.216672
7738,6171947,8514,128,0.034445,224,6225261,-1,64000.0,15309790,15318304,9137843,8514,4,8,True,True,6029.0208,-0.03356738055053255
7739,6180587,10886,2,0.675044,224,6225261,-1,1000.0,6528674,6539560,348087,10886,120,10,True,True,292.10050555555557,-0.6551135219711456
7740,6180626,47,1,0.216166,224,6225261,-1,500.0,11450675,11450722,5270049,47,43,8,True,True,0.5456569444444445,-0.216166
7741,6180674,58,1,0.696742,224,6225261,-1,500.0,8931596,8931654,2750922,58,79,8,True,True,0.5955972222222222,-0.6644455135498161
7742,6180804,34,2,0.836501,224,6225261,-1,1000.0,7706760,7706794,1525956,34,96,10,True,True,0.9643722222222222,-0.836501
7743,6180922,3,1,0.811512,224,6225261,-1,500.0,6743752,6743755,562830,3,117,8,True,True,0.051875000000000004,-0.811512
7744,6181531,14512,1,0.641012,224,6225261,-1,500.0,9034196,9048708,2852665,14512,77,9,True,True,182.21699444444442,-0.5966655778726607
7745,6181893,34,4,0.71641,224,6225261,-1,2000.0,6755652,6755686,573759,34,118,6,True,True,2.5252555555555554,-0.71641
7746,6181980,11445,16,0.89701,224,6225261,-1,8000.0,7598760,7610205,1416780,11445,98,12,True,True,2128.3463333333334,-0.8899112415948982
7747,6182070,10698,256,0.390618,224,6225261,-1,128000.0,14000690,14011388,7818620,10698,16,0,True,True,74908.1016888889,-0.35896939701711644
7748,6182223,59,2,0.308324,224,6225261,-1,1000.0,11186075,11186134,5003852,59,46,12,True,True,2.0323861111111112,-0.308324
7749,6182229,14021,8,0.052415,224,6225261,-1,4000.0,12284217,12298238,6101988,14021,35,12,True,True,1774.0820555555556,-0.051378798449117705
7750,6182245,6,7,0.004666,224,6225261,-1,3500.0,11272475,11272481,5090230,6,47,12,True,True,0.90895,-0.004666
7751,6182363,11,15,0.77241,224,6225261,-1,7500.0,6254461,6254472,72098,11,143,10,True,True,1.8292083333333333,-0.77241
7752,6182386,12,2,0.767114,224,6225261,-1,1000.0,7040852,7040864,858466,12,115,7,True,True,0.3420666666666667,-0.767114
7753,6182528,13,32,0.928821,224,6225261,-1,16000.0,8473596,8473609,2291068,13,89,12,True,True,9.607288888888888,-0.928821
7754,6182662,527,8,0.374645,224,6225261,-1,4000.0,12197817,12198344,6015155,527,36,12,True,True,106.14951111111112,-0.374645
7755,6182694,1989,2,0.23854,224,6225261,-1,1000.0,13374017,13376006,7191323,1989,23,12,True,True,90.427675,-0.23854
7756,6182782,38,2,0.091386,224,6225261,-1,1000.0,6429174,6429212,246392,38,140,10,True,True,1.0976722222222222,-0.091386
7757,6182850,21,4,0.421683,224,6225261,-1,2000.0,12551017,12551038,6368167,21,32,0,True,True,0.5388833333333334,-0.421683
7758,6182870,18,2,0.989291,224,6225261,-1,1000.0,6232861,6232879,49991,18,150,8,True,True,0.52835,-0.989291
7759,6182876,16473,21,0.337117,224,6225261,-1,10500.0,13984217,14000690,7801341,16473,17,12,True,True,7998.212075,-0.3092106211956524
7760,6183019,13368,6,0.192152,224,6225261,-1,3000.0,14692990,14706358,8509971,13368,10,12,True,True,1618.3733333333334,-0.1607077490156032
7761,6183053,24,4,0.668949,224,6225261,-1,2000.0,7804360,7804384,1621307,24,104,0,True,True,1.730666666666667,-0.668949
7762,6184878,28,1,0.220568,224,6225261,-1,500.0,10721275,10721303,4536397,28,59,12,True,True,0.08158888888888889,-0.220568
7763,6186030,10651,4,0.882286,224,6225261,-1,2000.0,7378442,7389093,1192412,10651,113,11,True,True,856.8355555555556,-0.880384196969366
7764,6186037,134,4,0.796924,224,6225261,-1,2000.0,7834660,7834794,1648623,134,103,6,True,True,11.540377777777778,-0.796924
7765,6186291,7,1,0.830451,224,6225261,-1,500.0,7856260,7856267,1669969,7,103,10,True,True,0.15913333333333335,-0.830451
7766,6186296,4,1,0.167883,224,6225261,-1,500.0,8046460,8046464,1860164,4,101,12,True,True,0.08183333333333334,-0.167883
7767,6186359,9079,16,0.167047,224,6225261,-1,8000.0,8646396,8655475,2460037,9079,94,12,True,True,2127.4192666666668,-0.16259262107934877
7768,6186610,2,64,0.41568,224,6225261,-1,32000.0,15304390,15304392,9117780,2,5,12,True,True,0.8142222222222222,-0.41568
7769,6186646,12762,5,0.107684,224,6225261,-1,2500.0,12637417,12650179,6450771,12762,35,12,True,True,873.0877708333334,-0.10123835883946188
7770,6186691,94,4,0.327141,224,6225261,-1,2000.0,7960060,7960154,1773369,94,105,7,True,True,9.332633333333334,-0.327141
7771,6186720,10727,1,0.562054,224,6225261,-1,500.0,7054785,7065512,868065,10727,130,6,True,True,147.11202083333333,-0.5331976256386247
7772,6186760,4,16,0.189548,224,6225261,-1,8000.0,8165400,8165404,1978640,4,102,8,True,True,1.1484444444444444,-0.189548
7773,6187354,35732,16,0.207119,224,6225261,-1,8000.0,12548817,12584549,6361463,35732,38,8,True,True,4056.291177777778,-0.19326442515400138
7774,6187374,16088,32,0.541703,224,6225261,-1,16000.0,7467042,7483130,1279668,16088,121,12,True,True,10888.248444444445,-0.5368091815749196
7775,6187428,7,4,0.938923,224,6225261,-1,2000.0,6738352,6738359,550924,7,146,11,True,True,0.42443333333333333,-0.938923
7776,6187452,40,4,0.120804,224,6225261,-1,2000.0,7957860,7957900,1770408,40,108,12,True,True,4.082666666666666,-0.120804
7777,6187476,230,32,0.21378,224,6225261,-1,16000.0,14694090,14694320,8506614,230,11,6,True,True,78.82355555555554,-0.21378
7778,6187562,4,1,0.356576,224,6225261,-1,500.0,11083475,11083479,4895913,4,58,8,True,True,0.032100000000000004,-0.356576
7779,6187628,5482,64,0.173622,224,6225261,-1,32000.0,14954390,14959872,8766762,5482,10,12,True,True,1561.123022222222,-0.13577244784885115
7780,6187688,7780,16,0.402139,224,6225261,-1,8000.0,14606590,14614370,8418902,7780,14,12,True,True,2361.3920000000003,-0.36184284460192034
7781,6196956,48,8,0.31624,224,6225261,-1,4000.0,9148885,9148933,2951929,48,92,8,True,True,5.107733333333333,-0.31624
7782,6197065,8715,64,0.389187,224,6225261,-1,32000.0,14695190,14703905,8498125,8715,12,6,True,True,11424.587555555558,-0.3417441471104617
7783,6197309,20587,32,0.458776,224,6225261,-1,16000.0,11088875,11109462,4891566,20587,61,8,True,True,7448.297644444445,-0.4578064005300699
7784,6197333,132,8,0.066016,224,6225261,-1,4000.0,13460417,13460549,7263084,132,30,12,True,True,33.479600000000005,-0.066016
7785,6197371,40,8,0.815085,224,6225261,-1,4000.0,8159960,8160000,1962589,40,113,7,True,True,4.9142222222222225,-0.815085
7786,6197433,8,4,0.649945,224,6225261,-1,2000.0,9121885,9121893,2924452,8,97,1,True,True,0.4679111111111111,-0.649945
7787,6198518,5,2,0.36898,224,6225261,-1,1000.0,7109342,7109347,910824,5,140,7,True,True,0.16397222222222224,-0.36898
7788,6198545,6037,1,0.067331,224,6225261,-1,500.0,11763617,11769654,5565072,6037,53,12,True,True,166.692475,-0.06533031097825752
7789,6198567,13942,3,0.218561,224,6225261,-1,1500.0,14173490,14187432,7974923,13942,21,12,True,True,479.51170833333333,-0.2183321552412231
7790,6199325,12,4,0.301534,224,6225261,-1,2000.0,10984075,10984087,4784750,12,69,12,True,True,0.8205333333333333,-0.301534
7791,6199601,9528,16,0.598869,224,6225261,-1,8000.0,11472275,11481803,5272674,9528,60,10,True,True,1836.2169555555552,-0.4824458712123667
7792,6199623,16060,128,0.983102,224,6225261,-1,64000.0,6754552,6770612,554929,16060,161,9,True,True,40456.93866666667,-0.9754999086025197
7793,6200106,14,3,0.101814,224,6225261,-1,1500.0,7063942,7063956,863836,14,146,1,True,True,0.5818749999999999,-0.101814
7794,6200395,17,19,0.536182,224,6225261,-1,9500.0,9414585,9414602,3214190,17,95,0,True,True,3.836522222222222,-0.536182
7795,6201790,98,3,0.990531,224,6225261,-1,1500.0,7060597,7060695,858807,98,150,1,True,True,3.7048083333333333,-0.990531
7796,6201992,13,32,0.850465,224,6225261,-1,16000.0,6330861,6330874,128869,13,182,10,True,True,5.079822222222222,-0.850465
7797,6202188,15248,8,0.171459,224,6225261,-1,4000.0,9976075,9991323,3773887,15248,82,12,True,True,2413.455377777778,-0.1680346638570936
7798,6202259,119,4,0.959035,224,6225261,-1,2000.0,7111542,7111661,909283,119,146,7,True,True,7.641122222222221,-0.959035
7799,6202348,13269,32,0.599867,224,6225261,-1,16000.0,8387196,8400465,2184848,13269,115,11,True,True,9544.942666666666,-0.5515693448819463
7800,6202504,4977,8,0.981416,224,6225261,-1,4000.0,6651952,6656929,449448,4977,171,10,True,True,815.4541333333333,-0.9650590548320457
7801,6202738,9543,16,0.696315,224,6225261,-1,8000.0,6407574,6417117,204836,9543,183,6,True,True,2415.2928,-0.6750155271737224
7802,6202784,3,4,0.677901,224,6225261,-1,2000.0,7113742,7113745,910958,3,147,7,True,True,0.2086666666666667,-0.677901
7803,6202795,12009,1,0.972367,224,6225261,-1,500.0,6262461,6274470,59666,12009,191,6,True,True,172.92384166666665,-0.9699760498149431
7804,6202868,670,1,0.693721,224,6225261,-1,500.0,6261361,6262031,58493,670,192,1,True,True,9.188305555555555,-0.693721
7805,6203049,269,8,0.332047,224,6225261,-1,4000.0,13201217,13201486,6998168,269,34,12,True,True,58.262411111111106,-0.332047
7806,6203171,1197,3,0.635353,224,6225261,-1,1500.0,8837596,8838793,2634425,1197,111,12,True,True,43.0086125,-0.6097748763162775
7807,6204006,19249,128,0.883967,224,6225261,-1,64000.0,7335242,7354491,1131236,19249,144,11,True,True,38423.75128888889,-0.8699737300504323
7808,6204286,8237,4,0.317967,224,6225261,-1,2000.0,6530946,6539183,326660,8237,180,1,True,True,443.43792222222226,-0.3026858676814319
7809,6204343,16776,1,0.851554,224,6225261,-1,500.0,9155385,9172161,2951042,16776,101,8,True,True,222.539525,-0.8430253300816448
7810,6206461,119,16,0.48213,224,6225261,-1,8000.0,7871460,7871579,1664999,119,129,7,True,True,48.33251111111111,-0.48213
7811,6207230,21,4,0.335105,224,6225261,-1,2000.0,13633217,13633238,7425987,21,30,12,True,True,2.1154,-0.335105
7812,6207482,681,8,0.608533,224,6225261,-1,4000.0,10807675,10808356,4600193,681,75,12,True,True,134.61856666666668,-0.608533
7813,6207629,10100,64,0.585037,224,6225261,-1,32000.0,10283875,10293975,4076246,10100,81,12,True,True,7807.035555555555,-0.5362398045172534
7814,6207858,109,32,0.382371,224,6225261,-1,16000.0,12853417,12853526,6645559,109,42,12,True,True,114.97804444444445,-0.382371
7815,6207901,27,32,0.640592,224,6225261,-1,16000.0,8257596,8257623,2049695,27,124,8,True,True,18.6036,-0.640592
7816,6208349,196,1,0.232425,224,6225261,-1,500.0,7264942,7265138,1056593,196,156,12,True,True,1.865811111111111,-0.232425
7817,6210331,11382,10,0.587469,224,6225261,-1,5000.0,7685160,7696542,1474829,11382,146,12,True,True,2890.2775833333335,-0.5783410599454392
7818,6210539,12,2,0.988381,224,6225261,-1,1000.0,7060585,7060597,850046,12,167,2,True,True,0.3024333333333334,-0.988381
7819,6210662,20824,32,0.232606,224,6225261,-1,16000.0,12680617,12701441,6469955,20824,44,11,True,True,22439.558666666664,-0.21802218787086272
7820,6210840,189,3,0.616349,224,6225261,-1,1500.0,9121696,9121885,2910856,189,111,6,True,True,8.2908,-0.616349
7821,6210850,9410,4,0.896779,224,6225261,-1,2000.0,7811960,7821370,1601110,9410,142,7,True,True,1050.2908333333332,-0.8966405097728996
7822,6211134,23,4,0.308849,224,6225261,-1,2000.0,6504874,6504897,293740,23,196,10,True,True,1.741738888888889,-0.308849
7823,6211443,21,5,0.737913,224,6225261,-1,2500.0,8751196,8751217,2539753,21,119,9,True,True,0.8048541666666666,-0.737913
7824,6212544,5,2,0.757246,224,6225261,-1,1000.0,8155560,8155565,1943016,5,133,10,True,True,0.16504166666666667,-0.757246
7825,6214784,7,16,0.619766,224,6225261,-1,8000.0,7798560,7798567,1583776,7,149,8,True,True,2.418266666666667,-0.619766
7826,6214847,161,4,0.059923,224,6225261,-1,2000.0,14781590,14781751,8566743,161,12,12,True,True,15.598555555555555,-0.05930873443503642
7827,6219088,11,1,0.374524,224,6225261,-1,500.0,9779475,9779486,3560387,11,92,10,True,True,0.2132777777777778,-0.374524
7828,6223783,10,4,0.296615,224,6225261,-1,2000.0,10370275,10370285,4146492,10,84,12,True,True,0.4561111111111111,-0.296615
7829,6224187,10232,4,0.151671,224,6225261,-1,2000.0,7512360,7522592,1288173,10232,157,6,True,True,462.2218666666667,-0.14796823436391032
7830,6225090,18531,100,0.204385,224,6225261,-1,50000.0,11358875,11377406,5133785,18531,68,12,True,True,25457.95611111111,-0.19692252692100967
7831,6225413,11946,113,0.037907,226,6227461,-1,56500.0,9887475,9899421,3662062,11946,93,12,True,True,27926.612833333336,-0.03765898079170583
7832,6226281,9339,64,0.923409,226,6227461,-1,32000.0,6406474,6415813,180193,9339,212,10,True,True,9618.047644444445,-0.9098680873403144
7833,6226847,91,1,0.598075,226,6227461,-1,500.0,7042485,7042576,815638,91,183,2,True,True,1.3011736111111112,-0.598075
7834,6232781,8,8,0.945876,226,6232861,-1,4000.0,6507074,6507082,274293,8,206,7,True,True,0.9417777777777778,-0.945876
7835,6234484,38,64,0.739256,245,6254461,-1,32000.0,8133960,8133998,1899476,38,139,6,True,True,56.57102222222222,-0.739256
7836,6234645,5418,32,0.32869,245,6254461,-1,16000.0,6943252,6948670,708607,5418,188,7,True,True,2935.131733333333,-0.3047437341710949
7837,6234774,319,4,0.278126,245,6254461,-1,2000.0,11186075,11186394,4951301,319,70,0,True,True,21.97732777777778,-0.278126
7838,6235408,28813,1,0.643602,245,6254461,-1,500.0,7511260,7540073,1275852,28813,162,1,True,True,359.87403333333333,-0.6404882045035248
7839,6237416,7,8,0.760494,245,6254461,-1,4000.0,7053685,7053692,816269,7,185,1,True,True,0.8568777777777777,-0.760494
7840,6237461,1018,1,0.520873,245,6254461,-1,500.0,7510242,7511260,1272781,1018,163,10,True,True,12.227311111111112,-0.520873
7841,6237706,12201,1,0.977568,245,6254461,-1,500.0,7044685,7056886,806979,12201,188,7,True,True,182.5862152777778,-0.9771070291994789
7842,6237799,10444,14,0.648046,245,6254461,-1,7000.0,6946852,6957296,709053,10444,193,2,True,True,2632.8617777777777,-0.6418560880779807
7843,6237848,14170,2,0.288455,245,6254461,-1,1000.0,8734996,8749166,2497148,14170,127,12,True,True,236.7189277777778,-0.2856404006943879
7844,6239963,212,2,0.023693,245,6254461,-1,1000.0,8926196,8926408,2686233,212,123,12,True,True,5.075633333333333,-0.023693
7845,6240057,14,1,0.846935,245,6254461,-1,500.0,6481074,6481088,241017,14,219,8,True,True,0.15018888888888887,-0.846935
7846,6240278,19618,2,0.33127,245,6254461,-1,1000.0,11936417,11956035,5696139,19618,58,12,True,True,471.57254166666667,-0.2986524687561661
7847,6241516,23,1,0.242249,245,6254461,-1,500.0,8157760,8157783,1916244,23,142,7,True,True,0.35320972222222224,-0.242249
7848,6242557,54,4,0.539312,245,6254461,-1,2000.0,7135342,7135396,892785,54,179,10,True,True,3.0629999999999997,-0.539312
7849,6242604,9233,64,0.906632,245,6254461,-1,32000.0,7033252,7042485,790648,9233,198,12,True,True,8423.500711111112,-0.9031413713731746
7850,6242942,14832,119,0.665006,245,6254461,-1,59500.0,11677217,11692049,5434275,14832,61,11,True,True,39725.28176944445,-0.6618502565403876
7851,6244121,9,64,0.248338,245,6254461,-1,32000.0,15217990,15217999,8973869,9,6,7,True,True,10.34,-0.248338
7852,6244172,10,8,0.68735,245,6254461,-1,4000.0,9263385,9263395,3019213,10,115,10,True,True,1.639,-0.68735
7853,6244213,24,1,0.719502,245,6254461,-1,500.0,9241785,9241809,2997572,24,116,12,True,True,0.4011333333333334,-0.719502
7854,6244275,3,8,0.608063,245,6254461,-1,4000.0,11099675,11099678,4855400,3,75,9,True,True,0.2813,-0.608063
4420,3599033,10,8,0.121962,1,3599033,-1,4000.0,3685433,3685443,86400,10,0,12,True,True,1.3423333333333334,-0.121962
4421,3601659,10,1,0.768146,188,3685433,-1,500.0,3743980,3743990,142321,10,0,11,True,True,0.13512500000000002,-0.768146
4422,3601907,6031,4,0.248962,188,3685433,-1,2000.0,6424857,6430888,2822950,6031,0,1,True,True,297.4925944444444,-0.2438455824937176
4423,3601977,9968,128,0.771225,188,3685433,-1,64000.0,4799749,4809717,1197772,9968,1,7,True,True,13181.579022222222,-0.733461474520091
4424,3602335,9031,2,0.442961,188,3685433,-1,1000.0,9388969,9398000,5786634,9031,0,8,True,True,355.4482333333333,-0.44153987166033243
4425,3602647,10350,1,0.737619,188,3685433,-1,500.0,5764097,5774447,2161450,10350,2,7,True,True,219.12541805555554,-0.7270138025811488
4426,3602663,886,8,0.03351,188,3685433,-1,4000.0,11566269,11567155,7963606,886,0,0,True,True,144.84598888888888,-0.03281739569510453
4427,3604547,6,6,0.460835,188,3685433,-1,3000.0,7425874,7425880,3821327,6,2,12,True,True,0.57125,-0.460835
4428,3604641,1145,32,0.770996,188,3685433,-1,16000.0,4154099,4155244,549458,1145,6,1,True,True,196.57346666666666,-0.7223384255937775
4429,3604922,15,1,0.521139,188,3685433,-1,500.0,7490674,7490689,3885752,15,2,11,True,True,0.4320833333333333,-0.521139
4430,3604995,7,4,0.982116,188,3685433,-1,2000.0,4686949,4686956,1081954,7,7,11,True,True,0.22477777777777777,-0.982116
4431,3605014,40369,50,0.472826,188,3685433,-1,25000.0,7339474,7379843,3734460,40369,4,11,True,True,23473.581041666668,-0.46204623911412795
4432,3605223,9932,1,0.681442,188,3685433,-1,500.0,5226349,5236281,1621126,9932,7,8,True,True,88.66274166666666,-0.6640694285304559
4433,3605492,4812,256,0.312109,188,3685433,-1,128000.0,8046591,8051403,4441099,4812,2,7,True,True,28304.501333333334,-0.3116601281022793
4434,3605570,579,4,0.323063,188,3685433,-1,2000.0,9124369,9124948,5518799,579,2,11,True,True,68.27696666666667,-0.323063
4435,3605841,241,2,0.629164,188,3685433,-1,1000.0,4202699,4202940,596858,241,12,11,True,True,5.5671,-0.629164
4436,3605933,11431,2,0.042186,188,3685433,-1,1000.0,9383569,9395000,5777636,11431,2,11,True,True,459.07688055555553,-0.04141188455645079
4437,3606018,184,16,0.937421,188,3685433,-1,8000.0,4061889,4062073,455871,184,15,1,True,True,38.13297777777778,-0.937421
4438,3606157,43,1,0.520926,188,3685433,-1,500.0,8735526,8735569,5129369,43,4,12,True,True,0.9139888888888889,-0.520926
4439,3607787,11,8,0.253313,188,3685433,-1,4000.0,9950569,9950580,6342782,11,1,11,True,True,2.3513111111111114,-0.253313
4440,3607835,3669,32,0.63852,188,3685433,-1,16000.0,4492396,4496065,884561,3669,15,12,True,True,1856.2392444444445,-0.6346511932943903
4441,3607893,10395,32,0.198724,188,3685433,-1,16000.0,6884774,6895169,3276881,10395,10,6,True,True,6254.772355555556,-0.1975546849730653
4442,3607918,131,4,0.88752,188,3685433,-1,2000.0,4546396,4546527,938478,131,16,11,True,True,6.741405555555555,-0.88752
4443,3608069,9617,128,0.863658,188,3685433,-1,64000.0,7296274,7305891,3688205,9617,10,12,True,True,12593.47751111111,-0.8611926011235045
4444,3608142,45,4,0.217788,188,3685433,-1,2000.0,11697855,11697900,8089713,45,0,12,True,True,3.35175,-0.217788
4445,3609215,18897,5,0.112928,188,3685433,-1,2500.0,11786455,11805352,8177240,18897,0,7,True,True,1860.6600833333332,-0.1122607643130754
4446,3609235,6,16,0.632909,188,3685433,-1,8000.0,8332791,8332797,4723556,6,8,12,True,True,1.5158666666666667,-0.632909
4447,3609295,102,1,0.324513,188,3685433,-1,500.0,7122374,7122476,3513079,102,14,11,True,True,1.7235166666666666,-0.324513
4448,3609324,52,1,0.16736,188,3685433,-1,500.0,7509691,7509743,3900367,52,10,1,True,True,0.91065,-0.16736
4449,3612264,97,32,0.2761,188,3685433,-1,16000.0,9475369,9475466,5863105,97,4,12,True,True,40.373555555555555,-0.2761
4450,3612998,3,8,0.11965,188,3685433,-1,4000.0,11376169,11376172,7763171,3,3,11,True,True,0.4564666666666667,-0.11965
4451,3613280,117,16,0.789144,188,3685433,-1,8000.0,3700780,3700897,87500,117,30,7,True,True,26.64928888888889,-0.7160508291203603
4452,3613362,13488,8,0.00893,188,3685433,-1,4000.0,12177877,12191365,8564515,13488,0,12,True,True,2340.0933999999997,-0.007768566632832049
4453,3614472,25974,8,0.041993,188,3685433,-1,4000.0,7912591,7938565,4298119,25974,13,12,True,True,4110.478988888889,-0.04081692428518587
4454,3614510,5239,4,0.783475,188,3685433,-1,2000.0,5583849,5589088,1969339,5239,23,6,True,True,406.41566111111115,-0.7556747764551666
4455,3614555,18,32,0.475271,188,3685433,-1,16000.0,8246391,8246409,4631836,18,12,11,True,True,11.203199999999999,-0.475271
4456,3614578,139,1,0.596212,188,3685433,-1,500.0,9993769,9993908,6379191,139,5,11,True,True,4.874459722222222,-0.596212
4457,3614804,416,16,0.371399,188,3685433,-1,8000.0,8908369,8908785,5293565,416,11,12,True,True,96.22542222222222,-0.371399
4458,3615033,9,8,0.08948,188,3685433,-1,4000.0,11811655,11811664,8196622,9,1,10,True,True,1.4447999999999999,-0.08948
4459,3615173,17,14,0.157698,188,3685433,-1,7000.0,7209874,7209891,3594701,17,23,6,True,True,2.484786111111111,-0.157698
4460,3615213,396,1,0.091402,188,3685433,-1,500.0,7804591,7804987,4189378,396,18,8,True,True,11.177298611111112,-0.07687391674368986
4461,3615711,16582,256,0.618645,188,3685433,-1,128000.0,11478769,11495351,7863058,16582,5,8,True,True,86492.84479999999,-0.5728405335010448
4462,3615813,15389,16,0.930849,188,3685433,-1,8000.0,4691349,4706738,1075536,15389,33,7,True,True,2854.799911111111,-0.8907617256805528
4463,3615840,28,1,0.996973,188,3685433,-1,500.0,4061861,4061889,446021,28,40,6,True,True,0.36267777777777777,-0.996973
4464,3615880,7607,32,0.625132,188,3685433,-1,16000.0,4270811,4278418,654931,7607,37,10,True,True,1443.806888888889,-0.5785271586649957
4465,3615923,14759,32,0.059775,188,3685433,-1,16000.0,12523477,12538236,8907554,14759,0,12,True,True,10576.328488888888,-0.05646009418082598
4466,3615992,10,32,0.644575,188,3685433,-1,16000.0,4405996,4406006,790004,10,38,11,True,True,4.966222222222222,-0.644575
4467,3627860,12820,256,0.701328,188,3685433,-1,128000.0,8548806,8561626,4920946,12820,16,7,True,True,49930.77404444444,-0.6537397843959579
4468,3628129,6,4,0.791466,188,3685433,-1,2000.0,6428457,6428463,2800328,6,30,1,True,True,0.3091333333333333,-0.791466
4469,3628218,19,32,0.125827,188,3685433,-1,16000.0,11473369,11473388,7845151,19,7,12,True,True,19.842755555555556,-0.125827
4470,3628580,26,4,0.232675,188,3685433,-1,2000.0,11566269,11566295,7937689,26,6,6,True,True,2.1701333333333332,-0.232675
4471,3628688,27,16,0.981676,188,3685433,-1,8000.0,3970761,3970788,342073,27,48,6,True,True,5.7425999999999995,-0.981676
4472,3628874,34,4,0.788562,188,3685433,-1,2000.0,3897495,3897529,268621,34,49,0,True,True,1.594411111111111,-0.788562
4473,3628952,22,8,0.756698,188,3685433,-1,4000.0,4589727,4589749,960775,22,40,11,True,True,0.9868222222222222,-0.756698
4474,3628991,27,1,0.805525,188,3685433,-1,500.0,4739949,4739976,1110958,27,38,8,True,True,0.2953125,-0.805525
4475,3641283,24,10,0.438719,188,3685433,-1,5000.0,9340369,9340393,5699086,24,15,12,True,True,2.7430000000000003,-0.438719
4476,3641363,6696,4,0.192965,188,3685433,-1,2000.0,11568255,11574951,7926892,6696,5,6,True,True,524.7065333333334,-0.19181177969637977
4477,3643034,67,1,0.68925,188,3685433,-1,500.0,7998991,7999058,4355957,67,24,12,True,True,1.9791055555555555,-0.68925
4478,3643821,17,8,0.358167,188,3685433,-1,4000.0,7607991,7608008,3964170,17,27,9,True,True,1.3188222222222221,-0.358167
4479,3659990,2,4,0.134732,188,3685433,-1,2000.0,4929349,4929351,1269359,2,41,11,True,True,0.11844444444444444,-0.134732
4480,3660044,204,25,0.898663,188,3685433,-1,12500.0,6514857,6515061,2854813,204,36,12,True,True,104.63499999999999,-0.898663
4481,3660260,7004,128,0.485302,188,3685433,-1,64000.0,11818155,11825159,8157895,7004,2,6,True,True,16224.967822222221,-0.4802181787896091
4482,3660679,5,16,0.4375,188,3685433,-1,8000.0,4546527,4546532,885848,5,49,1,True,True,1.0292222222222223,-0.4375
4483,3660746,5,1,0.294715,188,3685433,-1,500.0,11867877,11867882,8207131,5,2,8,True,True,0.1259861111111111,-0.294715
4484,3660784,140,34,0.697038,188,3685433,-1,17000.0,3698440,3698580,37656,140,63,1,True,True,74.67911111111111,-0.697038
4485,3660860,9450,32,0.189776,188,3685433,-1,16000.0,7501474,7510924,3840614,9450,31,9,True,True,5270.103466666667,-0.1768917989320995
4486,3661028,773,1,0.186627,188,3685433,-1,500.0,5474749,5475522,1813721,773,44,8,True,True,10.777981944444445,-0.186627
4487,3661037,3,2,0.347665,188,3685433,-1,1000.0,4589749,4589752,928712,3,51,1,True,True,0.03364166666666667,-0.347665
4488,3661057,9,16,0.732402,188,3685433,-1,8000.0,5675488,5675497,2014431,9,43,12,True,True,1.7722,-0.732402
4489,3661097,2714,1,0.275324,188,3685433,-1,500.0,8735569,8738283,5074472,2714,21,1,True,True,55.76976527777777,-0.2661709062302456
4490,3661187,11,16,0.83135,188,3685433,-1,8000.0,4358096,4358107,696909,11,59,8,True,True,1.8822222222222222,-0.83135
4491,3661202,4,6,0.914474,188,3685433,-1,3000.0,3847695,3847699,186493,4,67,9,True,True,0.2302,-0.914474
4492,3661241,8,1,0.55452,188,3685433,-1,500.0,6992774,6992782,3331533,8,39,11,True,True,0.13871111111111112,-0.55452
4493,3661274,20842,1,0.068877,188,3685433,-1,500.0,12264277,12285119,8603003,20842,1,12,True,True,409.12966944444446,-0.06542449779387043
4494,3661337,35594,16,0.155025,188,3685433,-1,8000.0,10728169,10763763,7066832,35594,14,12,True,True,10048.0326,-0.1545889921471144
4495,3661440,101,8,0.295673,188,3685433,-1,4000.0,8562726,8562827,4901286,101,25,6,True,True,12.36127777777778,-0.295673
4496,3661501,63,1,0.263349,188,3685433,-1,500.0,6627557,6627620,2966056,63,44,3,True,True,1.0363763888888888,-0.2592407728319719
4497,3662111,8148,64,0.367113,188,3685433,-1,32000.0,11116969,11125117,7454858,8148,14,12,True,True,8090.3636444444455,-0.36463182028680163
4498,3662159,5579,4,0.00072,188,3685433,-1,2000.0,11913277,11918856,8251118,5579,3,11,True,True,391.34585,-0.0007194756697662252
4499,3662220,11570,1,0.638026,188,3685433,-1,500.0,4292411,4303981,630191,11570,67,10,True,True,104.32046944444446,-0.6106733546953922
4500,3663788,609,1,0.379044,188,3685433,-1,500.0,5947697,5948306,2283909,609,50,8,True,True,8.003275,-0.379044
4501,3663875,76,8,0.185534,188,3685433,-1,4000.0,7826191,7826267,4162316,76,34,10,True,True,22.183555555555554,-0.185534
4502,3663967,14665,10,0.01872,188,3685433,-1,5000.0,11817055,11831720,8153088,14665,6,8,True,True,2684.5168055555555,-0.01863206736052935
4503,3664153,27,2,0.856829,188,3685433,-1,1000.0,4060761,4060788,396608,27,76,1,True,True,0.75,-0.856829
4504,3664169,5448,2,0.776017,188,3685433,-1,1000.0,4766949,4772397,1102780,5448,60,8,True,True,123.07814166666668,-0.7730157196877665
4505,3664201,8450,4,0.238787,188,3685433,-1,2000.0,6338449,6346899,2674248,8450,52,10,True,True,463.9073333333333,-0.23225740525539046
4506,3664343,84,16,0.721004,188,3685433,-1,8000.0,6873874,6873958,3209531,84,48,6,True,True,25.181333333333335,-0.721004
4507,3664361,91,1,0.658289,188,3685433,-1,500.0,6949574,6949665,3285213,91,47,10,True,True,1.8486902777777778,-0.658289
4508,3664393,22,2,0.538957,188,3685433,-1,1000.0,7502574,7502596,3838181,22,39,6,True,True,0.7267333333333333,-0.538957
4509,3664433,6,13,0.387491,188,3685433,-1,6500.0,4950949,4950955,1286516,6,62,10,True,True,0.8068666666666667,-0.387491
4510,3664610,111,4,0.52407,188,3685433,-1,2000.0,7596091,7596202,3931481,111,38,12,True,True,6.1740666666666675,-0.52407
4511,3664644,4,32,0.497549,188,3685433,-1,16000.0,8154591,8154595,4489947,4,32,10,True,True,2.556977777777778,-0.497549
4512,3664668,188,32,0.551468,188,3685433,-1,16000.0,4497796,4497984,833128,188,75,8,True,True,95.22826666666667,-0.551468
4513,3664712,4,8,0.613039,188,3685433,-1,4000.0,6074849,6074853,2410137,4,58,7,True,True,0.24457777777777778,-0.613039
4514,3664784,6124,1,0.3226,188,3685433,-1,500.0,7507974,7514098,3843190,6124,41,8,True,True,105.41606944444445,-0.3173324439112226
4515,3664816,16150,121,0.640904,188,3685433,-1,60500.0,4770549,4786699,1105733,16150,69,1,True,True,25850.414455555554,-0.6265845065021187
4516,3665011,232,32,0.110464,188,3685433,-1,16000.0,11870077,11870309,8205066,232,4,7,True,True,229.92746666666667,-0.110464
4517,3665100,33,4,0.523201,188,3685433,-1,2000.0,8649126,8649159,4984026,33,29,12,True,True,1.5445833333333334,-0.523201
4518,3665246,165,101,0.06668,188,3685433,-1,50500.0,10814569,10814734,7149323,165,18,12,True,True,272.31072916666665,-0.06667999999999999
4519,3665281,7,64,0.835193,188,3685433,-1,32000.0,4761549,4761556,1096268,7,74,10,True,True,4.231111111111111,-0.835193
4520,3665449,6317,8,0.129774,188,3685433,-1,4000.0,11790055,11796372,8124606,6317,9,2,True,True,987.6780000000001,-0.1297337040559442
4521,3665460,328,4,0.873493,188,3685433,-1,2000.0,5769497,5769825,2104037,328,65,8,True,True,27.06546666666667,-0.873493
4522,3665924,9014,74,0.202079,188,3685433,-1,37000.0,6293049,6302063,2627125,9014,63,11,True,True,12140.918430555555,-0.20072353842178312
4523,3665959,15066,4,0.48537,188,3685433,-1,2000.0,3897661,3912727,231702,15066,97,1,True,True,722.9103666666666,-0.48427389579773056
4524,3665973,7608,3,0.098754,188,3685433,-1,1500.0,11203369,11210977,7537396,7608,18,12,True,True,437.57036250000004,-0.09734396580360237
4525,3666177,10056,113,0.571012,188,3685433,-1,56500.0,5382949,5393005,1716772,10056,72,11,True,True,25283.24950416667,-0.5684707162166471
4526,3666436,7,1,0.8363,188,3685433,-1,500.0,3698433,3698440,31997,7,105,9,True,True,0.10982222222222221,-0.8363
4527,3667058,8,8,0.657921,188,3685433,-1,4000.0,6424849,6424857,2757791,8,63,12,True,True,0.6909333333333334,-0.657921
4528,3667074,37,8,0.525821,188,3685433,-1,4000.0,9081169,9081206,5414095,37,29,12,True,True,6.248888888888889,-0.525821
4529,3668186,12,8,0.701314,188,3685433,-1,4000.0,4248099,4248111,579913,12,95,7,True,True,0.6285333333333334,-0.701314
4530,3668196,39839,1,0.255939,188,3685433,-1,500.0,11862477,11902316,8194281,39839,6,1,True,True,982.6507944444446,-0.2553533967588518
4531,3668426,38,4,0.366354,188,3685433,-1,2000.0,5004949,5004987,1336523,38,77,9,True,True,1.2818666666666667,-0.366354
4532,3668615,13,64,0.605954,188,3685433,-1,32000.0,8044391,8044404,4375776,13,41,11,True,True,19.188,-0.605954
4533,3668830,23991,4,0.070874,188,3685433,-1,2000.0,12525677,12549668,8856847,23991,0,7,True,True,2223.2745333333337,-0.07025130263217605
4534,3668847,12081,256,0.930211,188,3685433,-1,128000.0,4328315,4340396,659468,12081,97,6,True,True,20310.24853333333,-0.9207212289703598
4535,3668865,5,1,0.208738,188,3685433,-1,500.0,5339749,5339754,1670884,5,78,10,True,True,0.06392361111111111,-0.208738
4536,3669374,4541,184,0.491406,188,3685433,-1,92000.0,10296169,10300710,6626795,4541,24,12,True,True,7913.142077777777,-0.48347478529267623
4537,3669407,7819,4,0.889767,188,3685433,-1,2000.0,3893095,3900914,223688,7819,111,6,True,True,365.33334444444444,-0.8884018657390673
4538,3669434,2,4,0.079957,188,3685433,-1,2000.0,11565169,11565171,7895735,2,17,12,True,True,0.16693333333333335,-0.079957
4539,3669546,5723,2,0.80102,188,3685433,-1,1000.0,3922861,3928584,253315,5723,110,1,True,True,150.26300833333332,-0.729003444188791
4540,3669588,33704,64,0.0607,188,3685433,-1,32000.0,4294611,4328315,625023,33704,101,7,True,True,19014.258133333333,-0.05999733218366907
4541,3669597,10,1,0.55802,188,3685433,-1,500.0,4154089,4154099,484492,10,107,6,True,True,0.057263888888888885,-0.55802
4542,3670045,612,43,0.938244,188,3685433,-1,21500.0,3698580,3699192,28535,612,119,1,True,True,412.8688,-0.9382440000000002
4543,3670118,3,16,0.415953,188,3685433,-1,8000.0,5496349,5496352,1826231,3,78,10,True,True,0.6418,-0.415953
4544,3670126,12,8,0.369069,188,3685433,-1,4000.0,4066589,4066601,396463,12,109,2,True,True,1.3016,-0.369069
4545,3670158,26577,128,0.708434,188,3685433,-1,64000.0,4057161,4083738,387003,26577,113,11,True,True,44583.806399999994,-0.6908354574250376
4546,3670351,9,2,0.823643,188,3685433,-1,1000.0,4643749,4643758,973398,9,93,11,True,True,0.1942,-0.823643
4547,3670440,3747,1,0.265816,188,3685433,-1,500.0,4062989,4066736,392549,3747,111,6,True,True,49.948636111111114,-0.26180406563487957
4548,3672786,28250,128,0.040653,188,3685433,-1,64000.0,12005077,12033327,8332291,28250,4,8,True,True,72782.92391111111,-0.040345088054258064
4549,3672822,13457,128,0.070388,188,3685433,-1,64000.0,12437077,12450534,8764255,13457,2,12,True,True,42727.488,-0.06796975343187327
4550,3673201,21313,16,0.303905,188,3685433,-1,8000.0,6622857,6644170,2949656,21313,68,10,True,True,5290.619044444445,-0.3005868114109217
4551,3673565,89,1,0.944603,188,3685433,-1,500.0,4249211,4249300,575646,89,109,6,True,True,0.5827027777777778,-0.944603
4552,3673625,16711,4,0.960587,188,3685433,-1,2000.0,3743990,3760701,70365,16711,126,1,True,True,810.4919166666667,-0.921733847103201
4553,3673741,75,2,0.097119,188,3685433,-1,1000.0,10209769,10209844,6536028,75,28,12,True,True,2.3225,-0.097119
4554,3673762,201,1,0.725172,188,3685433,-1,500.0,5177749,5177950,1503987,201,87,12,True,True,2.8075791666666663,-0.725172
4555,3673920,5,1,0.531661,188,3685433,-1,500.0,3745090,3745095,71170,5,128,6,True,True,0.06743055555555555,-0.531661
4556,3674946,25,1,0.18946,188,3685433,-1,500.0,6881474,6881499,3206528,25,67,8,True,True,0.5776041666666666,-0.18946
4557,3674980,12598,32,0.526192,188,3685433,-1,16000.0,9864169,9876767,6189189,12598,31,12,True,True,5163.073244444445,-0.523850308365725
4558,3675045,21116,45,0.248763,188,3685433,-1,22500.0,11567155,11588271,7892110,21116,17,2,True,True,19128.1639375,-0.24849204476099862
4559,3675284,288,3,0.625325,188,3685433,-1,1500.0,6876074,6876362,3200790,288,70,7,True,True,16.8216,-0.625325
4560,3675406,1649,5,0.178898,188,3685433,-1,2500.0,8197791,8199440,4522385,1649,47,11,True,True,194.7079652777778,-0.178898
4561,3675425,101,1,0.749194,188,3685433,-1,500.0,4886149,4886250,1210724,101,96,12,True,True,1.1529430555555555,-0.749194
4562,3675572,12,2,0.415185,188,3685433,-1,1000.0,6872774,6872786,3197202,12,73,12,True,True,0.4496666666666667,-0.415185
4563,3675590,8667,16,0.105514,188,3685433,-1,8000.0,11784255,11792922,8108665,8667,15,11,True,True,2929.2692,-0.10275779049917295
4564,3675622,29,12,0.638624,188,3685433,-1,6000.0,4248111,4248140,572489,29,120,1,True,True,2.2784333333333335,-0.638624
4565,3675637,7754,128,0.357963,188,3685433,-1,64000.0,9518569,9526323,5842932,7754,34,11,True,True,10994.225066666666,-0.3349042835169296
4566,3675654,189,32,0.458721,188,3685433,-1,16000.0,7079174,7079363,3403520,189,69,12,True,True,74.298,-0.458721
4567,3675688,10761,1,0.665242,188,3685433,-1,500.0,4352696,4363457,677008,10761,117,8,True,True,115.43184722222222,-0.6639129906356235
4568,3675741,8744,4,0.882824,188,3685433,-1,2000.0,5582749,5591493,1907008,8744,91,12,True,True,681.7622944444445,-0.8503038841292347
4569,3675872,9308,1,0.166809,188,3685433,-1,500.0,3836895,3846203,161023,9308,141,12,True,True,100.86300416666667,-0.1564845957168766
4570,3675903,11829,72,0.180397,188,3685433,-1,36000.0,4340396,4352225,664493,11829,119,8,True,True,6591.0176,-0.17976648254239624
4571,3676012,238,1,0.401557,188,3685433,-1,500.0,5942297,5942535,2266285,238,87,12,True,True,3.0143361111111107,-0.401557
4572,3676024,33,8,0.337513,188,3685433,-1,4000.0,9604969,9605002,5928945,33,34,12,True,True,1.8487333333333333,-0.337513
4573,3676082,23,5,0.158176,188,3685433,-1,2500.0,6649157,6649180,2973075,23,78,10,True,True,1.5195972222222225,-0.158176
4574,3676130,45,1,0.998434,188,3685433,-1,500.0,3897495,3897540,221365,45,143,7,True,True,0.5275625,-0.998434
4575,3676133,2356,2,0.443012,188,3685433,-1,1000.0,3895295,3897651,219162,2356,144,7,True,True,55.24165555555556,-0.443012
4576,3676184,230,8,0.352324,188,3685433,-1,4000.0,4689149,4689379,1012965,230,111,7,True,True,16.493555555555556,-0.352324
4577,3677867,53,45,0.315155,188,3685433,-1,22500.0,11332969,11333022,7655102,53,25,11,True,True,44.01649999999999,-0.315155
4578,3677893,32,1,0.991463,188,3685433,-1,500.0,3969661,3969693,291768,32,142,11,True,True,0.42537777777777774,-0.991463
4579,3677973,1043,1,0.324654,188,3685433,-1,500.0,8821969,8823012,5143996,1043,44,12,True,True,19.485268055555554,-0.324654
4580,3677995,13208,38,0.37172,188,3685433,-1,19000.0,7597191,7610399,3919196,13208,61,6,True,True,5387.403872222222,-0.3590273165476371
4581,3678079,1889,4,0.764184,188,3685433,-1,2000.0,4343996,4345885,665917,1889,126,1,True,True,54.86039444444444,-0.7186223819408356
4582,3678090,14913,128,0.430588,188,3685433,-1,64000.0,7610191,7625104,3932101,14913,60,7,True,True,19061.496533333335,-0.42183024643902883
4583,3678108,13165,16,0.725868,188,3685433,-1,8000.0,5469349,5482514,1791241,13165,101,12,True,True,3044.916022222222,-0.7223264389867503
4584,3678125,7,4,0.608413,188,3685433,-1,2000.0,4792149,4792156,1114024,7,111,10,True,True,0.38052777777777774,-0.608413
4585,3678176,6,37,0.563145,188,3685433,-1,18500.0,6699957,6699963,3021781,6,82,7,True,True,4.722125,-0.563145
4586,3678377,8869,256,0.213928,188,3685433,-1,128000.0,10641769,10650638,6963392,8869,30,12,True,True,49875.6768,-0.1985940508554256
4587,3678440,12027,210,0.765708,188,3685433,-1,105000.0,4600549,4612576,922109,12027,122,9,True,True,23001.024375,-0.7133826579426015
4588,3679211,14,64,0.926147,188,3685433,-1,32000.0,4346196,4346210,666985,14,132,7,True,True,6.917866666666667,-0.926147
4589,3679280,44,128,0.254089,188,3685433,-1,64000.0,11386969,11387013,7707689,44,24,8,True,True,125.03040000000001,-0.254089
4590,3679312,4,1,0.961652,188,3685433,-1,500.0,5220949,5220953,1541637,4,108,11,True,True,0.04508888888888889,-0.961652
4591,3679372,7906,32,0.4475,188,3685433,-1,16000.0,3919261,3927167,239889,7906,156,10,True,True,3308.8357333333333,-0.44091213972106524
4592,3680172,1984,32,0.397091,188,3685433,-1,16000.0,10900969,10902953,7220797,1984,29,12,True,True,716.8853333333333,-0.397091
4593,3680281,13,14,0.726313,188,3685433,-1,7000.0,4245899,4245912,565618,13,145,11,True,True,1.0482694444444445,-0.726313
4594,3680922,11742,86,0.982956,188,3685433,-1,43000.0,3687633,3699375,6711,11742,173,7,True,True,16306.359666666667,-0.9807447718488922
4595,3681024,1300,8,0.595763,188,3685433,-1,4000.0,5318149,5319449,1637125,1300,108,8,True,True,104.85222222222222,-0.595763
4596,3681070,19,1,0.517609,188,3685433,-1,500.0,4797549,4797568,1116479,19,117,8,True,True,0.24029722222222225,-0.517609
4597,3681095,23,32,0.993412,188,3685433,-1,16000.0,4503196,4503219,822101,23,132,8,True,True,12.652044444444444,-0.993412
4598,3681213,5,32,0.301842,188,3685433,-1,16000.0,11611455,11611460,7930242,5,17,11,True,True,3.508888888888889,-0.301842
4599,3681391,13,8,0.300334,188,3685433,-1,4000.0,8001191,8001204,4319800,13,60,7,True,True,2.7737666666666665,-0.300334
4600,3681904,3459,4,0.221887,188,3685433,-1,2000.0,7707391,7710850,4025487,3459,65,9,True,True,151.04306111111111,-0.2215769947433663
4601,3682096,13849,4,0.85572,188,3685433,-1,2000.0,5761897,5775746,2079801,13849,103,12,True,True,1173.8734111111112,-0.8434932228911142
4602,3682167,19827,32,0.021701,188,3685433,-1,16000.0,11999677,12019504,8317510,19827,6,12,True,True,12182.748000000001,-0.021499561722468242
4603,3682283,6,1,0.82194,188,3685433,-1,500.0,4347296,4347302,665013,6,143,6,True,True,0.046325000000000005,-0.82194
4604,3682525,22,32,0.689719,188,3685433,-1,16000.0,6883674,6883696,3201149,22,85,7,True,True,13.49528888888889,-0.689719
4605,3682574,13,1,0.275957,188,3685433,-1,500.0,8203191,8203204,4520617,13,57,8,True,True,0.4109625,-0.275957
4606,3682589,3,4,0.553663,188,3685433,-1,2000.0,4013961,4013964,331372,3,166,11,True,True,0.22386666666666666,-0.553663
4607,3683826,2914,1,0.556323,188,3685433,-1,500.0,6786374,6789288,3102548,2914,91,1,True,True,40.010838888888884,-0.556323
4608,3685104,2,1,0.925922,188,3685433,-1,500.0,4152989,4152991,467885,2,161,12,True,True,0.011452777777777777,-0.925922
4609,3688341,561,1,0.154715,207,3698433,-1,500.0,7509074,7509635,3820733,561,73,6,True,True,9.80770972222222,-0.15445039228904345
4610,3688365,19295,64,0.037736,207,3698433,-1,32000.0,6247649,6266944,2559284,19295,103,12,True,True,24335.50951111111,-0.037074792723745156
4611,3688398,12603,8,0.355656,207,3698433,-1,4000.0,7696591,7709194,4008193,12603,68,12,True,True,1058.6243444444444,-0.35053086318950855
4612,3688772,56,1,0.138408,207,3698433,-1,500.0,7509635,7509691,3820863,56,74,1,True,True,0.9807,-0.138408
4613,3688871,53,8,0.367083,207,3698433,-1,4000.0,11289769,11289822,7600898,53,29,12,True,True,7.2392111111111115,-0.367083
4614,3688977,11,8,0.582156,207,3698433,-1,4000.0,3891995,3892006,203018,11,183,11,True,True,1.0205555555555557,-0.582156
4615,3689104,7367,16,0.232994,207,3698433,-1,8000.0,10555369,10562736,6866265,7367,36,12,True,True,2270.974044444444,-0.23258168198298412
4616,3689453,19,1,0.811074,207,3698433,-1,500.0,6623957,6623976,2934504,19,100,0,True,True,0.2968486111111111,-0.811074
4617,3690701,14513,16,0.091905,207,3698433,-1,8000.0,12091477,12105990,8400776,14513,5,12,True,True,4448.058533333334,-0.07911908667102928
4618,3690792,149,32,0.399798,207,3698433,-1,16000.0,11381569,11381718,7690777,149,28,8,True,True,105.93568888888889,-0.399798
4619,3690846,16952,256,0.917882,207,3698433,-1,128000.0,5969297,5986249,2278451,16952,112,10,True,True,40072.225422222225,-0.9170437623134952
4620,3690876,21615,64,0.734266,207,3698433,-1,32000.0,8527191,8548806,4836315,21615,59,12,True,True,26640.034399999997,-0.7166985783162173
4621,3690903,30,8,0.723581,207,3698433,-1,4000.0,5312749,5312779,1621846,30,128,12,True,True,2.372,-0.723581
4622,3691207,140,16,0.792904,207,3698433,-1,8000.0,4362796,4362936,671589,140,156,6,True,True,24.223111111111113,-0.792904
4623,3691710,20607,32,0.172902,207,3698433,-1,16000.0,8994769,9015376,5303059,20607,52,12,True,True,9585.534266666667,-0.15805967844317478
4624,3691896,6844,35,0.825705,207,3698433,-1,17500.0,5855897,5862741,2164001,6844,117,12,True,True,5728.878020833334,-0.6801363915542444
4625,3692532,17,8,0.689595,207,3698433,-1,4000.0,6699963,6699980,3007431,17,101,1,True,True,2.8928333333333334,-0.689595
4626,3692654,1207,32,0.576232,207,3698433,-1,16000.0,9253969,9255176,5561315,1207,50,11,True,True,630.1076444444444,-0.576232
4627,3692800,10,1,0.907656,207,3698433,-1,500.0,3897651,3897661,204851,10,191,3,True,True,0.11723611111111111,-0.907656
4628,3692903,3,12,0.595231,207,3698433,-1,6000.0,6654557,6654560,2961654,3,104,8,True,True,0.401,-0.595231
4629,3693006,11,21,0.300393,207,3698433,-1,10500.0,6786363,6786374,3093357,11,102,12,True,True,3.171758333333333,-0.300393
4630,3699045,8653,32,0.730789,212,3700780,-1,16000.0,3745095,3753748,46050,8653,201,1,True,True,3496.4317333333333,-0.7186160995931256
4631,3699066,22116,32,0.576284,212,3700780,-1,16000.0,9907369,9929485,6208303,22116,43,11,True,True,15324.393155555557,-0.5659397585220275
4632,3699271,21,1,0.078477,212,3700780,-1,500.0,8132991,8133012,4433720,21,68,12,True,True,0.5173583333333334,-0.078477
4633,3699282,111,18,0.055923,212,3700780,-1,9000.0,6249849,6249960,2550567,111,118,7,True,True,36.832575,-0.055923
4634,3699352,13,4,0.770902,212,3700780,-1,2000.0,3848795,3848808,149443,13,202,6,True,True,0.5106833333333333,-0.770902
4635,3699478,11,4,0.34793,212,3700780,-1,2000.0,6623957,6623968,2924479,11,111,6,True,True,0.6874388888888889,-0.34793
4636,3699527,13020,12,0.817142,212,3700780,-1,6000.0,6295249,6308269,2595722,13020,118,7,True,True,2857.37635,-0.8161064638863238
4637,3700163,6,11,0.416522,212,3700780,-1,5500.0,8440791,8440797,4740628,6,63,12,True,True,1.6380833333333333,-0.416522
4638,3701086,44,32,0.867831,246,3743980,-1,16000.0,6072649,6072693,2371563,44,124,12,True,True,11.107555555555555,-0.867831
4639,3701224,130,1,0.869787,246,3743980,-1,500.0,6697757,6697887,2996533,130,108,11,True,True,2.5680416666666663,-0.869787
4640,3701346,187,32,0.226718,246,3743980,-1,16000.0,10944169,10944356,7242823,187,34,11,True,True,94.82977777777778,-0.226718
4641,3712058,24,36,0.652779,246,3743980,-1,18000.0,5986249,5986273,2274191,24,127,8,True,True,7.821600000000001,-0.652779
4642,3712151,13959,64,0.602302,246,3743980,-1,32000.0,5091349,5105308,1379198,13959,148,12,True,True,10068.927644444446,-0.5962873981085689
4643,3714914,7407,9,0.011434,246,3743980,-1,4500.0,11030569,11037976,7315655,7407,34,12,True,True,1189.9694125,-0.011342195435422288
4644,3715223,18,16,0.777419,246,3743980,-1,8000.0,4159499,4159517,444276,18,190,8,True,True,1.4988,-0.777419
4645,3715324,18,16,0.382487,246,3743980,-1,8000.0,10382569,10382587,6667245,18,41,12,True,True,4.0752,-0.382487
4646,3715542,5,8,0.304783,246,3743980,-1,4000.0,9777769,9777774,6062227,5,48,12,True,True,0.5880000000000001,-0.304783
4647,3720730,18,16,0.041182,246,3743980,-1,8000.0,9210769,9210787,5490039,18,56,12,True,True,5.574800000000001,-0.041182
4648,3720939,56,4,0.53993,246,3743980,-1,2000.0,6601257,6601313,2880318,56,120,12,True,True,4.6648,-0.53993
4649,3721655,12,1,0.14958,246,3743980,-1,500.0,5587449,5587461,1865794,12,141,2,True,True,0.24948333333333333,-0.14958
4650,3723113,108,2,0.502402,246,3743980,-1,1000.0,9691369,9691477,5968256,108,49,12,True,True,3.0135,-0.502402
4651,3723509,38,1,0.220797,246,3743980,-1,500.0,7712791,7712829,3989282,38,83,8,True,True,0.4035388888888889,-0.220797
4652,3723658,819,1,0.05052,246,3743980,-1,500.0,8354391,8355210,4630733,819,70,10,True,True,17.797325,-0.05052
4653,3723949,12732,20,0.731579,246,3743980,-1,10000.0,5589088,5601820,1865139,12732,144,2,True,True,3286.2852222222223,-0.6380517404616292
4654,3724018,394,4,0.392883,246,3743980,-1,2000.0,10468969,10469363,6744951,394,41,12,True,True,30.939944444444443,-0.392883
4655,3733006,4,16,0.445616,246,3743980,-1,8000.0,3750495,3750499,17489,4,225,8,True,True,0.8075555555555555,-0.445616
4656,3733414,122,4,0.595132,246,3743980,-1,2000.0,6316849,6316971,2583435,122,130,10,True,True,8.111644444444446,-0.595132
4657,3736777,71,3,0.504729,246,3743980,-1,1500.0,6622857,6622928,2886080,71,123,0,True,True,3.327829166666666,-0.504729
4658,3736867,291,2,0.222086,246,3743980,-1,1000.0,4361696,4361987,624829,291,187,2,True,True,6.293683333333333,-0.222086
4659,3737473,40,1,0.289783,246,3743980,-1,500.0,11741055,11741095,8003582,40,18,10,True,True,0.9290555555555555,-0.289783
4660,3737586,14,4,0.394322,246,3743980,-1,2000.0,6927974,6927988,3190388,14,108,11,True,True,0.9120222222222223,-0.394322
4661,3737606,16503,3,0.132189,246,3743980,-1,1500.0,11819255,11835758,8081649,16503,12,6,True,True,896.9735625000001,-0.1320098726288704
4662,3737796,274,12,0.082545,246,3743980,-1,6000.0,12350677,12350951,8612881,274,3,12,True,True,86.62966666666667,-0.082545
4663,3740770,18193,1,0.571441,246,3743980,-1,500.0,4994149,5012342,1253379,18193,167,11,True,True,172.6605986111111,-0.5529092389061214
4664,3740870,2,4,0.049311,246,3743980,-1,2000.0,10123369,10123371,6382499,2,48,12,True,True,0.11892222222222222,-0.049311
4665,3740946,4650,1,0.399191,246,3743980,-1,500.0,6161249,6165899,2420303,4650,141,12,True,True,48.3150375,-0.3830872794798499
4666,3741105,22,1,0.085079,246,3743980,-1,500.0,11862455,11862477,8121350,22,13,11,True,True,0.5488999999999999,-0.085079
4667,3741132,20,4,0.501823,246,3743980,-1,2000.0,3926461,3926481,185329,20,224,2,True,True,0.9995555555555555,-0.501823
4668,3741765,21010,1,0.773825,246,3743980,-1,500.0,7799191,7820201,4057426,21010,90,12,True,True,699.2941597222223,-0.7230916267033175
4669,3741794,1379,32,0.130375,246,3743980,-1,16000.0,11719455,11720834,7977661,1379,22,10,True,True,767.765911111111,-0.130375
4670,3741818,8052,16,0.134871,246,3743980,-1,8000.0,10036969,10045021,6295151,8052,51,11,True,True,3276.4993111111107,-0.13315746355265082
4671,3742130,11773,256,0.559296,246,3743980,-1,128000.0,7447474,7459247,3705344,11773,107,10,True,True,71871.09688888889,-0.4610948313697848
4672,3742226,27737,2,0.487861,246,3743980,-1,1000.0,5675497,5703234,1933271,27737,157,1,True,True,654.8590194444444,-0.48099969443904095
4673,3744910,24,1,0.652248,245,3745090,-1,500.0,7208774,7208798,3463864,24,112,12,True,True,0.2505666666666667,-0.652248
4674,3745166,37,4,0.196099,245,3750495,-1,2000.0,8561626,8561663,4816460,37,75,6,True,True,2.2641944444444446,-0.196099
4675,3745225,5,16,0.615997,245,3750495,-1,8000.0,4734549,4734554,989324,5,188,11,True,True,0.8,-0.615997
8402,6658550,8,1,0.126368,1,6658550,-1,500.0,6744950,6744958,86400,8,0,12,True,True,0.043511111111111105,-0.126368
8403,6659967,7085,8,0.378801,172,6744950,-1,4000.0,12440794,12447879,5780827,7085,0,12,True,True,678.119511111111,-0.3728149657362436
8404,6661077,2266,32,0.735422,172,6744950,-1,16000.0,9268664,9270930,2607587,2266,1,2,True,True,684.9661333333333,-0.6327416972977319
8405,6662693,92,1,0.052865,172,6744950,-1,500.0,13218394,13218486,6555701,92,0,12,True,True,0.9054333333333334,-0.052865
8406,6663607,6,2,0.725419,172,6744950,-1,1000.0,6788150,6788156,124543,6,3,0,True,True,0.13576666666666667,-0.725419
8407,6663928,2959,64,0.9745,172,6744950,-1,32000.0,7725557,7728516,1061629,2959,3,12,True,True,2257.7203555555557,-0.9706285457608905
8408,6664109,6,4,0.707502,172,6744950,-1,2000.0,10023577,10023583,3359468,6,2,12,True,True,0.1229,-0.707502
8409,6667408,18,2,0.249112,172,6744950,-1,1000.0,12068194,12068212,5400786,18,2,10,True,True,0.55745,-0.249112
8410,6667915,35,1,0.608703,172,6744950,-1,500.0,7215341,7215376,547426,35,6,11,True,True,0.5396319444444445,-0.608703
8411,6669820,3,1,0.706787,172,6744950,-1,500.0,7031641,7031644,361821,3,7,11,True,True,0.033912500000000005,-0.706787
8412,6670131,6799,2,0.183105,172,6744950,-1,1000.0,16117546,16124345,9447415,6799,0,12,True,True,245.00129166666667,-0.18292273359676256
8413,6670278,21978,2,0.986246,172,6744950,-1,1000.0,6862156,6884134,191878,21978,9,7,True,True,501.00068888888893,-0.9793504613100141
8414,6670422,210,2,0.798469,172,6744950,-1,1000.0,7370941,7371151,700519,210,7,7,True,True,12.667083333333334,-0.798469
8415,6670615,22390,152,0.502229,172,6744950,-1,76000.0,16031146,16053536,9360531,22390,1,12,True,True,86686.81262222223,-0.5013511496111169
8416,6670823,31,18,0.275823,172,6744950,-1,9000.0,14807594,14807625,8136771,31,2,0,True,True,21.42255,-0.275823
8417,6671262,315,2,0.427765,172,6744950,-1,1000.0,8424043,8424358,1752781,315,8,7,True,True,8.370249999999999,-0.427765
8418,6671303,2,60,0.941677,172,6744950,-1,30000.0,7368741,7368743,697438,2,11,10,True,True,4.048333333333334,-0.941677
8419,6671362,5,8,0.881388,172,6744950,-1,4000.0,7053241,7053246,381879,5,13,10,True,True,0.43338888888888893,-0.881388
8420,6671435,8,2,0.814023,172,6744950,-1,1000.0,9655277,9655285,2983842,8,7,12,True,True,0.10566666666666666,-0.814023
8421,6672239,38,16,0.305187,172,6744950,-1,8000.0,10721394,10721432,4049155,38,6,12,True,True,7.313733333333333,-0.305187
8422,6672376,65655,1,0.857921,172,6744950,-1,500.0,7392541,7458196,720165,65655,12,10,True,True,885.9338041666666,-0.8356275929268128
8423,6672527,16,32,0.947455,172,6744950,-1,16000.0,6809750,6809766,137223,16,19,10,True,True,4.512711111111111,-0.947455
8424,6672602,19,2,0.406515,172,6744950,-1,1000.0,7911918,7911937,1239316,19,11,1,True,True,0.20583333333333334,-0.406515
8425,6672621,10,1,0.312737,172,6744950,-1,500.0,10931994,10932004,4259373,10,6,10,True,True,0.14248611111111112,-0.312737
8426,6672835,18979,2,0.090141,172,6744950,-1,1000.0,15516571,15535550,8843736,18979,2,12,True,True,726.2527694444444,-0.08894445248280557
8427,6673123,6401,32,0.079475,172,6744950,-1,16000.0,15520171,15526572,8847048,6401,2,1,True,True,4071.148444444444,-0.0790134938329717
8428,6673156,13820,1,0.729953,172,6744950,-1,500.0,9710377,9724197,3037221,13820,11,8,True,True,128.38835277777778,-0.707290043874985
8429,6673287,12,1,0.944867,172,6744950,-1,500.0,7879716,7879728,1206429,12,16,12,True,True,0.06463333333333333,-0.944867
8430,6677934,4116,8,0.165113,172,6744950,-1,4000.0,14102994,14107110,7425060,4116,5,7,True,True,491.8190666666667,-0.16164575947558277
8431,6677950,48,8,0.057412,172,6744950,-1,4000.0,11477394,11477442,4799444,48,9,12,True,True,5.7104,-0.057412
8432,6684601,37,2,0.743409,172,6744950,-1,1000.0,10219077,10219114,3534476,37,12,12,True,True,1.1670416666666668,-0.743409
8433,6684784,14,16,0.55416,172,6744950,-1,8000.0,10499877,10499891,3815093,14,12,12,True,True,3.2252888888888886,-0.55416
8434,6685046,98,8,0.492851,172,6744950,-1,4000.0,9390364,9390462,2705318,98,17,8,True,True,8.254866666666667,-0.492851
8435,6685053,82,8,0.874353,172,6744950,-1,4000.0,8510443,8510525,1825390,82,19,12,True,True,5.411088888888889,-0.874353
8436,6685090,5649,32,0.962166,172,6744950,-1,16000.0,7097541,7103190,412451,5649,28,11,True,True,1028.5436,-0.8959205707045658
8437,6685291,41,1,0.423984,172,6744950,-1,500.0,8971025,8971066,2285734,41,19,12,True,True,0.1979388888888889,-0.423984
8438,6685422,9165,8,0.508682,172,6744950,-1,4000.0,7397941,7407106,712519,9165,25,8,True,True,1193.9283777777778,-0.4929770994854195
8439,6685437,42,16,0.730797,172,6744950,-1,8000.0,6866311,6866353,180874,42,33,2,True,True,8.116266666666666,-0.730797
8440,6685575,14349,256,0.479656,172,6744950,-1,128000.0,16247146,16261495,9561571,14349,0,12,True,True,76553.4912,-0.4498639261569587
8441,6685967,370,4,0.515011,172,6744950,-1,2000.0,8018518,8018888,1332551,370,23,12,True,True,9.728944444444444,-0.515011
8442,6687864,3,1,0.997954,172,6744950,-1,500.0,6925711,6925714,237847,3,35,9,True,True,0.021362500000000003,-0.997954
8443,6688959,12,4,0.888081,172,6744950,-1,2000.0,8170818,8170830,1481859,12,23,11,True,True,0.6021333333333333,-0.888081
8444,6688970,7565,16,0.697882,172,6744950,-1,8000.0,8511625,8519190,1822655,7565,21,6,True,True,1216.0152222222223,-0.6256101803970323
8445,6688989,65,2,0.405471,172,6744950,-1,1000.0,8421843,8421908,1732854,65,24,2,True,True,1.926347222222222,-0.405471
8446,6689034,2,4,0.616287,172,6744950,-1,2000.0,9275864,9275866,2586830,2,19,2,True,True,0.09758888888888889,-0.616287
8447,6689145,10104,4,0.910886,172,6744950,-1,2000.0,7924918,7935022,1235773,10104,28,0,True,True,236.43978888888887,-0.9049359713583364
8448,6690630,13444,15,0.745917,172,6744950,-1,7500.0,7888037,7901481,1197407,13444,30,2,True,True,1770.3275624999997,-0.7180974201105749
8449,6690784,12,2,0.71416,172,6744950,-1,1000.0,6814101,6814113,123317,12,44,1,True,True,0.1375666666666667,-0.71416
8450,6690805,12,4,0.702592,172,6744950,-1,2000.0,6954962,6954974,264157,12,41,7,True,True,1.0352666666666668,-0.702592
8451,6690999,162,4,0.749668,172,6744950,-1,2000.0,6960762,6960924,269763,162,41,1,True,True,12.964500000000001,-0.749668
8452,6691121,122,1,0.244226,172,6744950,-1,500.0,14721194,14721316,8030073,122,6,8,True,True,1.741888888888889,-0.244226
8453,6691182,1384,6,0.738983,172,6744950,-1,3000.0,9087864,9089248,2396682,1384,22,2,True,True,102.77353333333333,-0.738983
8454,6691260,20,2,0.950868,172,6744950,-1,1000.0,6862711,6862731,171451,20,47,1,True,True,0.4426666666666667,-0.950868
8455,6691976,2,1,0.823363,172,6744950,-1,500.0,6931162,6931164,239186,2,45,2,True,True,0.01802222222222222,-0.823363
8456,6692023,180,4,0.880332,172,6744950,-1,2000.0,9265064,9265244,2573041,180,22,7,True,True,4.965,-0.880332
8457,6692104,26055,32,0.528111,172,6744950,-1,16000.0,9262864,9288919,2570760,26055,23,12,True,True,8929.819733333332,-0.4997627291474351
8458,6692240,2,32,0.609194,172,6744950,-1,16000.0,9753577,9753579,3061337,2,17,11,True,True,0.7997333333333333,-0.609194
8459,6693041,7498,8,0.607374,172,6744950,-1,4000.0,7601357,7608855,908316,7498,38,10,True,True,649.4811888888888,-0.5761824869864913
8460,6693060,9,9,0.964647,172,6744950,-1,4500.0,7879728,7879737,1186668,9,36,1,True,True,0.436275,-0.964647
8461,6693068,7871,1,0.674522,172,6744950,-1,500.0,6957162,6965033,264094,7871,49,7,True,True,153.69745555555556,-0.6457946900719995
8462,6693225,45,2,0.881931,172,6744950,-1,1000.0,8511625,8511670,1818400,45,27,0,True,True,0.742375,-0.881931
8463,6693234,13127,128,0.523516,172,6744950,-1,64000.0,12267994,12281121,5574760,13127,10,8,True,True,17367.17671111111,-0.4886205142598401
8464,6693334,20781,32,0.225069,172,6744950,-1,16000.0,9661777,9682558,2968443,20781,20,8,True,True,3820.8278666666665,-0.21851598550829374
8465,6693490,146,1,0.075122,172,6744950,-1,500.0,15768346,15768492,9074856,146,3,6,True,True,5.745911111111111,-0.075122
8466,6693495,5968,2,0.839409,172,6744950,-1,1000.0,6988441,6994409,294946,5968,52,1,True,True,94.29210555555555,-0.8376529598622661
8467,6693954,8839,2,0.513684,172,6744950,-1,1000.0,9079025,9087864,2385071,8839,29,12,True,True,194.13521944444446,-0.4813984111751672
8468,6694487,18,2,0.952484,172,6744950,-1,1000.0,6929011,6929029,234524,18,58,6,True,True,0.276,-0.952484
8469,6694554,650,1,0.422722,172,6744950,-1,500.0,13310194,13310844,6615640,650,9,8,True,True,11.487847222222221,-0.422722
8470,6694558,7636,16,0.379095,172,6744950,-1,8000.0,13879394,13887030,7184836,7636,9,8,True,True,2285.388311111111,-0.3745214974892396
8471,6694656,49,1,0.373284,172,6744950,-1,500.0,15251930,15251979,8557274,49,6,11,True,True,1.0211055555555555,-0.373284
8472,6694767,7,1,0.113234,172,6744950,-1,500.0,15703771,15703778,9009004,7,4,8,True,True,0.24060555555555554,-0.113234
8473,6694773,146,3,0.914045,172,6744950,-1,1500.0,7579757,7579903,884984,146,49,12,True,True,6.175191666666667,-0.914045
8474,6694882,45,16,0.249765,172,6744950,-1,8000.0,15525571,15525616,8830689,45,5,8,True,True,13.866999999999999,-0.249765
8475,6694978,6,8,0.53912,172,6744950,-1,4000.0,9656377,9656383,2961399,6,27,6,True,True,0.317,-0.53912
8476,6695010,8038,256,0.766414,172,6744950,-1,128000.0,10634994,10643032,3939984,8038,21,7,True,True,27416.599466666667,-0.7446287956469244
8477,6695053,16759,64,0.117865,172,6744950,-1,32000.0,14980394,14997153,8285341,16759,9,12,True,True,29078.59893333333,-0.11732338634542974
8478,6695148,93,4,0.299178,172,6744950,-1,2000.0,7928518,7928611,1233370,93,46,2,True,True,3.6275166666666663,-0.299178
8479,6695180,58,128,0.293545,172,6744950,-1,64000.0,12699994,12700052,6004814,58,16,12,True,True,94.05795555555555,-0.293545
8480,6695199,6,1,0.213066,172,6744950,-1,500.0,7924918,7924924,1229719,6,49,7,True,True,0.023191666666666666,-0.213066
8481,6695238,25,4,0.738026,172,6744950,-1,2000.0,9090064,9090089,2394826,25,37,7,True,True,0.9980555555555555,-0.738026
8482,6695298,20,64,0.568842,172,6744950,-1,32000.0,14893994,14894014,8198696,20,10,12,True,True,27.073777777777778,-0.568842
8483,6695334,12654,92,0.217463,172,6744950,-1,46000.0,16506346,16519000,9811012,12654,0,11,True,True,13531.523044444446,-0.21351405693554337
8484,6695375,8,32,0.30482,172,6744950,-1,16000.0,8517425,8517433,1822050,8,43,7,True,True,2.584888888888889,-0.30482
8485,6695418,8,2,0.933111,172,6744950,-1,1000.0,8410643,8410651,1715225,8,49,11,True,True,0.2717777777777778,-0.933111
8486,6695567,7916,256,0.642974,172,6744950,-1,128000.0,13396594,13404510,6701027,7916,16,12,True,True,14982.382933333332,-0.5888804516950196
8487,6695643,41,8,0.825727,172,6744950,-1,4000.0,7450157,7450198,754514,41,63,1,True,True,5.856166666666668,-0.825727
8488,6696117,662,4,0.035429,172,6744950,-1,2000.0,15944746,15945408,9248629,662,4,1,True,True,87.5495,-0.035429
8489,6696123,68,1,0.463057,172,6744950,-1,500.0,9176464,9176532,2480341,68,41,12,True,True,0.45805555555555555,-0.463057
8490,6696212,17714,8,0.617749,172,6744950,-1,4000.0,12176194,12193908,5479982,17714,23,12,True,True,1418.5015555555556,-0.5962482549911712
8491,6696220,9492,4,0.488266,172,6744950,-1,2000.0,8192418,8201910,1496198,9492,54,10,True,True,191.62423333333334,-0.4612079571221913
8492,6696273,189,4,0.355744,172,6744950,-1,2000.0,13971194,13971383,7274921,189,16,8,True,True,13.920900000000001,-0.355744
8493,6696284,286,16,0.61553,172,6744950,-1,8000.0,9268664,9268950,2572380,286,40,0,True,True,38.343066666666665,-0.61553
8494,6696298,22865,1,0.328552,172,6744950,-1,500.0,7750116,7772981,1053818,22865,66,10,True,True,185.50548888888886,-0.2931350377660584
8495,6696472,11783,4,0.353893,172,6744950,-1,2000.0,14362194,14373977,7665722,11783,15,12,True,True,458.7340222222222,-0.3498964019391326
8496,6696604,20,4,0.005154,172,6744950,-1,2000.0,11650194,11650214,4953590,20,27,12,True,True,0.5608888888888889,-0.005154
8497,6696658,25,8,0.890196,172,6744950,-1,4000.0,7142941,7142966,446283,25,78,7,True,True,4.100277777777778,-0.890196
8498,6698389,10136,2,0.186158,172,6744950,-1,1000.0,15109994,15120130,8411605,10136,11,11,True,True,520.4327888888888,-0.1847908132495047
8499,6698447,22,4,0.354532,172,6744950,-1,2000.0,14715794,14715816,8017347,22,16,7,True,True,1.1950888888888889,-0.354532
8500,6698564,17,1,0.101338,172,6744950,-1,500.0,9395764,9395781,2697200,17,42,8,True,True,0.12020416666666665,-0.101338
8501,6698630,1956,1,0.492046,172,6744950,-1,500.0,8040118,8042074,1341488,1956,63,10,True,True,9.660466666666668,-0.492046
8502,6699954,9735,1,0.084744,172,6744950,-1,500.0,16419946,16429681,9719992,9735,1,12,True,True,115.99691666666666,-0.08455483996367225
8503,6705235,25,1,0.514319,172,6744950,-1,500.0,10111077,10111102,3405842,25,37,12,True,True,0.2734375,-0.514319
8504,6705489,19,22,0.153711,172,6744950,-1,11000.0,15854746,15854765,9149257,19,6,12,True,True,7.4403999999999995,-0.153711
8505,6705689,2302,8,0.123843,172,6744950,-1,4000.0,12089794,12092096,5384105,2302,30,10,True,True,209.48200000000003,-0.123843
8506,6705986,4,1,0.487412,172,6744950,-1,500.0,7639157,7639161,933171,4,78,10,True,True,0.05926111111111111,-0.487412
8507,6706134,41,16,0.15563,172,6744950,-1,8000.0,15343730,15343771,8637596,41,12,0,True,True,14.656133333333335,-0.15563
8508,6706223,14224,2,0.656633,172,6744950,-1,1000.0,8603825,8618049,1897602,14224,59,12,True,True,155.48461666666668,-0.6133797918379907
8509,6706301,13442,8,0.226095,172,6744950,-1,4000.0,13045594,13059036,6339293,13442,27,12,True,True,793.7866222222221,-0.22108936236022664
8510,6706308,37,1,0.395359,172,6744950,-1,500.0,10813194,10813231,4106886,37,37,8,True,True,0.45602499999999996,-0.395359
8511,6706394,30,8,0.299285,172,6744950,-1,4000.0,11104794,11104824,4398400,30,36,12,True,True,3.7483333333333335,-0.299285
8512,6706686,147,32,0.428341,172,6744950,-1,16000.0,14057594,14057741,7350908,147,22,12,True,True,77.07373333333334,-0.428341
8513,6706712,3,4,0.182182,172,6744950,-1,2000.0,13482994,13482997,6776282,3,25,12,True,True,0.15785,-0.182182
8514,6706728,8,32,0.811544,172,6744950,-1,16000.0,11909394,11909402,5202666,8,36,12,True,True,4.049777777777778,-0.811544
8515,6706789,20,1,0.108695,172,6744950,-1,500.0,13569394,13569414,6862605,20,25,12,True,True,0.25636111111111115,-0.108695
8516,6707123,32855,8,0.438572,172,6744950,-1,4000.0,12786394,12819249,6079271,32855,31,12,True,True,4935.256533333334,-0.4380434195789017
8517,6707147,17258,8,0.839357,172,6744950,-1,4000.0,7148341,7165599,441194,17258,97,8,True,True,942.1565,-0.6800575811158174
8518,6708435,4880,1,0.161834,172,6744950,-1,500.0,9883177,9888057,3174742,4880,50,12,True,True,59.998554166666665,-0.16151275759124198
8519,6708487,62,4,0.353738,172,6744950,-1,2000.0,7140741,7140803,432254,62,100,11,True,True,1.9588555555555554,-0.353738
8520,6708512,324,4,0.43396,172,6744950,-1,2000.0,11736594,11736918,5028082,324,39,12,True,True,17.145,-0.43396
8521,6708732,57,1,0.359237,172,6744950,-1,500.0,7909637,7909694,1200905,57,85,10,True,True,0.30875,-0.359237
8522,6708906,16,1,0.870514,172,6744950,-1,500.0,7450141,7450157,741235,16,95,11,True,True,0.2856666666666667,-0.870514
8523,6708965,55,8,0.198465,172,6744950,-1,4000.0,8733425,8733480,2024460,55,69,12,True,True,1.6646666666666665,-0.198465
8524,6709526,98,16,0.189567,172,6744950,-1,8000.0,15122330,15122428,8412804,98,14,7,True,True,38.62942222222222,-0.189567
8525,6709543,8202,2,0.040256,172,6744950,-1,1000.0,10283877,10292079,3574334,8202,49,11,True,True,218.77190000000002,-0.0396419569703211
8526,6709545,284,16,0.394546,172,6744950,-1,8000.0,15066794,15067078,8357249,284,16,12,True,True,101.86764444444444,-0.394546
8527,6710014,9997,1,0.743924,172,6744950,-1,500.0,8510525,8520522,1800511,9997,77,1,True,True,101.8798236111111,-0.72290975703401
8528,6710249,2100,8,0.900998,172,6744950,-1,4000.0,6812001,6814101,101752,2100,123,1,True,True,96.29666666666668,-0.900998
8529,6710726,20,2,0.160313,172,6744950,-1,1000.0,11916994,11917014,5206268,20,40,7,True,True,0.5922222222222222,-0.160313
8530,6710888,13426,42,0.198992,172,6744950,-1,21000.0,15257330,15270756,8546442,13426,13,8,True,True,11546.294433333333,-0.19865210555533774
8531,6710908,15363,1,0.479295,172,6744950,-1,500.0,7406941,7422304,696033,15363,103,8,True,True,178.54736944444443,-0.4581790792748346
8532,6711020,7021,21,0.665243,172,6744950,-1,10500.0,13045594,13052615,6334574,7021,33,0,True,True,1062.67455,-0.6509678086203793
8533,6711492,20210,4,0.2658,172,6744950,-1,2000.0,15343771,15363981,8632279,20210,12,1,True,True,1862.9295333333334,-0.26542757362987046
8534,6711790,2644,1,0.421095,172,6744950,-1,500.0,12872794,12875438,6161004,2644,36,12,True,True,35.636075,-0.4144423042692245
8535,6711902,21375,256,0.550124,172,6744950,-1,128000.0,15746971,15768346,9035069,21375,8,11,True,True,181896.54791111112,-0.5300772797069753
8536,6712080,73,4,0.79982,172,6744950,-1,2000.0,8126518,8126591,1414438,73,90,12,True,True,2.2175777777777776,-0.79982
8537,6712146,42,71,0.714321,172,6744950,-1,35500.0,12046594,12046636,5334448,42,45,12,True,True,44.75899166666667,-0.714321
8538,6712201,95,1,0.324888,172,6744950,-1,500.0,9363364,9363459,2651163,95,69,6,True,True,0.9274375,-0.324888
8539,6712467,6,16,0.764393,172,6744950,-1,8000.0,7401541,7401547,689074,6,111,1,True,True,1.5722666666666667,-0.764393
8540,6712772,33,1,0.881767,172,6744950,-1,500.0,7880837,7880870,1168065,33,101,6,True,True,0.2267375,-0.881767
8541,6712792,8619,16,0.501859,172,6744950,-1,8000.0,8647025,8655644,1934233,8619,81,11,True,True,1086.579888888889,-0.4772716699180496
8542,6713969,3251,1,0.923561,172,6744950,-1,500.0,6927911,6931162,213942,3251,131,7,True,True,26.48657777777778,-0.8350185424543564
8543,6714465,81,5,0.843063,172,6744950,-1,2500.0,7911837,7911918,1197372,81,100,6,True,True,2.1937499999999996,-0.843063
8544,6714576,16,2,0.388849,172,6744950,-1,1000.0,7884437,7884453,1169861,16,103,2,True,True,0.24982222222222222,-0.388849
8545,6715167,3,1,0.109733,172,6744950,-1,500.0,13873994,13873997,7158827,3,30,7,True,True,0.05750833333333334,-0.109733
8546,6715187,24,26,0.10788,172,6744950,-1,13000.0,11822994,11823018,5107807,24,49,12,True,True,5.713066666666667,-0.10788
8547,6715308,98,8,0.021152,172,6744950,-1,4000.0,11390994,11391092,4675686,98,53,12,True,True,12.167244444444442,-0.021152
8548,6715781,6502,8,0.155542,172,6744950,-1,4000.0,15343730,15350232,8627949,6502,15,12,True,True,1181.4958666666666,-0.15541726235725753
8549,6715792,68,1,0.500001,172,6744950,-1,500.0,12959194,12959262,6243402,68,39,12,True,True,0.6218222222222223,-0.500001
8550,6716171,15494,8,0.767385,172,6744950,-1,4000.0,7617557,7633051,901386,15494,115,9,True,True,1768.7671333333333,-0.7427517166668297
8551,6716218,21849,2,0.236505,172,6744950,-1,1000.0,16333546,16355395,9617328,21849,2,12,True,True,602.6528916666667,-0.22568316380736334
8552,6716224,39,8,0.67831,172,6744950,-1,4000.0,7606757,7606796,890533,39,117,8,True,True,3.8363,-0.67831
8553,6716336,323,16,0.342141,172,6744950,-1,8000.0,13304794,13305117,6588458,323,37,12,True,True,85.90364444444444,-0.342141
8554,6716745,436,9,0.976439,172,6744950,-1,4500.0,7172141,7172577,455396,436,130,10,True,True,16.35,-0.976439
8555,6716958,10598,32,0.737432,172,6744950,-1,16000.0,8992625,9003223,2275667,10598,86,10,True,True,1980.302488888889,-0.7291993773213182
8556,6717398,25270,1,0.434329,172,6744950,-1,500.0,10807794,10833064,4090396,25270,61,12,True,True,299.5934166666667,-0.43261352549456605
8557,6717678,379,4,0.289467,172,6744950,-1,2000.0,14540794,14541173,7823116,379,27,2,True,True,36.39242222222222,-0.289467
8558,6717855,52,3,0.485929,172,6744950,-1,1500.0,8798225,8798277,2080370,52,90,10,True,True,0.6699333333333334,-0.48592899999999994
8559,6717865,4,16,0.7609,172,6744950,-1,8000.0,9568873,9568877,2851008,4,76,1,True,True,0.6824,-0.7609
8560,6718881,47,64,0.247747,172,6744950,-1,32000.0,6788150,6788197,69269,47,157,11,True,True,34.032177777777775,-0.247747
8561,6719183,5048,32,0.152496,172,6744950,-1,16000.0,14275794,14280842,7556611,5048,29,12,True,True,2037.1212444444445,-0.14575292784763016
8562,6719217,1317,9,0.51124,172,6744950,-1,4500.0,6815201,6816518,95984,1317,154,6,True,True,92.9802,-0.5112399999999999
8563,6719376,16026,16,0.249467,172,6744950,-1,8000.0,13655794,13671820,6936418,16026,35,12,True,True,3254.035066666667,-0.2457595995524317
8564,6719543,6,16,0.766728,172,6744950,-1,8000.0,8281043,8281049,1561500,6,105,1,True,True,0.644,-0.766728
8565,6719575,240,8,0.864167,172,6744950,-1,4000.0,10240677,10240917,3521102,240,69,10,True,True,28.162666666666667,-0.864167
8566,6719590,9,4,0.994257,172,6744950,-1,2000.0,7150541,7150550,430951,9,140,7,True,True,0.37475,-0.994257
8567,6719804,143,8,0.247354,172,6744950,-1,4000.0,15611971,15612114,8892167,143,11,12,True,True,19.034888888888887,-0.247354
8568,6719831,1,3,0.820609,172,6744950,-1,1500.0,7932118,7932119,1212287,1,113,2,True,True,0.010783333333333332,-0.820609
8569,6719897,12,4,0.198412,172,6744950,-1,2000.0,13871794,13871806,7151897,12,36,12,True,True,0.9201333333333335,-0.198412
8570,6719987,93,8,0.706461,172,6744950,-1,4000.0,7054341,7054434,334354,93,148,6,True,True,8.061033333333334,-0.706461
8571,6720322,860,8,0.809952,172,6744950,-1,4000.0,7728516,7729376,1008194,860,127,2,True,True,83.82622222222223,-0.7580618092442667
8572,6720698,28,32,0.701145,172,6744950,-1,16000.0,10502094,10502122,3781396,28,69,1,True,True,12.983288888888888,-0.701145
8573,6720775,10084,1,0.502334,172,6744950,-1,500.0,12262594,12272678,5541819,10084,52,12,True,True,113.24823611111113,-0.5016447414481021
8574,6724918,7775,1,0.181188,172,6744950,-1,500.0,10370277,10378052,3645359,7775,72,12,True,True,132.6706986111111,-0.17549452757211126
8575,6750100,26,3,0.992552,206,6788150,-1,1500.0,6982362,6982388,232262,26,156,10,True,True,0.66105,-0.992552
8576,6753849,169,4,0.591196,206,6788150,-1,2000.0,9937177,9937346,3183328,169,78,11,True,True,5.530055555555555,-0.591196
8577,6756623,10137,16,0.634477,206,6788150,-1,8000.0,8412843,8422980,1656220,10137,111,7,True,True,2470.794,-0.5884948197177062
8578,6756733,11913,1,0.229384,206,6788150,-1,500.0,7260741,7272654,504008,11913,147,7,True,True,107.43182916666667,-0.1872788130583335
8579,6757768,2,4,0.132296,206,6788150,-1,2000.0,12354394,12354396,5596626,2,51,12,True,True,0.06287777777777778,-0.132296
8580,6759208,10,8,0.038366,206,6788150,-1,4000.0,8418243,8418253,1659035,10,112,8,True,True,1.0735555555555556,-0.038366
8581,6759419,51,8,0.990399,206,6788150,-1,4000.0,6811950,6812001,52531,51,175,7,True,True,2.3386333333333336,-0.990399
8582,6759463,20,32,0.929098,206,6788150,-1,16000.0,9084425,9084445,2324962,20,98,8,True,True,7.696888888888889,-0.929098
8583,6759475,9246,1,0.426303,206,6788150,-1,500.0,14807594,14816840,8048119,9246,26,12,True,True,326.84090555555554,-0.41868589719718186
8584,6759776,2755,1,0.616467,206,6788150,-1,500.0,6859956,6862711,100180,2755,174,1,True,True,34.97998333333334,-0.5672473209289054
8585,6760116,14,16,0.090935,206,6788150,-1,8000.0,14627194,14627208,7867078,14,29,12,True,True,4.004311111111111,-0.090935
8586,6760143,10204,8,0.050955,206,6788150,-1,4000.0,14189394,14199598,7429251,10204,33,12,True,True,911.1431333333333,-0.0503146628822569
8587,6760202,8,30,0.407297,206,6788150,-1,15000.0,15430171,15430179,8669969,8,15,12,True,True,5.819,-0.407297
8588,6760727,12352,4,0.306446,206,6788150,-1,2000.0,14100794,14113146,7340067,12352,36,11,True,True,761.8734000000001,-0.2961118449483451
8589,6760798,17,4,0.63331,206,6788150,-1,2000.0,10502077,10502094,3741279,17,77,7,True,True,0.9853388888888889,-0.63331
8590,6760809,91,32,0.231428,206,6788150,-1,16000.0,12613594,12613685,5852785,91,55,12,True,True,20.157511111111113,-0.231428
8591,6760837,5,8,0.336178,206,6788150,-1,4000.0,9362264,9362269,2601427,5,97,12,True,True,0.39050000000000007,-0.336178
8592,6760951,309,32,0.479195,206,6788150,-1,16000.0,9568564,9568873,2807613,309,94,12,True,True,105.86084444444447,-0.4785936106386869
8593,6761259,15,1,0.509864,206,6788150,-1,500.0,7347141,7347156,585882,15,159,11,True,True,0.14279166666666668,-0.509864
8594,6761321,23,2,0.643873,206,6788150,-1,1000.0,13131994,13132017,6370673,23,49,12,True,True,0.3972611111111111,-0.643873
8595,6761626,29,4,0.30429,206,6788150,-1,2000.0,9704977,9705006,2943351,29,91,11,True,True,0.9626388888888888,-0.30429
8596,6761885,5,2,0.269246,206,6788150,-1,1000.0,15118994,15118999,8357109,5,22,2,True,True,0.2767361111111111,-0.269246
8597,6762086,24,1,0.280556,206,6788150,-1,500.0,13785394,13785418,7023308,24,43,12,True,True,0.32903333333333334,-0.280556
8598,6762107,17051,8,0.351025,206,6788150,-1,4000.0,11914794,11931845,5152687,17051,68,8,True,True,1948.370511111111,-0.34545972539313397
8599,6762250,951,16,0.418074,206,6788150,-1,8000.0,10503194,10504145,3740944,951,81,6,True,True,220.48406666666665,-0.418074
8600,6762557,16076,1,0.319841,206,6788150,-1,500.0,9568877,9584953,2806320,16076,99,1,True,True,119.28564027777777,-0.31446639923430475
8601,6762605,22,4,0.047556,206,6788150,-1,2000.0,15208730,15208752,8446125,22,21,12,True,True,2.9867444444444446,-0.047556
8602,6762689,13406,8,0.040889,206,6788150,-1,4000.0,16463146,16476552,9700457,13406,1,11,True,True,1385.0895777777778,-0.04083631097089766
8603,6762751,645,1,0.052131,206,6788150,-1,500.0,14713594,14714239,7950843,645,33,12,True,True,8.759458333333333,-0.052131
8604,6762947,4452,4,0.744755,206,6788150,-1,2000.0,10024677,10029129,3261730,4452,93,6,True,True,119.87429999999998,-0.7188637598979963
8605,6763239,643,2,0.211978,206,6788150,-1,1000.0,11018394,11019037,4255155,643,79,12,True,True,16.97341388888889,-0.211978
8606,6763259,6866,64,0.472058,206,6788150,-1,32000.0,9796777,9803643,3033518,6866,98,11,True,True,3949.564533333333,-0.4510525752532514
8607,6763736,251,8,0.908482,206,6788150,-1,4000.0,8515225,8515476,1751489,251,129,2,True,True,20.275222222222226,-0.908482
8608,6764066,118,32,0.100762,206,6788150,-1,16000.0,11191194,11191312,4427128,118,78,12,True,True,43.6128,-0.100762
8609,6764140,11607,7,0.18484,206,6788150,-1,3500.0,14534994,14546601,7770854,11607,36,12,True,True,1922.7570541666666,-0.1811154770626363
8610,6792760,455,1,0.948328,250,6809750,-1,500.0,6859501,6859956,66741,455,200,11,True,True,6.278368055555555,-0.948328
8611,6792892,89,2,0.363581,250,6809750,-1,1000.0,10413477,10413566,3620585,89,91,11,True,True,2.9456527777777777,-0.363581
8612,6792903,2,8,0.304357,250,6809750,-1,4000.0,15120130,15120132,8327227,2,24,2,True,True,0.3941777777777778,-0.304357
8613,6792922,9391,8,0.096887,250,6809750,-1,4000.0,13698994,13708385,6906072,9391,49,11,True,True,1681.6993333333332,-0.09673978389223903
8614,6792964,41,4,0.013662,250,6809750,-1,2000.0,11218194,11218235,4425230,41,81,8,True,True,1.4652944444444445,-0.013662
8615,6792988,13,8,0.551768,250,6809750,-1,4000.0,10632794,10632807,3839806,13,90,11,True,True,1.3167555555555555,-0.551768
8616,6793046,25,1,0.861974,250,6809750,-1,500.0,8281018,8281043,1487972,25,147,7,True,True,0.16770833333333332,-0.861974
8617,6793120,1,64,0.331212,250,6809750,-1,32000.0,14275794,14275795,7482674,1,39,0,True,True,0.8745777777777778,-0.331212
8618,6793359,12183,4,0.741292,250,6809750,-1,2000.0,7922718,7934901,1129359,12183,158,9,True,True,291.7819,-0.5911632767643497
8619,6793507,94,2,0.361385,250,6809750,-1,1000.0,13965794,13965888,7172287,94,46,12,True,True,3.8775000000000004,-0.361385
8620,6793644,375,2,0.778808,250,6809750,-1,1000.0,8776625,8777000,1982981,375,134,11,True,True,6.011319444444444,-0.6683118404361833
8621,6793657,5,1,0.528862,250,6809750,-1,500.0,7727757,7727762,934100,5,171,7,True,True,0.05984722222222223,-0.528862
8622,6793690,13373,16,0.371592,250,6809750,-1,8000.0,10910394,10923767,4116704,13373,88,9,True,True,2999.3921777777778,-0.35945958356063323
8623,6794425,36,1,0.650248,250,6809750,-1,500.0,10899594,10899630,4105169,36,89,12,True,True,0.44605,-0.650248
8624,6794611,16,8,0.210033,250,6809750,-1,4000.0,16160746,16160762,9366135,16,5,11,True,True,3.724088888888889,-0.210033
8625,6794650,8,1,0.384049,250,6809750,-1,500.0,15115394,15115402,8320744,8,27,8,True,True,0.20041111111111112,-0.384049
8626,6794882,6903,16,0.887194,250,6809750,-1,8000.0,7258541,7265444,463659,6903,192,11,True,True,817.4838444444445,-0.8859996861514634
8627,6794897,9,4,0.130485,250,6809750,-1,2000.0,14448594,14448603,7653697,9,40,12,True,True,1.3414,-0.130485
8628,6795119,4,1,0.742587,250,6809750,-1,500.0,8127618,8127622,1332499,4,158,6,True,True,0.030377777777777778,-0.742587
8629,6795199,30161,62,0.120354,250,6809750,-1,31000.0,10589594,10619755,3794395,30161,98,12,True,True,23847.19967222222,-0.12027270790106676
8630,6795317,113,1,0.586561,250,6809750,-1,500.0,8278818,8278931,1483501,113,157,12,True,True,0.7233569444444445,-0.586561
8631,6795662,23,4,0.912177,250,6809750,-1,2000.0,7493357,7493380,697695,23,186,11,True,True,0.8165,-0.912177
8632,6795678,11543,4,0.654355,250,6809750,-1,2000.0,7879737,7891280,1084059,11543,175,1,True,True,278.56974444444444,-0.5565440848731729
8633,6795730,72,16,0.190434,250,6809750,-1,8000.0,9893977,9894049,3098247,72,112,9,True,True,13.9104,-0.190434
8634,6795780,240,4,0.70466,250,6809750,-1,2000.0,11212794,11213034,4417014,240,87,10,True,True,8.206666666666667,-0.70466
8635,6796706,8,32,0.925501,250,6809750,-1,16000.0,10132677,10132685,3335971,8,109,10,True,True,0.9333333333333333,-0.925501
8636,6797232,9963,1,0.07488,250,6809750,-1,500.0,12527194,12537157,5729962,9963,70,12,True,True,68.6203,-0.07388902512183078
8637,6797280,18,2,0.546579,250,6809750,-1,1000.0,11563794,11563812,4766514,18,85,12,True,True,0.19755,-0.546579
8638,6797293,62,8,0.342898,250,6809750,-1,4000.0,6952762,6952824,155469,62,219,10,True,True,10.697755555555554,-0.342898
8639,6797647,13965,128,0.725351,250,6809750,-1,64000.0,9272264,9286229,2474617,13965,133,3,True,True,21240.958044444444,-0.7147099969712751
8640,6797758,1656,1,0.989645,250,6809750,-1,500.0,8884625,8886281,2086867,1656,145,12,True,True,8.251270833333333,-0.9397460036198316
8641,6797788,16,1,0.201999,250,6809750,-1,500.0,15698371,15698387,8900583,16,13,12,True,True,0.5895555555555556,-0.201999
8642,6797820,77,16,0.720769,250,6809750,-1,8000.0,9384964,9385041,2587144,77,131,10,True,True,15.928733333333334,-0.720769
8643,6797940,56,1,0.043811,250,6809750,-1,500.0,14537194,14537250,7739254,56,40,7,True,True,1.3561333333333334,-0.043811
8644,6801335,5109,64,0.191707,250,6809750,-1,32000.0,11304594,11309703,4503259,5109,90,12,True,True,2300.895466666667,-0.18878709160618637
8645,6801695,17432,1,0.550496,250,6809750,-1,500.0,12354394,12371826,5552699,17432,74,0,True,True,242.3242361111111,-0.5224512504590972
8646,6801769,11,1,0.252526,250,6809750,-1,500.0,11960194,11960205,5158425,11,82,11,True,True,0.10928194444444445,-0.252526
8647,6801804,22853,35,0.877075,250,6809750,-1,17500.0,7303941,7326794,502137,22853,210,11,True,True,8189.465958333333,-0.7911045921505657
8648,6801841,23,32,0.853438,250,6809750,-1,16000.0,6914911,6914934,113070,23,233,11,True,True,4.174755555555556,-0.853438
8649,6802457,5,2,0.906815,250,6809750,-1,1000.0,6871711,6871716,69254,5,234,8,True,True,0.1365,-0.906815
8650,6802703,23827,1,0.975126,250,6809750,-1,500.0,7793316,7817143,990613,23827,191,11,True,True,603.4060166666667,-0.9686052360677966
8651,6802844,5402,1,0.894913,250,6809750,-1,500.0,6816301,6821703,13457,5402,241,6,True,True,32.08133888888889,-0.7810237337623789
8652,6808475,12039,1,0.448482,250,6809750,-1,500.0,10283877,10295916,3475402,12039,113,0,True,True,170.109825,-0.444855877795026
8653,6808515,225,16,0.717326,250,6809750,-1,8000.0,7910737,7910962,1102222,225,185,6,True,True,19.5,-0.717326
8654,6809122,42,1,0.910849,250,6809750,-1,500.0,9482164,9482206,2673042,42,134,12,True,True,0.7438083333333334,-0.910849
8655,6809142,3938,1,0.067708,250,6809750,-1,500.0,15941146,15945084,9132004,3938,9,12,True,True,126.57553055555556,-0.06601399133717889
8656,6809863,679,1,0.419004,251,6811950,-1,500.0,6987762,6988441,177899,679,229,8,True,True,5.271680555555555,-0.419004
8657,6810153,9066,32,0.931332,251,6811950,-1,16000.0,8367443,8376509,1557290,9066,171,12,True,True,1306.9794666666667,-0.9186252059655045
6872,5320285,20178,32,0.782156,1,5320285,-1,16000.0,5406685,5426863,86400,20178,0,12,True,True,13202.802622222222,-0.7762699374972106
6873,5320299,5629,1,0.947383,130,5406685,-1,500.0,6225427,6231056,905128,5629,0,8,True,True,90.60364583333333,-0.9429793687246111
6874,5320322,43,1,0.82361,130,5406685,-1,500.0,6448027,6448070,1127705,43,0,11,True,True,0.6375944444444445,-0.82361
6875,5320330,6210,64,0.041969,130,5406685,-1,32000.0,14293066,14299276,8972736,6210,0,1,True,True,5626.750577777778,-0.040789739186274064
6876,5320417,54,8,0.105411,130,5406685,-1,4000.0,8581293,8581347,3260876,54,1,11,True,True,9.5826,-0.105411
6877,5320442,4531,11,0.629926,130,5406685,-1,5500.0,8797293,8801824,3476851,4531,1,11,True,True,440.87353749999994,-0.6230179847583442
6878,5320811,78,1,0.870869,130,5406685,-1,500.0,5987066,5987144,666255,78,5,12,True,True,0.7073083333333334,-0.870869
6879,5326366,3,16,0.910986,130,5406685,-1,8000.0,7312522,7312525,1986156,3,3,10,True,True,0.7152666666666667,-0.910986
6880,5326406,82,2,0.157033,130,5406685,-1,1000.0,13768866,13768948,8442460,82,1,12,True,True,3.381361111111111,-0.157033
6881,5326414,738,1,0.292123,130,5406685,-1,500.0,7944093,7944831,2617679,738,4,11,True,True,16.097625,-0.292123
6882,5326463,8,4,0.441518,130,5406685,-1,2000.0,8883693,8883701,3557230,8,2,12,True,True,0.4833777777777778,-0.441518
6883,5326490,27824,32,0.505897,130,5406685,-1,16000.0,8926893,8954717,3600403,27824,2,11,True,True,9986.200444444446,-0.5054684318435394
6884,5326642,8,1,0.732552,130,5406685,-1,500.0,5625974,5625982,299332,8,11,1,True,True,0.1319,-0.732552
6885,5326650,12078,75,0.099294,130,5406685,-1,37500.0,14638666,14650744,9312016,12078,0,12,True,True,7867.787916666666,-0.09926758849093179
6886,5326702,2168,1,0.647093,130,5406685,-1,500.0,5623806,5625974,297104,2168,13,1,True,True,35.744899999999994,-0.647093
6887,5326733,123,16,0.334608,130,5406685,-1,8000.0,11189784,11189907,5863051,123,3,0,True,True,16.39453333333333,-0.334608
6888,5326785,41,64,0.137772,130,5406685,-1,32000.0,10023324,10023365,4696539,41,4,7,True,True,80.05386666666666,-0.137772
6889,5326885,9,21,0.848595,130,5406685,-1,10500.0,7783533,7783542,2456648,9,10,12,True,True,5.0859375,-0.848595
6890,5327312,15,32,0.439108,130,5406685,-1,16000.0,7449733,7449748,2122421,15,11,12,True,True,7.263999999999999,-0.439108
6891,5329574,6132,123,0.41575,130,5406685,-1,61500.0,7494033,7500165,2164459,6132,11,6,True,True,14175.8950375,-0.3973877010063033
6892,5329625,78,4,0.769033,130,5406685,-1,2000.0,5691974,5692052,362349,78,17,11,True,True,7.417800000000001,-0.769033
6893,5329685,3044,1,0.245316,130,5406685,-1,500.0,10930584,10933628,5600899,3044,4,12,True,True,44.53100555555556,-0.23502848030546833
6894,5329717,4,1,0.809145,130,5406685,-1,500.0,6606082,6606086,1276365,4,15,11,True,True,0.07572777777777778,-0.809145
6895,5329743,52,16,0.34132,130,5406685,-1,8000.0,8062893,8062945,2733150,52,10,10,True,True,21.229866666666666,-0.34132
6896,5329758,22,16,0.505023,130,5406685,-1,8000.0,12357266,12357288,7027508,22,3,12,True,True,8.9496,-0.505023
6897,5329929,64,8,0.085234,130,5406685,-1,4000.0,11103384,11103448,5773455,64,5,12,True,True,3.1637333333333335,-0.085234
6898,5329953,19403,32,0.372436,130,5406685,-1,16000.0,13943866,13963269,8613913,19403,2,12,True,True,16962.897022222223,-0.3690427365064116
6899,5329987,18,1,0.754845,130,5406685,-1,500.0,7289822,7289840,1959835,18,19,10,True,True,0.24125,-0.754845
6900,5330013,41,1,0.360643,130,5406685,-1,500.0,11189784,11189825,5859771,41,6,0,True,True,0.34155277777777776,-0.360643
6901,5330215,11785,4,0.664995,130,5406685,-1,2000.0,5867556,5879341,537341,11785,25,10,True,True,755.2453277777777,-0.6562103290104223
6902,5330225,41,4,0.151611,130,5406685,-1,2000.0,7900893,7900934,2570668,41,16,8,True,True,4.061961111111112,-0.151611
6903,5330796,12039,128,0.753507,130,5406685,-1,64000.0,9670124,9682163,4339328,12039,10,10,True,True,31672.108977777778,-0.7458826863050703
6904,5331322,6,3,0.421722,130,5406685,-1,1500.0,6561782,6561788,1230460,6,24,8,True,True,0.241175,-0.421722
6905,5331339,5,2,0.228182,130,5406685,-1,1000.0,7580433,7580438,2249094,5,19,12,True,True,0.2067638888888889,-0.228182
6906,5331402,7,1,0.801769,130,5406685,-1,500.0,6821092,6821099,1489690,7,24,1,True,True,0.12782777777777776,-0.801769
6907,5331500,12101,32,0.413409,130,5406685,-1,16000.0,13245066,13257167,7913566,12101,4,12,True,True,5987.720488888888,-0.41318362913720397
6908,5331724,2922,1,0.409309,130,5406685,-1,500.0,6218927,6221849,887203,2922,30,10,True,True,63.697151388888884,-0.37946054966520754
6909,5332028,13055,64,0.458753,130,5406685,-1,32000.0,11654584,11667639,6322556,13055,6,7,True,True,22921.088177777776,-0.4458126962082918
6910,5332161,81,32,0.85239,130,5406685,-1,16000.0,6009781,6009862,677620,81,32,1,True,True,45.010799999999996,-0.85239
6911,5332646,86,1,0.794607,130,5406685,-1,500.0,9648524,9648610,4315878,86,13,1,True,True,2.107,-0.794607
6912,5332815,13,62,0.361774,130,5406685,-1,31000.0,7691733,7691746,2358918,13,22,8,True,True,9.680955555555556,-0.361774
6913,5332881,34,4,0.029763,130,5406685,-1,2000.0,12590566,12590600,7257685,34,5,11,True,True,0.6987000000000001,-0.029763
6914,5333114,8162,1,0.145584,130,5406685,-1,500.0,6639286,6647448,1306172,8162,30,7,True,True,118.22354722222221,-0.14057833125592709
6915,5333205,8,1,0.009949,130,5406685,-1,500.0,6562882,6562890,1229677,8,32,6,True,True,0.09862222222222222,-0.009949
6916,5333254,19,1,0.806247,130,5406685,-1,500.0,6924629,6924648,1591375,19,29,11,True,True,0.3109402777777778,-0.806247
6917,5335249,15,1,0.943643,130,5406685,-1,500.0,6009766,6009781,674517,15,39,10,True,True,0.26047916666666665,-0.943643
6918,5335270,6733,64,0.084778,130,5406685,-1,32000.0,11276184,11282917,5940914,6733,8,12,True,True,6507.116622222222,-0.07906578813129557
6919,5335279,3,32,0.314805,130,5406685,-1,16000.0,7073029,7073032,1737750,3,30,8,True,True,1.3496000000000001,-0.314805
6920,5340417,383,2,0.981945,130,5406685,-1,1000.0,6317327,6317710,976910,383,38,7,True,True,11.109127777777779,-0.981945
6921,5340511,14931,4,0.164325,130,5406685,-1,2000.0,12182266,12197197,6841755,14931,7,12,True,True,1542.0014888888888,-0.16090186709645898
6922,5340780,110,6,0.061468,130,5406685,-1,3000.0,13857466,13857576,8516686,110,3,12,True,True,14.230333333333332,-0.061468000000000016
6923,5340881,12,1,0.759192,130,5406685,-1,500.0,5602192,5602204,261311,12,50,11,True,True,0.2521333333333334,-0.759192
6924,5340988,39962,32,0.660176,130,5406685,-1,16000.0,10152984,10192946,4811996,39962,15,1,True,True,20495.851555555553,-0.6548575147884181
6925,5344910,8897,8,0.641466,130,5406685,-1,4000.0,9756524,9765421,4411614,8897,17,12,True,True,2134.7948,-0.6403779294805042
6926,5344928,82,2,0.902511,130,5406685,-1,1000.0,5831774,5831856,486846,82,49,11,True,True,3.037188888888889,-0.902511
6927,5345018,18384,32,0.05781,130,5406685,-1,16000.0,14725066,14743450,9380048,18384,0,12,True,True,16215.623022222222,-0.055480703632997216
6928,5345307,137,1,0.631608,130,5406685,-1,500.0,9259593,9259730,3914286,137,21,8,True,True,1.8217194444444444,-0.631608
6929,5346560,21193,5,0.71337,130,5406685,-1,2500.0,6404827,6426020,1058267,21193,44,6,True,True,1136.6416458333333,-0.6584170157815505
6930,5346791,429,4,0.660362,130,5406685,-1,2000.0,10325784,10326213,4978993,429,16,12,True,True,24.18845,-0.660362
6931,5347388,67,4,0.519778,130,5406685,-1,2000.0,5889256,5889323,541868,67,52,1,True,True,3.0384499999999997,-0.519778
6932,5347761,27299,2,0.295724,130,5406685,-1,1000.0,7697133,7724432,2349372,27299,31,8,True,True,663.3820638888888,-0.2930793945236974
6933,5347929,6468,64,0.402003,130,5406685,-1,32000.0,11189784,11196252,5841855,6468,12,0,True,True,3265.2789333333335,-0.25616268651496604
6934,5348178,7111,2,0.680871,130,5406685,-1,1000.0,7954893,7962004,2606715,7111,29,9,True,True,322.07946666666663,-0.6765981395470145
6935,5348221,13489,128,0.55361,130,5406685,-1,64000.0,9196593,9210082,3848372,13489,24,12,True,True,31016.356444444442,-0.5465283996652862
6936,5348239,5,8,0.304323,130,5406685,-1,4000.0,12009466,12009471,6661227,5,10,7,True,True,1.2031111111111112,-0.304323
6937,5351461,8142,14,0.742698,130,5406685,-1,7000.0,5875156,5883298,523695,8142,58,8,True,True,1532.6450222222225,-0.6439571145612719
6938,5351872,9,16,0.909231,130,5406685,-1,8000.0,5514685,5514694,162813,9,65,10,True,True,2.454,-0.909231
6939,5352215,331,1,0.007902,130,5406685,-1,500.0,10021124,10021455,4668909,331,21,12,True,True,10.712906944444445,-0.007902
6940,5352494,6,38,0.279781,130,5406685,-1,19000.0,12268666,12268672,6916172,6,9,12,True,True,8.771033333333335,-0.279781
6941,5354007,20,4,0.527792,130,5406685,-1,2000.0,9200193,9200213,3846186,20,27,1,True,True,1.5518888888888889,-0.527792
6942,5354320,591,1,0.920451,130,5406685,-1,500.0,5631374,5631965,277054,591,65,8,True,True,9.904174999999999,-0.920451
6943,5365988,59,1,0.700295,130,5406685,-1,500.0,6611886,6611945,1245898,59,49,2,True,True,0.868201388888889,-0.700295
6944,5366909,14,8,0.446189,130,5406685,-1,4000.0,5623792,5623806,256883,14,69,10,True,True,1.8465999999999998,-0.446189
6945,5368060,28288,32,0.205134,130,5406685,-1,16000.0,8927993,8956281,3559933,28288,29,6,True,True,10125.250755555555,-0.20480995316610595
6946,5368628,29,4,0.544425,130,5406685,-1,2000.0,8278893,8278922,2910265,29,34,12,True,True,2.092672222222222,-0.544425
6947,5368861,25820,32,0.788342,130,5406685,-1,16000.0,7580433,7606253,2211572,25820,42,0,True,True,15701.787333333335,-0.7599500456644511
6948,5369672,15,16,0.652037,130,5406685,-1,8000.0,7808742,7808757,2439070,15,39,1,True,True,3.4036666666666666,-0.652037
6949,5370616,1305,1,0.697471,130,5406685,-1,500.0,9561993,9563298,4191377,1305,26,12,True,True,29.630749999999995,-0.697471
6950,5370641,67,16,0.887675,130,5406685,-1,8000.0,5493085,5493152,122444,67,77,12,True,True,21.161577777777776,-0.887675
6951,5370673,44,32,0.781563,130,5406685,-1,16000.0,8192493,8192537,2821820,44,36,12,True,True,23.66417777777778,-0.781563
6952,5371268,13678,10,0.404506,130,5406685,-1,5000.0,6725686,6739364,1354418,13678,54,11,True,True,3330.817666666667,-0.40128985301822273
6953,5372935,449,1,0.197296,130,5406685,-1,500.0,7041329,7041778,1668394,449,52,6,True,True,7.3841472222222215,-0.17768267641644242
6954,5373410,98,64,0.301531,130,5406685,-1,32000.0,14030266,14030364,8656856,98,3,12,True,True,188.62168888888888,-0.301531
6955,5378120,396,13,0.03697,130,5406685,-1,6500.0,7363333,7363729,1985213,396,50,7,True,True,109.2949,-0.03697
6956,5388412,6,1,0.334493,130,5406685,-1,500.0,6817486,6817492,1429074,6,57,12,True,True,0.09270833333333334,-0.334493
6957,5388565,8152,2,0.725099,130,5406685,-1,1000.0,7040229,7048381,1651664,8152,55,8,True,True,233.21423888888893,-0.6623234068946959
6958,5389569,16113,2,0.740052,130,5406685,-1,1000.0,6865392,6881505,1475823,16113,57,6,True,True,652.6335416666666,-0.7392452925549066
6959,5389584,10674,128,0.126006,130,5406685,-1,64000.0,13115466,13126140,7725882,10674,8,11,True,True,12537.04,-0.10462938030438289
6960,5389601,1979,4,0.991924,130,5406685,-1,2000.0,6556382,6558361,1166781,1979,67,8,True,True,94.70614444444445,-0.991924
6961,5389650,26581,155,0.283928,130,5406685,-1,77500.0,14203066,14229647,8813416,26581,3,12,True,True,72636.06770833333,-0.2789157048335256
6962,5391038,45,1,0.09282,130,5406685,-1,500.0,6096181,6096226,705143,45,74,12,True,True,0.853,-0.09282
6963,5391101,5394,8,0.551786,130,5406685,-1,4000.0,6731086,6736480,1339985,5394,62,8,True,True,1035.0077777777776,-0.5458074986907331
6964,5391112,6,4,0.521336,130,5406685,-1,2000.0,9254193,9254199,3863081,6,31,9,True,True,0.3192333333333333,-0.521336
6965,5391518,27437,32,0.757046,130,5406685,-1,16000.0,6491227,6518664,1099709,27437,71,11,True,True,11392.923377777777,-0.741365872934953
6966,5391702,8,12,0.160027,130,5406685,-1,6000.0,11920866,11920874,6529164,8,15,12,True,True,1.869333333333333,-0.160027
6967,5391780,16,1,0.027891,130,5406685,-1,500.0,5699974,5699990,308194,16,86,6,True,True,0.3383555555555555,-0.027891
6968,5391840,32318,256,0.796599,130,5406685,-1,128000.0,6518664,6550982,1126824,32318,72,3,True,True,123577.5416888889,-0.7830842573837473
6969,5391868,7,1,0.592504,130,5406685,-1,500.0,5557885,5557892,166017,7,94,10,True,True,0.14264444444444443,-0.592504
6970,5391915,8,16,0.24134,130,5406685,-1,8000.0,11652384,11652392,6260469,8,17,0,True,True,4.410488888888889,-0.24134
6971,5391923,81,1,0.774158,130,5406685,-1,500.0,5842656,5842737,450733,81,87,9,True,True,1.3690125,-0.774158
6972,5392042,21,8,0.726509,130,5406685,-1,4000.0,7339533,7339554,1947491,21,56,1,True,True,3.442366666666667,-0.726509
6973,5394059,27,8,0.986955,130,5406685,-1,4000.0,6499227,6499254,1105168,27,75,2,True,True,2.2953,-0.986955
6974,5394249,11103,32,0.110442,130,5406685,-1,16000.0,8041293,8052396,2647044,11103,44,12,True,True,9086.013733333333,-0.10952708975419366
6975,5394560,7298,14,0.059946,130,5406685,-1,7000.0,12444766,12452064,7050206,7298,11,12,True,True,2339.3138611111112,-0.05465062330963424
6976,5394817,14571,2,0.372979,130,5406685,-1,1000.0,11656784,11671355,6261967,14571,17,7,True,True,739.445438888889,-0.3404001789786498
6977,5394829,50,2,0.62699,130,5406685,-1,1000.0,6197327,6197377,802498,50,85,11,True,True,1.788611111111111,-0.62699
6978,5394850,119,1,0.354473,130,5406685,-1,500.0,6495627,6495746,1100777,119,79,7,True,True,1.027697222222222,-0.354473
6979,5394947,10210,61,0.047733,130,5406685,-1,30500.0,10757784,10767994,5362837,10210,26,12,True,True,4642.419233333332,-0.04683358721746794
6980,5395042,13069,128,0.650962,130,5406685,-1,64000.0,5536285,5549354,141243,13069,105,10,True,True,31722.964977777774,-0.6355948543657174
6981,5395051,13,1,0.12475,130,5406685,-1,500.0,11189784,11189797,5794733,13,24,12,True,True,0.10829722222222221,-0.12475
6982,5404216,108,8,0.297961,130,5406685,-1,4000.0,7034829,7034937,1630613,108,67,10,True,True,14.3076,-0.297961
6983,5404231,12590,4,0.736859,130,5406685,-1,2000.0,6493427,6506017,1089196,12590,83,7,True,True,532.8918444444444,-0.6563415678151141
6984,5404251,19571,32,0.453147,130,5406685,-1,16000.0,5880956,5900527,476705,19571,96,7,True,True,7314.017466666666,-0.4291989230944751
6985,5404355,423,1,0.982951,130,5406685,-1,500.0,6926829,6927252,1522474,423,68,7,True,True,6.4108,-0.982951
6986,5404531,3,32,0.805388,130,5406685,-1,16000.0,6550982,6550985,1146451,3,81,7,True,True,1.4786666666666668,-0.805388
6987,5404663,8273,256,0.989,130,5406685,-1,128000.0,7095422,7103695,1690759,8273,64,10,True,True,42622.803911111114,-0.879990470497883
6988,5404726,360,1,0.565597,130,5406685,-1,500.0,7013229,7013589,1608503,360,69,12,True,True,4.441,-0.565597
6989,5404883,1167,32,0.894339,130,5406685,-1,16000.0,6220027,6221194,815144,1167,93,6,True,True,817.8819555555556,-0.8330047931938103
6990,5405062,5649,1,0.627744,130,5406685,-1,500.0,8931593,8937242,3526531,5649,40,2,True,True,69.30046944444445,-0.6277085111088145
6991,5405093,38,1,0.533289,130,5406685,-1,500.0,7686333,7686371,2281240,38,57,11,True,True,0.39435555555555557,-0.533289
6992,5405279,2611,6,0.595549,130,5406685,-1,3000.0,7580433,7583044,2175154,2611,58,0,True,True,315.95024166666667,-0.5809026765046589
6993,5405300,6178,1,0.350337,130,5406685,-1,500.0,13072266,13078444,7666966,6178,10,6,True,True,178.84365,-0.3423546934642271
6994,5405341,13,32,0.284535,130,5406685,-1,16000.0,6311827,6311840,906486,13,96,12,True,True,5.602711111111111,-0.284535
6995,5405392,6561,1,0.784789,130,5406685,-1,500.0,8667693,8674254,3262301,6561,46,12,True,True,92.124,-0.6934973203392335
6996,5405421,11,5,0.714854,130,5406685,-1,2500.0,7339522,7339533,1934101,11,67,8,True,True,1.1269652777777779,-0.714854
6997,5405739,13037,8,0.672434,130,5406685,-1,4000.0,5788574,5801611,382835,13037,113,12,True,True,1768.6009888888889,-0.6566920394239645
6998,5405856,10708,4,0.714351,130,5406685,-1,2000.0,5694174,5704882,288318,10708,115,7,True,True,947.0955222222223,-0.6940358281976207
6999,5406099,4,4,0.519667,130,5406685,-1,2000.0,9929324,9929328,4523225,4,33,12,True,True,0.43435555555555555,-0.519667
7000,5406479,9453,64,0.247633,130,5406685,-1,32000.0,12855166,12864619,7448687,9453,11,8,True,True,19298.394933333337,-0.21316424504480605
7001,5406487,7846,2,0.327847,130,5406685,-1,1000.0,6817492,6825338,1411005,7846,82,1,True,True,294.69163333333336,-0.3250764787169646
7002,5406499,17137,16,0.582369,130,5406685,-1,8000.0,6864292,6881429,1457793,17137,81,10,True,True,5533.819355555556,-0.5808536299964888
7003,5407008,60,32,0.822843,196,5493085,-1,16000.0,10152924,10152984,4745916,60,32,0,True,True,26.41333333333333,-0.822843
7004,5408337,30,1,0.361268,196,5493085,-1,500.0,10412184,10412214,5003847,30,30,12,True,True,0.3595833333333333,-0.361268
7005,5408442,13751,4,0.097988,196,5493085,-1,2000.0,10152924,10166675,4744482,13751,34,11,True,True,797.3751666666666,-0.09462844578025568
7006,5408570,39,2,0.71164,196,5493085,-1,1000.0,5558992,5559031,150422,39,129,6,True,True,1.2933916666666667,-0.71164
7007,5408757,11264,1,0.828438,196,5493085,-1,500.0,7042429,7053693,1633672,11264,77,6,True,True,173.77598472222223,-0.7737118939530395
7008,5408765,62,16,0.081947,196,5493085,-1,8000.0,13158666,13158728,7749901,62,9,11,True,True,9.564533333333333,-0.081947
7009,5408895,18,14,0.062194,196,5493085,-1,7000.0,14465866,14465884,9056971,18,2,12,True,True,1.4119000000000002,-0.062194
7010,5409161,8,71,0.888509,196,5493085,-1,35500.0,7783542,7783550,2374381,8,63,1,True,True,15.284722222222221,-0.888509
7011,5420634,14037,16,0.476253,196,5493085,-1,8000.0,8106093,8120130,2685459,14037,57,11,True,True,5044.2774,-0.46880031514078063
7012,5422871,157,16,0.446164,196,5493085,-1,8000.0,11746784,11746941,6323913,157,21,12,True,True,49.0354,-0.44571154055195666
7013,5422941,8321,16,0.369294,196,5493085,-1,8000.0,12007266,12015587,6584325,8321,20,12,True,True,3347.5096666666664,-0.3453681726417655
7014,5477459,2,8,0.526256,196,5493085,-1,4000.0,6360527,6360529,883068,2,111,11,True,True,0.17737777777777777,-0.526256
7015,5477492,47,4,0.588239,196,5493085,-1,2000.0,6314027,6314074,836535,47,113,7,True,True,2.5319944444444444,-0.588239
7016,5477898,6728,1,0.518945,196,5493085,-1,500.0,7583733,7590461,2105835,6728,71,7,True,True,137.0319875,-0.5145444760883435
7017,5477922,13,32,0.394782,196,5493085,-1,16000.0,11362584,11362597,5884662,13,26,12,True,True,8.570755555555555,-0.394782
7018,5478470,419,8,0.263694,196,5493085,-1,4000.0,10671384,10671803,5192914,419,35,12,True,True,40.36832222222222,-0.263694
7019,5478503,40,16,0.498827,196,5493085,-1,8000.0,7581533,7581573,2103030,40,74,6,True,True,13.23288888888889,-0.498827
7020,5478704,24,15,0.423422,196,5493085,-1,7500.0,9110193,9110217,3631489,24,52,7,True,True,4.523,-0.423422
7021,5478751,62,2,0.44008,196,5493085,-1,1000.0,11652384,11652446,6173633,62,26,12,True,True,4.272661111111111,-0.44008
7022,5479037,2589,2,0.931036,196,5493085,-1,1000.0,6608286,6610875,1129249,2589,105,7,True,True,87.27710833333333,-0.8289141537516769
7023,5479188,71,1,0.489541,196,5493085,-1,500.0,7181822,7181893,1702634,71,87,12,True,True,1.0487291666666665,-0.489541
7024,5479215,588,8,0.973272,196,5493085,-1,4000.0,6403727,6404315,924512,588,119,11,True,True,69.8936,-0.973272
7025,5479876,5033,32,0.823812,196,5493085,-1,16000.0,8538093,8543126,3058217,5033,61,12,True,True,4658.951866666666,-0.8164659387428602
7026,5479895,11349,1,0.144346,196,5493085,-1,500.0,13331466,13342815,7851571,11349,9,12,True,True,334.056925,-0.14101114293874242
7027,5480199,37,3,0.127124,196,5493085,-1,1500.0,12358366,12358403,6878167,37,17,6,True,True,2.822175,-0.127124
7028,5480208,151,1,0.711151,196,5493085,-1,500.0,6842692,6842843,1362484,151,102,10,True,True,2.288908333333333,-0.711151
7029,5480252,1035,2,0.129385,196,5493085,-1,1000.0,11748041,11749076,6267789,1035,24,6,True,True,40.448375,-0.129385
7030,5480313,14,32,0.704525,196,5493085,-1,16000.0,5646574,5646588,166261,14,147,7,True,True,8.129333333333333,-0.704525
7031,5480362,4,1,0.863272,196,5493085,-1,500.0,10584984,10584988,5104622,4,40,12,True,True,0.0936388888888889,-0.863272
7032,5480469,3,4,0.118058,196,5493085,-1,2000.0,12536566,12536569,7056097,3,16,12,True,True,0.21698333333333333,-0.118058
7033,5480759,566,16,0.212643,196,5493085,-1,8000.0,11560584,11561150,6079825,566,31,2,True,True,106.44573333333334,-0.212643
7034,5485254,131,2,0.473356,196,5493085,-1,1000.0,9648393,9648524,4163139,131,54,12,True,True,6.419,-0.473356
7035,5485298,15703,245,0.746496,196,5493085,-1,122500.0,6881429,6897132,1396131,15703,105,8,True,True,78623.47436805557,-0.7461000634651649
7036,5485316,3332,8,0.94407,196,5493085,-1,4000.0,5898466,5901798,413150,3332,142,7,True,True,338.3548888888889,-0.8815857904150727
7037,5486882,13,5,0.369332,196,5493085,-1,2500.0,9475593,9475606,3988711,13,56,12,True,True,1.3968680555555553,-0.369332
7038,5486925,10610,19,0.951822,196,5493085,-1,9500.0,5885656,5896266,398731,10610,145,6,True,True,2287.9639555555555,-0.9160549866614981
7039,5487043,7,26,0.6016,196,5493085,-1,13000.0,6637086,6637093,1150043,7,116,2,True,True,2.4115,-0.6016
7040,5487080,10179,3,0.40862,196,5493085,-1,1500.0,11448984,11459163,5961904,10179,32,12,True,True,523.739225,-0.39458040839499386
7041,5487115,84,1,0.120866,196,5493085,-1,500.0,12547366,12547450,7060251,84,16,0,True,True,1.27995,-0.120866
7042,5487163,45,6,0.571765,196,5493085,-1,3000.0,11016984,11017029,5529821,45,41,12,True,True,1.4006250000000002,-0.571765
7043,5487270,308,31,0.040282,196,5493085,-1,15500.0,9243393,9243701,3756123,308,62,11,True,True,151.3225388888889,-0.040282
7044,5487342,177,4,0.153305,196,5493085,-1,2000.0,12547366,12547543,7060024,177,17,9,True,True,10.788149999999998,-0.153305
7045,5487359,26976,32,0.371467,196,5493085,-1,16000.0,11535384,11562360,6048025,26976,34,12,True,True,11898.090666666667,-0.3651391642037737
7046,5487843,2,1,0.99102,196,5493085,-1,500.0,5648774,5648776,160931,2,162,7,True,True,0.04230833333333334,-0.99102
7047,5490421,5,1,0.30326,196,5493085,-1,500.0,12676966,12676971,7186545,5,15,12,True,True,0.02770138888888889,-0.30326
7048,5490572,21,2,0.485926,196,5493085,-1,1000.0,12095866,12095887,6605294,21,25,12,True,True,1.1578,-0.485926
7049,5490962,111,4,0.791204,196,5493085,-1,2000.0,5702174,5702285,211212,111,161,6,True,True,9.389366666666666,-0.791204
7050,5491084,157,4,0.14214,196,5493085,-1,2000.0,11565984,11566141,6074900,157,35,8,True,True,6.699538888888889,-0.14214
7051,5491425,61,1,0.589624,196,5493085,-1,500.0,6502827,6502888,1011402,61,134,2,True,True,0.7137847222222223,-0.589624
7052,5491435,11921,1,0.048651,196,5493085,-1,500.0,7290922,7302843,1799487,11921,104,6,True,True,163.5449763888889,-0.04854380631395843
7053,5491457,33,16,0.894253,196,5493085,-1,8000.0,5831856,5831889,340399,33,162,1,True,True,9.778266666666667,-0.894253
7054,5491562,13,16,0.889057,196,5493085,-1,8000.0,7334122,7334135,1842560,13,103,10,True,True,4.9504,-0.889057
7055,5491583,3979,4,0.215581,196,5493085,-1,2000.0,5695274,5699253,203691,3979,168,6,True,True,364.9047222222222,-0.21523036798120873
7056,5491672,6016,16,0.819125,196,5493085,-1,8000.0,7268222,7274238,1776550,6016,107,12,True,True,1649.8838666666666,-0.7973833313729513
7057,5491709,6190,14,0.488794,196,5493085,-1,7000.0,7637733,7643923,2146024,6190,93,9,True,True,1191.546027777778,-0.4678348611662503
7058,5491949,14,16,0.122328,196,5493085,-1,8000.0,5988166,5988180,496217,14,157,6,True,True,2.0312444444444444,-0.122328
7059,5491967,22,5,0.348649,196,5493085,-1,2500.0,9302793,9302815,3810826,22,65,11,True,True,1.4153333333333336,-0.348649
7060,5491982,9,32,0.870427,196,5493085,-1,16000.0,5644374,5644383,152392,9,177,9,True,True,4.7084,-0.870427
7061,5492093,656,13,0.417575,196,5493085,-1,6500.0,5869756,5870412,377663,656,165,0,True,True,143.9929111111111,-0.417575
7062,5492111,86,6,0.573059,196,5493085,-1,3000.0,5701074,5701160,208963,86,172,6,True,True,10.911966666666666,-0.573059
7063,5492209,66,4,0.565764,196,5493085,-1,2000.0,7361133,7361199,1868924,66,103,10,True,True,6.248,-0.565764
7064,5492297,16,2,0.900287,196,5493085,-1,1000.0,6633486,6633502,1141189,16,132,0,True,True,0.41053333333333336,-0.900287
7065,5492396,13696,10,0.781349,196,5493085,-1,5000.0,6633486,6647182,1141090,13696,133,10,True,True,1900.6157222222223,-0.7615678945911714
7066,5492736,12909,32,0.475228,196,5493085,-1,16000.0,11660384,11673293,6167648,12909,31,1,True,True,9733.394933333333,-0.43372062819946794
7067,5492746,6972,4,0.720033,196,5493085,-1,2000.0,5698874,5705846,206128,6972,178,2,True,True,591.9936333333333,-0.7199112704507034
7068,5492762,7019,8,0.60571,196,5493085,-1,4000.0,8365293,8372312,2872531,7019,81,12,True,True,1236.4371555555556,-0.5980259712338758
7069,5492799,67,8,0.761951,196,5493085,-1,4000.0,6154127,6154194,661328,67,160,8,True,True,11.051277777777775,-0.761951
7070,5493423,5372,16,0.504764,234,5514685,-1,8000.0,10498584,10503956,5005161,5372,52,12,True,True,1684.0577777777778,-0.4996555826562118
7071,5493530,88,13,0.460936,234,5514685,-1,6500.0,8451693,8451781,2958163,88,82,12,True,True,22.072844444444442,-0.460936
7072,5493769,13421,1,0.449929,234,5514685,-1,500.0,7492933,7506354,1999164,13421,105,11,True,True,257.5063055555555,-0.44608096022414495
7073,5493787,13,8,0.449075,234,5514685,-1,4000.0,5894656,5894669,400869,13,170,8,True,True,1.2641777777777776,-0.449075
7074,5493820,8,4,0.866346,234,5514685,-1,2000.0,5845956,5845964,352136,8,177,6,True,True,0.5214222222222222,-0.866346
7075,5498257,36,16,0.325216,234,5514685,-1,8000.0,12763366,12763402,7265109,36,15,12,True,True,4.3744000000000005,-0.325216
7076,5498524,6193,16,0.799812,234,5514685,-1,8000.0,7067629,7073822,1569105,6193,120,10,True,True,1425.3404666666665,-0.7944214427494272
7077,5498578,7933,4,0.664502,234,5514685,-1,2000.0,8935193,8943126,3436615,7933,75,2,True,True,381.91060555555555,-0.6412392487475503
7078,5503043,45,2,0.409628,234,5514685,-1,1000.0,10844184,10844229,5341141,45,50,12,True,True,0.404625,-0.409628
7079,5503055,41,4,0.232822,234,5514685,-1,2000.0,12849766,12849807,7346711,41,15,12,True,True,2.1048944444444446,-0.232822
7080,5503068,48,18,0.395397,234,5514685,-1,9000.0,7643133,7643181,2140065,48,102,8,True,True,9.6096,-0.395397
7081,5503216,94,4,0.540994,234,5514685,-1,2000.0,5878756,5878850,375540,94,180,2,True,True,5.0931444444444445,-0.49476954219006875
7082,5503428,11,1,0.958079,234,5514685,-1,500.0,5900666,5900677,397238,11,175,7,True,True,0.14952361111111112,-0.958079
7083,5503584,37,1,0.890043,234,5514685,-1,500.0,5884556,5884593,380972,37,180,2,True,True,0.43886111111111115,-0.890043
7084,5503596,4,1,0.735913,234,5514685,-1,500.0,5896266,5896270,392670,4,177,2,True,True,0.04862222222222222,-0.735913
7085,5503600,11,32,0.645917,234,5514685,-1,16000.0,5844856,5844867,341256,11,188,7,True,True,5.7356444444444445,-0.645917
7086,5503641,4,4,0.865954,234,5514685,-1,2000.0,6682486,6682490,1178845,4,141,11,True,True,0.3048888888888889,-0.865954
7087,5503690,23431,64,0.707209,234,5514685,-1,32000.0,7805142,7828573,2301452,23431,97,10,True,True,25524.95351111111,-0.6888288999348499
7088,5503736,280,16,0.571995,234,5514685,-1,8000.0,9389193,9389473,3885457,280,70,12,True,True,43.723555555555556,-0.571995
7089,5503803,35,16,0.796159,234,5514685,-1,8000.0,5633574,5633609,129771,35,206,7,True,True,9.384666666666666,-0.796159
7090,5504030,35,2,0.707399,234,5514685,-1,1000.0,7626933,7626968,2122903,35,106,11,True,True,0.7921666666666667,-0.707399
7091,5504142,9,2,0.561044,234,5514685,-1,1000.0,5869756,5869765,365614,9,190,7,True,True,0.303925,-0.561044
7092,5504872,4,4,0.123782,234,5514685,-1,2000.0,12941566,12941570,7436694,4,14,12,True,True,0.24153333333333332,-0.123782
7093,5505288,30625,128,0.559353,234,5514685,-1,64000.0,9934724,9965349,4429436,30625,64,8,True,True,93490.35662222221,-0.5021816397055583
7094,5505382,7,2,0.192427,234,5514685,-1,1000.0,13417866,13417873,7912484,7,9,12,True,True,0.3460916666666667,-0.192427
7095,5505403,262,33,0.618704,234,5514685,-1,16500.0,10239384,10239646,4733981,262,60,12,True,True,89.93040833333332,-0.618704
7096,5505919,8727,128,0.576856,234,5514685,-1,64000.0,9107993,9116720,3602074,8727,82,12,True,True,14873.230399999999,-0.5746407304864394
7097,5506043,1264,1,0.052874,234,5514685,-1,500.0,14379466,14380730,8873423,1264,3,12,True,True,14.04971111111111,-0.052874
7098,5506093,121,1,0.570244,234,5514685,-1,500.0,7895493,7895614,2389400,121,103,1,True,True,2.556461111111111,-0.570244
7099,5507487,30,8,0.189396,234,5514685,-1,4000.0,11834466,11834496,6326979,30,34,1,True,True,3.3853333333333335,-0.189396
7100,5508181,351,2,0.475836,234,5514685,-1,1000.0,7895142,7895493,2386961,351,105,12,True,True,14.831700000000001,-0.475836
7101,5508235,556,16,0.896864,234,5514685,-1,8000.0,7046029,7046585,1537794,556,137,1,True,True,118.3415111111111,-0.896864
7102,5508271,117,32,0.120283,234,5514685,-1,16000.0,13071166,13071283,7562895,117,16,12,True,True,111.5452,-0.120283
7103,5512274,9671,7,0.936182,234,5514685,-1,3500.0,7073822,7083493,1561548,9671,136,2,True,True,760.7189430555557,-0.8342357101845186
7104,5512317,6,1,0.179743,234,5514685,-1,500.0,12450166,12450172,6937849,6,26,8,True,True,0.13465833333333335,-0.179743
7105,5512777,20,7,0.018974,234,5514685,-1,3500.0,14552266,14552286,9039489,20,2,12,True,True,1.8596666666666668,-0.018974
7106,5513422,88,138,0.786757,234,5514685,-1,69000.0,9021593,9021681,3508171,88,88,12,True,True,152.51798333333332,-0.7811907120920969
7107,5513454,3,10,0.245287,234,5514685,-1,5000.0,13682466,13682469,8169012,3,11,8,True,True,0.9993333333333333,-0.245287
7108,5513708,7,2,0.705618,234,5514685,-1,1000.0,5557892,5557899,44184,7,231,1,True,True,0.28528888888888887,-0.705618
7109,5517238,53,1,0.887656,252,5536285,-1,500.0,6148727,6148780,631489,53,190,8,True,True,1.0265805555555556,-0.887656
7110,5519081,16744,4,0.444229,252,5536285,-1,2000.0,10757784,10774528,5238703,16744,60,0,True,True,469.5281777777777,-0.4349912482737551
7111,5519111,53,15,0.806921,252,5536285,-1,7500.0,6315127,6315180,796016,53,184,6,True,True,11.529708333333334,-0.8069210000000002
7112,5519157,42120,185,0.606855,252,5536285,-1,92500.0,10109724,10151844,4590567,42120,71,12,True,True,137154.31333333332,-0.6001519676918049
7113,5519879,144,4,0.401798,252,5536285,-1,2000.0,13504266,13504410,7984387,144,12,12,True,True,16.416800000000002,-0.401798
7114,5522376,10914,32,0.044984,252,5536285,-1,16000.0,14289466,14300380,8767090,10914,6,12,True,True,4703.7231111111105,-0.044942353685117634
7115,5524692,16121,8,0.861974,252,5536285,-1,4000.0,6606086,6622207,1081394,16121,171,1,True,True,2122.7125,-0.8444629985634009
7116,5525123,5,6,0.023263,252,5536285,-1,3000.0,13677066,13677071,8151943,5,13,12,True,True,0.723125,-0.023263
7117,5525158,6,13,0.437017,252,5536285,-1,6500.0,8754093,8754099,3228935,6,101,12,True,True,1.0768333333333335,-0.437017
7118,5525495,6,60,0.414936,252,5536285,-1,30000.0,9842924,9842930,4317429,6,79,12,True,True,9.496500000000001,-0.414936
7119,5526245,9346,256,0.859648,252,5536285,-1,128000.0,6139381,6148727,613136,9346,200,11,True,True,48123.278577777775,-0.8501494927389898
7120,5526393,11543,64,0.317382,252,5536285,-1,32000.0,12270866,12282409,6744473,11543,35,7,True,True,25418.227733333333,-0.30610824108219964
7121,5526548,25,1,0.257178,252,5536285,-1,500.0,11834441,11834466,6307893,25,43,12,True,True,0.3526388888888889,-0.257178
7122,5526694,11103,1,0.114645,252,5536285,-1,500.0,13590666,13601769,8063972,11103,14,12,True,True,402.7817416666667,-0.10549549119324766
7123,5526755,39,32,0.099334,252,5536285,-1,16000.0,12984766,12984805,7458011,39,23,11,True,True,42.51,-0.099334
7124,5526871,12087,32,0.168156,252,5536285,-1,16000.0,13771066,13783153,8244195,12087,11,7,True,True,7026.403466666667,-0.16644126230784057
7125,5526964,9,32,0.144034,252,5536285,-1,16000.0,14116666,14116675,8589702,9,8,12,True,True,8.6668,-0.144034
7126,5529375,6075,128,0.255555,252,5536285,-1,64000.0,11746941,11753016,6217566,6075,49,1,True,True,14788.981866666667,-0.25517784682948436
7127,5529431,6,1,0.089629,252,5536285,-1,500.0,11556984,11556990,6027553,6,58,10,True,True,0.07688333333333335,-0.089629
1150,994133,154,1,0.052609,1,994133,-1,500.0,1080533,1080687,86400,154,0,12,True,True,2.1138638888888885,-0.052609
1151,994202,6763,2,0.15741,10,1080533,-1,1000.0,7047616,7054379,6053414,6763,0,12,True,True,180.09752500000002,-0.14811883961989591
1152,994284,10744,16,0.617838,10,1080533,-1,8000.0,5528016,5538760,4533732,10744,1,12,True,True,2590.1009777777776,-0.5553607632268911
1153,994848,30,1,0.673969,10,1080533,-1,500.0,1166933,1166963,172085,30,2,12,True,True,0.5453749999999999,-0.673969
1154,994925,4132,128,0.272103,10,1080533,-1,64000.0,7929170,7933302,6934245,4132,0,6,True,True,10034.969955555554,-0.2699448550359534
1155,995038,72,1,0.661939,10,1080533,-1,500.0,3587184,3587256,2592146,72,3,11,True,True,1.1888,-0.661939
1156,995070,14346,1,0.485662,10,1080533,-1,500.0,4672616,4686962,3677546,14346,3,10,True,True,260.55354444444447,-0.42684551102837076
1157,995191,16,40,0.442044,10,1080533,-1,20000.0,7938702,7938718,6943511,16,0,8,True,True,6.712888888888889,-0.442044
1158,995919,234,8,0.273167,10,1080533,-1,4000.0,9942014,9942248,8946095,234,0,12,True,True,38.5424,-0.273167
1159,995960,21928,16,0.754943,10,1080533,-1,8000.0,2074464,2096392,1078504,21928,7,12,True,True,7592.767288888888,-0.7503948771059773
1160,995966,8966,256,0.113818,10,1080533,-1,128000.0,9344265,9353231,8348299,8966,1,1,True,True,87665.08693333334,-0.1136481417970174
1161,1093171,1,5,0.429914,104,1166933,-1,2500.0,4297538,4297539,3204367,1,7,0,True,True,0.10765277777777779,-0.429914
1162,1093221,15556,64,0.283246,104,1166933,-1,32000.0,4405538,4421094,3312317,15556,7,10,True,True,24482.540266666667,-0.27544039900891226
1163,1093281,10,1,0.678486,104,1166933,-1,500.0,1546970,1546980,453689,10,11,11,True,True,0.14008333333333334,-0.678486
1164,1093299,23,1,0.486633,104,1166933,-1,500.0,3853238,3853261,2759939,23,9,9,True,True,0.41847222222222225,-0.486633
1165,1093712,4738,32,0.667133,104,1166933,-1,16000.0,3349584,3354322,2255872,4738,11,7,True,True,2801.5382222222224,-0.6257758454156537
1166,1093772,12,8,0.045417,104,1166933,-1,4000.0,7932770,7932782,6838998,12,3,2,True,True,1.8430666666666666,-0.045417
1167,1093777,14,8,0.395263,104,1166933,-1,4000.0,5862816,5862830,4769039,14,6,10,True,True,1.7865555555555555,-0.395263
1168,1093910,16958,1,0.599325,104,1166933,-1,500.0,1210133,1227091,116223,16958,16,11,True,True,348.1830763888889,-0.591431300097428
1169,1093937,63,1,0.007687,104,1166933,-1,500.0,8289702,8289765,7195765,63,2,11,True,True,0.8383375000000001,-0.007687
1170,1093970,6681,4,0.301419,104,1166933,-1,2000.0,7798470,7805151,6704500,6681,6,8,True,True,492.24266666666665,-0.2951531847879171
1171,1094413,13584,4,0.211234,104,1166933,-1,2000.0,8980902,8994486,7886489,13584,2,11,True,True,617.7699,-0.15915859785763908
1172,1094762,81,1,0.137235,104,1166933,-1,500.0,9245502,9245583,8150740,81,2,8,True,True,2.5206749999999998,-0.137235
1173,1094806,4127,4,0.25552,104,1166933,-1,2000.0,8505702,8509829,7410896,4127,4,12,True,True,308.8921722222222,-0.23379484495958772
1174,1094913,15538,1,0.328122,104,1166933,-1,500.0,4651016,4666554,3556103,15538,14,11,True,True,339.5983888888889,-0.3194843849805239
1175,1095007,5,6,0.00773,104,1166933,-1,3000.0,10503614,10503619,9408607,5,0,12,True,True,0.3327916666666667,-0.00773
1176,1095043,7568,1,0.747014,104,1166933,-1,500.0,1475025,1482593,379982,7568,23,10,True,True,116.91386111111109,-0.6380573025835573
1177,1095366,20494,2,0.175695,104,1166933,-1,1000.0,1611870,1632364,516504,20494,22,7,True,True,731.6507555555556,-0.16458486861355068
1178,1095385,18,16,0.380207,104,1166933,-1,8000.0,5436216,5436234,4340831,18,14,11,True,True,3.9488,-0.380207
1179,1095413,34,4,0.703671,104,1166933,-1,2000.0,1663764,1663798,568351,34,23,7,True,True,2.1310444444444445,-0.703671
1180,1095456,22,2,0.500262,104,1166933,-1,1000.0,5646816,5646838,4551360,22,13,8,True,True,0.6205222222222223,-0.500262
1181,1095651,10565,1,0.833354,104,1166933,-1,500.0,1937264,1947829,841613,10565,24,10,True,True,168.4727986111111,-0.7686238918967151
1182,1095814,3,16,0.8062,104,1166933,-1,8000.0,1452325,1452328,356511,3,29,8,True,True,1.0218,-0.8062
1183,1095861,25,1,0.072075,104,1166933,-1,500.0,9240102,9240127,8144241,25,4,12,True,True,0.9848958333333332,-0.072075
1184,1095977,15240,7,0.861764,104,1166933,-1,3500.0,1477225,1492465,381248,15240,29,7,True,True,1570.7442916666664,-0.832224812693847
1185,1095989,22,1,0.042302,104,1166933,-1,500.0,8894502,8894524,7798513,22,6,11,True,True,0.3978027777777778,-0.042302
1186,1096064,35,2,0.018742,104,1166933,-1,1000.0,1290459,1290494,194395,35,33,1,True,True,0.9678472222222222,-0.018742
1187,1097312,6379,2,0.921162,104,1166933,-1,1000.0,1579370,1585749,482058,6379,29,9,True,True,267.7739,-0.9125208889380233
1188,1098703,9,1,0.86211,104,1166933,-1,500.0,1213733,1213742,115030,9,35,1,True,True,0.212475,-0.86211
1189,1102692,3,8,0.575759,104,1166933,-1,4000.0,2117664,2117667,1014972,3,25,0,True,True,0.5986666666666667,-0.575759
1190,1102770,8,2,0.5734,104,1166933,-1,1000.0,4519216,4519224,3416446,8,20,12,True,True,0.2782444444444444,-0.5734
1191,1126168,9182,1,0.709499,104,1166933,-1,500.0,4432816,4441998,3306648,9182,21,10,True,True,214.71308055555556,-0.7076239547017834
1192,1126543,12,1,0.417694,104,1166933,-1,500.0,1363725,1363737,237182,12,37,1,True,True,0.20658333333333334,-0.417694
1193,1126627,8,2,0.115173,104,1166933,-1,1000.0,8160102,8160110,7033475,8,9,12,True,True,0.4105111111111111,-0.115173
1194,1127158,4722,32,0.020857,104,1166933,-1,16000.0,6167416,6172138,5040258,4722,15,6,True,True,3501.359022222222,-0.020763807612520113
1195,1135592,103,36,0.324768,104,1166933,-1,18000.0,6783016,6783119,5647424,103,15,12,True,True,36.0603,-0.324768
1196,1135907,12,1,0.801322,104,1166933,-1,500.0,1915664,1915676,779757,12,33,7,True,True,0.19898333333333335,-0.801322
1197,1137382,3744,8,0.618125,104,1166933,-1,4000.0,1614070,1617814,476688,3744,35,7,True,True,619.4708444444444,-0.6161600030545228
1198,1139349,9081,1,0.832026,104,1166933,-1,500.0,3341984,3351065,2202635,9081,30,7,True,True,169.10225416666668,-0.817140347248926
1199,1146845,26,1,0.91977,104,1166933,-1,500.0,1715664,1715690,568819,26,35,7,True,True,0.42463055555555557,-0.91977
1200,1146985,279,1,0.08813,104,1166933,-1,500.0,7933302,7933581,6786317,279,11,2,True,True,5.356412499999999,-0.08813
1201,1147010,5,23,0.844484,104,1166933,-1,11500.0,1758864,1758869,611854,5,36,11,True,True,2.023041666666667,-0.844484
1202,1147066,593,16,0.243316,104,1166933,-1,8000.0,8937702,8938295,7790636,593,6,11,True,True,77.97291111111112,-0.243316
1203,1147188,25840,32,0.588871,104,1166933,-1,16000.0,4077938,4103778,2930750,25840,29,6,True,True,11284.576355555557,-0.5798352850509657
1204,1147611,3,10,0.523963,104,1166933,-1,5000.0,1278533,1278536,130922,3,50,8,True,True,0.5709166666666667,-0.523963
1205,1148007,12000,2,0.395767,104,1166933,-1,1000.0,3200124,3212124,2052117,12000,34,1,True,True,406.4464,-0.38350065734729877
1206,1149858,6,8,0.310275,104,1166933,-1,4000.0,7738816,7738822,6588958,6,16,12,True,True,1.0480666666666667,-0.310275
1207,1149895,19,1,0.339513,104,1166933,-1,500.0,5387616,5387635,4237721,19,24,12,True,True,0.22744583333333335,-0.339513
1208,1149959,40703,8,0.333069,104,1166933,-1,4000.0,5393016,5433719,4243057,40703,24,8,True,True,3758.543733333333,-0.3257154237578391
1209,1150623,31,1,0.168133,104,1166933,-1,500.0,6696616,6696647,5545993,31,19,8,True,True,0.3868111111111111,-0.168133
1210,1150917,11999,8,0.510483,104,1166933,-1,4000.0,1656164,1668163,505247,11999,46,10,True,True,1495.4442777777779,-0.50974199359799
1211,1151265,945,1,0.114027,104,1166933,-1,500.0,4383938,4384883,3232673,945,32,12,True,True,21.69384722222222,-0.11132379567218892
1212,1151881,41,4,0.509952,104,1166933,-1,2000.0,1884264,1884305,732383,41,44,7,True,True,3.454022222222222,-0.509952
1213,1152096,5885,64,0.905923,104,1166933,-1,32000.0,4607816,4613701,3455720,5885,29,12,True,True,7140.588088888889,-0.8608344834297936
1214,1152326,16,4,0.349375,104,1166933,-1,2000.0,8851302,8851318,7698976,16,8,12,True,True,0.6596444444444444,-0.349375
1215,1152376,78,1,0.727379,104,1166933,-1,500.0,1588070,1588148,435694,78,53,8,True,True,1.2591583333333334,-0.727379
1216,1152625,2691,32,0.818949,104,1166933,-1,16000.0,2295864,2298555,1143239,2691,42,12,True,True,1980.3056000000001,-0.7780550782149664
1217,1154344,11288,256,0.815037,104,1166933,-1,128000.0,1492465,1503753,338121,11288,57,0,True,True,45954.36764444444,-0.7931642895767945
1218,1154580,39231,21,0.236269,104,1166933,-1,10500.0,4694216,4733447,3539636,39231,28,10,True,True,18319.900374999997,-0.23608443110046673
1219,1154754,47,4,0.146444,104,1166933,-1,2000.0,3901838,3901885,2747084,47,38,8,True,True,3.468077777777778,-0.146444
1220,1154807,20,1,0.197272,104,1166933,-1,500.0,9153702,9153722,7998895,20,5,12,True,True,0.7060000000000001,-0.197272
1221,1155116,73,1,0.602399,104,1166933,-1,500.0,3641404,3641477,2486288,73,41,1,True,True,1.08405,-0.602399
1222,1156885,275,32,0.760215,104,1166933,-1,16000.0,1858264,1858539,701379,275,52,7,True,True,198.2566666666667,-0.760215
1223,1156930,21,16,0.655509,104,1166933,-1,8000.0,3457584,3457605,2300654,21,43,12,True,True,7.597333333333334,-0.655509
1224,1157013,250,16,0.177146,104,1166933,-1,8000.0,7981902,7982152,6824889,250,13,11,True,True,31.283333333333335,-0.177146
1225,1157242,3957,128,0.772848,104,1166933,-1,64000.0,3371184,3375141,2213942,3957,45,10,True,True,6274.070933333333,-0.7701328031546355
1226,1157590,4,1,0.494117,104,1166933,-1,500.0,1615170,1615174,457580,4,60,6,True,True,0.08302222222222222,-0.494117
1227,1157662,571,4,0.754446,104,1166933,-1,2000.0,1382125,1382696,224463,571,70,8,True,True,25.823855555555557,-0.7387127940936457
1228,1157674,47,22,0.759877,104,1166933,-1,11000.0,2994868,2994915,1837194,47,49,12,True,True,13.700500000000003,-0.7598770000000002
1229,1157686,12145,27,0.448905,104,1166933,-1,13500.0,4910216,4922361,3752530,12145,30,11,True,True,8460.2457,-0.44411740576440584
1230,1158062,1278,1,0.924154,104,1166933,-1,500.0,1262333,1263611,104271,1278,76,8,True,True,17.171006944444443,-0.7550749310875576
1231,1158132,9455,1,0.564492,104,1166933,-1,500.0,2403864,2413319,1245732,9455,51,10,True,True,141.97856388888889,-0.5258970670809565
1232,1159630,20,4,0.635298,104,1166933,-1,2000.0,1713464,1713484,553834,20,61,6,True,True,1.0673333333333335,-0.635298
1233,1160181,12751,8,0.624522,104,1166933,-1,4000.0,2447064,2459815,1286883,12751,51,11,True,True,2168.115422222222,-0.5767607317826683
1234,1160206,1405,23,0.864247,104,1166933,-1,11500.0,2732564,2733969,1572358,1405,51,10,True,True,484.90452777777784,-0.864247
1235,1162444,17559,29,0.627217,104,1166933,-1,14500.0,1891864,1909423,729420,17559,59,8,True,True,9771.628702777778,-0.6168081176044059
1236,1162633,10395,1,0.150957,104,1166933,-1,500.0,7306816,7317211,6144183,10395,20,12,True,True,88.71239722222222,-0.1301669748044775
1237,1162667,27183,1,0.068286,104,1166933,-1,500.0,9828431,9855614,8665764,27183,2,12,True,True,614.7130847222222,-0.06788458737596219
1238,1162881,1,1,0.442208,104,1166933,-1,500.0,2448164,2448165,1285283,1,54,6,True,True,0.020444444444444442,-0.442208
1239,1162899,378,16,0.30282,104,1166933,-1,8000.0,7393216,7393594,6230317,378,21,12,True,True,21.932399999999998,-0.30282
1240,1162909,8618,32,0.274674,104,1166933,-1,16000.0,8678502,8687120,7515593,8618,11,12,True,True,2966.021511111111,-0.24514836636182621
1241,1162924,907,61,0.056172,104,1166933,-1,30500.0,10633214,10634121,9470290,907,0,11,True,True,609.5191166666667,-0.056172
1242,1162981,3,2,0.507337,104,1166933,-1,1000.0,2908468,2908471,1745487,3,56,12,True,True,0.09241666666666667,-0.507337
1243,1163064,15836,49,0.310408,104,1166933,-1,24500.0,6079916,6095752,4916852,15836,29,6,True,True,17843.00346111111,-0.3046213141996161
1244,1163448,240,4,0.451914,104,1166933,-1,2000.0,3663004,3663244,2499556,240,49,10,True,True,11.765333333333333,-0.451914
1245,1164035,54,2,0.05689,104,1166933,-1,1000.0,8764902,8764956,7600867,54,12,12,True,True,1.071,-0.05689
1246,1164071,1339,2,0.831697,104,1166933,-1,1000.0,2822068,2823407,1657997,1339,60,12,True,True,43.48931388888889,-0.829669163391203
1247,1165297,130,1,0.076731,104,1166933,-1,500.0,10244414,10244544,9079117,130,2,11,True,True,2.182375,-0.076731
1248,1165977,107,16,0.86425,104,1166933,-1,8000.0,1503770,1503877,337793,107,85,1,True,True,28.87335555555556,-0.86425
1249,1166085,343,1,0.855293,104,1166933,-1,500.0,1371325,1371668,205240,343,91,7,True,True,7.904662500000001,-0.7881252856802854
1250,1166325,41,16,0.615008,104,1166933,-1,8000.0,3614184,3614225,2447859,41,53,8,True,True,8.646444444444445,-0.615008
1251,1166467,320,4,0.507068,104,1166933,-1,2000.0,3840204,3840524,2673737,320,51,7,True,True,25.543111111111113,-0.507068
1252,1166489,16048,16,0.462712,104,1166933,-1,8000.0,1302794,1318842,136305,16048,95,1,True,True,4223.993422222222,-0.42693273501979095
1253,1166504,6611,8,0.554316,104,1166933,-1,4000.0,5641416,5648027,4474912,6611,34,12,True,True,802.3805111111111,-0.5518351573672463
1254,1166548,6845,8,0.791818,104,1166933,-1,4000.0,2117664,2124509,951116,6845,71,11,True,True,1339.9448,-0.7880547333318589
1255,1166563,8,5,0.895877,104,1166933,-1,2500.0,1479425,1479433,312862,8,91,7,True,True,0.6465555555555556,-0.895877
1256,1166965,13672,32,0.449734,206,1210133,-1,16000.0,3902938,3916610,2735973,13672,50,6,True,True,8911.932711111112,-0.44822224216779927
1257,1166983,17,1,0.809816,206,1210133,-1,500.0,1503753,1503770,336770,17,91,7,True,True,0.28670972222222224,-0.809816
1258,1167043,5,2,0.651837,206,1210133,-1,1000.0,1568570,1568575,401527,5,89,10,True,True,0.27170833333333333,-0.651837
1259,1167058,13082,32,0.321527,206,1210133,-1,16000.0,10028414,10041496,8861356,13082,3,12,True,True,11589.3248,-0.2976713751431341
1260,1167100,21,32,0.475629,206,1210133,-1,16000.0,5992416,5992437,4825316,21,33,12,True,True,10.321733333333334,-0.475629
1261,1167121,2163,1,0.150861,206,1210133,-1,500.0,6259216,6261379,5092095,2163,31,12,True,True,42.26753194444444,-0.14033450444639559
1262,1167209,4961,4,0.061874,206,1210133,-1,2000.0,6788416,6793377,5621207,4961,29,8,True,True,157.43003333333334,-0.060179178810020904
1263,1167268,1093,1,0.103502,206,1210133,-1,500.0,10201214,10202307,9033946,1093,3,12,True,True,11.991120833333332,-0.103502
1264,1167302,11886,27,0.899127,206,1210133,-1,13500.0,4211138,4223024,3043836,11886,54,11,True,True,5570.744775,-0.8372428136371122
1265,1167605,8344,4,0.343438,206,1210133,-1,2000.0,4297538,4305882,3129933,8344,54,12,True,True,722.0459555555556,-0.3383500145110446
1266,1167610,121,4,0.714316,206,1210133,-1,2000.0,1305420,1305541,137810,121,108,7,True,True,6.898344444444445,-0.714316
1267,1169111,2,8,0.504549,206,1210133,-1,4000.0,7220416,7220418,6051305,2,29,12,True,True,0.19395555555555555,-0.504549
1268,1169121,13195,173,0.172559,206,1210133,-1,86500.0,9655631,9668826,8486510,13195,7,12,True,True,65084.91651805556,-0.171154042413984
1269,1169177,61,8,0.247744,206,1210133,-1,4000.0,3296584,3296645,2127407,61,71,7,True,True,8.6132,-0.247744
1270,1169243,16,32,0.437758,206,1210133,-1,16000.0,6432016,6432032,5262773,16,35,12,True,True,7.115377777777778,-0.437758
1271,1169296,5,16,0.439422,206,1210133,-1,8000.0,5441616,5441621,4272320,5,44,8,True,True,1.3076666666666668,-0.439422
1272,1169303,8961,16,0.522748,206,1210133,-1,8000.0,5299016,5307977,4129713,8961,48,12,True,True,1535.351777777778,-0.4781892434090434
1273,1169527,7861,44,0.158746,206,1210133,-1,22000.0,9067302,9075163,7897775,7861,12,12,True,True,11168.634094444446,-0.15818883972812295
1274,1169538,9,2,0.372852,206,1210133,-1,1000.0,3990438,3990447,2820900,9,63,6,True,True,0.250375,-0.372852
1275,1169590,7460,1,0.282894,206,1210133,-1,500.0,8419302,8426762,7249712,7460,20,12,True,True,66.10427222222222,-0.27756796934184913
1276,1170047,76,4,0.408769,206,1210133,-1,2000.0,1902664,1902740,732617,76,92,9,True,True,5.663688888888888,-0.408769
1277,1170344,75,1,0.338367,206,1210133,-1,500.0,1403725,1403800,233381,75,115,10,True,True,1.4758333333333333,-0.338367
1278,1173850,14008,30,0.597886,206,1210133,-1,15000.0,5083016,5097024,3909166,14008,51,12,True,True,6872.448666666667,-0.5656575068428015
1279,1174083,8200,16,0.789227,206,1210133,-1,8000.0,3730004,3738204,2555921,8200,70,11,True,True,1440.7294222222222,-0.7759282904744632
1280,1174102,3921,77,0.647305,206,1210133,-1,38500.0,4167938,4171859,2993836,3921,64,12,True,True,4252.981531944444,-0.6434067787905812
1281,1174179,15452,16,0.065912,206,1210133,-1,8000.0,4780616,4796068,3606437,15452,53,12,True,True,4198.741511111111,-0.06125405182588852
1282,1174239,1532,1,0.094506,206,1210133,-1,500.0,7987302,7988834,6813063,1532,23,8,True,True,11.622663888888889,-0.09409856241094111
1283,1174274,58,32,0.678379,206,1210133,-1,16000.0,3347384,3347442,2173110,58,81,8,True,True,31.912888888888887,-0.678379
1284,1174317,200,2,0.284147,206,1210133,-1,1000.0,7652416,7652616,6478099,200,31,12,True,True,7.253888888888888,-0.284147
1285,1174618,578,1,0.723734,206,1210133,-1,500.0,2624564,2625142,1449946,578,90,12,True,True,10.99725277777778,-0.723734
1286,1174663,23,35,0.656564,206,1210133,-1,17500.0,3081268,3081291,1906605,23,86,12,True,True,12.357868055555556,-0.656564
1287,1174775,16600,4,0.906343,206,1210133,-1,2000.0,1632364,1648964,457589,16600,110,2,True,True,1314.7736888888887,-0.9034206507136238
1288,1174799,9673,32,0.87328,206,1210133,-1,16000.0,1289333,1299006,114534,9673,132,9,True,True,4469.171511111112,-0.8708416589882882
1289,1174889,6527,4,0.333362,206,1210133,-1,2000.0,5754816,5761343,4579927,6527,45,10,True,True,320.48065,-0.31928671084477594
1290,1176555,56,1,0.58274,206,1210133,-1,500.0,3200068,3200124,2023513,56,87,9,True,True,0.8488666666666667,-0.58274
1291,1176646,63,32,0.141428,206,1210133,-1,16000.0,9526031,9526094,8349385,63,8,12,True,True,31.169600000000003,-0.141428
1292,1176692,460,40,0.349821,206,1210133,-1,20000.0,9353231,9353691,8176539,460,9,8,True,True,635.1066666666667,-0.349821
1293,1176978,311,1,0.967697,206,1210133,-1,500.0,1475025,1475336,298047,311,127,0,True,True,6.386730555555556,-0.967697
1294,1177613,2086,2,0.69848,206,1210133,-1,1000.0,1361639,1363725,184026,2086,134,9,True,True,71.82213888888889,-0.69848
1295,1177628,9,16,0.391958,206,1210133,-1,8000.0,6691216,6691225,5513588,9,41,12,True,True,1.5904,-0.391958
1296,1177643,65,1,0.595041,206,1210133,-1,500.0,1350839,1350904,173196,65,136,11,True,True,0.6565,-0.595041
1297,1178313,4026,32,0.938002,206,1210133,-1,16000.0,1299194,1303220,120881,4026,139,6,True,True,2017.6272888888889,-0.9379329927344862
1298,1178624,16454,256,0.309582,206,1210133,-1,128000.0,7782016,7798470,6603392,16454,32,11,True,True,61117.34542222222,-0.2634710389187667
1299,1178638,12363,256,0.376679,206,1210133,-1,128000.0,9331902,9344265,8153264,12363,11,12,True,True,109149.5584,-0.37342235433548565
1300,1178662,147,1,0.791662,206,1210133,-1,500.0,1617814,1617961,439152,147,118,2,True,True,3.022483333333333,-0.791662
1301,1178718,6469,32,0.813185,206,1210133,-1,16000.0,4867016,4873485,3688298,6469,61,12,True,True,5388.494888888889,-0.7459647260194346
1302,1183323,278,32,0.670116,206,1210133,-1,16000.0,4410938,4411216,3227615,278,69,8,True,True,209.0312888888889,-0.670116
1303,1183672,116,1,0.828959,206,1210133,-1,500.0,1628614,1628730,444942,116,120,9,True,True,1.7955833333333333,-0.828959
1304,1183685,13339,8,0.738775,206,1210133,-1,4000.0,3167668,3181007,1983983,13339,95,12,True,True,1875.2630666666669,-0.7165656962129802
1305,1183718,6208,8,0.685414,206,1210133,-1,4000.0,3665204,3671412,2481486,6208,83,7,True,True,753.4502666666667,-0.6838779540107451
1306,1183767,10726,2,0.526393,206,1210133,-1,1000.0,8592102,8602828,7408335,10726,22,12,True,True,394.75003888888887,-0.517414077124123
1307,1183900,76,4,0.646025,206,1210133,-1,2000.0,2538164,2538240,1354264,76,104,12,True,True,5.228800000000001,-0.646025
1308,1183938,4,8,0.423406,206,1210133,-1,4000.0,5555016,5555020,4371078,4,54,8,True,True,0.6207555555555555,-0.423406
1309,1184946,18041,8,0.361828,206,1210133,-1,4000.0,7928070,7946111,6743124,18041,33,11,True,True,1922.362444444444,-0.34576085375313786
1310,1185012,163,2,0.362598,206,1210133,-1,1000.0,6874816,6874979,5689804,163,42,12,True,True,7.121288888888889,-0.362598
1311,1185031,22,12,0.180263,206,1210133,-1,6000.0,9569231,9569253,8384200,22,8,11,True,True,3.3033,-0.18026299999999998
1312,1185212,4,1,0.214193,206,1210133,-1,500.0,1256933,1256937,71721,4,158,11,True,True,0.058911111111111115,-0.214193
1313,1185291,84,32,0.947668,206,1210133,-1,16000.0,1609670,1609754,424379,84,133,10,True,True,58.07573333333334,-0.947668
1314,1185684,15,4,0.486271,206,1210133,-1,2000.0,3989338,3989353,2803654,15,83,12,True,True,0.8345833333333333,-0.486271
1315,1191642,84,1,0.226543,206,1210133,-1,500.0,8073702,8073786,6882060,84,28,12,True,True,2.0176333333333334,-0.226543
1316,1191737,2892,1,0.137565,206,1210133,-1,500.0,2317464,2320356,1125727,2892,114,10,True,True,60.06548333333333,-0.137391008624653
1317,1191778,247,3,0.077165,206,1210133,-1,1500.0,8332902,8333149,7141124,247,26,11,True,True,6.9870125,-0.077165
1318,1191811,5636,8,0.844428,206,1210133,-1,4000.0,1985864,1991500,794053,5636,120,10,True,True,757.1773777777778,-0.8194263562770138
1319,1192077,4,1,0.101141,206,1210133,-1,500.0,1453425,1453429,261348,4,150,6,True,True,0.08515,-0.101141
1320,1192104,16915,256,0.770875,206,1210133,-1,128000.0,1769664,1786579,577560,16915,127,9,True,True,89269.07164444444,-0.7664399230245591
1321,1192299,3,8,0.83512,206,1210133,-1,4000.0,2339064,2339067,1146765,3,115,10,True,True,0.3384666666666667,-0.83512
1322,1192348,269,64,0.883682,206,1210133,-1,32000.0,1298094,1298363,105746,269,163,8,True,True,249.3689777777778,-0.883682
1323,1194337,3071,8,0.037747,206,1210133,-1,4000.0,9742031,9745102,8547694,3071,7,12,True,True,504.8724,-0.037747
1324,1194394,48,8,0.336764,206,1210133,-1,4000.0,4411216,4411264,3216822,48,77,1,True,True,9.022933333333334,-0.336764
1325,1194454,28023,1,0.766308,206,1210133,-1,500.0,1964264,1992287,769810,28023,124,8,True,True,503.95265138888897,-0.7475122904358973
1326,1194499,48,16,0.131049,206,1210133,-1,8000.0,6166316,6166364,4971817,48,54,12,True,True,16.01493333333333,-0.131049
1327,1194846,25,32,0.37672,206,1210133,-1,16000.0,7566016,7566041,6371170,25,42,12,True,True,6.256666666666667,-0.37672
1328,1194889,6967,256,0.162247,206,1210133,-1,128000.0,6172816,6179783,4977927,6967,54,8,True,True,41265.245866666664,-0.15973884619307024
1329,1195374,67,16,0.831345,206,1210133,-1,8000.0,3838004,3838071,2642630,67,95,12,True,True,21.392355555555554,-0.831345
1330,1195475,6491,128,0.771098,206,1210133,-1,64000.0,7479616,7486107,6284141,6491,43,12,True,True,4672.3134222222225,-0.6151179279428263
1331,1195492,4762,4,0.809044,206,1210133,-1,2000.0,2735668,2740430,1540176,4762,116,1,True,True,311.6732666666667,-0.7833426123632686
1332,1195820,14,8,0.165539,206,1210133,-1,4000.0,1634564,1634578,438744,14,143,7,True,True,2.4423777777777778,-0.165539
1333,1195870,669,19,0.437673,206,1210133,-1,9500.0,6604816,6605485,5408946,669,53,12,True,True,209.48434166666667,-0.437673
1334,1196468,8784,128,0.410859,206,1210133,-1,64000.0,7884870,7893654,6688402,8784,38,12,True,True,18234.106666666667,-0.3985537218160504
1335,1197052,6,8,0.676363,206,1210133,-1,4000.0,5906016,5906022,4708964,6,62,11,True,True,1.1532,-0.676363
1336,1197189,7288,36,0.23753,206,1210133,-1,18000.0,7134016,7141304,5936827,7288,48,12,True,True,1152.3392,-0.2200235703808215
1337,1197554,19,2,0.444199,206,1210133,-1,1000.0,1307620,1307639,110066,19,174,7,True,True,0.5539555555555555,-0.444199
1338,1197715,7726,184,0.284928,206,1210133,-1,92000.0,10417214,10424940,9219499,7726,2,12,True,True,26530.433044444442,-0.28432065897550685
1339,1197805,30512,128,0.748537,206,1210133,-1,64000.0,3202324,3232836,2004519,30512,114,7,True,True,73314.92551111111,-0.7320968603796494
1340,1197926,48,8,0.448928,206,1210133,-1,4000.0,1712364,1712412,514438,48,147,10,True,True,5.123200000000001,-0.448928
1341,1198812,23,1,0.534011,206,1210133,-1,500.0,5841216,5841239,4642404,23,66,12,True,True,0.5268597222222223,-0.534011
1342,1198938,16,1,0.309468,206,1210133,-1,500.0,1669164,1669180,470226,16,149,8,True,True,0.23028888888888888,-0.309468
1343,1198971,14212,2,0.808624,206,1210133,-1,1000.0,2382264,2396476,1183293,14212,130,11,True,True,535.7223444444445,-0.7865208206061526
1344,1199693,30,8,0.469016,206,1210133,-1,4000.0,1303220,1303250,103527,30,182,1,True,True,3.420666666666667,-0.469016
1345,1199930,7380,1,0.835113,206,1210133,-1,500.0,1446925,1454305,246995,7380,174,11,True,True,167.31605555555558,-0.8339581588124383
1346,1202155,74,8,0.367841,206,1210133,-1,4000.0,3635784,3635858,2433629,74,107,10,True,True,10.704511111111112,-0.367841
1347,1202424,36,2,0.94713,206,1210133,-1,1000.0,1369125,1369161,166701,36,179,8,True,True,1.8007,-0.94713
1348,1202559,26,8,0.98444,206,1210133,-1,4000.0,1290433,1290459,87874,26,190,6,True,True,2.8758888888888885,-0.98444
1349,1202714,24,7,0.46168,206,1210133,-1,3500.0,3189268,3189292,1986554,24,119,10,True,True,2.2922666666666665,-0.46168
1350,1203627,197,1,0.281772,206,1210133,-1,500.0,5212616,5212813,4008989,197,77,11,True,True,1.5194666666666665,-0.25907072675563925
1351,1203673,4662,4,0.381872,206,1210133,-1,2000.0,4521416,4526078,3317743,4662,86,7,True,True,337.83265555555556,-0.33937734004336667
1352,1203713,62,32,0.52746,206,1210133,-1,16000.0,3686804,3686866,2483091,62,106,10,True,True,37.3488,-0.52746
1353,1203772,135,2,0.966268,206,1210133,-1,1000.0,1292694,1292829,88922,135,193,7,True,True,4.028625,-0.966268
1354,1203872,57,32,0.816891,206,1210133,-1,16000.0,1273133,1273190,69261,57,198,9,True,True,31.882,-0.816891
1355,1203924,23275,43,0.801259,206,1210133,-1,21500.0,2451764,2475039,1247840,23275,132,2,True,True,24928.653434722222,-0.7848715072561984
1356,1205505,6,32,0.138399,206,1210133,-1,16000.0,4081538,4081544,2876033,6,97,2,True,True,2.560266666666667,-0.138399
1357,1205783,9475,256,0.250003,206,1210133,-1,128000.0,9855614,9865089,8649831,9475,7,1,True,True,60787.12711111111,-0.22911540511948741
1358,1206862,128,32,0.641179,206,1210133,-1,16000.0,2209464,2209592,1002602,128,142,12,True,True,55.096888888888884,-0.641179
1359,1223498,27,4,0.874117,251,1256933,-1,2000.0,1582670,1582697,359172,27,171,7,True,True,2.2725,-0.874117
1360,1223641,226,1,0.554541,251,1256933,-1,500.0,1376725,1376951,153084,226,187,8,True,True,2.718277777777778,-0.554541
1361,1224041,21,1,0.10259,251,1256933,-1,500.0,3842438,3842459,2618397,21,105,1,True,True,0.4198833333333334,-0.10259
1362,1225226,28,16,0.845892,251,1256933,-1,8000.0,1580470,1580498,355244,28,173,6,True,True,9.426666666666666,-0.845892
1363,1225273,21,4,0.851166,251,1256933,-1,2000.0,1882064,1882085,656791,21,154,7,True,True,1.7747333333333335,-0.851166
1364,1227915,12,32,0.285063,251,1256933,-1,16000.0,3608784,3608796,2380869,12,115,10,True,True,8.204266666666667,-0.285063
1365,1228250,7654,8,0.763117,251,1256933,-1,4000.0,2733969,2741623,1505719,7654,133,1,True,True,990.3718888888889,-0.743413952677246
1366,1229002,48,16,0.272791,251,1256933,-1,8000.0,10590014,10590062,9361012,48,1,0,True,True,9.437866666666668,-0.272791
1367,1229105,220,16,0.905306,251,1256933,-1,8000.0,3641184,3641404,2412079,220,114,8,True,True,52.272,-0.905306
1368,1229713,20658,119,0.147349,251,1256933,-1,59500.0,10719614,10740272,9489901,20658,0,12,True,True,25405.76947222222,-0.1353315427223365
1369,1230193,7676,1,0.437473,251,1256933,-1,500.0,6078816,6086492,4848623,7676,66,12,True,True,175.9985722222222,-0.4323692814253571
1370,1230556,6,16,0.946413,251,1256933,-1,8000.0,1988064,1988070,757508,6,153,7,True,True,1.6088,-0.946413
1371,1230732,17,8,0.222038,251,1256933,-1,4000.0,5549616,5549633,4318884,17,75,10,True,True,2.3660222222222225,-0.222038
1372,1230788,599,1,0.451128,251,1256933,-1,500.0,2735069,2735668,1504281,599,138,6,True,True,8.988327777777778,-0.451128
1373,1230842,9605,4,0.349585,251,1256933,-1,2000.0,8246502,8256107,7015660,9605,33,12,True,True,914.6031333333333,-0.34926586542337706
1374,1235051,23287,128,0.02667,251,1256933,-1,64000.0,10114814,10138101,8879763,23287,7,12,True,True,60593.42364444444,-0.025901088810732643
1375,1235300,14,8,0.053257,251,1256933,-1,4000.0,9439631,9439645,8204331,14,16,12,True,True,1.6619555555555556,-0.053257
1376,1235392,17,2,0.502007,251,1256933,-1,1000.0,4432816,4432833,3197424,17,96,0,True,True,0.7653777777777778,-0.502007
1377,1235511,454,1,0.235778,251,1256933,-1,500.0,5301216,5301670,4065705,454,84,7,True,True,5.321258333333334,-0.235778
1378,1236012,295,4,0.994525,251,1256933,-1,2000.0,1290494,1290789,54482,295,217,1,True,True,16.31513888888889,-0.994525
1379,1236187,17,4,0.374913,251,1256933,-1,2000.0,3896438,3896455,2660251,17,113,11,True,True,1.24355,-0.374913
1380,1236211,51,4,0.028188,251,1256933,-1,2000.0,10330814,10330865,9094603,51,5,12,True,True,4.520016666666667,-0.028188
1381,1236861,297,4,0.930826,251,1256933,-1,2000.0,1690764,1691061,453903,297,177,10,True,True,14.769150000000002,-0.930826
1382,1236977,126,1,0.839176,251,1256933,-1,500.0,1913464,1913590,676487,126,167,9,True,True,2.5676,-0.839176
1383,1237020,12617,1,0.649961,251,1256933,-1,500.0,1879864,1892481,642844,12617,172,10,True,True,258.49458055555556,-0.6471304784520435
1384,1237041,19866,16,0.791381,251,1256933,-1,8000.0,1856064,1875930,619023,19866,174,12,True,True,6577.8641333333335,-0.753661462124646
1385,1237455,182,16,0.1376,251,1256933,-1,8000.0,3339784,3339966,2102329,182,134,11,True,True,42.72551111111111,-0.1376
1386,1237793,10471,1,0.286879,251,1256933,-1,500.0,3751604,3762075,2513811,10471,119,10,True,True,155.78374166666666,-0.2836536356757145
1387,1237852,53,16,0.829762,251,1256933,-1,8000.0,1629714,1629767,391862,53,188,6,True,True,13.126333333333333,-0.829762
1388,1237979,28,8,0.696072,251,1256933,-1,4000.0,1661564,1661592,423585,28,185,8,True,True,3.4692,-0.696072
1389,1238030,25,4,0.138793,251,1256933,-1,2000.0,3543984,3544009,2305954,25,130,12,True,True,1.9429166666666664,-0.138793
1390,1240035,15281,128,0.705536,251,1256933,-1,64000.0,4076838,4092119,2836803,15281,110,12,True,True,26381.395022222223,-0.6905236293495889
1391,1240185,56,1,0.448601,251,1256933,-1,500.0,5733216,5733272,4493031,56,76,12,True,True,0.7697666666666666,-0.448601
1392,1240201,34,2,0.005251,251,1256933,-1,1000.0,3842404,3842438,2602203,34,119,7,True,True,1.3596222222222223,-0.005251
1393,1240206,7860,256,0.079226,251,1256933,-1,128000.0,3288724,3296584,2048518,7860,141,12,True,True,35181.59786666666,-0.07805505401675274
1394,1240227,36,64,0.255924,251,1256933,-1,32000.0,4076838,4076874,2836611,36,111,0,True,True,32.3776,-0.255924
1395,1240251,222,10,0.834963,251,1256933,-1,5000.0,1886464,1886686,646213,222,178,7,True,True,44.6775,-0.834963
1396,1242062,7846,3,0.548804,251,1256933,-1,1500.0,6345616,6353462,5103554,7846,65,12,True,True,440.55399166666666,-0.5365478404576328
1397,1242109,31,1,0.727235,251,1256933,-1,500.0,1307639,1307670,65530,31,228,1,True,True,0.4519111111111111,-0.727235
1398,1242152,2651,8,0.527772,251,1256933,-1,4000.0,4996616,4999267,3754464,2651,91,12,True,True,524.2682,-0.5032741791564688
1399,1242232,9941,12,0.111187,251,1256933,-1,6000.0,10590014,10599955,9347782,9941,3,12,True,True,1481.5213,-0.10859334349260108
1400,1242481,46,41,0.288102,251,1256933,-1,20500.0,6518416,6518462,5275935,46,65,12,True,True,26.18396666666667,-0.28810199999999997
1401,1242829,8,1,0.301151,251,1256933,-1,500.0,2710964,2710972,1468135,8,160,12,True,True,0.08785555555555555,-0.301151
1402,1242973,34,8,0.047749,251,1256933,-1,4000.0,5169416,5169450,3926443,34,92,12,True,True,2.6773111111111114,-0.047749
1403,1243056,18345,1,0.419826,251,1256933,-1,500.0,2123064,2141409,880008,18345,173,8,True,True,424.44515416666667,-0.410518076988669
1404,1243104,34,30,0.793899,251,1256933,-1,15000.0,1958864,1958898,715760,34,180,10,True,True,21.431333333333335,-0.793899
1405,1243221,20017,4,0.457114,251,1256933,-1,2000.0,6961216,6981233,5717995,20017,59,12,True,True,975.4701722222222,-0.443516515614908
9512,7420904,105,2,0.730865,1,7420904,-1,1000.0,7423104,7423209,2200,105,0,7,True,True,2.8642583333333334,-0.5923350664709558
9513,7421140,3189,4,0.225831,1,7423104,-1,2000.0,7509504,7512693,88364,3189,0,12,True,True,131.69055,-0.21631888399673654
9514,7447663,476,16,0.263812,139,7509504,-1,8000.0,13844213,13844689,6396550,476,0,10,True,True,73.70595555555556,-0.263812
9515,7451106,21769,32,0.296234,139,7509504,-1,16000.0,12688606,12710375,5237500,21769,1,12,True,True,11301.146355555557,-0.2839261429671349
9516,7451300,22056,128,0.082794,139,7509504,-1,64000.0,15814275,15836331,8362975,22056,0,12,True,True,64299.19146666666,-0.08110056197435937
9517,7451557,281,1,0.558515,139,7509504,-1,500.0,10699680,10699961,3248123,281,3,12,True,True,3.191691666666667,-0.558515
9518,7451869,38,64,0.872872,139,7509504,-1,32000.0,8326869,8326907,875000,38,4,2,True,True,24.526044444444445,-0.872872
9519,7453317,7620,1,0.659481,139,7509504,-1,500.0,7826969,7834589,373652,7620,5,10,True,True,98.36133472222224,-0.6539588462831313
9520,7453877,29,2,0.735268,139,7509504,-1,1000.0,9963911,9963940,2510034,29,4,6,True,True,1.0014666666666665,-0.735268
9521,7453926,1089,32,0.205891,139,7509504,-1,16000.0,13649813,13650902,6195887,1089,2,12,True,True,244.0328,-0.205891
9522,7454242,9589,42,0.078017,139,7509504,-1,21000.0,15727875,15737464,8273633,9589,1,7,True,True,7552.2888,-0.076159955086008
9523,7455218,114,4,0.971765,139,7509504,-1,2000.0,7782669,7782783,327451,114,9,6,True,True,6.151566666666667,-0.971765
9524,7457507,7217,1,0.060267,139,7509504,-1,500.0,7645604,7652821,188097,7217,10,6,True,True,89.36115416666667,-0.05919410686990913
9525,7457873,11752,130,0.013128,139,7509504,-1,65000.0,15906075,15917827,8448202,11752,0,8,True,True,41798.56073611111,-0.012984835315353337
9526,7458016,11,8,0.216135,139,7509504,-1,4000.0,11110089,11110100,3652073,11,6,12,True,True,1.4418555555555557,-0.216135
9527,7458182,96,4,0.818511,139,7509504,-1,2000.0,8086969,8087065,628787,96,10,2,True,True,5.448533333333334,-0.818511
9528,7458304,10277,71,0.187917,139,7509504,-1,35500.0,15720275,15730552,8261971,10277,3,2,True,True,13979.262676388891,-0.18503430614635233
9529,7458385,27,5,0.104535,139,7509504,-1,2500.0,12234308,12234335,4775923,27,7,12,True,True,3.1923749999999997,-0.104535
9530,7458487,184,4,0.208661,139,7509504,-1,2000.0,15686075,15686259,8227588,184,4,12,True,True,28.53737777777778,-0.208661
9531,7458666,13,32,0.590523,139,7509504,-1,16000.0,8339869,8339882,881203,13,12,7,True,True,3.6226666666666665,-0.590523
9532,7458715,1395,2,0.527645,139,7509504,-1,1000.0,8670752,8672147,1212037,1395,12,11,True,True,27.001000000000005,-0.527645
9533,7458727,46,1,0.858459,139,7509504,-1,500.0,7649204,7649250,190477,46,18,1,True,True,0.5481027777777778,-0.858459
9534,7458977,37320,8,0.760488,139,7509504,-1,4000.0,9204857,9242177,1745880,37320,12,12,True,True,3850.675733333333,-0.7114476910911871
9535,7459029,14846,1,0.311825,139,7509504,-1,500.0,15707675,15722521,8248646,14846,4,10,True,True,296.38614861111114,-0.3101729214787875
9536,7459262,6908,16,0.454022,139,7509504,-1,8000.0,12594108,12601016,5134846,6908,9,12,True,True,1630.2454222222223,-0.43660780966702295
9537,7459573,3195,4,0.153999,139,7509504,-1,2000.0,12147908,12151103,4688335,3195,11,7,True,True,273.8676555555556,-0.15129422347023241
9538,7459790,12,8,0.504511,139,7509504,-1,4000.0,11486808,11486820,4027018,12,12,6,True,True,1.6954666666666667,-0.504511
9539,7460179,8139,16,0.914125,139,7509504,-1,8000.0,8552382,8560521,1092203,8139,18,1,True,True,1872.8817333333334,-0.9030484491333898
9540,7460299,234,8,0.218785,139,7509504,-1,4000.0,15297275,15297509,7836976,234,6,12,True,True,33.321600000000004,-0.218785
9541,7460340,6157,1,0.363644,139,7509504,-1,500.0,12249808,12255965,4789468,6157,11,8,True,True,114.88908333333333,-0.3144791858828813
9542,7462757,1,1,0.975065,139,7509504,-1,500.0,8138169,8138170,675412,1,23,6,True,True,0.0126375,-0.975065
9543,7462847,46,3,0.867859,139,7509504,-1,1500.0,7552704,7552750,89857,46,29,11,True,True,2.11485,-0.867859
9544,7462894,755,4,0.513464,139,7509504,-1,2000.0,11210862,11211617,3747968,755,15,11,True,True,29.60019444444444,-0.513464
9545,7462915,17458,16,0.780021,139,7509504,-1,8000.0,8071469,8088927,608554,17458,26,10,True,True,3762.256111111111,-0.7780056984776912
9546,7463964,11,2,0.187953,139,7509504,-1,1000.0,12102508,12102519,4638544,11,14,7,True,True,0.4403972222222222,-0.187953
9547,7464892,13,4,0.277838,139,7509504,-1,2000.0,8132369,8132382,667477,13,26,6,True,True,0.6763611111111111,-0.277838
9548,7465082,6755,128,0.164196,139,7509504,-1,64000.0,15075875,15082630,7610793,6755,7,12,True,True,15527.583111111111,-0.16377645512867953
9549,7465329,22,2,0.307147,139,7509504,-1,1000.0,8627552,8627574,1162223,22,23,7,True,True,0.28679444444444446,-0.307147
9550,7465376,7661,16,0.869831,139,7509504,-1,8000.0,9605804,9613465,2140428,7661,21,12,True,True,1601.1779555555554,-0.8174853600034633
9551,7465404,2698,32,0.648383,139,7509504,-1,16000.0,12599508,12602206,5134104,2698,11,8,True,True,1234.7139555555555,-0.6445589489855464
9552,7465458,15,6,0.14729,139,7509504,-1,3000.0,9963940,9963955,2498482,15,21,1,True,True,1.554,-0.14728999999999998
9553,7465541,9,4,0.876196,139,7509504,-1,2000.0,8131269,8131278,665728,9,32,11,True,True,0.46825000000000006,-0.876196
9554,7465580,45,4,0.745026,139,7509504,-1,2000.0,7701404,7701449,235824,45,37,1,True,True,2.53125,-0.745026
9555,7465625,700,1,0.240562,139,7509504,-1,500.0,10786080,10786780,3320455,700,20,12,True,True,10.690555555555555,-0.240562
9556,7465675,13,1,0.894098,139,7509504,-1,500.0,8552369,8552382,1086694,13,29,11,True,True,0.17672777777777776,-0.894098
9557,7465724,4622,8,0.18703,139,7509504,-1,4000.0,14111070,14115692,6645346,4622,8,12,True,True,892.0958444444445,-0.1757291876183913
9558,7465781,102,4,0.028586,139,7509504,-1,2000.0,12861406,12861508,5395625,102,11,0,True,True,7.602966666666665,-0.028586
9559,7465790,1354,8,0.661886,139,7509504,-1,4000.0,10007140,10008494,2541350,1354,24,10,True,True,99.62677777777779,-0.658620227487468
9560,7465971,63,32,0.452641,139,7509504,-1,16000.0,12254508,12254571,4788537,63,15,2,True,True,37.352000000000004,-0.452641
9561,7466592,21,2,0.265579,139,7509504,-1,1000.0,11485708,11485729,4019116,21,21,7,True,True,0.7417666666666667,-0.265579
9562,7468178,56,2,0.926928,139,7509504,-1,1000.0,7891769,7891825,423591,56,42,10,True,True,1.0999333333333332,-0.926928
9563,7468182,484,16,0.084067,139,7509504,-1,8000.0,14643870,14644354,7175688,484,8,12,True,True,238.04195555555555,-0.084067
9564,7468203,10,8,0.431474,139,7509504,-1,4000.0,11487908,11487918,4019705,10,21,6,True,True,1.416,-0.431474
9565,7468269,26,16,0.15062,139,7509504,-1,8000.0,9962785,9962811,2494516,26,31,6,True,True,7.182933333333333,-0.15062
9566,7468381,1733,4,0.50219,139,7509504,-1,2000.0,9032041,9033774,1563660,1733,34,11,True,True,84.81083333333332,-0.4902236358938196
9567,7468392,9270,256,0.507927,139,7509504,-1,128000.0,8618282,8627552,1149890,9270,37,11,True,True,12403.3216,-0.35712693225062714
9568,7469489,16453,1,0.053157,139,7509504,-1,500.0,15713075,15729528,8243586,16453,4,8,True,True,321.25710833333335,-0.052834865665160616
9569,7469646,52,2,0.272589,139,7509504,-1,1000.0,11752508,11752560,4282862,52,22,8,True,True,1.1369222222222222,-0.272589
9570,7469780,170,1,0.097813,139,7509504,-1,500.0,14730270,14730440,7260490,170,9,12,True,True,7.640083333333333,-0.097813
9571,7469818,11436,128,0.648622,139,7509504,-1,64000.0,10223140,10234576,2753322,11436,31,12,True,True,15944.932266666669,-0.6320607153501174
9572,7470263,126,2,0.732002,139,7509504,-1,1000.0,7744604,7744730,274341,126,54,11,True,True,3.5119000000000002,-0.732002
9573,7470324,19,8,0.422588,139,7509504,-1,4000.0,14022470,14022489,6552146,19,12,8,True,True,4.483155555555556,-0.422588
9574,7470968,77,2,0.294006,139,7509504,-1,1000.0,15513275,15513352,8042307,77,7,11,True,True,5.704630555555555,-0.294006
9575,7471047,5,8,0.402692,139,7509504,-1,4000.0,7771306,7771311,300259,5,56,6,True,True,0.5072777777777778,-0.402692
9576,7471089,262,1,0.594049,139,7509504,-1,500.0,8044469,8044731,573380,262,53,6,True,True,4.6847055555555555,-0.594049
9577,7471439,140,32,0.529563,139,7509504,-1,16000.0,8193269,8193409,721830,140,48,9,True,True,28.659555555555556,-0.529563
9578,7471767,213,1,0.493616,139,7509504,-1,500.0,8249469,8249682,777702,213,48,11,True,True,2.1027833333333334,-0.493616
9579,7471808,102,11,0.433565,139,7509504,-1,5500.0,10309540,10309642,2837732,102,33,12,True,True,26.031958333333332,-0.433565
9580,7471834,10,4,0.681161,139,7509504,-1,2000.0,9053641,9053651,1581807,10,41,10,True,True,0.3453333333333333,-0.681161
9581,7471849,155,1,0.646345,139,7509504,-1,500.0,7639104,7639259,167255,155,66,12,True,True,1.7010694444444443,-0.6064178807041465
9582,7471908,27,1,0.958972,139,7509504,-1,500.0,8182469,8182496,710561,27,52,11,True,True,0.3664125,-0.958972
9583,7471940,6347,32,0.21958,139,7509504,-1,16000.0,13131413,13137760,5659473,6347,16,12,True,True,3751.7245333333335,-0.2180430401568308
9584,7472063,7103,16,0.053138,139,7509504,-1,8000.0,14460270,14467373,6988207,7103,12,12,True,True,3995.4776666666667,-0.050662220871745954
9585,7472164,321,1,0.035688,139,7509504,-1,500.0,8332269,8332590,860105,321,51,8,True,True,2.3205625,-0.035688
9586,7472257,9092,64,0.266178,139,7509504,-1,32000.0,14557470,14566562,7085213,9092,12,8,True,True,12056.105777777779,-0.2609145665927668
9587,7472310,34,4,0.065847,139,7509504,-1,2000.0,12498708,12498742,5026398,34,23,7,True,True,3.0086222222222223,-0.065847
9588,7472367,260,2,0.101032,139,7509504,-1,1000.0,8428469,8428729,956102,260,52,7,True,True,8.4825,-0.101032
9589,7472391,7,1,0.226465,139,7509504,-1,500.0,13034206,13034213,5561815,7,19,12,True,True,0.1030361111111111,-0.226465
9590,7472466,44,16,0.620221,139,7509504,-1,8000.0,7964169,7964213,491703,44,66,8,True,True,9.559733333333334,-0.620221
9591,7472913,203,5,0.715823,139,7509504,-1,2500.0,11310662,11310865,3837749,203,34,1,True,True,9.648138888888889,-0.715823
9592,7473068,4428,32,0.391908,139,7509504,-1,16000.0,14244270,14248698,6771202,4428,14,1,True,True,2212.6285333333335,-0.39100627850733216
9593,7473076,9633,85,0.101304,139,7509504,-1,42500.0,15599675,15609308,8126599,9633,7,12,True,True,18017.33395138889,-0.10053565860677958
9594,7473095,5,32,0.733924,139,7509504,-1,16000.0,7692404,7692409,219309,5,76,11,True,True,2.1144444444444446,-0.733924
9595,7473646,211,1,0.879528,139,7509504,-1,500.0,8088069,8088280,614423,211,66,6,True,True,2.9938555555555557,-0.879528
9596,7474035,16855,220,0.268267,139,7509504,-1,110000.0,14240670,14257525,6766635,16855,16,11,True,True,58098.12402777778,-0.2628677469799233
9597,7474304,116,32,0.205705,139,7509504,-1,16000.0,15124475,15124591,7650171,116,10,8,True,True,59.93333333333333,-0.205705
9598,7475199,4,8,0.785728,139,7509504,-1,4000.0,8292669,8292673,817470,4,62,10,True,True,0.20951111111111112,-0.785728
9599,7475208,21,1,0.347633,139,7509504,-1,500.0,13822613,13822634,6347405,21,21,12,True,True,0.30870000000000003,-0.347633
9600,7475834,57,16,0.287993,139,7509504,-1,8000.0,13930613,13930670,6454779,57,20,12,True,True,20.345200000000002,-0.287993
9601,7477326,23,1,0.596313,139,7509504,-1,500.0,9697604,9697627,2220278,23,51,11,True,True,0.27734166666666665,-0.596313
9602,7477372,2,32,0.733882,139,7509504,-1,16000.0,7755404,7755406,278032,2,81,9,True,True,0.7107555555555555,-0.733882
9603,7478388,75,4,0.094243,139,7509504,-1,2000.0,13520213,13520288,6041825,75,24,12,True,True,3.9020833333333336,-0.094243
9604,7478403,4037,1,0.50324,139,7509504,-1,500.0,9985540,9989577,2507137,4037,49,10,True,True,51.747476388888884,-0.5024413947808748
9605,7478737,15613,25,0.700471,139,7509504,-1,12500.0,9913785,9929398,2435048,15613,53,1,True,True,6161.8720486111115,-0.656879400923242
9606,7478932,12150,4,0.476758,139,7509504,-1,2000.0,7989369,8001519,510437,12150,79,1,True,True,667.8143333333333,-0.47188019568387257
9607,7479608,11987,1,0.305324,139,7509504,-1,500.0,15119075,15131062,7639467,11987,11,11,True,True,191.74698333333333,-0.29235442754380775
9608,7479731,23,16,0.906668,139,7509504,-1,8000.0,8206269,8206292,726538,23,71,7,True,True,1.9846444444444444,-0.906668
9609,7480361,86,8,0.238619,139,7509504,-1,4000.0,12239708,12239794,4759347,86,35,0,True,True,15.201933333333335,-0.238619
9610,7480435,12668,237,0.315112,139,7509504,-1,118500.0,12775006,12787674,5294571,12668,29,12,True,True,62954.85641666666,-0.2835029367366139
9611,7480498,8452,1,0.069455,139,7509504,-1,500.0,12602206,12610658,5121708,8452,31,2,True,True,123.98789722222223,-0.06913892650581635
9612,7481026,93,3,0.187344,139,7509504,-1,1500.0,12244408,12244501,4763382,93,37,1,True,True,8.8198875,-0.187344
9613,7481280,23947,247,0.899869,139,7509504,-1,123500.0,9382057,9406004,1900777,23947,61,12,True,True,67449.28314583334,-0.8915590615020123
9614,7481294,9,8,0.141834,139,7509504,-1,4000.0,15210875,15210884,7729581,9,10,12,True,True,1.3693000000000002,-0.141834
9615,7481416,4845,4,0.012735,139,7509504,-1,2000.0,14024670,14029515,6543254,4845,21,7,True,True,536.0790833333333,-0.012010267141182304
9616,7481427,46,20,0.474601,139,7509504,-1,10000.0,11397062,11397108,3915635,46,48,12,True,True,12.037944444444445,-0.474601
9617,7481465,14246,16,0.334054,139,7509504,-1,8000.0,11220662,11234908,3739197,14246,50,8,True,True,2458.488533333333,-0.32689232332841095
9618,7481557,48,7,0.177515,139,7509504,-1,3500.0,12250908,12250956,4769351,48,38,6,True,True,5.8184000000000005,-0.17751500000000003
9619,7481724,5912,64,0.263832,139,7509504,-1,32000.0,12240808,12246720,4759084,5912,41,6,True,True,10532.150755555556,-0.25781809310164205
9620,7482405,12589,32,0.076977,139,7509504,-1,16000.0,8319669,8332258,837264,12589,80,8,True,True,2838.3887999999997,-0.07359065278417266
9621,7482495,5781,4,0.679203,139,7509504,-1,2000.0,9118457,9124238,1635962,5781,69,1,True,True,361.26172777777776,-0.6543785601794845
9622,7483729,367,1,0.85309,139,7509504,-1,500.0,7781569,7781936,297840,367,99,8,True,True,4.950931944444444,-0.85309
9623,7483771,6,1,0.594005,139,7509504,-1,500.0,9118451,9118457,1634680,6,70,11,True,True,0.09952500000000002,-0.594005
9624,7483829,733,1,0.969542,139,7509504,-1,500.0,7773506,7774239,289677,733,101,7,True,True,9.456718055555555,-0.969542
9625,7484125,6337,128,0.583159,139,7509504,-1,64000.0,12507708,12514045,5023583,6337,36,8,True,True,13520.651022222222,-0.5595504270960294
9626,7485298,6441,64,0.488307,139,7509504,-1,32000.0,12299908,12306349,4814610,6441,38,11,True,True,8364.72,-0.47990044620487576
9627,7485400,6086,16,0.24751,139,7509504,-1,8000.0,14287470,14293556,6802070,6086,18,11,True,True,1325.8458666666666,-0.24433201231150195
9628,7485441,42,4,0.109386,139,7509504,-1,2000.0,13039613,13039655,5554172,42,30,8,True,True,2.1819,-0.109386
9629,7485503,324,2,0.818926,139,7509504,-1,1000.0,10136740,10137064,2651237,324,63,11,True,True,7.184699999999999,-0.818926
9630,7485531,3,19,0.567267,139,7509504,-1,9500.0,12239708,12239711,4754177,3,47,8,True,True,1.2594625000000002,-0.5672670000000001
9631,7485881,968,16,0.990413,139,7509504,-1,8000.0,8897777,8898745,1411896,968,79,9,True,True,111.75022222222223,-0.990413
9632,7485930,30,16,0.835359,139,7509504,-1,8000.0,10850880,10850910,3364950,30,60,10,True,True,6.358666666666666,-0.835359
9633,7486024,1347,4,0.525269,139,7509504,-1,2000.0,7783769,7785116,297745,1347,107,6,True,True,72.80535,-0.525269
9634,7486423,322,1,0.167305,139,7509504,-1,500.0,11703908,11704230,4217485,322,52,11,True,True,5.843405555555555,-0.167305
9635,7486522,39,8,0.146583,139,7509504,-1,4000.0,8800577,8800616,1314055,39,82,12,True,True,3.457566666666667,-0.146583
9636,7486545,96,32,0.09391,139,7509504,-1,16000.0,15716675,15716771,8230130,96,4,2,True,True,61.6448,-0.09391
9637,7486552,12,1,0.304602,139,7509504,-1,500.0,12502308,12502320,5015756,12,40,2,True,True,0.2406666666666667,-0.304602
9638,7486563,517,8,0.736186,139,7509504,-1,4000.0,9293457,9293974,1806894,517,78,7,True,True,56.485122222222216,-0.736186
9639,7486797,12091,64,0.452616,139,7509504,-1,32000.0,11215262,11227353,3728465,12091,61,7,True,True,8612.241333333333,-0.44806376090871686
9640,7486842,462,1,0.734815,139,7509504,-1,500.0,9053651,9054113,1566809,462,83,1,True,True,4.089829166666666,-0.6826314332515611
9641,7486887,589,32,0.989793,139,7509504,-1,16000.0,8573982,8574571,1087095,589,91,10,True,True,243.81982222222223,-0.989793
9642,7486917,28843,4,0.25734,139,7509504,-1,2000.0,11660708,11689551,4173791,28843,55,12,True,True,1712.6719444444448,-0.24231845724566742
9643,7505496,7,2,0.486493,139,7509504,-1,1000.0,7770206,7770213,264710,7,121,6,True,True,0.17754722222222222,-0.486493
9644,7505618,77,1,0.364289,139,7509504,-1,500.0,12100308,12100385,4594690,77,53,7,True,True,1.5413902777777777,-0.364289
9645,7505678,5,4,0.013561,139,7509504,-1,2000.0,14816670,14816675,7310992,5,15,12,True,True,0.3577222222222222,-0.013561
9646,7505987,3,1,0.352626,139,7509504,-1,500.0,13433813,13433816,5927826,3,31,12,True,True,0.06518333333333334,-0.352626
9647,7506481,10809,1,0.710157,139,7509504,-1,500.0,7644504,7655313,138023,10809,131,8,True,True,136.72076666666666,-0.6804437034053122
9648,7507707,1443,16,0.891372,139,7509504,-1,8000.0,7956569,7958012,448862,1443,117,11,True,True,321.0835333333333,-0.891372
9649,7508060,599,16,0.774526,139,7509504,-1,8000.0,9514004,9514603,2005944,599,82,10,True,True,140.07282222222224,-0.774526
9650,7508335,25,32,0.856956,139,7509504,-1,16000.0,8446469,8446494,938134,25,99,2,True,True,12.415555555555555,-0.856956
9651,7508355,439,16,0.902167,139,7509504,-1,8000.0,8988841,8989280,1480486,439,91,1,True,True,83.69653333333333,-0.8900673489154285
9652,7508810,41,1,0.595744,139,7509504,-1,500.0,11838908,11838949,4330098,41,56,11,True,True,0.7196069444444445,-0.595744
9653,7509792,1361,1,0.112761,177,7552704,-1,500.0,9449204,9450565,1939412,1361,84,11,True,True,13.3197625,-0.10008384211288147
9654,7510285,49,1,0.685784,177,7552704,-1,500.0,9075251,9075300,1564966,49,90,10,True,True,0.5886125,-0.685784
9655,7511158,181,4,0.728216,177,7552704,-1,2000.0,9913604,9913785,2402446,181,81,11,True,True,13.26227222222222,-0.728216
9656,7511337,264,4,0.020727,177,7552704,-1,2000.0,8988577,8988841,1477240,264,96,12,True,True,12.754133333333332,-0.020727
9657,7511356,16631,256,0.978637,177,7552704,-1,128000.0,11167662,11184293,3656306,16631,68,6,True,True,67732.74488888889,-0.97672067277304
9658,7511475,10,1,0.856266,177,7552704,-1,500.0,8899977,8899987,1388502,10,98,0,True,True,0.0895,-0.856266
9659,7514110,15957,32,0.659367,177,7552704,-1,16000.0,7805369,7821326,291259,15957,130,10,True,True,6131.310888888889,-0.6517117458099451
9660,7514206,8830,6,0.141633,177,7552704,-1,3000.0,12496508,12505338,4982302,8830,44,7,True,True,1118.4488833333335,-0.1390612196639112
9661,7515103,4,7,0.497832,177,7552704,-1,3500.0,9918485,9918489,2403382,4,82,6,True,True,0.5070333333333333,-0.497832
9662,7515573,71,1,0.244368,177,7552704,-1,500.0,11213062,11213133,3697489,71,68,7,True,True,0.695898611111111,-0.244368
9663,7516063,225,8,0.741012,177,7552704,-1,4000.0,8713952,8714177,1197889,225,104,11,True,True,13.66,-0.741012
9664,7516430,12454,64,0.973291,177,7552704,-1,32000.0,7761906,7774360,245476,12454,141,6,True,True,9985.780622222223,-0.964366296370849
9665,7516582,11,1,0.35942,177,7552704,-1,500.0,13347413,13347424,5830831,11,32,11,True,True,0.25035694444444445,-0.35942
9666,7523724,10082,16,0.744365,177,7552704,-1,8000.0,8492969,8503051,969245,10082,112,6,True,True,3166.6072222222224,-0.7429963645765029
9667,7524970,12360,8,0.193842,177,7552704,-1,4000.0,12472708,12485068,4947738,12360,46,12,True,True,2568.9119555555553,-0.1887949456152341
9668,7525197,20221,4,0.954814,177,7552704,-1,2000.0,7985769,8005990,460572,20221,133,10,True,True,1137.8453833333333,-0.945195801200991
9669,7525374,37,8,0.638734,177,7552704,-1,4000.0,9870404,9870441,2345030,37,88,12,True,True,6.0606,-0.638734
9670,7526550,15363,1,0.965453,177,7552704,-1,500.0,7760806,7776169,234256,15363,147,8,True,True,193.80736805555554,-0.9460942844136472
9671,7537641,10,8,0.877144,177,7552704,-1,4000.0,8043369,8043379,505728,10,133,9,True,True,1.4304444444444446,-0.877144
9672,7537765,8549,2,0.678802,177,7552704,-1,1000.0,8323269,8331818,785504,8549,120,2,True,True,135.6997,-0.6536077549011473
9673,7537949,63,20,0.899221,177,7552704,-1,10000.0,7774606,7774669,236657,63,145,6,True,True,16.255750000000003,-0.899221
9674,7538406,43480,111,0.449269,177,7552704,-1,55500.0,12947806,12991286,5409400,43480,36,12,True,True,102891.00754166665,-0.44357167902884514
9675,7538432,144,8,0.958306,177,7552704,-1,4000.0,8137069,8137213,598637,144,129,1,True,True,14.558399999999999,-0.958306
9676,7541236,118,1,0.526907,177,7552704,-1,500.0,7776169,7776287,234933,118,147,2,True,True,1.4194416666666667,-0.526907
9677,7541612,16086,8,0.265309,177,7552704,-1,4000.0,11023689,11039775,3482077,16086,75,12,True,True,2295.784866666667,-0.2638490592935578
9678,7541791,407,4,0.679066,177,7552704,-1,2000.0,9649004,9649411,2107213,407,92,11,True,True,12.456461111111112,-0.679066
9679,7541852,19,58,0.887995,177,7552704,-1,29000.0,8503769,8503788,961917,19,117,9,True,True,22.42263888888889,-0.887995
9680,7542109,173,4,0.391026,177,7552704,-1,2000.0,14373870,14374043,6831761,173,20,12,True,True,17.260594444444443,-0.391026
9681,7542142,19,2,0.417294,177,7552704,-1,1000.0,8139269,8139288,597127,19,132,6,True,True,0.480225,-0.417294
9682,7542176,299,7,0.993944,177,7552704,-1,3500.0,8072569,8072868,530393,299,139,6,True,True,27.624693055555554,-0.993944
9683,7542197,10425,8,0.309323,177,7552704,-1,4000.0,13304213,13314638,5762016,10425,34,12,True,True,1738.710277777778,-0.30490406729355707
9684,7542226,15,8,0.0411,177,7552704,-1,4000.0,11747108,11747123,4204882,15,64,11,True,True,1.2815,-0.0411
9685,7542506,5,1,0.520078,177,7552704,-1,500.0,10526880,10526885,2984374,5,82,12,True,True,0.06936111111111111,-0.520078
9686,7542518,10317,1,0.343274,177,7552704,-1,500.0,11397108,11407425,3854590,10317,70,1,True,True,136.87757916666666,-0.33534230855315683
9687,7543012,8973,128,0.612367,177,7552704,-1,64000.0,11158689,11167662,3615677,8973,78,8,True,True,18248.429333333333,-0.5950405029848114
9688,7543040,8227,32,0.43346,177,7552704,-1,16000.0,8032569,8040796,489529,8227,148,11,True,True,3489.0871999999995,-0.42556482795852674
9689,7543055,5167,1,0.455028,177,7552704,-1,500.0,14989475,14994642,7446420,5167,15,12,True,True,86.93470555555555,-0.4441799391466935
9690,7543071,9,4,0.968153,177,7552704,-1,2000.0,7755406,7755415,212335,9,167,1,True,True,0.3998,-0.968153
9691,7543195,2172,1,0.792341,177,7552704,-1,500.0,7765506,7767678,222311,2172,165,2,True,True,26.305333333333337,-0.792341
9692,7554084,9942,4,0.288409,252,7639104,-1,2000.0,8886977,8896919,1332893,9942,116,12,True,True,288.3870833333333,-0.2842586930532027
9693,7554231,35,32,0.96947,252,7639104,-1,16000.0,7913369,7913404,359138,35,155,10,True,True,13.382444444444445,-0.96947
9694,7554406,43,32,0.498927,252,7639104,-1,16000.0,12145708,12145751,4591302,43,61,11,True,True,29.63177777777778,-0.498927
9695,7554775,2,8,0.685527,252,7639104,-1,4000.0,8491869,8491871,937094,2,128,11,True,True,0.3511111111111111,-0.685527
9696,7554832,53,16,0.466317,252,7639104,-1,8000.0,13045013,13045066,5490181,53,37,8,True,True,10.711888888888888,-0.466317
9697,7554839,40,55,0.150228,252,7639104,-1,27500.0,15900675,15900715,8345836,40,1,12,True,True,62.25694444444445,-0.150228
9698,7554850,1522,14,0.966671,252,7639104,-1,7000.0,8083369,8084891,528519,1522,150,9,True,True,312.2213888888889,-0.9666710000000002
9699,7554855,11313,128,0.623795,252,7639104,-1,64000.0,8442869,8454182,888014,11313,132,2,True,True,23292.54026666667,-0.6187838771707151
9700,7554941,19250,16,0.66432,252,7639104,-1,8000.0,10829280,10848530,3274339,19250,86,11,True,True,4117.065111111111,-0.6624179628600445
9701,7555000,46,8,0.303646,252,7639104,-1,4000.0,13563413,13563459,6008413,46,33,11,True,True,3.8302666666666667,-0.303646
9702,7555030,5551,4,0.28826,252,7639104,-1,2000.0,11307062,11312613,3752032,5551,78,12,True,True,209.09230555555555,-0.28392954172402857
9703,7555576,9,3,0.799785,252,7639104,-1,1500.0,11153289,11153298,3597713,9,85,11,True,True,0.25875,-0.799785
9704,7555625,8,12,0.015592,252,7639104,-1,6000.0,15383675,15383683,7828050,8,11,12,True,True,1.6901333333333333,-0.015592000000000003
9705,7555664,5,1,0.040953,252,7639104,-1,500.0,8337669,8337674,782005,5,140,8,True,True,0.04354166666666667,-0.040953
9706,7555997,5,3,0.283017,252,7639104,-1,1500.0,10093540,10093545,2537543,5,97,12,True,True,0.13972916666666665,-0.283017
9707,7556017,9121,32,0.593072,252,7639104,-1,16000.0,10440480,10449601,2884463,9121,94,6,True,True,1951.8257333333331,-0.593013665579131
9708,7556166,31,8,0.053193,252,7639104,-1,4000.0,12861406,12861437,5305240,31,45,12,True,True,4.621411111111111,-0.053193
9709,7556438,21446,1,0.305822,252,7639104,-1,500.0,14197470,14218916,6641032,21446,27,12,True,True,430.14728611111116,-0.30300756181899013
9710,7556455,96,31,0.430323,252,7639104,-1,15500.0,12494308,12494404,4937853,96,56,10,True,True,65.19093333333335,-0.430323
9711,7556597,36,2,0.660253,252,7639104,-1,1000.0,9654404,9654440,2097807,36,112,8,True,True,0.5681,-0.660253
9712,7556755,6,1,0.000642,252,7639104,-1,500.0,8902177,8902183,1345422,6,128,7,True,True,0.053700000000000005,-0.000642
9713,7556892,9528,32,0.251433,252,7639104,-1,16000.0,14903075,14912603,7346183,9528,18,0,True,True,4687.851155555555,-0.24759737008071242
9714,7556984,9,16,0.350218,252,7639104,-1,8000.0,11795708,11795717,4238724,9,73,11,True,True,2.208,-0.350218
9715,7558656,58,8,0.283266,252,7639104,-1,4000.0,12494308,12494366,4935652,58,57,0,True,True,10.164177777777777,-0.283266
9716,7558728,21,2,0.859011,252,7639104,-1,1000.0,7769106,7769127,210378,21,189,3,True,True,0.5326416666666667,-0.859011
9717,7558783,39,32,0.665326,252,7639104,-1,16000.0,10937289,10937328,3378506,39,95,1,True,True,22.9736,-0.665326
9718,7558912,32,32,0.768885,252,7639104,-1,16000.0,10395940,10395972,2837028,32,102,12,True,True,12.48711111111111,-0.768885
9719,7559187,7647,29,0.155037,252,7639104,-1,14500.0,15470075,15477722,7910888,7647,11,12,True,True,3436.8852166666666,-0.1400312868184689
9720,7559722,9032,16,0.086003,252,7639104,-1,8000.0,13034213,13043245,5474491,9032,45,1,True,True,1979.3133555555557,-0.08331510341473583
9721,7559765,2,2,0.270669,252,7639104,-1,1000.0,12775006,12775008,5215241,2,50,0,True,True,0.09632777777777778,-0.270669
9722,7559900,26386,165,0.995914,252,7639104,-1,82500.0,8575082,8601468,1015182,26386,145,6,True,True,56251.35908333333,-0.9818392224404627
9723,7559976,9378,1,0.196727,252,7639104,-1,500.0,7697804,7707182,137828,9378,203,8,True,True,132.9432611111111,-0.19621063673468195
9724,7560136,28,13,0.585225,252,7639104,-1,6500.0,8714177,8714205,1154041,28,141,1,True,True,2.7623555555555557,-0.585225
9725,7560771,9,2,0.080718,252,7639104,-1,1000.0,10937280,10937289,3376509,9,99,11,True,True,0.33135,-0.080718
9726,7560886,251,8,0.218858,252,7639104,-1,4000.0,14903075,14903326,7342189,251,20,12,True,True,29.983344444444448,-0.218858
9727,7561424,240,8,0.473178,252,7639104,-1,4000.0,10439140,10439380,2877716,240,107,11,True,True,11.496,-0.473178
9728,7561428,10,2,0.354632,252,7639104,-1,1000.0,13930670,13930680,6369242,10,34,1,True,True,0.4461666666666667,-0.354632
9729,7561500,8311,8,0.811709,252,7639104,-1,4000.0,8448669,8456980,887169,8311,157,7,True,True,1021.4099333333335,-0.7802228342896337
9730,7561546,8018,128,0.637045,252,7639104,-1,64000.0,11574308,11582326,4012762,8018,84,12,True,True,17344.082844444445,-0.623835618824921
9731,7561575,499,8,0.422563,252,7639104,-1,4000.0,9295657,9296156,1734082,499,131,7,True,True,46.429177777777774,-0.422563
9732,7561780,114,32,0.966907,252,7639104,-1,16000.0,8509169,8509283,947389,114,156,8,True,True,77.1704,-0.966907
9733,7561869,11828,123,0.098139,252,7639104,-1,61500.0,12386308,12398136,4824439,11828,65,12,True,True,27010.970833333333,-0.09583735659278525
9734,7561916,15,16,0.261261,252,7639104,-1,8000.0,9406004,9406019,1844088,15,131,9,True,True,1.7316666666666667,-0.261261
9735,7561944,37,1,0.302023,252,7639104,-1,500.0,9961685,9961722,2399741,37,121,11,True,True,0.6388666666666667,-0.302023
9736,7562063,148,64,0.310736,252,7639104,-1,32000.0,10894080,10894228,3332017,148,104,11,True,True,174.00853333333336,-0.310736
9737,7562097,26,32,0.563908,252,7639104,-1,16000.0,11483508,11483534,3921411,26,89,12,True,True,14.027288888888888,-0.563908
9738,7562119,700,13,0.678923,252,7639104,-1,6500.0,9917385,9918085,2355266,700,125,1,True,True,161.0548333333333,-0.663551158490566
9739,7562305,3,2,0.32248,252,7639104,-1,1000.0,9784004,9784007,2221699,3,129,12,True,True,0.11441666666666668,-0.32248
9740,7562431,6273,8,0.578167,252,7639104,-1,4000.0,8439269,8445542,876838,6273,170,8,True,True,804.1563888888888,-0.5777845356778618
9741,7562440,4825,16,0.683321,252,7639104,-1,8000.0,8049869,8054694,487429,4825,193,8,True,True,1565.3064444444444,-0.678939145556427
9742,7562457,999,4,0.199507,252,7639104,-1,2000.0,13217813,13218812,5655356,999,44,12,True,True,116.26140000000001,-0.199507
9743,7562624,42,1,0.135691,252,7639104,-1,500.0,8271069,8271111,708445,42,180,10,True,True,0.345275,-0.135691
9744,7562724,6792,128,0.554284,252,7639104,-1,64000.0,14017070,14023862,6454346,6792,34,12,True,True,26859.299911111113,-0.48031960807193336
9745,7562749,15,1,0.301062,252,7639104,-1,500.0,14816675,14816690,7253926,15,21,1,True,True,0.26829166666666665,-0.301062
9746,7562848,7025,2,0.085598,252,7639104,-1,1000.0,9492404,9499429,1929556,7025,138,11,True,True,161.14867222222222,-0.08522613632594289
9747,7562964,28,1,0.566665,252,7639104,-1,500.0,11925308,11925336,4362344,28,82,12,True,True,0.5603888888888888,-0.566665
9748,7562969,86,1,0.628319,252,7639104,-1,500.0,9962811,9962897,2399842,86,126,1,True,True,1.4849333333333332,-0.628319
9749,7562995,13964,16,0.545831,252,7639104,-1,8000.0,8426269,8440233,863274,13964,178,12,True,True,3466.6657555555557,-0.5439221361416456
9750,7563194,10781,20,0.375966,252,7639104,-1,10000.0,9291257,9302038,1728063,10781,146,12,True,True,2541.634666666667,-0.3545075760992264
9751,7563252,6624,2,0.875921,252,7639104,-1,1000.0,8314269,8320893,751017,6624,186,10,True,True,76.68200833333333,-0.7662995475421059
9752,7563313,139,8,0.436893,252,7639104,-1,4000.0,10439380,10439519,2876067,139,116,1,True,True,6.6581,-0.436893
9753,7564405,6,1,0.13861,252,7639104,-1,500.0,12011708,12011714,4447303,6,82,12,True,True,0.14113333333333336,-0.13861
9754,7564740,14547,1,0.441901,252,7639104,-1,500.0,7958769,7973316,394029,14547,212,7,True,True,196.17892083333334,-0.42969485985373024
9755,7564774,6,16,0.31326,252,7639104,-1,8000.0,8433869,8433875,869095,6,180,8,True,True,1.4450666666666667,-0.31326
9756,7564834,20618,32,0.93488,252,7639104,-1,16000.0,8133469,8154087,568635,20618,199,6,True,True,9753.783955555557,-0.9015623779561965
9757,7564875,32,4,0.712599,252,7639104,-1,2000.0,9519404,9519436,1954529,32,141,8,True,True,1.8396444444444444,-0.712599
9758,7564880,13,8,0.468379,252,7639104,-1,4000.0,12098108,12098121,4533228,13,82,12,True,True,2.305911111111111,-0.468379
9759,7565888,11,2,0.427669,252,7639104,-1,1000.0,8899977,8899988,1334089,11,162,7,True,True,0.1969,-0.427669
9760,7565897,69,2,0.420506,252,7639104,-1,1000.0,14546670,14546739,6980773,69,26,12,True,True,3.2479833333333334,-0.420506
9761,7565911,20256,128,0.410259,252,7639104,-1,64000.0,12256708,12276964,4690797,20256,71,7,True,True,73316.56248888889,-0.40629280129009243
9762,7566277,4590,1,0.027673,252,7639104,-1,500.0,15725675,15730265,8159398,4590,4,8,True,True,87.46075,-0.027439658234557195
9763,7566559,28,32,0.558909,252,7639104,-1,16000.0,13736213,13736241,6169654,28,42,12,True,True,12.500444444444444,-0.558909
9764,7566576,2,32,0.957492,252,7639104,-1,16000.0,7870169,7870171,303593,2,225,11,True,True,0.7874666666666666,-0.957492
9765,7566639,79,4,0.420919,252,7639104,-1,2000.0,14552070,14552149,6985431,79,27,8,True,True,6.595183333333334,-0.420919
9766,7566742,64,5,0.755856,252,7639104,-1,2500.0,8204069,8204133,637327,64,202,9,True,True,1.6653333333333333,-0.755856
9767,7566922,8560,8,0.615209,252,7639104,-1,4000.0,10613280,10621840,3046358,8560,121,12,True,True,833.7955555555556,-0.6117083810478827
7477,5838914,19466,16,0.616028,1,5838914,-1,8000.0,5925314,5944780,86400,19466,0,12,True,True,4058.3325777777777,-0.5478035640568977
7478,5839417,118,8,0.189102,63,5925314,-1,4000.0,6842860,6842978,1003443,118,0,10,True,True,17.200466666666667,-0.189102
7479,5839583,4,2,0.535468,63,5925314,-1,1000.0,8386895,8386899,2547312,4,0,12,True,True,0.12677777777777777,-0.535468
7480,5839618,2272,4,0.789588,63,5925314,-1,2000.0,6402596,6404868,562978,2272,2,10,True,True,349.1194888888889,-0.762013428115202
7481,5839644,34,8,0.327681,63,5925314,-1,4000.0,8564095,8564129,2724451,34,0,7,True,True,4.084911111111111,-0.327681
7482,5839700,19967,1,0.053259,63,5925314,-1,500.0,8938787,8958754,3099087,19967,0,8,True,True,356.55690555555555,-0.05050179722700867
7483,5839896,20,1,0.795612,63,5925314,-1,500.0,6353996,6354016,514100,20,5,6,True,True,0.2446222222222222,-0.7916923747796609
7484,5840012,82,4,0.872851,63,5925314,-1,2000.0,6495496,6495578,655484,82,4,8,True,True,8.057411111111112,-0.872851
7485,5840100,18,1,0.851503,63,5925314,-1,500.0,6989860,6989878,1149760,18,3,6,True,True,0.22890000000000002,-0.851503
7486,5840188,107,1,0.968384,63,5925314,-1,500.0,6023614,6023721,183426,107,8,8,True,True,1.382677777777778,-0.968384
7487,5870614,11551,32,0.885834,63,5925314,-1,16000.0,6793860,6805411,923246,11551,5,11,True,True,5436.967155555556,-0.8464244022817153
7488,5880600,3,16,0.209238,63,5925314,-1,8000.0,10240105,10240108,4359505,3,0,7,True,True,0.46813333333333335,-0.209238
7489,5880962,15,2,0.081408,63,5925314,-1,1000.0,10194705,10194720,4313743,15,1,8,True,True,0.46962499999999996,-0.081408
7490,5881100,68,4,0.470667,63,5925314,-1,2000.0,7802795,7802863,1921695,68,5,6,True,True,3.911888888888889,-0.470667
7491,5881385,2,8,0.663502,63,5925314,-1,4000.0,7668795,7668797,1787410,2,6,7,True,True,0.26066666666666666,-0.663502
7492,5881622,112,17,0.064873,63,5925314,-1,8500.0,10372360,10372472,4490738,112,0,7,True,True,41.55215555555555,-0.064873
7493,5883158,1641,1,0.508614,63,5925314,-1,500.0,8585695,8587336,2702537,1641,4,10,True,True,29.43201666666667,-0.500914156809621
7494,5883784,6,1,0.751308,63,5925314,-1,500.0,7489395,7489401,1605611,6,9,11,True,True,0.09260000000000002,-0.751308
7495,5885585,1201,64,0.645072,63,5925314,-1,32000.0,8554295,8555496,2668710,1201,6,12,True,True,1264.5195555555556,-0.645072
7496,5887426,17,64,0.509159,63,5925314,-1,32000.0,9250303,9250320,3362877,17,3,6,True,True,22.61377777777778,-0.509159
7497,5888353,2940,16,0.498588,63,5925314,-1,8000.0,6156514,6159454,268161,2940,18,10,True,True,1616.8693333333333,-0.498588
7498,5888516,102,4,0.464267,63,5925314,-1,2000.0,8929787,8929889,3041271,102,5,7,True,True,8.245566666666665,-0.464267
7499,5889002,20,8,0.321823,63,5925314,-1,4000.0,9552005,9552025,3663003,20,3,7,True,True,2.900888888888889,-0.321823
7500,5889054,7028,1,0.373879,63,5925314,-1,500.0,8467895,8474923,2578841,7028,10,8,True,True,119.92036805555556,-0.357556748357209
7501,5890305,1107,1,0.69451,63,5925314,-1,500.0,5930714,5931821,40409,1107,23,8,True,True,11.4343875,-0.69451
7502,5890888,78,1,0.71565,63,5925314,-1,500.0,5931814,5931892,40926,78,23,6,True,True,0.805675,-0.71565
7503,5890994,2,64,0.494792,63,5925314,-1,32000.0,9102501,9102503,3211507,2,5,0,True,True,2.993422222222222,-0.494792
7504,5891319,21,4,0.268335,63,5925314,-1,2000.0,9361557,9361578,3470238,21,4,6,True,True,1.6594666666666669,-0.268335
7505,5894446,38,1,0.400946,63,5925314,-1,500.0,8430095,8430133,2535649,38,13,9,True,True,0.4766888888888889,-0.400946
7506,5895769,6344,1,0.921185,63,5925314,-1,500.0,6018214,6024558,122445,6344,26,12,True,True,81.7525888888889,-0.9195005208919511
7507,5895801,14,16,0.583983,63,5925314,-1,8000.0,6843960,6843974,948159,14,19,6,True,True,4.173866666666666,-0.583983
7508,5896365,6,16,0.036604,63,5925314,-1,8000.0,6348196,6348202,451831,6,25,6,True,True,1.3878666666666668,-0.036604
7509,5897788,87,45,0.219526,63,5925314,-1,22500.0,8961487,8961574,3063699,87,7,10,True,True,84.89025,-0.219526
7510,5897835,22,1,0.203,63,5925314,-1,500.0,6794960,6794982,897125,22,22,6,True,True,0.27466388888888893,-0.203
7511,5903646,2,16,0.863168,63,5925314,-1,8000.0,7079560,7079562,1175914,2,19,6,True,True,0.7057777777777778,-0.863168
7512,5903692,5511,16,0.3959,63,5925314,-1,8000.0,7780095,7785606,1876403,5511,17,11,True,True,2075.343066666667,-0.3949036752588686
7513,5903830,14,1,0.305999,63,5925314,-1,500.0,10091005,10091019,4187175,14,3,8,True,True,0.2197222222222222,-0.305999
7514,5903854,21512,256,0.888709,63,5925314,-1,128000.0,7446195,7467707,1542341,21512,21,7,True,True,107480.8664888889,-0.8667703969751837
7515,5903891,13741,32,0.57137,63,5925314,-1,16000.0,9305657,9319398,3401766,13741,6,7,True,True,12107.994933333335,-0.5694808520988319
7516,5903910,6463,1,0.935499,63,5925314,-1,500.0,6490096,6496559,586186,6463,30,12,True,True,163.31376805555556,-0.9145153045833633
7517,5904073,7,16,0.374107,63,5925314,-1,8000.0,10283305,10283312,4379232,7,1,11,True,True,1.6002,-0.374107
7518,5904109,192,32,0.550552,63,5925314,-1,16000.0,6340196,6340388,436087,192,35,1,True,True,80.29013333333334,-0.550552
7519,5904173,54,29,0.13433,63,5925314,-1,14500.0,10332005,10332059,4427832,54,1,7,True,True,23.231175,-0.13433
7520,5904231,20,8,0.084028,63,5925314,-1,4000.0,9998105,9998125,4093874,20,6,8,True,True,2.631777777777778,-0.084028
7521,5904299,7667,1,0.444505,63,5925314,-1,500.0,9461205,9468872,3556906,7667,8,12,True,True,161.78603611111112,-0.43434314212354236
7522,5904344,7,4,0.351575,63,5925314,-1,2000.0,8782387,8782394,2878043,7,16,7,True,True,0.49295555555555554,-0.351575
7523,5904545,13,64,0.583962,63,5925314,-1,32000.0,6293383,6293396,388838,13,40,10,True,True,14.327733333333333,-0.583962
7524,5905986,11287,128,0.465253,63,5925314,-1,64000.0,10339742,10351029,4433756,11287,1,8,True,True,20548.860444444443,-0.4476681486255721
7525,5906035,4050,67,0.621126,63,5925314,-1,33500.0,8556495,8560545,2650460,4050,20,7,True,True,4387.200479166667,-0.611846115852122
7526,5906485,4656,2,0.426102,63,5925314,-1,1000.0,9549805,9554461,3643320,4656,9,12,True,True,168.6196,-0.4260403500818292
7527,5906664,83,37,0.467551,63,5925314,-1,18500.0,8693787,8693870,2787123,83,19,12,True,True,53.81500972222222,-0.467551
7528,5906719,25,1,0.408953,63,5925314,-1,500.0,6572455,6572480,665736,25,38,1,True,True,0.45503472222222224,-0.408953
7529,5906995,65,8,0.804504,63,5925314,-1,4000.0,6549496,6549561,642501,65,39,9,True,True,13.807444444444444,-0.804504
7530,5907080,18,4,0.31702,63,5925314,-1,2000.0,9244503,9244521,3337423,18,14,7,True,True,1.3944999999999999,-0.31702
7531,5907182,677,2,0.382371,63,5925314,-1,1000.0,8276695,8277372,2369513,677,28,7,True,True,20.83843611111111,-0.382371
7532,5907513,29749,128,0.179566,63,5925314,-1,64000.0,10399360,10429109,4491847,29749,0,10,True,True,62872.65102222221,-0.17732979245845343
7533,5908228,324,8,0.23379,63,5925314,-1,4000.0,9249203,9249527,3340975,324,15,6,True,True,53.874,-0.23379
7534,5922727,807,2,0.645355,63,5925314,-1,1000.0,6182083,6182890,259356,807,51,6,True,True,32.72833333333333,-0.645355
7535,5922836,12,1,0.359093,63,5925314,-1,500.0,6664260,6664272,741424,12,42,10,True,True,0.2575333333333334,-0.359093
7536,5922893,56,8,0.082419,63,5925314,-1,4000.0,10370160,10370216,4447267,56,2,2,True,True,7.588622222222222,-0.082419
7537,5923043,9440,30,0.842603,63,5925314,-1,15000.0,6642660,6652100,719617,9440,44,11,True,True,5323.394166666667,-0.839507450216856
7538,5923741,6610,32,0.512791,63,5925314,-1,16000.0,10189305,10195915,4265564,6610,8,11,True,True,3358.6577777777775,-0.4948011936028471
7539,5924008,267,32,0.643654,63,5925314,-1,16000.0,6351796,6352063,427788,267,52,3,True,True,102.43306666666666,-0.643654
7540,5924145,828,2,0.785873,63,5925314,-1,1000.0,6347096,6347924,422951,828,54,6,True,True,23.940700000000003,-0.785873
7541,5937302,20,8,0.926606,117,6018214,-1,4000.0,6111114,6111134,173812,20,59,6,True,True,5.652,-0.926606
7542,5937343,15455,1,0.098409,117,6018214,-1,500.0,6599460,6614915,662117,15455,46,10,True,True,313.66247222222216,-0.0909642607280242
7543,5937364,22032,1,0.071349,117,6018214,-1,500.0,8927587,8949619,2990223,22032,23,7,True,True,422.26721111111107,-0.07052154933471715
7544,5937459,60,16,0.038281,117,6018214,-1,8000.0,8457095,8457155,2519636,60,31,8,True,True,15.577333333333334,-0.038281
7545,5938122,17491,128,0.200307,117,6018214,-1,64000.0,9812305,9829796,3874183,17491,11,12,True,True,70954.73813333335,-0.18667797436776828
7546,5939596,10,1,0.196646,117,6018214,-1,500.0,9368305,9368315,3428709,10,15,1,True,True,0.21220833333333333,-0.196646
7547,5940046,5,9,0.329241,117,6018214,-1,4500.0,7139995,7140000,1199949,5,42,0,True,True,0.611375,-0.329241
7548,5943944,43,16,0.302716,117,6018214,-1,8000.0,9026287,9026330,3082343,43,22,11,True,True,15.248755555555558,-0.302716
7549,5944054,4569,8,0.815565,117,6018214,-1,4000.0,6176414,6180983,232360,4569,65,1,True,True,729.0072333333333,-0.7790205027594791
7550,5944985,16221,32,0.683539,117,6018214,-1,16000.0,8883587,8899808,2938602,16221,27,2,True,True,13780.099333333334,-0.6629118090895749
7551,5945227,20,1,0.274465,117,6018214,-1,500.0,6988760,6988780,1043533,20,47,6,True,True,0.25433333333333336,-0.274465
7552,5945250,9156,1,0.705643,117,6018214,-1,500.0,6345996,6355152,400746,9156,64,2,True,True,119.62604999999999,-0.6917278987167352
7553,5949338,6946,1,0.997996,117,6018214,-1,500.0,6172814,6179760,223476,6946,69,7,True,True,147.1681861111111,-0.9306608857196507
7554,5949610,9251,4,0.998405,117,6018214,-1,2000.0,6293396,6302647,343786,9251,66,1,True,True,648.45255,-0.9957221628791595
7555,5950566,59,4,0.752383,117,6018214,-1,2000.0,6180983,6181042,230417,59,69,3,True,True,4.598394444444445,-0.752383
7556,5950742,7103,32,0.739821,117,6018214,-1,16000.0,7670995,7678098,1720253,7103,41,7,True,True,3911.5314666666663,-0.7374586208455347
7557,5950940,1359,8,0.912383,117,6018214,-1,4000.0,6571096,6572455,620156,1359,57,10,True,True,197.8855,-0.912383
7558,5951016,40,8,0.008534,117,6018214,-1,4000.0,10354629,10354669,4403613,40,3,2,True,True,4.808000000000001,-0.008534
7559,5951084,22235,2,0.299474,117,6018214,-1,1000.0,8265495,8287730,2314411,22235,40,12,True,True,685.445736111111,-0.2942904852594895
7560,5951247,6,1,0.822309,117,6018214,-1,500.0,6352896,6352902,401649,6,65,6,True,True,0.07193333333333334,-0.822309
7561,5951296,6,78,0.783128,117,6018214,-1,39000.0,9097101,9097107,3145805,6,23,0,True,True,13.27495,-0.783128
7562,5951655,140,1,0.403811,117,6018214,-1,500.0,6113314,6113454,161659,140,79,7,True,True,5.905861111111111,-0.403811
7563,5951854,12,1,0.405758,117,6018214,-1,500.0,9257903,9257915,3306049,12,19,6,True,True,0.22203333333333333,-0.405758
7564,5951926,14,1,0.579954,117,6018214,-1,500.0,9145703,9145717,3193777,14,23,11,True,True,0.26485277777777777,-0.579954
7565,5951995,14,28,0.655309,117,6018214,-1,14000.0,9097101,9097115,3145106,14,26,1,True,True,11.119188888888887,-0.655309
7566,5952001,11284,16,0.472004,117,6018214,-1,8000.0,9239003,9250287,3287002,11284,23,2,True,True,3564.431377777778,-0.4661102066225639
7567,5952197,8289,16,0.512647,117,6018214,-1,8000.0,8890787,8899076,2938590,8289,33,2,True,True,3724.425733333333,-0.5123797418731151
7568,5953161,12067,16,0.761161,117,6018214,-1,8000.0,7933495,7945562,1980334,12067,47,6,True,True,5034.9966,-0.7350193379386422
7569,5955024,20,4,0.149281,117,6018214,-1,2000.0,10237905,10237925,4282881,20,8,11,True,True,0.7407777777777779,-0.149281
7570,5955318,15,1,0.397505,117,6018214,-1,500.0,9303457,9303472,3348139,15,20,7,True,True,0.37424999999999997,-0.397505
7571,5955467,16,16,0.226926,117,6018214,-1,8000.0,9985105,9985121,4029638,16,13,12,True,True,6.2844444444444445,-0.226926
7572,5955906,27,1,0.749137,117,6018214,-1,500.0,6890460,6890487,934554,27,61,11,True,True,0.3705,-0.749137
7573,5956088,10745,1,0.474438,117,6018214,-1,500.0,9352157,9362902,3396069,10745,20,0,True,True,195.81959027777776,-0.4600406694244597
7574,5961665,86,1,0.515825,117,6018214,-1,500.0,8386895,8386981,2425230,86,48,0,True,True,1.362861111111111,-0.515825
7575,5969778,334,8,0.785975,117,6018214,-1,4000.0,6342396,6342730,372618,334,83,7,True,True,34.91784444444445,-0.785975
7576,5970831,20,1,0.757621,117,6018214,-1,500.0,8879987,8880007,2909156,20,39,2,True,True,0.4440555555555556,-0.757621
7577,5972158,9422,1,0.72251,117,6018214,-1,500.0,6799660,6809082,827502,9422,67,2,True,True,153.75278055555555,-0.7127366070178826
7578,5972911,50,1,0.461401,117,6018214,-1,500.0,9301257,9301307,3328346,50,23,1,True,True,1.325,-0.461401
7579,5972972,7561,17,0.791915,117,6018214,-1,8500.0,6110014,6117575,137042,7561,97,12,True,True,5129.9223375,-0.7413496793767695
7580,5973042,2995,5,0.313075,117,6018214,-1,2500.0,8274495,8277490,2301453,2995,53,2,True,True,230.80013888888888,-0.3128185159280113
7581,5973569,43036,2,0.187847,117,6018214,-1,1000.0,10366560,10409596,4392991,43036,3,2,True,True,1765.1299444444444,-0.1847943202047224
7582,5975531,24,16,0.770131,117,6018214,-1,8000.0,6538696,6538720,563165,24,79,11,True,True,7.477333333333333,-0.770131
7583,5993285,22793,128,0.697941,117,6018214,-1,64000.0,9348857,9371650,3355572,22793,22,0,True,True,56364.361066666665,-0.6762707634603151
7584,5995698,2,8,0.209585,117,6018214,-1,4000.0,9362902,9362904,3367204,2,20,2,True,True,0.3160888888888889,-0.209585
7585,5995748,7,4,0.449972,117,6018214,-1,2000.0,6250183,6250190,254435,7,95,6,True,True,0.5804166666666667,-0.449972
7586,5995800,686,1,0.558447,117,6018214,-1,500.0,8066695,8067381,2070895,686,58,10,True,True,13.796222222222223,-0.558447
7587,5995817,602,1,0.3747,117,6018214,-1,500.0,8901587,8902189,2905770,602,41,9,True,True,16.69546666666667,-0.3747
7588,5995826,170,4,0.577508,117,6018214,-1,2000.0,8693787,8693957,2697961,170,46,0,True,True,11.916055555555555,-0.577508
7589,5997313,37,6,0.128346,117,6018214,-1,3000.0,10401560,10401597,4404247,37,0,7,True,True,3.026291666666667,-0.128346
7590,5997397,69,8,0.943354,117,6018214,-1,4000.0,7618995,7619064,1621598,69,67,11,True,True,10.774733333333332,-0.943354
7591,5997607,47,16,0.009681,117,6018214,-1,8000.0,8780187,8780234,2782580,47,47,12,True,True,13.749066666666666,-0.009681
7592,6010433,2573,2,0.810401,117,6018214,-1,1000.0,7103595,7106168,1093162,2573,72,10,True,True,108.98799166666667,-0.810401
7593,6010526,2,4,0.834299,117,6018214,-1,2000.0,6225283,6225285,214757,2,103,11,True,True,0.3484,-0.834299
7594,6010551,78,1,0.339822,117,6018214,-1,500.0,7443995,7444073,1433444,78,71,11,True,True,2.3663250000000002,-0.339822
7595,6010570,6486,32,0.419147,117,6018214,-1,16000.0,6966060,6972546,955490,6486,77,9,True,True,2576.299466666667,-0.4191118611649449
7596,6010615,23,1,0.685763,117,6018214,-1,500.0,7958695,7958718,1948080,23,63,1,True,True,0.4668041666666667,-0.685763
7597,6011833,103,8,0.403369,117,6018214,-1,4000.0,9898705,9898808,3886872,103,16,12,True,True,17.408144444444446,-0.403369
7598,6084405,10,1,0.778643,185,6110014,-1,500.0,6247983,6247993,163578,10,107,10,True,True,0.17813888888888887,-0.778643
7599,6084716,8396,8,0.537604,185,6110014,-1,4000.0,9102501,9110897,3017785,8396,36,8,True,True,1412.1645333333333,-0.5187206540758622
7600,6085683,12,4,0.32608,185,6110014,-1,2000.0,7622295,7622307,1536612,12,71,6,True,True,1.0590666666666668,-0.32608
7601,6085768,291,64,0.02324,185,6110014,-1,32000.0,10377760,10378051,4291992,291,2,8,True,True,742.6837333333333,-0.02324
7602,6085843,31,32,0.785358,185,6110014,-1,16000.0,7801695,7801726,1715852,31,69,10,True,True,14.266888888888888,-0.785358
7603,6085865,8087,26,0.922144,185,6110014,-1,13000.0,7373395,7381482,1287530,8087,78,9,True,True,3950.2747194444446,-0.9182582491262561
7604,6093970,4,2,0.153691,185,6110014,-1,1000.0,9235403,9235407,3141433,4,35,7,True,True,0.15322222222222223,-0.153691
7605,6094137,1277,1,0.952638,185,6110014,-1,500.0,7080660,7081937,986523,1277,82,6,True,True,27.495502777777777,-0.9299951159812532
7606,6094181,836,16,0.330251,185,6110014,-1,8000.0,7314995,7315831,1220814,836,80,6,True,True,174.11982222222224,-0.3293892079208829
7607,6094592,4818,1,0.629839,185,6110014,-1,500.0,8983087,8987905,2888495,4818,42,10,True,True,110.05148472222223,-0.6205513968592389
7608,6094727,8,8,0.603003,185,6110014,-1,4000.0,7715295,7715303,1620568,8,73,6,True,True,1.1597333333333333,-0.603003
7609,6094907,18787,2,0.607837,185,6110014,-1,1000.0,9233203,9251990,3138296,18787,36,12,True,True,739.5952055555556,-0.6045578558972291
7610,6094978,10,4,0.866945,185,6110014,-1,2000.0,6403696,6403706,308718,10,106,6,True,True,1.5922222222222224,-0.866945
7611,6095254,11,44,0.980172,185,6110014,-1,22000.0,6750660,6750671,655406,11,97,12,True,True,9.913261111111112,-0.980172
7612,6095273,34,1,0.204205,185,6110014,-1,500.0,10341942,10341976,4246669,34,7,7,True,True,0.43907222222222225,-0.204205
7613,6095276,750,8,0.390636,185,6110014,-1,4000.0,9353257,9354007,3257981,750,26,6,True,True,104.925,-0.390636
7614,6095281,697,1,0.534491,185,6110014,-1,500.0,9351057,9351754,3255776,697,28,7,True,True,13.261393055555557,-0.534491
7615,6095288,87,1,0.188339,185,6110014,-1,500.0,7621195,7621282,1525907,87,81,6,True,True,1.9068361111111112,-0.18709074899897402
7616,6095300,5354,8,0.108638,185,6110014,-1,4000.0,10286605,10291959,4191305,5354,10,6,True,True,698.6633666666667,-0.10850330720969106
7617,6095363,19008,8,0.569515,185,6110014,-1,4000.0,9093501,9112509,2998138,19008,46,2,True,True,3617.1556,-0.5166260254488975
7618,6095534,31,4,0.451535,185,6110014,-1,2000.0,8923187,8923218,2827653,31,53,10,True,True,2.83495,-0.451535
7619,6095582,113,2,0.894744,185,6110014,-1,1000.0,6158714,6158827,63132,113,133,6,True,True,7.768122222222222,-0.894744
7620,6095896,137,32,0.093242,185,6110014,-1,16000.0,10334205,10334342,4238309,137,9,7,True,True,65.03542222222222,-0.093242
7621,6095972,9,2,0.104313,185,6110014,-1,1000.0,10285505,10285514,4189533,9,12,6,True,True,0.29100000000000004,-0.104313
7622,6095994,6961,17,0.552907,185,6110014,-1,8500.0,8092695,8099656,1996701,6961,76,7,True,True,3064.0694694444446,-0.4919012525490764
7623,6096053,39045,8,0.032059,185,6110014,-1,4000.0,9553105,9592150,3457052,39045,23,6,True,True,12288.481444444444,-0.03098754354060551
7624,6096103,12315,4,0.689025,185,6110014,-1,2000.0,8933387,8945702,2837284,12315,54,2,True,True,964.4182777777778,-0.6875967720563267
7625,6096127,23680,2,0.488613,185,6110014,-1,1000.0,7081995,7105675,985868,23680,98,1,True,True,944.346125,-0.48461542592090323
7626,6096190,11,1,0.186692,185,6110014,-1,500.0,9348857,9348868,3252667,11,34,11,True,True,0.22407916666666666,-0.186692
7627,6096215,699,18,0.069491,185,6110014,-1,9000.0,10085605,10086304,3989390,699,19,6,True,True,178.64692499999998,-0.069491
7628,6096769,50,1,0.962995,185,6110014,-1,500.0,6134914,6134964,38145,50,143,10,True,True,2.0596527777777776,-0.962995
7629,6096778,13995,36,0.283818,185,6110014,-1,18000.0,9146803,9160798,3050025,13995,46,6,True,True,8463.224150000002,-0.2693028072148923
7630,6096933,51,1,0.233039,185,6110014,-1,500.0,8462495,8462546,2365562,51,74,8,True,True,0.8303083333333333,-0.233039
7631,6096961,72,4,0.65957,185,6110014,-1,2000.0,7362595,7362667,1265634,72,99,7,True,True,6.4848,-0.65957
7632,6097020,8852,128,0.069979,185,6110014,-1,64000.0,10361660,10370512,4264640,8852,6,2,True,True,21563.127466666665,-0.06893306300530729
7633,6097126,33,8,0.057453,185,6110014,-1,4000.0,9987305,9987338,3890179,33,22,7,True,True,6.058433333333333,-0.057453
7634,6097130,279,4,0.518532,185,6110014,-1,2000.0,8925387,8925666,2828257,279,62,7,True,True,20.912599999999998,-0.518532
7635,6097184,6985,8,0.171826,185,6110014,-1,4000.0,9725905,9732890,3628721,6985,26,12,True,True,993.5753333333333,-0.16178930139845996
7636,6097211,410,4,0.859707,185,6110014,-1,2000.0,6577860,6578270,480649,410,123,1,True,True,34.285111111111114,-0.859707
7637,6097271,3,8,0.410861,185,6110014,-1,4000.0,8090495,8090498,1993224,3,87,7,True,True,0.6414,-0.410861
7638,6097277,278,2,0.157035,185,6110014,-1,1000.0,9360457,9360735,3263180,278,34,2,True,True,10.98408888888889,-0.157035
7639,6097332,23,4,0.110744,185,6110014,-1,2000.0,9461205,9461228,3363873,23,30,0,True,True,1.9562777777777778,-0.110744
7640,6097351,23,32,0.536453,185,6110014,-1,16000.0,6821260,6821283,723909,23,119,10,True,True,14.918311111111112,-0.536453
7641,6098046,203,8,0.478251,185,6110014,-1,4000.0,7139995,7140198,1041949,203,109,2,True,True,22.063844444444445,-0.478251
7642,6098145,19,1,0.068763,185,6110014,-1,500.0,9356857,9356876,3258712,19,36,2,True,True,0.33408333333333334,-0.068763
7643,6098202,1062,2,0.955097,185,6110014,-1,1000.0,6359396,6360458,261194,1062,138,8,True,True,35.8956,-0.955097
7644,6098431,6,1,0.865699,185,6110014,-1,500.0,7136395,7136401,1037964,6,111,2,True,True,0.08316666666666667,-0.865699
7645,6098546,4961,16,0.129932,185,6110014,-1,8000.0,10092105,10097066,3993559,4961,19,6,True,True,1293.6317333333332,-0.12826913410633883
7646,6098955,14,1,0.205677,185,6110014,-1,500.0,9463405,9463419,3364450,14,31,7,True,True,0.29769444444444443,-0.205677
7647,6100368,8,26,0.432201,185,6110014,-1,13000.0,8876387,8876395,2776019,8,74,8,True,True,4.0623555555555555,-0.432201
7648,6100373,624,1,0.709672,185,6110014,-1,500.0,7358195,7358819,1257822,624,111,11,True,True,13.345490277777778,-0.7095173036776774
7649,6100434,3,2,0.47478,185,6110014,-1,1000.0,7132795,7132798,1032361,3,116,7,True,True,0.08370833333333334,-0.47478
7650,6100512,20254,16,0.603709,185,6110014,-1,8000.0,8870987,8891241,2770475,20254,75,7,True,True,7043.804688888889,-0.591431902443118
7651,6100987,28,2,0.939154,185,6110014,-1,1000.0,6178614,6178642,77627,28,161,7,True,True,1.0911444444444443,-0.939154
7652,6101020,9091,128,0.587492,185,6110014,-1,64000.0,9089901,9098992,2988881,9091,61,6,True,True,34935.25262222222,-0.5254483856616102
7653,6101026,128,16,0.502475,185,6110014,-1,8000.0,7736895,7737023,1635869,128,102,10,True,True,19.254044444444443,-0.502475
7654,6101073,7,1,0.684836,185,6110014,-1,500.0,8298295,8298302,2197222,7,91,10,True,True,0.10452361111111111,-0.684836
7655,6106453,89,16,0.275441,185,6110014,-1,8000.0,9639505,9639594,3533052,89,28,12,True,True,26.551666666666666,-0.275441
7656,6106775,9486,8,0.007443,185,6110014,-1,4000.0,6955260,6964746,848485,9486,129,11,True,True,801.5262666666666,-0.0073240847629336804
7657,6106898,10,16,0.142692,185,6110014,-1,8000.0,9374805,9374815,3267907,10,35,8,True,True,3.124888888888889,-0.142692
7658,6107010,66,32,0.06397,185,6110014,-1,16000.0,8887187,8887253,2780177,66,75,2,True,True,49.78746666666667,-0.06397
7659,6107212,15,1,0.399237,185,6110014,-1,500.0,8607387,8607402,2500175,15,84,1,True,True,0.3174375,-0.399237
7660,6107349,5513,1,0.807566,185,6110014,-1,500.0,7227495,7233008,1120146,5513,121,6,True,True,59.92990694444445,-0.7416368315060917
7661,6107760,42,4,0.525857,185,6110014,-1,2000.0,8561895,8561937,2454135,42,87,8,True,True,2.5230333333333332,-0.525857
7662,6107783,6,4,0.910303,185,6110014,-1,2000.0,6796060,6796066,688277,6,140,6,True,True,0.29963333333333336,-0.910303
7663,6108059,58,1,0.879239,185,6110014,-1,500.0,7081937,7081995,973878,58,129,2,True,True,1.2265388888888888,-0.879239
7664,6108112,537,1,0.460205,185,6110014,-1,500.0,6271783,6272320,163671,537,168,10,True,True,9.208804166666667,-0.460205
7665,6108162,11,4,0.576133,185,6110014,-1,2000.0,8300495,8300506,2192333,11,96,7,True,True,0.6570055555555556,-0.576133
7666,6108299,73,1,0.737291,185,6110014,-1,500.0,8419295,8419368,2310996,73,94,8,True,True,1.0495777777777777,-0.737291
7667,6109439,8251,8,0.287912,185,6110014,-1,4000.0,7714195,7722446,1604756,8251,112,11,True,True,1204.7674777777777,-0.287194101312259
7668,6110021,745,2,0.880994,188,6111114,-1,1000.0,7932395,7933140,1822374,745,107,12,True,True,41.225402777777774,-0.880994
7669,6110292,24,16,0.456307,188,6111114,-1,8000.0,8088295,8088319,1978003,24,104,10,True,True,8.885866666666669,-0.456307
7670,6110560,683,2,0.700317,188,6111114,-1,1000.0,8413895,8414578,2303335,683,95,10,True,True,21.986908333333332,-0.700317
7671,6110618,475,1,0.711648,188,6111114,-1,500.0,7078460,7078935,967842,475,138,12,True,True,10.47638888888889,-0.711648
7672,6111648,10744,4,0.297449,193,6113314,-1,2000.0,9992705,10003449,3881057,10744,23,8,True,True,768.1487277777778,-0.2754647665994475
7673,6111677,29494,4,0.613028,193,6113314,-1,2000.0,8179095,8208589,2067418,29494,104,12,True,True,2096.3492166666665,-0.6009465511654238
7674,6112290,396,7,0.809985,193,6113314,-1,3500.0,8392295,8392691,2280005,396,97,8,True,True,48.08265,-0.809985
7675,6112402,206,1,0.175126,193,6113314,-1,500.0,10284405,10284611,4172003,206,14,6,True,True,2.943225,-0.175126
7676,6112602,13650,14,0.249135,193,6113314,-1,7000.0,10146105,10159755,4033503,13650,20,9,True,True,3587.749375,-0.2468497913708152
7677,6112924,20785,193,0.899965,193,6113314,-1,96500.0,9102503,9123288,2989579,20785,61,0,True,True,81029.24598611111,-0.8835120810672821
7678,6116203,5,8,0.733244,230,6134914,-1,4000.0,7226395,7226400,1110192,5,135,12,True,True,0.49983333333333335,-0.733244
7679,6116352,1695,8,0.457828,230,6134914,-1,4000.0,7400795,7402490,1284443,1695,130,10,True,True,282.59516666666667,-0.4377020356451945
7680,6116390,8,4,0.910833,230,6134914,-1,2000.0,6987660,6987668,871270,8,149,10,True,True,0.40693333333333337,-0.910833
7681,6116853,16547,64,0.183444,230,6134914,-1,32000.0,9255703,9272250,3138850,16547,53,8,True,True,19408.18968888889,-0.1831792048572857
7682,6117029,5,2,0.568615,230,6134914,-1,1000.0,6577855,6577860,460826,5,166,8,True,True,0.20905555555555558,-0.568615
7683,6118255,11693,41,0.393551,230,6134914,-1,20500.0,7955095,7966788,1836840,11693,115,10,True,True,9975.321069444446,-0.3892653063802956
7684,6118441,9726,24,0.945687,230,6134914,-1,12000.0,8045095,8054821,1926654,9726,114,12,True,True,6493.950333333333,-0.8883713603942285
7685,6118880,394,1,0.239695,230,6134914,-1,500.0,6912060,6912454,793180,394,155,10,True,True,5.018574999999999,-0.239695
7686,6118914,18,1,0.87054,230,6134914,-1,500.0,7575795,7575813,1456881,18,130,12,True,True,0.38872500000000004,-0.87054
7687,6118928,95,1,0.273776,230,6134914,-1,500.0,8939887,8939982,2820959,95,72,6,True,True,1.8651666666666669,-0.273776
7688,6119064,23817,2,0.628083,230,6134914,-1,1000.0,6992060,7015877,872996,23817,152,7,True,True,597.48595,-0.6269616304575221
7689,6119108,9,4,0.29189,230,6134914,-1,2000.0,9352157,9352166,3233049,9,46,6,True,True,0.6849500000000001,-0.29189
7690,6123749,14,4,0.916296,230,6134914,-1,2000.0,6169514,6169528,45765,14,202,9,True,True,1.2884666666666666,-0.916296
7691,6123915,18,4,0.698044,230,6134914,-1,2000.0,7623395,7623413,1499480,18,129,6,True,True,1.5886000000000002,-0.698044
7692,6124059,81,1,0.722409,230,6134914,-1,500.0,6170614,6170695,46555,81,203,6,True,True,1.9506374999999998,-0.722409
7693,6124598,92,2,0.217255,230,6134914,-1,1000.0,8607295,8607387,2482697,92,92,10,True,True,3.8939000000000004,-0.217255
7694,6124770,8,1,0.493488,230,6134914,-1,500.0,6890460,6890468,765690,8,162,0,True,True,0.10977777777777778,-0.493488
7695,6125092,2,5,0.99239,230,6134914,-1,2500.0,7379195,7379197,1254103,2,139,2,True,True,0.19041666666666668,-0.99239
7696,6125214,4,4,0.552824,230,6134914,-1,2000.0,8868787,8868791,2743573,4,87,12,True,True,0.2232888888888889,-0.552824
7697,6125511,10193,16,0.995316,230,6134914,-1,8000.0,6226383,6236576,100872,10193,201,6,True,True,5553.903911111111,-0.9156730120657867
7698,6125774,15531,128,0.076534,230,6134914,-1,64000.0,10351029,10366560,4225255,15531,8,6,True,True,36697.6896,-0.07464444188142005
7699,6126004,10,16,0.105225,230,6134914,-1,8000.0,9248103,9248113,3122099,10,58,2,True,True,3.1902222222222223,-0.105225
7700,6126999,20414,256,0.766539,230,6134914,-1,128000.0,9069487,9089901,2942488,20414,72,11,True,True,188261.0456888889,-0.7656627216553534
7701,6127255,15208,4,0.326013,230,6134914,-1,2000.0,8451695,8466903,2324440,15208,105,10,True,True,998.4242944444445,-0.3198452737698503
7702,6127551,151,16,0.450936,230,6134914,-1,8000.0,6845060,6845211,717509,151,170,6,True,True,45.01813333333333,-0.450936
7703,6128779,3,1,0.252767,230,6134914,-1,500.0,9368302,9368305,3239523,3,41,8,True,True,0.0636625,-0.252767
7704,6128835,200,32,0.506065,230,6134914,-1,16000.0,7360395,7360595,1231560,200,148,7,True,True,136.86222222222221,-0.506065
7705,6128855,154,2,0.462167,230,6134914,-1,1000.0,9301103,9301257,3172248,154,55,11,True,True,8.162,-0.462167
7706,6129010,26,32,0.073195,230,6134914,-1,16000.0,9256803,9256829,3127793,26,57,6,True,True,15.39431111111111,-0.073195
7707,6130829,3,5,0.694486,230,6134914,-1,2500.0,7080660,7080663,949831,3,162,0,True,True,0.33083333333333337,-0.694486
7708,6132809,32539,37,0.749736,230,6134914,-1,18500.0,7108995,7141534,976186,32539,159,8,True,True,19211.064098611114,-0.7203106607615853
7709,6133298,352,1,0.381156,230,6134914,-1,500.0,9089901,9090253,2956603,352,74,0,True,True,11.970566666666665,-0.3498537992577597
7710,6133568,34,106,0.745957,230,6134914,-1,53000.0,7620095,7620129,1486527,34,142,6,True,True,70.34807777777777,-0.745957
7711,6133731,53,4,0.855773,230,6134914,-1,2000.0,6380996,6381049,247265,53,200,10,True,True,6.393272222222222,-0.855773
7712,6133928,6435,4,0.396674,230,6134914,-1,2000.0,10135305,10141740,4001377,6435,22,11,True,True,393.71074999999996,-0.37517695687832225
7713,6134348,3,8,0.010737,230,6134914,-1,4000.0,9369405,9369408,3235057,3,41,6,True,True,0.5093,-0.010737
7714,6134461,109,4,0.114683,230,6134914,-1,2000.0,10084505,10084614,3950044,109,26,11,True,True,6.190594444444445,-0.114683
7715,6134542,144,8,0.917137,230,6134914,-1,4000.0,6157614,6157758,23072,144,228,6,True,True,39.5968,-0.917137
7716,6157938,30,8,0.32711,231,6158714,-1,4000.0,7666595,7666625,1508657,30,142,11,True,True,4.292333333333334,-0.32711
7717,6158059,72,1,0.748676,231,6158714,-1,500.0,7313895,7313967,1155836,72,159,12,True,True,0.9297,-0.748676
7718,6158070,1194,32,0.484759,231,6158714,-1,16000.0,8270895,8272089,2112825,1194,123,8,True,True,608.9930666666667,-0.484759
7719,6158142,61,8,0.068237,231,6158714,-1,4000.0,10358060,10358121,4199918,61,7,2,True,True,10.656022222222223,-0.068237
7720,6166540,36,1,0.548429,240,6169514,-1,500.0,9240103,9240139,3073563,36,67,6,True,True,0.68905,-0.548429
7721,6166801,8740,64,0.242294,240,6169514,-1,32000.0,10041305,10050045,3874504,8740,28,11,True,True,9454.699555555555,-0.23478896852849906
7722,6167111,15477,8,0.950018,240,6169514,-1,4000.0,6336596,6352073,169485,15477,219,11,True,True,1714.8640888888885,-0.9385075498355687
7723,6167127,12518,64,0.140256,240,6169514,-1,32000.0,10345542,10358060,4178415,12518,10,2,True,True,12407.968888888889,-0.12738673534232645
7724,6167151,6896,1,0.820427,240,6169514,-1,500.0,6249083,6255979,81932,6896,225,6,True,True,138.89757777777777,-0.8143645977068794
7725,6167179,4606,42,0.841563,240,6169514,-1,21000.0,7845995,7850601,1678816,4606,139,11,True,True,5970.923758333333,-0.8265503811013742
7726,6167293,35,32,0.170589,240,6169514,-1,16000.0,10329805,10329840,4162512,35,15,11,True,True,14.589555555555556,-0.170589
7727,6167321,2351,32,0.018066,240,6169514,-1,16000.0,10334342,10336693,4167021,2351,13,1,True,True,1100.5009333333333,-0.017814366996161967
7728,6167402,3,64,0.100515,240,6169514,-1,32000.0,7130595,7130598,963193,3,174,10,True,True,2.9128000000000003,-0.100515
7729,6168363,50,16,0.294145,240,6169514,-1,8000.0,9368305,9368355,3199942,50,48,0,True,True,16.976666666666667,-0.294145
7730,6170285,6,15,0.534654,240,6170614,-1,7500.0,7375595,7375601,1205310,6,163,7,True,True,1.704625,-0.534654
7731,6170812,28303,8,0.39085,241,6172814,-1,4000.0,6847260,6875563,676448,28303,194,7,True,True,3278.741288888889,-0.389920826129487
7732,6170820,852,1,0.077585,241,6172814,-1,500.0,9242303,9243155,3071483,852,72,7,True,True,16.501583333333333,-0.077585
7714,6134461,109,4,0.114683,1,6134461,-1,2000.0,6220861,6220970,86400,109,0,12,True,True,10.351972222222221,-0.114683
7715,6134542,144,8,0.917137,113,6220861,-1,4000.0,6643648,6643792,509106,144,0,8,True,True,19.9696,-0.917137
7716,6157938,30,8,0.32711,113,6220861,-1,4000.0,10809758,10809788,4651820,30,0,12,True,True,2.615,-0.32711
7717,6158059,72,1,0.748676,113,6220861,-1,500.0,6680048,6680120,521989,72,1,2,True,True,1.3454,-0.748676
7718,6158070,1194,32,0.484759,113,6220861,-1,16000.0,10870505,10871699,4712435,1194,0,2,True,True,803.5354666666666,-0.484759
7719,6158142,61,8,0.068237,113,6220861,-1,4000.0,10971005,10971066,4812863,61,0,8,True,True,6.971622222222223,-0.068237
7720,6166540,36,1,0.548429,113,6220861,-1,500.0,10717958,10717994,4551418,36,3,7,True,True,0.6031000000000001,-0.548429
7721,6166801,8740,64,0.242294,113,6220861,-1,32000.0,11142526,11151266,4975725,8740,0,11,True,True,8937.516622222223,-0.2420496130221411
7722,6167111,15477,8,0.950018,113,6220861,-1,4000.0,6430502,6445979,263391,15477,7,2,True,True,3415.430733333333,-0.9401862319387304
7723,6167127,12518,64,0.140256,113,6220861,-1,32000.0,11185726,11198244,5018599,12518,0,11,True,True,29478.065244444442,-0.13573919696703377
7724,6167151,6896,1,0.820427,113,6220861,-1,500.0,7464948,7471844,1297797,6896,6,8,True,True,92.32203333333332,-0.8076192732283807
7725,6167179,4606,42,0.841563,113,6220861,-1,21000.0,7088348,7092954,921169,4606,7,11,True,True,4277.51695,-0.7748013284476204
7726,6167293,35,32,0.170589,113,6220861,-1,16000.0,10965605,10965640,4798312,35,3,11,True,True,19.64977777777778,-0.170589
7727,6167321,2351,32,0.018066,113,6220861,-1,16000.0,6314861,6317212,147540,2351,12,12,True,True,1192.1137333333334,-0.018066
7728,6167402,3,64,0.100515,113,6220861,-1,32000.0,6676448,6676451,509046,3,10,2,True,True,3.378133333333334,-0.100515
7729,6168363,50,16,0.294145,113,6220861,-1,8000.0,10981294,10981344,4812931,50,2,7,True,True,10.661111111111111,-0.294145
7730,6170285,6,15,0.534654,113,6220861,-1,7500.0,6637148,6637154,466863,6,13,2,True,True,1.5113750000000001,-0.534654
7731,6170812,28303,8,0.39085,113,6220861,-1,4000.0,10878105,10906408,4707293,28303,5,6,True,True,3283.251077777778,-0.37403702101340136
7732,6170820,852,1,0.077585,113,6220861,-1,500.0,7600348,7601200,1429528,852,9,12,True,True,10.898499999999999,-0.077585
7733,6171254,11,32,0.763589,113,6220861,-1,16000.0,8409848,8409859,2238594,11,9,1,True,True,7.486844444444444,-0.763589
7734,6171266,6290,1,0.677383,113,6220861,-1,500.0,6317212,6323502,145946,6290,18,2,True,True,89.02201666666667,-0.6292875169261942
7735,6171277,10237,3,0.153496,113,6220861,-1,1500.0,11412988,11423225,5241711,10237,0,11,True,True,1032.0157583333335,-0.1508589565145801
7736,6171329,8,10,0.358087,113,6220861,-1,5000.0,7968748,7968756,1797419,8,11,10,True,True,2.1375555555555557,-0.358087
7737,6171796,29,4,0.216672,113,6220861,-1,2000.0,7848848,7848877,1677052,29,12,10,True,True,1.416811111111111,-0.216672
7738,6171947,8514,128,0.034445,113,6220861,-1,64000.0,11499388,11507902,5327441,8514,0,12,True,True,35937.533511111105,-0.03397991625486997
7739,6180587,10886,2,0.675044,113,6220861,-1,1000.0,6544762,6555648,364175,10886,21,6,True,True,441.95996111111106,-0.6580221478349383
7740,6180626,47,1,0.216166,113,6220861,-1,500.0,10715758,10715805,4535132,47,11,10,True,True,0.7254319444444445,-0.216166
7741,6180674,58,1,0.696742,113,6220861,-1,500.0,6377502,6377560,196828,58,24,6,True,True,1.336738888888889,-0.696742
7742,6180804,34,2,0.836501,113,6220861,-1,1000.0,6990848,6990882,810044,34,18,7,True,True,1.5283944444444446,-0.836501
7743,6180922,3,1,0.811512,113,6220861,-1,500.0,6649048,6649051,468126,3,21,0,True,True,0.053295833333333334,-0.811512
7744,6181531,14512,1,0.641012,113,6220861,-1,500.0,6649048,6663560,467517,14512,22,8,True,True,209.5854888888889,-0.5735935491445395
7745,6181893,34,4,0.71641,113,6220861,-1,2000.0,7266548,7266582,1084655,34,17,12,True,True,2.2171777777777777,-0.71641
7746,6181980,11445,16,0.89701,113,6220861,-1,8000.0,6228461,6239906,46481,11445,31,7,True,True,5215.681288888889,-0.8175787820531608
7747,6182070,10698,256,0.390618,113,6220861,-1,128000.0,11289479,11300177,5107409,10698,2,7,True,True,116174.10524444445,-0.3900066471944407
7748,6182223,59,2,0.308324,113,6220861,-1,1000.0,10871605,10871664,4689382,59,9,6,True,True,2.4816055555555554,-0.308324
7749,6182229,14021,8,0.052415,113,6220861,-1,4000.0,10922405,10936426,4740176,14021,8,6,True,True,1864.7140222222224,-0.05183054224521757
7750,6182245,6,7,0.004666,113,6220861,-1,3500.0,6851448,6851454,669203,6,23,6,True,True,0.62265,-0.004666
7751,6182363,11,15,0.77241,113,6220861,-1,7500.0,6633548,6633559,451185,11,30,7,True,True,2.8875,-0.77241
7752,6182386,12,2,0.767114,113,6220861,-1,1000.0,6372002,6372014,189616,12,34,1,True,True,0.5362000000000001,-0.767114
7753,6182528,13,32,0.928821,113,6220861,-1,16000.0,7512848,7512861,1330320,13,19,11,True,True,4.039822222222222,-0.928821
7754,6182662,527,8,0.374645,113,6220861,-1,4000.0,11033594,11034121,4850932,527,5,6,True,True,181.89034444444445,-0.37459516116480573
7755,6182694,1989,2,0.23854,113,6220861,-1,1000.0,8144848,8146837,1962154,1989,17,11,True,True,61.82070000000001,-0.21587574754322508
7756,6182782,38,2,0.091386,113,6220861,-1,1000.0,9546430,9546468,3363648,38,16,8,True,True,1.937261111111111,-0.091386
7757,6182850,21,4,0.421683,113,6220861,-1,2000.0,10983494,10983515,4800644,21,6,7,True,True,1.1194166666666667,-0.421683
7758,6182870,18,2,0.989291,113,6220861,-1,1000.0,6392302,6392320,209432,18,38,6,True,True,0.7631,-0.989291
7759,6182876,16473,21,0.337117,113,6220861,-1,10500.0,7936348,7952821,1753472,16473,21,6,True,True,7495.616158333334,-0.3325248208004917
7760,6183019,13368,6,0.192152,113,6220861,-1,3000.0,7803448,7816816,1620429,13368,23,7,True,True,767.7752666666667,-0.17427287607526482
7761,6183053,24,4,0.668949,113,6220861,-1,2000.0,7825048,7825072,1641995,24,23,10,True,True,1.1776,-0.668949
7762,6184878,28,1,0.220568,113,6220861,-1,500.0,10864158,10864186,4679280,28,14,8,True,True,0.45266666666666666,-0.220568
7763,6186030,10651,4,0.882286,113,6220861,-1,2000.0,6226261,6236912,40231,10651,48,8,True,True,1064.0777555555555,-0.7896567622590752
7764,6186037,134,4,0.796924,113,6220861,-1,2000.0,7416348,7416482,1230311,134,29,9,True,True,9.766366666666666,-0.796924
7765,6186291,7,1,0.830451,113,6220861,-1,500.0,6438102,6438109,251811,7,42,6,True,True,0.19670972222222222,-0.830451
7766,6186296,4,1,0.167883,113,6220861,-1,500.0,11091726,11091730,4905430,4,5,8,True,True,0.1950111111111111,-0.167883
7767,6186359,9079,16,0.167047,113,6220861,-1,8000.0,6856848,6865927,670489,9079,34,8,True,True,2388.017333333333,-0.1630410086277036
7768,6186610,2,64,0.41568,113,6220861,-1,32000.0,10921305,10921307,4734695,2,12,11,True,True,1.8462222222222222,-0.41568
7769,6186646,12762,5,0.107684,113,6220861,-1,2500.0,11300177,11312939,5113531,12762,2,6,True,True,2080.5701041666666,-0.09360538354652913
7770,6186691,94,4,0.327141,113,6220861,-1,2000.0,10339858,10339952,4153167,94,21,12,True,True,12.244022222222224,-0.327141
7771,6186720,10727,1,0.562054,113,6220861,-1,500.0,6333947,6344674,147227,10727,52,1,True,True,149.3037875,-0.5495513691495253
7772,6186760,4,16,0.189548,113,6220861,-1,8000.0,9288230,9288234,3101470,4,23,12,True,True,1.029511111111111,-0.189548
7773,6187354,35732,16,0.207119,113,6220861,-1,8000.0,11305577,11341309,5118223,35732,2,8,True,True,16330.083933333335,-0.19130938533921674
7774,6187374,16088,32,0.541703,113,6220861,-1,16000.0,10815558,10831646,4628184,16088,19,2,True,True,6032.2576,-0.5354268752105207
7775,6187428,7,4,0.938923,113,6220861,-1,2000.0,6366347,6366354,178919,7,55,10,True,True,0.4853722222222222,-0.938923
7776,6187452,40,4,0.120804,113,6220861,-1,2000.0,6540362,6540402,352910,40,50,11,True,True,3.4602222222222223,-0.120804
7777,6187476,230,32,0.21378,113,6220861,-1,16000.0,9519430,9519660,3331954,230,25,0,True,True,138.89955555555554,-0.21378
7778,6187562,4,1,0.356576,113,6220861,-1,500.0,7288148,7288152,1100586,4,38,10,True,True,0.08553333333333334,-0.356576
7779,6187628,5482,64,0.173622,113,6220861,-1,32000.0,9167230,9172712,2979602,5482,27,12,True,True,6929.343288888889,-0.17202851793921195
7780,6187688,7780,16,0.402139,113,6220861,-1,8000.0,10518058,10525838,4330370,7780,23,12,True,True,4630.796844444445,-0.4015639345247376
7781,6196956,48,8,0.31624,113,6220861,-1,4000.0,10604458,10604506,4407502,48,23,12,True,True,6.533333333333334,-0.31624
7782,6197065,8715,64,0.389187,113,6220861,-1,32000.0,10809758,10818473,4612693,8715,20,0,True,True,5435.594577777779,-0.3551705005585675
7783,6197309,20587,32,0.458776,113,6220861,-1,16000.0,8190248,8210835,1992939,20587,32,7,True,True,12296.925644444444,-0.45796322859762667
7784,6197333,132,8,0.066016,113,6220861,-1,4000.0,11039526,11039658,4842193,132,8,6,True,True,49.302,-0.066016
7785,6197371,40,8,0.815085,113,6220861,-1,4000.0,6378602,6378642,181231,40,62,6,True,True,7.375111111111111,-0.815085
7786,6197433,8,4,0.649945,113,6220861,-1,2000.0,6994482,6994490,797049,8,47,2,True,True,0.6561333333333333,-0.649945
7787,6198518,5,2,0.36898,113,6220861,-1,1000.0,7403348,7403353,1204830,5,44,1,True,True,0.19338888888888892,-0.36898
7788,6198545,6037,1,0.067331,113,6220861,-1,500.0,8818018,8824055,2619473,6037,32,8,True,True,99.11692222222221,-0.0666116762112793
7789,6198567,13942,3,0.218561,113,6220861,-1,1500.0,9541030,9554972,3342463,13942,29,10,True,True,974.4352916666668,-0.2150292855087433
7790,6199325,12,4,0.301534,113,6220861,-1,2000.0,8926018,8926030,2726693,12,33,11,True,True,0.6588666666666667,-0.301534
7791,6199601,9528,16,0.598869,113,6220861,-1,8000.0,9561230,9570758,3361629,9528,28,7,True,True,3657.0316888888888,-0.5728565697028625
7792,6199623,16060,128,0.983102,113,6220861,-1,64000.0,6481102,6497162,281479,16060,65,2,True,True,27133.320888888888,-0.9444702558458683
7793,6200106,14,3,0.101814,113,6220861,-1,1500.0,10253458,10253472,4053352,14,28,12,True,True,1.8350499999999996,-0.101814
7794,6200395,17,19,0.536182,113,6220861,-1,9500.0,6368547,6368564,168152,17,73,6,True,True,7.018969444444444,-0.536182
7795,6201790,98,3,0.990531,113,6220861,-1,1500.0,6542562,6542660,340772,98,65,7,True,True,6.1294916666666674,-0.990531
7796,6201992,13,32,0.850465,113,6220861,-1,16000.0,7180148,7180161,978156,13,52,8,True,True,7.368977777777777,-0.850465
7797,6202188,15248,8,0.171459,113,6220861,-1,4000.0,10811958,10827206,4609770,15248,21,7,True,True,1334.2373777777777,-0.1666841637154544
7798,6202259,119,4,0.959035,113,6220861,-1,2000.0,6415002,6415121,212743,119,72,10,True,True,8.638077777777777,-0.959035
7799,6202348,13269,32,0.599867,113,6220861,-1,16000.0,9178030,9191299,2975682,13269,35,2,True,True,8191.8388444444445,-0.5912861312555052
7800,6202504,4977,8,0.981416,113,6220861,-1,4000.0,6465502,6470479,262998,4977,71,7,True,True,875.2513333333333,-0.948591095148109
7801,6202738,9543,16,0.696315,113,6220861,-1,8000.0,6437002,6446545,234264,9543,73,6,True,True,4283.6052,-0.6940426056897557
7802,6202784,3,4,0.677901,113,6220861,-1,2000.0,6555648,6555651,352864,3,67,2,True,True,0.21693333333333334,-0.677901
7803,6202795,12009,1,0.972367,113,6220861,-1,500.0,7399748,7411757,1196953,12009,52,11,True,True,240.69537499999998,-0.9572183083128951
7804,6202868,670,1,0.693721,113,6220861,-1,500.0,8276648,8277318,2073780,670,40,12,True,True,10.82236111111111,-0.693721
7805,6203049,269,8,0.332047,113,6220861,-1,4000.0,9617258,9617527,3414209,269,30,7,True,True,43.60191111111111,-0.332047
7806,6203171,1197,3,0.635353,113,6220861,-1,1500.0,8496248,8497445,2293077,1197,40,12,True,True,86.18898750000001,-0.635353
7807,6204006,19249,128,0.883967,113,6220861,-1,64000.0,7972048,7991297,1768042,19249,45,7,True,True,68544.58613333333,-0.8531126853954382
7808,6204286,8237,4,0.317967,113,6220861,-1,2000.0,10426258,10434495,4221972,8237,28,12,True,True,1051.0760944444444,-0.3086980644615842
7809,6204343,16776,1,0.851554,113,6220861,-1,500.0,6416102,6432878,211759,16776,82,6,True,True,362.2825444444444,-0.8453760044782394
7810,6206461,119,16,0.48213,113,6220861,-1,8000.0,9180230,9180349,2973769,119,37,7,True,True,40.2934,-0.48213
7811,6207230,21,4,0.335105,113,6220861,-1,2000.0,8839618,8839639,2632388,21,41,10,True,True,1.3879833333333333,-0.335105
7812,6207482,681,8,0.608533,113,6220861,-1,4000.0,9564830,9565511,3357348,681,32,2,True,True,126.39743333333334,-0.5746646797243017
7813,6207629,10100,64,0.585037,113,6220861,-1,32000.0,8947630,8957730,2740001,10100,41,10,True,True,9931.072,-0.5787937221892913
7814,6207858,109,32,0.382371,113,6220861,-1,16000.0,10693058,10693167,4485200,109,26,12,True,True,53.10964444444444,-0.382371
7815,6207901,27,32,0.640592,113,6220861,-1,16000.0,7334948,7334975,1127047,27,63,1,True,True,14.895599999999998,-0.640592
7816,6208349,196,1,0.232425,113,6220861,-1,500.0,6988648,6988844,780299,196,70,7,True,True,4.405372222222223,-0.232425
7817,6210331,11382,10,0.587469,113,6220861,-1,5000.0,8994430,9005812,2784099,11382,42,11,True,True,1515.8253333333334,-0.5761114056948206
7818,6210539,12,2,0.988381,113,6220861,-1,1000.0,6477502,6477514,266963,12,86,8,True,True,0.5168333333333334,-0.988381
7819,6210662,20824,32,0.232606,113,6220861,-1,16000.0,11038426,11059250,4827764,20824,9,6,True,True,21294.19822222222,-0.2242506686563471
7820,6210840,189,3,0.616349,113,6220861,-1,1500.0,6320812,6321001,109972,189,101,1,True,True,7.7356125,-0.616349
7821,6210850,9410,4,0.896779,113,6220861,-1,2000.0,6344747,6354157,133897,9410,100,9,True,True,598.9623444444445,-0.8713444549571563
7822,6211134,23,4,0.308849,113,6220861,-1,2000.0,9553630,9553653,3342496,23,36,2,True,True,1.9036333333333333,-0.308849
7823,6211443,21,5,0.737913,113,6220861,-1,2500.0,6850348,6850369,638905,21,76,12,True,True,1.8006041666666668,-0.737913
7824,6212544,5,2,0.757246,113,6220861,-1,1000.0,6391202,6391207,178658,5,97,2,True,True,0.21197222222222223,-0.757246
7825,6214784,7,16,0.619766,113,6220861,-1,8000.0,8101648,8101655,1886864,7,54,10,True,True,2.8051333333333335,-0.619766
7826,6214847,161,4,0.059923,113,6220861,-1,2000.0,6327902,6328063,113055,161,106,7,True,True,9.855883333333333,-0.059923
7827,6219088,11,1,0.374524,113,6220861,-1,500.0,7758048,7758059,1538960,11,61,8,True,True,0.20223194444444445,-0.374524
7828,6223783,10,4,0.296615,116,6226261,-1,2000.0,9570758,9570768,3346975,10,34,2,True,True,1.0626111111111112,-0.296615
7829,6224187,10232,4,0.151671,116,6226261,-1,2000.0,7331348,7341580,1107161,10232,70,11,True,True,691.7325777777778,-0.1433879419768398
7830,6225090,18531,100,0.204385,116,6226261,-1,50000.0,11369788,11388319,5144698,18531,2,8,True,True,68450.83166666667,-0.2002115550444165
7831,6225413,11946,113,0.037907,116,6226261,-1,56500.0,11309177,11321123,5083764,11946,3,2,True,True,30420.31221388889,-0.03481965449364651
7832,6226281,9339,64,0.923409,117,6228461,-1,32000.0,6676448,6685787,450167,9339,84,0,True,True,12706.390577777776,-0.7322568146347971
7833,6226847,91,1,0.598075,117,6228461,-1,500.0,9550030,9550121,3323183,91,40,2,True,True,2.104375,-0.598075
7834,6232781,8,8,0.945876,228,6314861,-1,4000.0,6763948,6763956,531167,8,84,2,True,True,1.6738666666666666,-0.945876
7835,6234484,38,64,0.739256,228,6314861,-1,32000.0,8951230,8951268,2716746,38,49,1,True,True,37.30755555555556,-0.739256
7836,6234645,5418,32,0.32869,228,6314861,-1,16000.0,9468630,9474048,3233985,5418,44,12,True,True,4894.6776,-0.32862232418356274
7837,6234774,319,4,0.278126,228,6314861,-1,2000.0,9376830,9377149,3142056,319,45,12,True,True,20.931716666666667,-0.278126
7838,6235408,28813,1,0.643602,228,6314861,-1,500.0,7623048,7651861,1387640,28813,69,6,True,True,403.9940597222223,-0.6067574964288148
7839,6237416,7,8,0.760494,228,6314861,-1,4000.0,8766648,8766655,2529232,7,56,1,True,True,1.0213,-0.760494
7840,6237461,1018,1,0.520873,228,6314861,-1,500.0,6685448,6686466,447987,1018,90,8,True,True,35.96085,-0.520873
7841,6237706,12201,1,0.977568,228,6314861,-1,500.0,6384002,6396203,146296,12201,113,8,True,True,269.25160416666665,-0.9628990314276131
7842,6237799,10444,14,0.648046,228,6314861,-1,7000.0,8882818,8893262,2645019,10444,54,11,True,True,2413.8704722222224,-0.6322092442202399
7843,6237848,14170,2,0.288455,228,6314861,-1,1000.0,10431658,10445828,4193810,14170,32,8,True,True,933.2513666666667,-0.28540606205761826
7844,6239963,212,2,0.023693,228,6314861,-1,1000.0,11369788,11370000,5129825,212,2,0,True,True,15.50838888888889,-0.023693
7845,6240057,14,1,0.846935,228,6314861,-1,500.0,7469648,7469662,1229591,14,76,2,True,True,0.1921111111111111,-0.846935
7846,6240278,19618,2,0.33127,228,6314861,-1,1000.0,9170830,9190448,2930552,19618,51,1,True,True,768.1502055555555,-0.3287258800977043
7847,6241516,23,1,0.242249,228,6314861,-1,500.0,10606658,10606681,4365142,23,31,7,True,True,0.41106111111111115,-0.242249
7848,6242557,54,4,0.539312,228,6314861,-1,2000.0,6467702,6467756,225145,54,111,7,True,True,4.731599999999999,-0.539312
7849,6242604,9233,64,0.906632,228,6314861,-1,32000.0,7752648,7761881,1510044,9233,75,11,True,True,10825.849155555556,-0.9011306480936946
7850,6242942,14832,119,0.665006,228,6314861,-1,59500.0,9907858,9922690,3664916,14832,38,11,True,True,38449.71316666667,-0.6645774241596641
7851,6244121,9,64,0.248338,228,6314861,-1,32000.0,11330777,11330786,5086656,9,4,10,True,True,22.136,-0.248338
7852,6244172,10,8,0.68735,228,6314861,-1,4000.0,6754948,6754958,510776,10,99,1,True,True,1.5587777777777778,-0.68735
7853,6244213,24,1,0.719502,228,6314861,-1,500.0,6729748,6729772,485535,24,100,10,True,True,0.8439333333333334,-0.719502
7854,6244275,3,8,0.608063,228,6314861,-1,4000.0,6990882,6990885,746607,3,93,1,True,True,0.5394333333333334,-0.608063
7855,6244781,5455,114,0.381486,228,6314861,-1,57000.0,11086326,11091781,4841545,5455,12,11,True,True,21329.311966666668,-0.2873524722557814
7856,6245020,28567,1,0.321637,228,6314861,-1,500.0,9864658,9893225,3619638,28567,41,6,True,True,756.5106541666667,-0.31737382605379433
7857,6245128,3,2,0.442361,228,6314861,-1,1000.0,9571858,9571861,3326730,3,43,6,True,True,0.15939166666666668,-0.442361
7858,6246233,8,3,0.006043,228,6314861,-1,1500.0,10985694,10985702,4739461,8,16,7,True,True,0.3288333333333333,-0.006043
7859,6246872,28,2,0.869867,228,6314861,-1,1000.0,7039748,7039776,792876,28,96,11,True,True,1.5057777777777777,-0.869867
7860,6247440,6376,4,0.069985,228,6314861,-1,2000.0,9080830,9087206,2833390,6376,60,12,True,True,364.6983888888889,-0.06918565063318323
7861,6247495,18,17,0.192465,228,6314861,-1,8500.0,9618358,9618376,3370863,18,43,6,True,True,6.1999,-0.192465
7862,6249536,43,4,0.634367,228,6314861,-1,2000.0,8812618,8812661,2563082,43,69,11,True,True,2.671972222222222,-0.634367
7863,6249682,63,16,0.141532,228,6314861,-1,8000.0,7801248,7801311,1551566,63,83,11,True,True,12.5958,-0.141532
7864,6249698,7093,1,0.20422,228,6314861,-1,500.0,9683158,9690251,3433460,7093,43,10,True,True,141.3997361111111,-0.19860438650597653
7865,6249760,22807,32,0.091759,228,6314861,-1,16000.0,7827248,7850055,1577488,22807,82,7,True,True,8919.045244444445,-0.0895539001039282
7866,6249915,15444,16,0.592631,228,6314861,-1,8000.0,10989294,11004738,4739379,15444,16,2,True,True,4635.6668,-0.5786535890474125
7867,6249937,23254,64,0.831221,228,6314861,-1,32000.0,7356548,7379802,1106611,23254,97,10,True,True,18956.393066666664,-0.8274531871711169
7868,6250937,20830,2,0.931813,228,6314861,-1,1000.0,6670648,6691478,419711,20830,119,10,True,True,1036.1512833333334,-0.8912669256797877
7869,6250948,49,2,0.23631,228,6314861,-1,1000.0,10869558,10869607,4618610,49,27,8,True,True,2.0609944444444444,-0.23631
7870,6251161,27,1,0.078165,228,6314861,-1,500.0,9570230,9570257,3319069,27,50,8,True,True,0.7172625,-0.078165
7871,6251172,7,26,0.724989,228,6314861,-1,13000.0,9382230,9382237,3131058,7,59,8,True,True,3.174636111111111,-0.724989
7872,6251927,99,4,0.311463,228,6314861,-1,2000.0,7459548,7459647,1207621,99,97,11,True,True,5.1546,-0.311463
7873,6251990,5,1,0.721674,228,6314861,-1,500.0,6387602,6387607,135612,5,144,1,True,True,0.11509722222222224,-0.721674
7874,6252113,2,4,0.244925,228,6314861,-1,2000.0,10975405,10975407,4723292,2,20,7,True,True,0.12192222222222222,-0.244925
7875,6256781,23843,84,0.176436,228,6314861,-1,42000.0,10977994,11001837,4721213,23843,20,2,True,True,30530.69786666667,-0.15586604010804073
7876,6256847,10440,1,0.248969,228,6314861,-1,500.0,6751348,6761788,494501,10440,120,10,True,True,216.85282777777778,-0.22840669139716788
7877,6256880,29,1,0.285353,228,6314861,-1,500.0,7621948,7621977,1365068,29,95,10,True,True,0.20308055555555557,-0.285353
7878,6260604,7213,16,0.448271,228,6314861,-1,8000.0,9994258,10001471,3733654,7213,45,11,True,True,2600.4168444444445,-0.4456473348623357
7879,6260611,2338,4,0.635604,228,6314861,-1,2000.0,6369664,6372002,109053,2338,154,6,True,True,203.22904444444444,-0.6182332101851605
7880,6260754,18,16,0.271861,228,6314861,-1,8000.0,11037326,11037344,4776572,18,15,2,True,True,12.4196,-0.271861
7881,6260898,10,4,0.781289,228,6314861,-1,2000.0,8080048,8080058,1819150,10,86,10,True,True,1.1536111111111111,-0.781289
7882,6261066,16,1,0.080016,228,6314861,-1,500.0,11099326,11099342,4838260,16,11,8,True,True,0.7346222222222222,-0.080016
7883,6261074,10,1,0.972555,228,6314861,-1,500.0,6671748,6671758,410674,10,131,6,True,True,0.17234722222222223,-0.972555
7884,6261097,13,2,0.398244,228,6314861,-1,1000.0,7466048,7466061,1204951,13,103,6,True,True,0.3239166666666667,-0.398244
7885,6261328,12317,1,0.167766,228,6314861,-1,500.0,10723358,10735675,4462030,12317,37,8,True,True,232.85790555555556,-0.16689166615617443
7886,6261346,12203,4,0.441376,228,6314861,-1,2000.0,10080658,10092861,3819312,12203,48,12,True,True,2263.0685166666667,-0.4388162449724927
7887,6261501,36,4,0.505293,228,6314861,-1,2000.0,10979094,10979130,4717593,36,22,6,True,True,1.963,-0.505293
7888,6261542,10,32,0.734928,228,6314861,-1,16000.0,8188048,8188058,1926506,10,88,11,True,True,6.238666666666667,-0.734928
7889,6261575,49,8,0.760324,228,6314861,-1,4000.0,6472102,6472151,210527,49,149,7,True,True,8.671911111111111,-0.760324
7890,6261599,12716,8,0.819604,228,6314861,-1,4000.0,6760348,6773064,498749,12716,129,8,True,True,2953.520177777778,-0.777682652288896
7891,6261631,6,1,0.793559,228,6314861,-1,500.0,6463302,6463308,201671,6,153,10,True,True,0.13788333333333336,-0.793559
7892,6262442,10208,1,0.019811,228,6314861,-1,500.0,9774958,9785166,3512516,10208,53,8,True,True,198.12514722222224,-0.018236051869324192
7893,6262462,277,4,0.381419,228,6314861,-1,2000.0,8498448,8498725,2235986,277,85,7,True,True,26.593538888888887,-0.381419
7894,6262642,15546,8,0.854042,228,6314861,-1,4000.0,6329002,6344548,66360,15546,173,6,True,True,1773.6094222222223,-0.8399038307634836
7895,6262648,29052,128,0.758858,228,6314861,-1,64000.0,6638248,6667300,375600,29052,144,6,True,True,56268.734577777774,-0.7137084809371763
7896,6262662,82,32,0.921532,228,6314861,-1,16000.0,7174748,7174830,912086,82,121,12,True,True,55.48746666666666,-0.9155916854288825
7897,6262673,18,1,0.595183,228,6314861,-1,500.0,6608648,6608666,345975,18,148,7,True,True,0.226325,-0.595183
7898,6262684,4772,32,0.152799,228,6314861,-1,16000.0,11032494,11037266,4769810,4772,18,11,True,True,6586.352711111112,-0.15276014635695934
7899,6262698,15738,128,0.726648,228,6314861,-1,64000.0,8319848,8335586,2057150,15738,89,11,True,True,32754.8,-0.6973316016429344
7900,6262737,401,2,0.257292,228,6314861,-1,1000.0,7405548,7405949,1142811,401,115,7,True,True,17.42567777777778,-0.257292
7901,6263014,52,8,0.463651,228,6314861,-1,4000.0,6435902,6435954,172888,52,164,8,True,True,11.585022222222221,-0.463651
7902,6263982,24,1,0.453603,228,6314861,-1,500.0,9517230,9517254,3253248,24,68,11,True,True,0.47120000000000006,-0.453603
7903,6264048,132,8,0.375147,228,6314861,-1,4000.0,11037194,11037326,4773146,132,17,2,True,True,45.53853333333333,-0.375147
7904,6264128,24339,1,0.606025,228,6314861,-1,500.0,9777158,9801497,3513030,24339,55,7,True,True,549.0924611111111,-0.5998324842048891
7905,6264153,4789,16,0.07194,228,6314861,-1,8000.0,10973205,10977994,4709052,4789,27,7,True,True,1126.7521111111112,-0.07128068259849196
7906,6264206,6395,4,0.136656,228,6314861,-1,2000.0,6900048,6906443,635842,6395,135,11,True,True,440.9822222222222,-0.1360505438169513
7907,6264222,10100,1,0.469258,228,6314861,-1,500.0,6986448,6996548,722226,10100,135,12,True,True,218.9632,-0.4463188909262092
7908,6264833,3,16,0.154724,228,6314861,-1,8000.0,6555562,6555565,290729,3,159,9,True,True,0.9244666666666667,-0.154724
7909,6264838,6470,8,0.189626,228,6314861,-1,4000.0,8671248,8677718,2406410,6470,90,12,True,True,1217.4225333333334,-0.15409198728167153
7910,6265259,27,1,0.012834,228,6314861,-1,500.0,7935248,7935275,1669989,27,104,12,True,True,0.5773874999999999,-0.012834
7911,6265407,245,2,0.5007,228,6314861,-1,1000.0,6333702,6333947,68295,245,189,3,True,True,6.742263888888888,-0.5007
7912,6265505,6010,176,0.725345,228,6314861,-1,88000.0,9519430,9525440,3253925,6010,71,7,True,True,19303.02488888889,-0.718002665858889
7913,6265684,16444,36,0.491454,228,6314861,-1,18000.0,9661558,9678002,3395874,16444,59,11,True,True,18462.5095,-0.45899018592430946
7914,6266486,10,32,0.925691,228,6314861,-1,16000.0,6672848,6672858,406362,10,153,6,True,True,5.5151111111111115,-0.925691
7915,6293965,6405,256,0.940285,228,6314861,-1,128000.0,6497162,6503567,203197,6405,168,6,True,True,15412.082133333333,-0.868433124025483
7916,6294014,47,2,0.970493,228,6314861,-1,1000.0,6330102,6330149,36088,47,194,6,True,True,1.4664,-0.970493
7917,6294183,8744,2,0.373145,228,6314861,-1,1000.0,7045148,7053892,750965,8744,134,8,True,True,441.0076777777777,-0.3647712604226813
7918,6294238,76,1,0.489551,228,6314861,-1,500.0,6315961,6316037,21723,76,200,6,True,True,1.2042833333333334,-0.489551
7919,6294258,12626,1,0.641049,228,6314861,-1,500.0,8188048,8200674,1893790,12626,99,0,True,True,250.0808166666667,-0.6338836487879258
7920,6294397,5647,43,0.588309,228,6314861,-1,21500.0,6325702,6331349,31305,5647,199,7,True,True,3748.598458333333,-0.586218218408593
7921,6294565,28479,256,0.408788,228,6314861,-1,128000.0,11341309,11369788,5046744,28479,4,2,True,True,285968.63217777776,-0.4084262735054131
7922,6294966,67,8,0.038827,228,6314861,-1,4000.0,8584848,8584915,2289882,67,94,12,True,True,6.737222222222222,-0.038827
7923,6295829,7814,32,0.921603,228,6314861,-1,16000.0,8676648,8684462,2380819,7814,93,8,True,True,7386.999733333332,-0.885397285432966
7924,6298965,26663,64,0.384826,228,6314861,-1,32000.0,11186826,11213489,4887861,26663,10,6,True,True,67507.904,-0.3833745104844435
7925,6299872,10537,4,0.565609,228,6314861,-1,2000.0,6426902,6437439,127030,10537,185,9,True,True,1111.5482166666666,-0.5471897674137859
7926,6300302,13,1,0.194228,228,6314861,-1,500.0,9201830,9201843,2901528,13,80,10,True,True,0.23907361111111108,-0.194228
7927,6300322,11,4,0.436298,228,6314861,-1,2000.0,9474030,9474041,3173708,11,76,8,True,True,1.2409833333333333,-0.436298
7928,6300898,46,1,0.255258,228,6314861,-1,500.0,9174430,9174476,2873532,46,84,2,True,True,0.9212777777777778,-0.255258
7929,6300934,906,1,0.913086,228,6314861,-1,500.0,6598848,6599754,297914,906,172,11,True,True,11.707533333333334,-0.913086
7930,6302260,33,1,0.722245,228,6314861,-1,500.0,7709448,7709481,1407188,33,122,12,True,True,0.46039583333333334,-0.722245
7931,6302530,24,5,0.509608,228,6314861,-1,2500.0,10167058,10167082,3864528,24,54,12,True,True,5.553333333333333,-0.509608
7932,6303072,4,32,0.488622,228,6314861,-1,16000.0,6367447,6367451,64375,4,203,6,True,True,2.2188444444444446,-0.488622
7933,6303104,118,16,0.688489,228,6314861,-1,8000.0,6996548,6996666,693444,118,146,2,True,True,38.3264,-0.688489
7934,6303782,4,2,0.696455,228,6314861,-1,1000.0,6323502,6323506,19720,4,213,2,True,True,0.11533333333333333,-0.696455
7935,6303857,21992,1,0.650906,228,6314861,-1,500.0,7513948,7535940,1210091,21992,127,6,True,True,205.21025000000003,-0.6396281301953518
7936,6304128,4,2,0.926519,228,6314861,-1,1000.0,6368564,6368568,64436,4,204,1,True,True,0.17384444444444444,-0.926519
7937,6304268,3,4,0.735664,228,6314861,-1,2000.0,6376402,6376405,72134,3,202,7,True,True,0.2765666666666667,-0.735664
7938,6304793,55,4,0.242353,228,6314861,-1,2000.0,10694158,10694213,4389365,55,46,6,True,True,3.3498055555555553,-0.242353
7939,6305356,7261,1,0.034508,228,6314861,-1,500.0,10877005,10884266,4571649,7261,35,8,True,True,130.99007083333333,-0.032767286611940685
7940,6306232,11,4,0.813126,228,6314861,-1,2000.0,6374202,6374213,67970,11,205,7,True,True,0.9830333333333334,-0.813126
7941,6306483,18483,16,0.630953,228,6314861,-1,8000.0,6708148,6726631,401665,18483,164,10,True,True,11902.593200000001,-0.6253626285018347
7942,6307347,18643,1,0.676426,228,6314861,-1,500.0,7466048,7484691,1158701,18643,132,0,True,True,241.51510833333336,-0.675738831986863
7943,6312530,12644,19,0.697471,228,6314861,-1,9500.0,8406248,8418892,2093718,12644,106,12,True,True,5423.749183333332,-0.6746612215487796
7944,6312649,6370,4,0.645334,228,6314861,-1,2000.0,8763048,8769418,2450399,6370,100,12,True,True,435.2863,-0.6426573986933045
7945,6312732,16236,8,0.261331,228,6314861,-1,4000.0,11273243,11289479,4960511,16236,10,1,True,True,4774.241099999999,-0.260978456355195
7946,6320189,19481,1,0.455471,226,6320812,-1,500.0,9615058,9634539,3294869,19481,68,11,True,True,404.5378222222222,-0.446221270778691
7947,6322813,10286,1,0.681066,227,6323502,-1,500.0,7947148,7957434,1624335,10286,120,9,True,True,200.02750277777778,-0.6514699015252808
7948,6322961,88,1,0.254288,227,6323502,-1,500.0,8058448,8058536,1735487,88,118,12,True,True,2.0404999999999998,-0.254288
7949,6324202,102,16,0.602149,229,6325702,-1,8000.0,6686548,6686650,362346,102,172,6,True,True,57.6504,-0.602149
7950,6324844,9561,1,0.951778,229,6325702,-1,500.0,6441702,6451263,116858,9561,200,2,True,True,262.76174583333335,-0.9453924636998712
7951,6325444,11804,128,0.841516,229,6325702,-1,64000.0,6631348,6643152,305904,11804,186,10,True,True,25694.0288,-0.8339101376193921
7952,6325959,19,4,0.012337,235,6327902,-1,2000.0,8926030,8926049,2600071,19,96,1,True,True,1.0432055555555555,-0.012337
7953,6325980,159,1,0.770972,235,6327902,-1,500.0,6543662,6543821,217682,159,193,6,True,True,3.314929166666667,-0.770972
7954,6326647,10527,1,0.644397,235,6327902,-1,500.0,9951058,9961585,3624411,10527,60,11,True,True,209.76178333333334,-0.6356204010888523
7955,6326677,9368,16,0.916883,235,6327902,-1,8000.0,6393402,6402770,66725,9368,212,6,True,True,2739.915466666667,-0.8319621822932941
7956,6327300,4292,32,0.397667,235,6327902,-1,16000.0,11043126,11047418,4715826,4292,17,2,True,True,6232.843022222222,-0.3931744165501468
7957,6327484,176,8,0.58616,235,6327902,-1,4000.0,6609748,6609924,282264,176,190,6,True,True,18.593422222222223,-0.58616
7958,6327837,11,1,0.900996,235,6327902,-1,500.0,6604248,6604259,276411,11,192,8,True,True,0.15086805555555557,-0.900996
7959,6331957,33,10,0.518537,243,6333702,-1,5000.0,8769418,8769451,2437461,33,104,2,True,True,6.018375000000001,-0.518537
7960,6332001,17,128,0.188823,243,6333702,-1,64000.0,11273226,11273243,4941225,17,11,12,True,True,70.79857777777778,-0.188823
7961,6332054,26653,1,0.422945,243,6333702,-1,500.0,9559030,9585683,3226976,26653,77,8,True,True,611.1105930555556,-0.4202700077875418
7962,6332099,123,2,0.82975,243,6333702,-1,1000.0,6606448,6606571,274349,123,195,7,True,True,3.0931083333333333,-0.82975
7963,6332200,1273,16,0.252871,243,6333702,-1,8000.0,9863558,9864831,3531358,1273,65,12,True,True,458.6873777777778,-0.24717577172133068
7964,6332235,9,16,0.30222,243,6333702,-1,8000.0,9290430,9290439,2958195,9,90,7,True,True,2.3164,-0.30222
7965,6332293,18787,128,0.967683,243,6333702,-1,64000.0,6469902,6488689,137609,18787,210,7,True,True,45425.33155555556,-0.9473454671325552
7966,6332822,138,1,0.658486,243,6333702,-1,500.0,7969848,7969986,1637026,138,128,6,True,True,3.687283333333333,-0.658486
7967,6333000,21997,128,0.382789,243,6333702,-1,64000.0,11093926,11115923,4760926,21997,16,7,True,True,129109.01831111111,-0.37849522222957255
7968,6333005,11747,64,0.307979,243,6333702,-1,32000.0,10858758,10870505,4525753,11747,44,11,True,True,12572.441244444446,-0.29294599326126297
7969,6333011,11207,19,0.411609,243,6333702,-1,9500.0,9769558,9780765,3436547,11207,70,12,True,True,4215.4242861111115,-0.38444185614394205
1472,1293277,13,1,0.496203,1,1293277,-1,500.0,1295477,1295490,2200,13,0,7,True,True,0.2574722222222222,-0.496203
1473,1294554,6774,64,0.497523,4,1295477,-1,32000.0,4561917,4568691,3267363,6774,0,12,True,True,2314.2607999999996,-0.48947058636746493
1474,1294669,12239,3,0.92431,4,1295477,-1,1500.0,1340877,1353116,46208,12239,1,11,True,True,797.1087208333333,-0.8536806370205862
1475,1294737,112,2,0.519276,4,1295477,-1,1000.0,2404077,2404189,1109340,112,1,7,True,True,2.0054222222222218,-0.519276
1476,1295058,292,16,0.801148,4,1295477,-1,8000.0,1297677,1297969,2619,292,3,7,True,True,91.14293333333333,-0.801148
1477,1296674,31905,16,0.727081,4,1297677,-1,8000.0,2141777,2173682,845103,31905,2,8,True,True,3056.8598888888887,-0.7203916528098163
1478,1298004,12956,1,0.078927,87,1340877,-1,500.0,9997172,10010128,8699168,12956,0,6,True,True,87.99193333333334,-0.07498012286603033
1479,1299053,5794,178,0.602453,87,1340877,-1,89000.0,7265927,7271721,5966874,5794,1,12,True,True,9846.836388888889,-0.5906538042402958
1480,1299172,10160,8,0.822341,87,1340877,-1,4000.0,2564922,2575082,1265750,10160,3,2,True,True,675.7369555555556,-0.8174997701594795
1481,1300217,5981,128,0.545474,87,1340877,-1,64000.0,7654727,7660708,6354510,5981,1,12,True,True,3473.251911111111,-0.5451915959927073
1482,1300293,11,1,0.321211,87,1340877,-1,500.0,1552677,1552688,252384,11,7,6,True,True,0.06048472222222223,-0.321211
1483,1300678,4,9,0.080069,87,1340877,-1,4500.0,11220172,11220176,9919494,4,0,12,True,True,0.49735,-0.080069
1484,1300931,8,4,0.660919,87,1340877,-1,2000.0,2209877,2209885,908946,8,7,6,True,True,0.22617777777777778,-0.660919
1485,1301041,7580,2,0.306496,87,1340877,-1,1000.0,2537869,2545449,1236828,7580,6,2,True,True,127.4107388888889,-0.3014240982360506
1486,1305566,17109,1,0.602622,87,1340877,-1,500.0,5928127,5945236,4622561,17109,4,11,True,True,223.94131111111108,-0.5962221109784289
1487,1305714,670,1,0.426116,87,1340877,-1,500.0,3553282,3553952,2247568,670,6,6,True,True,4.995222222222222,-0.426116
1488,1306220,46393,55,0.689765,87,1340877,-1,27500.0,2062477,2108870,756257,46393,12,6,True,True,26091.704222222226,-0.6416663026862912
1489,1306545,14816,1,0.351547,87,1340877,-1,500.0,5242277,5257093,3935732,14816,5,11,True,True,167.30595277777778,-0.3324638885786735
1490,1309878,42,2,0.042355,87,1340877,-1,1000.0,5712127,5712169,4402249,42,5,8,True,True,0.8282166666666666,-0.042355
1491,1310397,16,8,0.870037,87,1340877,-1,4000.0,4475517,4475533,3165120,16,8,11,True,True,1.164977777777778,-0.870037
1492,1312556,496,64,0.352559,87,1340877,-1,32000.0,3552182,3552678,2239626,496,10,6,True,True,266.03235555555557,-0.352559
1493,1313082,51,43,0.998151,87,1340877,-1,21500.0,1440277,1440328,127195,51,18,8,True,True,40.54613333333333,-0.998151
1494,1313539,32,2,0.274555,87,1340877,-1,1000.0,5026277,5026309,3712738,32,7,12,True,True,0.7932444444444444,-0.274555
1495,1313662,8755,32,0.980027,87,1340877,-1,16000.0,2401877,2410632,1088215,8755,15,2,True,True,2604.824622222222,-0.9635637107937887
1496,1314069,13,10,0.947904,87,1340877,-1,5000.0,1386277,1386290,72208,13,21,7,True,True,3.6152638888888884,-0.9479040000000002
1497,1315723,46,8,0.075041,87,1340877,-1,4000.0,8476634,8476680,7160911,46,2,6,True,True,6.800844444444445,-0.075041
1498,1316219,12086,8,0.637513,87,1340877,-1,4000.0,2552836,2564922,1236617,12086,14,7,True,True,808.0786888888889,-0.6202747096035188
1499,1316353,12827,25,0.363311,87,1340877,-1,12500.0,5933527,5946354,4617174,12827,5,8,True,True,4575.619131944444,-0.3592363023975689
1500,1319043,143,2,0.801096,87,1340877,-1,1000.0,1384077,1384220,65034,143,25,11,True,True,7.879300000000001,-0.801096
1501,1320593,9,2,0.679411,87,1340877,-1,1000.0,8302734,8302743,6982141,9,3,12,True,True,0.19747499999999998,-0.679411
1502,1320865,90,8,0.952789,87,1340877,-1,4000.0,3555488,3555578,2234623,90,13,6,True,True,5.368,-0.952789
1503,1322450,37,1,0.142779,87,1340877,-1,500.0,10696372,10696409,9373922,37,1,12,True,True,0.3464125,-0.142779
1504,1322616,57,1,0.607573,87,1340877,-1,500.0,3560888,3560945,2238272,57,14,8,True,True,0.41752500000000003,-0.607573
1505,1323015,12743,2,0.781312,87,1340877,-1,1000.0,3464682,3477425,2141667,12743,18,6,True,True,409.49815,-0.7530736045161313
1506,1323031,8047,37,0.034799,87,1340877,-1,18500.0,11392972,11401019,10069941,8047,0,12,True,True,5135.346498611112,-0.034684475119924466
1507,1323428,727,4,0.067233,87,1340877,-1,2000.0,11306572,11307299,9983144,727,1,12,True,True,41.44303888888889,-0.067233
1508,1323517,392,1,0.778515,87,1340877,-1,500.0,2135277,2135669,811760,392,28,11,True,True,1.9605444444444442,-0.778515
1509,1323542,13448,128,0.366328,87,1340877,-1,64000.0,11047372,11060820,9723830,13448,3,12,True,True,29619.259022222224,-0.34551732525419376
1510,1323995,46337,4,0.382854,87,1340877,-1,2000.0,3562045,3608382,2238050,46337,17,6,True,True,1066.1101333333331,-0.3723975164229761
1511,1324200,44,28,0.567245,87,1340877,-1,14000.0,7568327,7568371,6244127,44,9,12,True,True,6.580933333333334,-0.567245
1512,1327945,7659,16,0.605095,87,1340877,-1,8000.0,6108527,6116186,4780582,7659,11,12,True,True,887.6292444444445,-0.6025640188260146
1513,1327951,5,16,0.679062,87,1340877,-1,8000.0,3124982,3124987,1797031,5,25,11,True,True,1.985666666666667,-0.679062
1514,1328512,20621,179,0.948824,87,1340877,-1,89500.0,2578361,2598982,1249849,20621,26,0,True,True,31951.38986527778,-0.9465665209208092
1515,1328728,11,2,0.372013,87,1340877,-1,1000.0,4065117,4065128,2736389,11,19,12,True,True,0.6631777777777778,-0.372013
1516,1328802,12,1,0.763084,87,1340877,-1,500.0,3434382,3434394,2105580,12,26,12,True,True,0.03383333333333333,-0.763084
1517,1328814,5,1,0.573922,87,1340877,-1,500.0,3463582,3463587,2134768,5,26,7,True,True,0.10061111111111111,-0.573922
1518,1330137,7732,1,0.52946,87,1340877,-1,500.0,6652127,6659859,5321990,7732,11,12,True,True,59.86501944444444,-0.5292072494385878
1519,1330153,7,16,0.398034,87,1340877,-1,8000.0,1508377,1508384,178224,7,41,11,True,True,0.6640666666666666,-0.398034
1520,1330385,43,2,0.649561,87,1340877,-1,1000.0,2563636,2563679,1233251,43,32,9,True,True,0.6991083333333333,-0.649561
1521,1330698,7,8,0.249612,87,1340877,-1,4000.0,7913927,7913934,6583229,7,8,12,True,True,0.6835888888888889,-0.249612
1522,1331059,8744,128,0.113449,87,1340877,-1,64000.0,9045434,9054178,7714375,8744,6,12,True,True,7156.122666666666,-0.09502207511749261
1523,1331092,33237,13,0.735675,87,1340877,-1,6500.0,3346882,3380119,2015790,33237,31,6,True,True,2050.367709722222,-0.7241283619505806
1524,1331191,443,16,0.499044,87,1340877,-1,8000.0,8389134,8389577,7057943,443,8,12,True,True,105.77855555555556,-0.499044
1525,1331228,4,2,0.386987,87,1340877,-1,1000.0,3332782,3332786,2001554,4,33,11,True,True,0.021033333333333334,-0.386987
1526,1331306,21,32,0.561673,87,1340877,-1,16000.0,5706727,5706748,4375421,21,19,8,True,True,8.654800000000002,-0.561673
1527,1331604,25,1,0.261777,87,1340877,-1,500.0,2536977,2537002,1205373,25,41,6,True,True,0.20482638888888888,-0.261777
1528,1331611,39,1,0.26029,87,1340877,-1,500.0,10474572,10474611,9142961,39,5,12,True,True,0.33079583333333334,-0.26029
1529,1331759,8757,200,0.446273,87,1340877,-1,100000.0,9218234,9226991,7886475,8757,7,12,True,True,17354.745555555553,-0.4050852946667392
1530,1331776,17,8,0.996365,87,1340877,-1,4000.0,1461877,1461894,130101,17,52,10,True,True,2.0638,-0.996365
1531,1331818,3,28,0.285577,87,1340877,-1,14000.0,7006727,7006730,5674909,3,16,12,True,True,0.9979666666666668,-0.285577
1532,1331990,15,2,0.916479,87,1340877,-1,1000.0,1429477,1429492,97487,15,55,11,True,True,0.8909166666666666,-0.916479
1533,1332252,26,8,0.4912,87,1340877,-1,4000.0,5415077,5415103,4082825,26,23,11,True,True,1.289022222222222,-0.4912
1534,1333108,18,4,0.122637,87,1340877,-1,2000.0,6742127,6742145,5409019,18,17,1,True,True,0.6033,-0.122637
1535,1333163,16498,128,0.852826,87,1340877,-1,64000.0,2598982,2615480,1265819,16498,41,2,True,True,17127.274311111112,-0.8075079364409928
1536,1333242,867,1,0.452043,87,1340877,-1,500.0,2548669,2549536,1215427,867,46,8,True,True,6.393159722222222,-0.4496882079178264
1537,1333786,19,32,0.898679,87,1340877,-1,16000.0,1340877,1340896,7091,19,62,0,True,True,16.698888888888888,-0.898679
1538,1333912,5033,84,0.445111,87,1340877,-1,42000.0,6306527,6311560,4972615,5033,19,12,True,True,1757.6481999999999,-0.4445747855762703
1539,1334006,872,8,0.087791,87,1340877,-1,4000.0,3626845,3627717,2292839,872,31,11,True,True,31.98302222222222,-0.087791
1540,1334127,58,12,0.681929,87,1340877,-1,6000.0,1682277,1682335,348150,58,57,11,True,True,24.382233333333332,-0.6819290000000001
1541,1334696,29,3,0.845521,87,1340877,-1,1500.0,2007377,2007406,672681,29,57,10,True,True,0.444425,-0.845521
1542,1334724,2511,8,0.319588,87,1340877,-1,4000.0,7741127,7743638,6406403,2511,13,12,True,True,269.0284111111111,-0.3190452192160477
1543,1334768,8,36,0.347425,87,1340877,-1,18000.0,9391034,9391042,8056266,8,7,12,True,True,4.264,-0.347425
1544,1337018,21038,1,0.064939,87,1340877,-1,500.0,9996072,10017110,8659054,21038,7,11,True,True,149.527225,-0.062135082567936366
1545,1337084,10203,16,0.542171,87,1340877,-1,8000.0,5517677,5527880,4180593,10203,28,12,True,True,1208.762422222222,-0.4517519982801693
1546,1337224,459,3,0.891332,87,1340877,-1,1500.0,1434877,1435336,97653,459,67,8,True,True,40.3021125,-0.891332
1547,1337255,11,16,0.851362,87,1340877,-1,8000.0,2207677,2207688,870422,11,58,10,True,True,1.2439777777777778,-0.851362
1548,1337380,8,1,0.711809,87,1340877,-1,500.0,5609527,5609535,4272147,8,28,1,True,True,0.06365555555555555,-0.711809
1549,1337421,5291,16,0.927324,87,1340877,-1,8000.0,2490477,2495768,1153056,5291,56,12,True,True,807.597488888889,-0.6873738931423529
1550,1337520,59,16,0.6377,87,1340877,-1,8000.0,2620582,2620641,1283062,59,48,10,True,True,6.053400000000001,-0.6377
1551,1337540,58,8,0.793696,87,1340877,-1,4000.0,2179577,2179635,842037,58,62,10,True,True,3.272488888888889,-0.793696
1552,1337563,8260,2,0.508756,87,1340877,-1,1000.0,4194717,4202977,2857154,8260,35,11,True,True,103.21657222222223,-0.49646535152700283
1553,1337577,18561,16,0.121362,87,1340877,-1,8000.0,10609972,10628533,9272395,18561,5,7,True,True,2765.2263555555555,-0.11328762643091451
1554,1337629,12183,8,0.20098,87,1340877,-1,4000.0,3757317,3769500,2419688,12183,38,0,True,True,613.2729333333334,-0.18062779141487595
1555,1337691,25,1,0.138877,87,1340877,-1,500.0,9780072,9780097,8442381,25,9,1,True,True,0.2520486111111111,-0.138877
1556,1337703,119,8,0.790373,87,1340877,-1,4000.0,3583645,3583764,2245942,119,41,10,True,True,4.7124,-0.790373
1557,1337729,7,16,0.026284,87,1340877,-1,8000.0,10869172,10869179,9531443,7,4,11,True,True,0.7298666666666667,-0.026284
1558,1338585,19622,32,0.554021,87,1340877,-1,16000.0,5604077,5623699,4265492,19622,32,12,True,True,7421.872533333333,-0.5143829793340767
1559,1338629,64,1,0.368911,87,1340877,-1,500.0,3843717,3843781,2505088,64,41,12,True,True,1.3826666666666667,-0.368911
1560,1338983,182,16,0.803662,87,1340877,-1,8000.0,3343582,3343764,2004599,182,54,8,True,True,8.764311111111112,-0.803662
1561,1339153,4,71,0.551647,87,1340877,-1,35500.0,8959034,8959038,7619881,4,14,12,True,True,4.495483333333333,-0.551647
1562,1340956,9,8,0.611948,112,1384077,-1,4000.0,1639077,1639086,298121,9,78,12,True,True,1.7481,-0.611948
1563,1341428,4,8,0.086215,112,1384077,-1,4000.0,10169972,10169976,8828544,4,8,12,True,True,0.4434222222222222,-0.086215
1564,1343396,18753,128,0.309291,112,1384077,-1,64000.0,8653034,8671787,7309638,18753,16,1,True,True,26226.947733333334,-0.30632970340355103
1565,1343404,59,1,0.999595,112,1384077,-1,500.0,1985777,1985836,642373,59,79,11,True,True,0.30999583333333336,-0.999595
1566,1343558,25529,16,0.71887,112,1384077,-1,8000.0,3973317,3998846,2629759,25529,44,10,True,True,7063.555955555556,-0.6777996267708285
1567,1343568,19,32,0.525696,112,1384077,-1,16000.0,8872634,8872653,7529066,19,16,12,True,True,9.01528888888889,-0.525696
1568,1343589,9,4,0.769165,112,1384077,-1,2000.0,5798527,5798536,4454938,9,33,12,True,True,0.16524999999999998,-0.769165
1569,1343888,11393,1,0.823339,112,1384077,-1,500.0,3280582,3291975,1936694,11393,62,7,True,True,69.01570416666667,-0.7532022260655988
1570,1344060,19979,128,0.073751,112,1384077,-1,64000.0,6565727,6585706,5221667,19979,29,11,True,True,30177.91431111111,-0.07314395446079167
1571,1344137,5,32,0.97238,112,1384077,-1,16000.0,3554388,3554393,2210251,5,55,1,True,True,1.1928888888888889,-0.97238
1572,1344253,122,32,0.642339,112,1384077,-1,16000.0,8216334,8216456,6872081,122,21,12,True,True,44.05555555555556,-0.642339
1573,1363780,12229,38,0.449974,112,1384077,-1,19000.0,6436127,6448356,5072347,12229,31,11,True,True,2344.194719444444,-0.39966852634925637
1574,1364676,40,1,0.680109,112,1384077,-1,500.0,2069377,2069417,704701,40,85,6,True,True,0.4776666666666667,-0.680109
1575,1364795,22,16,0.344515,112,1384077,-1,8000.0,2543269,2543291,1178474,22,75,8,True,True,2.794977777777778,-0.344515
1576,1366877,6679,32,0.87796,112,1384077,-1,16000.0,2092077,2098756,725200,6679,86,10,True,True,2020.7791555555555,-0.877592267521172
1577,1367148,7834,13,0.780263,112,1384077,-1,6500.0,2303877,2311711,936729,7834,81,12,True,True,815.3957680555555,-0.753772283813451
1578,1367189,10,8,0.639794,112,1384077,-1,4000.0,4345917,4345927,2978728,10,47,12,True,True,1.0292222222222223,-0.639794
1579,1367258,28,1,0.181963,112,1384077,-1,500.0,3951717,3951745,2584459,28,51,10,True,True,0.5932888888888889,-0.181963
1580,1367279,4,19,0.966265,112,1384077,-1,9500.0,3278382,3278386,1911103,4,69,11,True,True,0.4910444444444445,-0.966265
1581,1367491,70,1,0.432618,112,1384077,-1,500.0,3235182,3235252,1867691,70,70,6,True,True,0.3671111111111111,-0.432618
1582,1369153,7330,4,0.910712,112,1384077,-1,2000.0,2578361,2585691,1209208,7330,75,7,True,True,232.55752222222222,-0.8908792295812442
1583,1371674,29978,16,0.055413,112,1384077,-1,8000.0,10607772,10637750,9236098,29978,7,1,True,True,4856.852,-0.054752117680684505
1584,1371746,7570,32,0.124161,112,1384077,-1,16000.0,8649434,8657004,7277688,7570,19,12,True,True,2497.6504000000004,-0.12307904063639565
1585,1371766,22985,1,0.153015,112,1384077,-1,500.0,8786234,8809219,7414468,22985,18,12,True,True,156.5574333333333,-0.1446941368977456
1586,1374454,11567,32,0.164657,112,1384077,-1,16000.0,5614927,5626494,4240473,11567,42,8,True,True,5502.824844444444,-0.1636781965622051
1587,1376090,11,17,0.322661,112,1384077,-1,8500.0,3232982,3232993,1856892,11,75,10,True,True,0.9807111111111111,-0.322661
1588,1381788,16620,8,0.709332,112,1384077,-1,4000.0,4151517,4168137,2769729,16620,53,12,True,True,4207.2744,-0.7051752626688377
1589,1384832,10899,256,0.346023,114,1386277,-1,128000.0,10560972,10571871,9176140,10899,8,12,True,True,37336.752,-0.3429408126366149
1590,1385180,25,3,0.940904,114,1386277,-1,1500.0,2208777,2208802,823597,25,95,6,True,True,0.5301041666666666,-0.9409039999999997
1591,1385597,192,1,0.894926,114,1386277,-1,500.0,1465177,1465369,79580,192,109,7,True,True,2.9302652777777776,-0.8942338537716724
1592,1389857,6,1,0.845934,151,1429477,-1,500.0,3347982,3347988,1958125,6,71,6,True,True,0.018125000000000002,-0.845934
1593,1389978,10134,32,0.250605,151,1429477,-1,16000.0,9477434,9487568,8087456,10134,14,12,True,True,3381.8276444444446,-0.24589215483881605
1594,1390228,10712,64,0.635057,151,1429477,-1,32000.0,3038582,3049294,1648354,10712,81,12,True,True,13811.804088888888,-0.6160520298170211
1595,1405595,74,1,0.550841,151,1429477,-1,500.0,8699834,8699908,7294239,74,21,2,True,True,0.5215972222222223,-0.550841
1596,1405663,4790,256,0.12517,151,1429477,-1,128000.0,4762287,4767077,3356624,4790,52,7,True,True,22663.433955555553,-0.11185470326680608
1597,1406002,106,32,0.302825,151,1429477,-1,16000.0,3649317,3649423,2243315,106,63,10,True,True,14.411288888888889,-0.302825
1598,1406116,50,4,0.533478,151,1429477,-1,2000.0,5609477,5609527,4203361,50,47,8,True,True,1.5913888888888887,-0.533478
1599,1406373,15161,64,0.502573,151,1429477,-1,32000.0,6022127,6037288,4615754,15161,40,7,True,True,16270.082844444445,-0.5011180587110747
1600,1406442,14079,1,0.168636,151,1429477,-1,500.0,7481927,7496006,6075485,14079,32,11,True,True,72.22257638888888,-0.1663873563012422
1601,1406530,1,8,0.941607,151,1429477,-1,4000.0,1462977,1462978,56447,1,119,6,True,True,0.12140000000000001,-0.941607
1602,1406645,12,16,0.154194,151,1429477,-1,8000.0,11133772,11133784,9727127,12,3,12,True,True,2.311466666666667,-0.154194
1603,1407095,154,32,0.658733,151,1429477,-1,16000.0,6747527,6747681,5340432,154,36,8,True,True,60.114755555555554,-0.658733
1604,1407146,4350,4,0.720633,151,1429477,-1,2000.0,2843082,2847432,1435936,4350,90,12,True,True,148.78676666666667,-0.6579703439971772
1605,1408195,10170,128,0.605139,151,1429477,-1,64000.0,7093127,7103297,5684932,10170,35,12,True,True,11536.345244444443,-0.5855300771837579
1606,1408412,53,9,0.84253,151,1429477,-1,4500.0,3461382,3461435,2052970,53,80,10,True,True,10.7702625,-0.84253
1607,1408478,13,16,0.563618,151,1429477,-1,8000.0,2621682,2621695,1213204,13,93,6,True,True,1.0616666666666665,-0.563618
1608,1408524,16770,21,0.825236,151,1429477,-1,10500.0,4745517,4762287,3336993,16770,59,0,True,True,7418.733174999999,-0.8172288929435817
1609,1408588,818,16,0.028373,151,1429477,-1,8000.0,10782772,10783590,9374184,818,6,12,True,True,231.3122222222222,-0.028373
1610,1408763,78,1,0.045462,151,1429477,-1,500.0,1899377,1899455,490614,78,122,6,True,True,0.3209916666666667,-0.045462
1611,1408861,22648,16,0.641454,151,1429477,-1,8000.0,3978717,4001365,2569856,22648,67,8,True,True,6610.100266666666,-0.6061065720647921
1612,1409391,32,2,0.576771,151,1429477,-1,1000.0,5155877,5155909,3746486,32,58,12,True,True,0.6384,-0.576771
1613,1409433,50,1,0.65113,151,1429477,-1,500.0,2708082,2708132,1298649,50,97,12,True,True,1.396111111111111,-0.65113
1614,1419280,17420,1,0.766959,151,1429477,-1,500.0,2063577,2080997,644297,17420,122,6,True,True,198.88248055555556,-0.7528591860220377
1615,1419841,10,1,0.416587,151,1429477,-1,500.0,3338182,3338192,1918341,10,89,8,True,True,0.029541666666666667,-0.416587
1616,1419867,10276,128,0.638991,151,1429477,-1,64000.0,4734717,4744993,3314850,10276,62,12,True,True,11752.477155555556,-0.4888215600806569
1617,1419942,13212,32,0.498038,151,1429477,-1,16000.0,6738527,6751739,5318585,13212,40,12,True,True,4478.5412,-0.4690918479854539
1618,1419965,3682,32,0.627164,151,1429477,-1,16000.0,4648317,4651999,3228352,3682,64,12,True,True,508.61093333333326,-0.588016560598898
1619,1420003,3,32,0.289672,151,1429477,-1,16000.0,8696234,8696237,7276231,3,24,11,True,True,0.7988,-0.289672
1620,1420167,12298,141,0.95665,151,1429477,-1,70500.0,2951082,2963380,1530915,12298,101,10,True,True,36509.91999166667,-0.9091377293914146
1621,1420244,56,2,0.482945,151,1429477,-1,1000.0,6920327,6920383,5500083,56,39,12,True,True,0.5648222222222222,-0.482945
1622,1420284,9835,8,0.804688,151,1429477,-1,4000.0,2397177,2407012,976893,9835,120,12,True,True,728.7162222222222,-0.7830673544175065
1623,1420302,31,1,0.684991,151,1429477,-1,500.0,2579461,2579492,1159159,31,108,6,True,True,0.23099305555555555,-0.684991
1624,1420306,8332,256,0.297434,151,1429477,-1,128000.0,9520634,9528966,8100328,8332,16,11,True,True,31992.628622222222,-0.2973158921348808
1625,1420347,34,16,0.072973,151,1429477,-1,8000.0,9607034,9607068,8186687,34,16,12,True,True,7.523822222222222,-0.072973
1626,1424591,1809,1,0.059913,151,1429477,-1,500.0,7827527,7829336,6402936,1809,34,12,True,True,24.815962499999998,-0.059913
1627,1424612,768,1,0.439605,151,1429477,-1,500.0,8129934,8130702,6705322,768,33,11,True,True,9.415466666666667,-0.439605
1628,1426672,18,24,0.484251,151,1429477,-1,12000.0,3289582,3289600,1862910,18,100,2,True,True,2.5866,-0.484251
1629,1427179,524,8,0.204023,151,1429477,-1,4000.0,6220127,6220651,4792948,524,51,10,True,True,31.719466666666662,-0.204023
1630,1432315,7,1,0.60666,162,1434877,-1,500.0,3978717,3978724,2546402,7,78,0,True,True,0.10917083333333334,-0.60666
1631,1432369,8,4,0.312582,162,1434877,-1,2000.0,3735717,3735725,2303348,8,84,11,True,True,0.15253333333333333,-0.312582
1632,1432443,52,16,0.718363,162,1434877,-1,8000.0,2570722,2570774,1138279,52,119,2,True,True,7.193333333333333,-0.718363
1633,1432465,5,2,0.7342,162,1434877,-1,1000.0,2307177,2307182,874712,5,131,6,True,True,0.08020833333333334,-0.7342
1634,1432472,7933,197,0.860777,162,1434877,-1,98500.0,5069477,5077410,3637005,7933,67,11,True,True,18712.834915277777,-0.8178948577713538
1635,1432563,40,1,0.975374,162,1434877,-1,500.0,2070477,2070517,637914,40,141,6,True,True,0.46694444444444444,-0.975374
1636,1432902,16297,1,0.130766,162,1434877,-1,500.0,8563034,8579331,7130132,16297,29,12,True,True,259.69244444444445,-0.12762951298589004
1637,1433882,10,1,0.37054,162,1434877,-1,500.0,2068277,2068287,634395,10,144,3,True,True,0.11941666666666667,-0.37054
1638,1434306,672,2,0.561651,162,1434877,-1,1000.0,2756682,2757354,1322376,672,114,8,True,True,27.656533333333336,-0.561651
1639,1434340,258,2,0.319116,162,1434877,-1,1000.0,4432317,4432575,2997977,258,76,12,True,True,10.323583333333335,-0.319116
1640,1434383,83,41,0.466473,162,1434877,-1,20500.0,9131834,9131917,7697451,83,21,12,True,True,25.82498888888889,-0.466473
1641,1434752,30097,16,0.267472,162,1434877,-1,8000.0,10604172,10634269,9169420,30097,10,11,True,True,4714.5201777777775,-0.2658281820182552
1642,1435236,54,1,0.247919,177,1440277,-1,500.0,7438727,7438781,6003491,54,43,12,True,True,0.457275,-0.247919
1643,1435263,34,1,0.096812,177,1440277,-1,500.0,8475534,8475568,7040271,34,33,12,True,True,0.6283388888888889,-0.096812
1644,1435411,15,32,0.290212,177,1440277,-1,16000.0,9866472,9866487,8431061,15,16,12,True,True,5.292666666666666,-0.290212
1645,1435621,33,32,0.38415,177,1440277,-1,16000.0,2492677,2492710,1057056,33,136,7,True,True,8.692933333333334,-0.38415
1646,1435683,2,2,0.615377,177,1440277,-1,1000.0,4939877,4939879,3504194,2,75,12,True,True,0.047716666666666664,-0.615377
1647,1435706,6918,1,0.24827,177,1440277,-1,500.0,2929482,2936400,1493776,6918,120,12,True,True,66.701725,-0.22316249835087867
1648,1435860,98,2,0.865308,177,1440277,-1,1000.0,2306077,2306175,870217,98,144,7,True,True,1.5720833333333333,-0.865308
1649,1435902,860,5,0.1597,177,1440277,-1,2500.0,6392927,6393787,4957025,860,56,12,True,True,18.164847222222225,-0.1576043035328917
1650,1435919,238,4,0.327436,177,1440277,-1,2000.0,9779834,9780072,8343915,238,18,12,True,True,9.598011111111111,-0.327436
1651,1436041,8762,16,0.577687,177,1440277,-1,8000.0,6833927,6842689,5397886,8762,51,12,True,True,1560.192177777778,-0.5706526622001731
1652,1436063,18,4,0.312715,177,1440277,-1,2000.0,1725477,1725495,289414,18,164,11,True,True,2.8760000000000003,-0.312715
1653,1436085,79,1,0.763121,177,1440277,-1,500.0,2574322,2574401,1138237,79,133,2,True,True,0.6535055555555556,-0.763121
1654,1436093,26,28,0.498266,177,1440277,-1,14000.0,5701327,5701353,4265234,26,68,12,True,True,5.9372444444444445,-0.498266
1655,1438443,13,1,0.514725,177,1440277,-1,500.0,7093127,7093140,5654684,13,48,0,True,True,0.1389013888888889,-0.514725
1656,1439228,3,2,0.49876,177,1440277,-1,1000.0,4767077,4767080,3327849,3,81,1,True,True,0.08981666666666667,-0.49876
1657,1440078,14813,8,0.30854,177,1440277,-1,4000.0,10213172,10227985,8773094,14813,13,11,True,True,2600.8400555555554,-0.3085306627125254
1658,1440364,46,2,0.023176,198,1461877,-1,1000.0,10874572,10874618,9434208,46,5,8,True,True,0.6525611111111111,-0.023176
1659,1440682,10185,1,0.945233,198,1461877,-1,500.0,2184977,2195162,744295,10185,158,8,True,True,93.55102916666667,-0.7589435739477208
1660,1440832,120,64,0.505444,198,1461877,-1,32000.0,2952182,2952302,1511350,120,127,6,True,True,154.10133333333334,-0.505444
1661,1441739,12,1,0.966687,198,1461877,-1,500.0,1551577,1551589,109838,12,176,11,True,True,0.06756666666666666,-0.966687
1662,1441788,212,1,0.215144,198,1461877,-1,500.0,4853477,4853689,3411689,212,83,12,True,True,3.429394444444444,-0.215144
1663,1442362,3461,128,0.352895,198,1461877,-1,64000.0,3757317,3760778,2314955,3461,102,10,True,True,3725.4030222222223,-0.3516591564083109
1664,1442591,40,1,0.05054,198,1461877,-1,500.0,6522527,6522567,5079936,40,60,12,True,True,0.3612777777777778,-0.05054
1665,1442660,76316,128,0.494894,198,1461877,-1,64000.0,10960972,11037288,9518312,76316,5,12,True,True,143140.3882666667,-0.49278469352527426
1666,1450502,450,32,0.882339,198,1461877,-1,16000.0,3551082,3551532,2100580,450,115,12,True,True,120.68,-0.882339
1667,1450575,102,2,0.65426,198,1461877,-1,1000.0,2215277,2215379,764702,102,161,8,True,True,1.1356,-0.65426
1668,1451480,778,32,0.470587,198,1461877,-1,16000.0,10083572,10084350,8632092,778,17,12,True,True,172.5882666666667,-0.45283278879718586
1669,1451527,12814,32,0.536691,198,1461877,-1,16000.0,4745517,4758331,3293990,12814,90,9,True,True,8563.874711111112,-0.5227186368343899
1670,1451581,96,4,0.847172,198,1461877,-1,2000.0,1942577,1942673,490996,96,179,11,True,True,2.0992,-0.847172
1671,1451844,30,16,0.430928,198,1461877,-1,8000.0,2217477,2217507,765633,30,163,7,True,True,2.6719999999999997,-0.430928
1672,1451875,16774,1,0.882456,198,1461877,-1,500.0,1898277,1915051,446402,16774,182,11,True,True,97.1699472222222,-0.8798326880721971
1673,1452049,27,1,0.727508,198,1461877,-1,500.0,3627717,3627744,2175668,27,109,1,True,True,0.1237875,-0.727508
1674,1452085,57,1,0.763857,198,1461877,-1,500.0,2136377,2136434,684292,57,172,6,True,True,0.28507916666666666,-0.763857
1675,1452408,18768,1,0.365937,198,1461877,-1,500.0,2929482,2948250,1477074,18768,137,0,True,True,252.1886,-0.36286502596770415
1676,1452615,52,16,0.400582,198,1461877,-1,8000.0,6112127,6112179,4659512,52,67,1,True,True,6.512711111111111,-0.400582
1677,1454614,8,1,0.570282,198,1461877,-1,500.0,3439782,3439790,1985168,8,123,8,True,True,0.035555555555555556,-0.570282
1678,1454636,39,1,0.194655,198,1461877,-1,500.0,9693434,9693473,8238798,39,23,12,True,True,0.422175,-0.194655
1679,1456872,6712,86,0.553223,198,1461877,-1,43000.0,8696234,8702946,7239362,6712,35,0,True,True,4042.3318166666663,-0.5011269284412624
1680,1596460,10681,32,0.073532,240,1639077,-1,16000.0,9952872,9963553,8356412,10681,20,12,True,True,4646.330711111111,-0.07098678460626572
1681,1596869,64,32,0.504256,240,1639077,-1,16000.0,2152577,2152641,555708,64,177,9,True,True,12.251022222222222,-0.504256
1682,1597436,24,10,0.764404,240,1639077,-1,5000.0,5420477,5420501,3823041,24,84,8,True,True,1.2243333333333333,-0.764404
1683,1597484,939,2,0.279721,240,1639077,-1,1000.0,5371877,5372816,3774393,939,86,12,True,True,23.15678333333333,-0.279721
1684,1597521,994,8,0.989091,240,1639077,-1,4000.0,2064677,2065671,467156,994,187,6,True,True,114.42044444444443,-0.989091
1685,1597734,3,42,0.680399,240,1639077,-1,21000.0,2751282,2751285,1153548,3,148,11,True,True,2.596825,-0.680399
1686,1597776,122,1,0.118811,240,1639077,-1,500.0,3038582,3038704,1440806,122,141,0,True,True,2.6743416666666673,-0.118811
1687,1597818,384,8,0.975083,240,1639077,-1,4000.0,2186077,2186461,588259,384,179,6,True,True,36.91093333333334,-0.975083
1688,1597823,17302,18,0.393904,240,1639077,-1,9000.0,2310777,2328079,712954,17302,171,2,True,True,2938.5514749999998,-0.3870015366150581
1689,1598531,28,1,0.794897,240,1639077,-1,500.0,3692517,3692545,2093986,28,114,11,True,True,0.07101111111111112,-0.794897
1690,1598542,127,51,0.339085,240,1639077,-1,25500.0,8000334,8000461,6401792,127,47,12,True,True,79.29827083333333,-0.339085
1691,1598584,14,3,0.938949,240,1639077,-1,1500.0,2157977,2157991,559393,14,185,8,True,True,0.24727499999999997,-0.938949
1692,1598620,11847,3,0.754965,240,1639077,-1,1500.0,3234082,3245929,1635462,11847,141,6,True,True,182.9667333333333,-0.7410430916914453
1693,1598714,12681,256,0.199058,240,1639077,-1,128000.0,10301772,10314453,8703058,12681,15,12,True,True,78131.5424,-0.17113693151961337
1694,1598776,6557,2,0.509123,240,1639077,-1,1000.0,6198527,6205084,4599751,6557,72,12,True,True,44.08466388888889,-0.44282684626509633
1695,1598819,490,37,0.500078,240,1639077,-1,18500.0,7913934,7914424,6315115,490,49,1,True,True,221.31190277777776,-0.500078
1696,1598835,37,32,0.045303,240,1639077,-1,16000.0,10215372,10215409,8616537,37,16,7,True,True,25.314577777777778,-0.045303
1697,1603039,14883,16,0.137036,240,1639077,-1,8000.0,5884927,5899810,4281888,14883,80,12,True,True,3547.076666666667,-0.13149037698128946
1698,1603587,160,1,0.333041,240,1639077,-1,500.0,5285477,5285637,3681890,160,93,11,True,True,3.7442222222222226,-0.333041
1699,1603891,46,32,0.473744,240,1639077,-1,16000.0,5798527,5798573,4194636,46,81,0,True,True,6.756888888888889,-0.473744
1700,1604086,27,64,0.456989,240,1639077,-1,32000.0,9304634,9304661,7700548,27,31,12,True,True,12.216,-0.456989
1701,1605702,50,4,0.606261,240,1639077,-1,2000.0,2061377,2061427,455675,50,206,11,True,True,3.493333333333333,-0.606261
1702,1605723,93,1,0.515506,240,1639077,-1,500.0,3930117,3930210,2324394,93,119,12,True,True,2.6687125000000003,-0.515506
1703,1605946,11059,128,0.327966,240,1639077,-1,64000.0,10825972,10837031,9220026,11059,8,11,True,True,15319.160177777778,-0.3244545969472503
1704,1606006,11257,64,0.613068,240,1639077,-1,32000.0,3285982,3297239,1679976,11257,148,8,True,True,5345.162133333333,-0.6051554112745686
1705,1606043,41,1,0.162502,240,1639077,-1,500.0,5431277,5431318,3825234,41,93,9,True,True,0.1615513888888889,-0.162502
1706,1606213,16,2,0.990616,240,1639077,-1,1000.0,1811877,1811893,205664,16,216,12,True,True,0.9251111111111111,-0.990616
1707,1606308,359,2,0.739319,240,1639077,-1,1000.0,1855077,1855436,248769,359,216,11,True,True,13.187266666666668,-0.739319
1708,1606337,1891,8,0.299234,240,1639077,-1,4000.0,4259517,4261408,2653180,1891,114,10,True,True,171.1565111111111,-0.299234
1709,1606500,13621,1,0.336373,240,1639077,-1,500.0,10388172,10401793,8781672,13621,16,12,True,True,202.58098194444443,-0.32761702892390326
1710,1606528,59,2,0.828289,240,1639077,-1,1000.0,3081782,3081841,1475254,59,158,11,True,True,1.2095,-0.828289
1711,1606786,19333,64,0.53234,240,1639077,-1,32000.0,2018177,2037510,411391,19333,214,9,True,True,9513.168266666667,-0.5306402854228847
1712,1606809,112,64,0.70874,240,1639077,-1,32000.0,3560945,3561057,1954136,112,134,1,True,True,52.5056,-0.70874
1713,1608097,518,2,0.299791,240,1639077,-1,1000.0,6019927,6020445,4411830,518,81,12,True,True,16.150088888888888,-0.299791
1714,1608200,15423,32,0.815749,240,1639077,-1,16000.0,4237917,4253340,2629717,15423,117,11,True,True,3950.1584000000003,-0.7547050446177699
1715,1608220,15378,1,0.368358,240,1639077,-1,500.0,7179527,7194905,5571307,15378,62,12,True,True,141.51253472222223,-0.36479850423538546
1716,1608688,1992,1,0.673806,240,1639077,-1,500.0,2535877,2537869,927189,1992,188,11,True,True,16.320566666666668,-0.673806
1717,1608889,7265,8,0.979898,240,1639077,-1,4000.0,3211382,3218647,1602493,7265,161,12,True,True,1020.5174333333334,-0.9561982232292471
1718,1611130,6,4,0.583702,240,1639077,-1,2000.0,3554382,3554388,1943252,6,141,6,True,True,0.17893333333333333,-0.583702
1719,1611158,29,32,0.796755,240,1639077,-1,16000.0,2567122,2567151,955964,29,183,7,True,True,7.507777777777777,-0.796755
1720,1611488,390,32,0.725324,240,1639077,-1,16000.0,3345782,3346172,1734294,390,152,7,True,True,37.7,-0.725324
1721,1611548,15,8,0.688044,240,1639077,-1,4000.0,7352327,7352342,5740779,15,61,12,True,True,1.6161666666666665,-0.688044
1722,1618229,16,1,0.026647,240,1639077,-1,500.0,2576161,2576177,957932,16,183,3,True,True,0.13235555555555556,-0.026647
1723,1618309,13,2,0.47459,240,1639077,-1,1000.0,2398277,2398290,779968,13,199,6,True,True,0.24905833333333333,-0.47459
1724,1618347,25525,16,0.967071,240,1639077,-1,8000.0,2550636,2576161,932289,25525,190,6,True,True,3384.510755555555,-0.9573750737500782
1725,1618857,5,13,0.782904,240,1639077,-1,6500.0,5199077,5199082,3580220,5,103,11,True,True,0.778013888888889,-0.782904
1726,1618870,2,8,0.776162,240,1639077,-1,4000.0,2549536,2549538,930666,2,192,1,True,True,0.1186,-0.776162
1727,1618883,135,32,0.577634,240,1639077,-1,16000.0,8086734,8086869,6467851,135,52,12,True,True,51.528,-0.577634
4529,3668186,12,8,0.701314,1,3668186,-1,4000.0,3711386,3711398,43200,12,0,11,True,True,1.2208,-0.701314
4530,3668196,39839,1,0.255939,111,3711386,-1,500.0,6907737,6947576,3239541,39839,0,10,True,True,570.5123680555556,-0.2537215773254124
4531,3668426,38,4,0.366354,111,3711386,-1,2000.0,4112096,4112134,443670,38,1,7,True,True,4.061355555555555,-0.366354
4532,3668615,13,64,0.605954,111,3711386,-1,32000.0,6808609,6808622,3139994,13,1,8,True,True,11.44231111111111,-0.605954
4533,3668830,23991,4,0.070874,111,3711386,-1,2000.0,7356761,7380752,3687931,23991,0,2,True,True,3050.9577000000004,-0.0673229414298695
4534,3668847,12081,256,0.930211,111,3711386,-1,128000.0,5971132,5983213,2302285,12081,3,7,True,True,58988.76373333334,-0.9051110833535173
4535,3668865,5,1,0.208738,111,3711386,-1,500.0,4925336,4925341,1256471,5,4,12,True,True,0.09700694444444445,-0.208738
4536,3669374,4541,184,0.491406,111,3711386,-1,92000.0,5761405,5765946,2092031,4541,4,6,True,True,16358.294088888888,-0.48134781561331463
4537,3669407,7819,4,0.889767,111,3711386,-1,2000.0,3748204,3756023,78797,7819,7,8,True,True,323.3025222222222,-0.8587326893509263
4538,3669434,2,4,0.079957,111,3711386,-1,2000.0,4253096,4253098,583662,2,6,2,True,True,0.13414444444444446,-0.079957
4539,3669546,5723,2,0.80102,111,3711386,-1,1000.0,4307858,4313581,638312,5723,6,10,True,True,221.21112499999998,-0.7923772715198887
4540,3669588,33704,64,0.0607,111,3711386,-1,32000.0,7353161,7386865,3683573,33704,1,2,True,True,67188.2768,-0.058394724241479914
4541,3669597,10,1,0.55802,111,3711386,-1,500.0,5958005,5958015,2288408,10,5,11,True,True,0.19140277777777778,-0.55802
4542,3670045,612,43,0.938244,111,3711386,-1,21500.0,4108184,4108796,438139,612,11,0,True,True,635.4583000000001,-0.938244
4543,3670118,3,16,0.415953,111,3711386,-1,8000.0,6705473,6705476,3035355,3,4,1,True,True,1.1783333333333335,-0.415953
4544,3670126,12,8,0.369069,111,3711386,-1,4000.0,4742958,4742970,1072832,12,9,2,True,True,2.4328000000000003,-0.369069
4545,3670158,26577,128,0.708434,111,3711386,-1,64000.0,6634862,6661439,2964704,26577,5,12,True,True,103265.58613333333,-0.6910185270641273
4546,3670351,9,2,0.823643,111,3711386,-1,1000.0,4085484,4085493,415133,9,15,10,True,True,0.4053,-0.823643
4547,3670440,3747,1,0.265816,111,3711386,-1,500.0,4134796,4138543,464356,3747,13,10,True,True,125.61509444444442,-0.2195326215586545
4548,3672786,28250,128,0.040653,111,3711386,-1,64000.0,7242664,7270914,3569878,28250,2,2,True,True,157481.46560000003,-0.03919467665317723
4549,3672822,13457,128,0.070388,111,3711386,-1,64000.0,7360987,7374444,3688165,13457,0,6,True,True,56828.839644444444,-0.06276490116087309
4550,3673201,21313,16,0.303905,111,3711386,-1,8000.0,6051532,6072845,2378331,21313,8,0,True,True,7216.452244444444,-0.29920472495478745
4551,3673565,89,1,0.944603,111,3711386,-1,500.0,3953284,3953373,279719,89,20,10,True,True,0.8011236111111111,-0.944603
4552,3673625,16711,4,0.960587,111,3711386,-1,2000.0,4108796,4125507,435171,16711,18,2,True,True,1538.0495055555555,-0.9482767201638816
4553,3673741,75,2,0.097119,111,3711386,-1,1000.0,6810809,6810884,3137068,75,5,7,True,True,2.0629166666666663,-0.097119
4554,3673762,201,1,0.725172,111,3711386,-1,500.0,3843304,3843505,169542,201,23,8,True,True,3.2816041666666664,-0.725172
4555,3673920,5,1,0.531661,111,3711386,-1,500.0,6375662,6375667,2701742,5,9,12,True,True,0.14124305555555555,-0.531661
4556,3674946,25,1,0.18946,111,3711386,-1,500.0,5508505,5508530,1833559,25,14,10,True,True,0.42385416666666664,-0.18946
4557,3674980,12598,32,0.526192,111,3711386,-1,16000.0,7046037,7058635,3371057,12598,4,10,True,True,5619.428622222222,-0.5210314387280978
4558,3675045,21116,45,0.248763,111,3711386,-1,22500.0,4750336,4771452,1075291,21116,17,6,True,True,27579.55075,-0.24423822716956753
4559,3675284,288,3,0.625325,111,3711386,-1,1500.0,5443705,5443993,1768421,288,16,7,True,True,15.4116,-0.625325
4560,3675406,1649,5,0.178898,111,3711386,-1,2500.0,7167436,7169085,3492030,1649,4,11,True,True,373.4496875,-0.17688429191880037
4561,3675425,101,1,0.749194,111,3711386,-1,500.0,3886504,3886605,211079,101,29,11,True,True,1.2676902777777779,-0.749194
4562,3675572,12,2,0.415185,111,3711386,-1,1000.0,5783005,5783017,2107433,12,15,10,True,True,0.5221333333333333,-0.415185
4563,3675590,8667,16,0.105514,111,3711386,-1,8000.0,7013637,7022304,3338047,8667,6,9,True,True,2722.6531999999997,-0.10243110446389882
4564,3675622,29,12,0.638624,111,3711386,-1,6000.0,4745923,4745952,1070301,29,22,2,True,True,8.66665,-0.638624
4565,3675637,7754,128,0.357963,111,3711386,-1,64000.0,6179032,6186786,2503395,7754,13,12,True,True,20773.2928,-0.35735094242394444
4566,3675654,189,32,0.458721,111,3711386,-1,16000.0,6181232,6181421,2505578,189,13,7,True,True,128.60399999999998,-0.458721
4567,3675688,10761,1,0.665242,111,3711386,-1,500.0,3713586,3724347,37898,10761,37,7,True,True,129.71476666666666,-0.6593617926700146
4568,3675741,8744,4,0.882824,111,3711386,-1,2000.0,3715786,3724530,40045,8744,37,7,True,True,422.0032888888889,-0.8759099464093298
4569,3675872,9308,1,0.166809,111,3711386,-1,500.0,4836736,4846044,1160864,9308,23,12,True,True,248.1573,-0.13215884669893183
4570,3675903,11829,72,0.180397,111,3711386,-1,36000.0,7230276,7242105,3554373,11829,4,2,True,True,35113.273199999996,-0.16990750115595338
4571,3676012,238,1,0.401557,111,3711386,-1,500.0,6791873,6792111,3115861,238,11,12,True,True,4.678022222222222,-0.401557
4572,3676024,33,8,0.337513,111,3711386,-1,4000.0,3910084,3910117,234060,33,37,2,True,True,3.3634333333333335,-0.337513
4573,3676082,23,5,0.158176,111,3711386,-1,2500.0,6881909,6881932,3205827,23,9,2,True,True,2.1284583333333336,-0.158176
4574,3676130,45,1,0.998434,111,3711386,-1,500.0,4063884,4063929,387754,45,37,10,True,True,0.8411250000000001,-0.998434
4575,3676133,2356,2,0.443012,111,3711386,-1,1000.0,7114980,7117336,3438847,2356,6,2,True,True,67.57568888888889,-0.4168768777172925
4576,3676184,230,8,0.352324,111,3711386,-1,4000.0,6064532,6064762,2388348,230,19,7,True,True,38.205555555555556,-0.352324
4577,3677867,53,45,0.315155,111,3711386,-1,22500.0,7117336,7117389,3439469,53,6,2,True,True,36.3480625,-0.315155
4578,3677893,32,1,0.991463,111,3711386,-1,500.0,3837904,3837936,160011,32,45,6,True,True,0.5539555555555555,-0.991463
4579,3677973,1043,1,0.324654,111,3711386,-1,500.0,5103536,5104579,1425563,1043,28,11,True,True,16.169397222222223,-0.324654
4580,3677995,13208,38,0.37172,111,3711386,-1,19000.0,5826205,5839413,2148210,13208,24,11,True,True,10036.612830555556,-0.3690019897030478
4581,3678079,1889,4,0.764184,111,3711386,-1,2000.0,4838936,4840825,1160857,1889,31,7,True,True,189.5821388888889,-0.764184
4582,3678090,14913,128,0.430588,111,3711386,-1,64000.0,6092632,6107545,2414542,14913,20,6,True,True,37831.53351111112,-0.4281726103034864
4583,3678108,13165,16,0.725868,111,3711386,-1,8000.0,6027732,6040897,2349624,13165,23,8,True,True,5843.07,-0.7223786672512055
4584,3678125,7,4,0.608413,111,3711386,-1,2000.0,6062332,6062339,2384207,7,22,8,True,True,0.6413166666666666,-0.608413
4585,3678176,6,37,0.563145,111,3711386,-1,18500.0,4222496,4222502,544320,6,41,7,True,True,5.878683333333333,-0.563145
4586,3678377,8869,256,0.213928,111,3711386,-1,128000.0,7389995,7398864,3711618,8869,0,3,True,True,54907.47982222222,-0.19047401539759562
4587,3678440,12027,210,0.765708,111,3711386,-1,105000.0,5959105,5971132,2280665,12027,27,6,True,True,49923.292708333334,-0.7590502868225104
4588,3679211,14,64,0.926147,111,3711386,-1,32000.0,4749236,4749250,1070025,14,39,2,True,True,21.375822222222222,-0.926147
4589,3679280,44,128,0.254089,111,3711386,-1,64000.0,7242105,7242149,3562825,44,5,7,True,True,278.784,-0.254089
4590,3679312,4,1,0.961652,111,3711386,-1,500.0,3713586,3713590,34274,4,59,0,True,True,0.0482,-0.961652
4591,3679372,7906,32,0.4475,111,3711386,-1,16000.0,4674558,4682464,995186,7906,43,7,True,True,5239.815644444445,-0.44099693292173936
4592,3680172,1984,32,0.397091,111,3711386,-1,16000.0,7215585,7217569,3535413,1984,7,6,True,True,891.8300444444444,-0.397091
4593,3680281,13,14,0.726313,111,3711386,-1,7000.0,4258496,4258509,578215,13,46,8,True,True,3.1660416666666666,-0.726313
4594,3680922,11742,86,0.982956,111,3711386,-1,43000.0,3742804,3754546,61882,11742,61,1,True,True,11870.817216666666,-0.9382895169306132
4595,3681024,1300,8,0.595763,111,3711386,-1,4000.0,3737386,3738686,56362,1300,62,10,True,True,134.72333333333333,-0.595763
4596,3681070,19,1,0.517609,111,3711386,-1,500.0,3931684,3931703,250614,19,56,10,True,True,0.2023763888888889,-0.517609
4597,3681095,23,32,0.993412,111,3711386,-1,16000.0,5533405,5533428,1852310,23,34,6,True,True,13.619066666666667,-0.993412
4598,3681213,5,32,0.301842,111,3711386,-1,16000.0,6815209,6815214,3133996,5,15,7,True,True,2.6906666666666665,-0.301842
4599,3681391,13,8,0.300334,111,3711386,-1,4000.0,5912605,5912618,2231214,13,32,12,True,True,2.393011111111111,-0.300334
4600,3681904,3459,4,0.221887,111,3711386,-1,2000.0,7104321,7107780,3422417,3459,11,6,True,True,286.2113,-0.19973195720464557
4601,3682096,13849,4,0.85572,111,3711386,-1,2000.0,3836804,3850653,154708,13849,65,12,True,True,900.5925277777778,-0.8306362655229965
4602,3682167,19827,32,0.021701,111,3711386,-1,16000.0,7349561,7369388,3667394,19827,4,7,True,True,23806.2504,-0.020227279344989697
4603,3682283,6,1,0.82194,111,3711386,-1,500.0,3907104,3907110,224821,6,63,7,True,True,0.08389166666666667,-0.82194
4604,3682525,22,32,0.689719,111,3711386,-1,16000.0,4262096,4262118,579571,22,51,2,True,True,13.198044444444443,-0.689719
4605,3682574,13,1,0.275957,111,3711386,-1,500.0,7092065,7092078,3409491,13,13,2,True,True,0.28370694444444444,-0.275957
4606,3682589,3,4,0.553663,111,3711386,-1,2000.0,5125136,5125139,1442547,3,42,10,True,True,0.20783333333333334,-0.553663
4607,3683826,2914,1,0.556323,111,3711386,-1,500.0,6091532,6094446,2407706,2914,28,10,True,True,56.203775,-0.556323
4608,3685104,2,1,0.925922,111,3711386,-1,500.0,5235336,5235338,1550232,2,43,6,True,True,0.029483333333333334,-0.925922
4609,3688341,561,1,0.154715,111,3711386,-1,500.0,7243764,7244325,3555423,561,5,6,True,True,25.757691666666663,-0.154715
4610,3688365,19295,64,0.037736,111,3711386,-1,32000.0,7223369,7242664,3535004,19295,9,2,True,True,40005.04631111111,-0.03662549049430681
4611,3688398,12603,8,0.355656,111,3711386,-1,4000.0,6916437,6929040,3228039,12603,18,7,True,True,1480.0726,-0.34882837306235526
4612,3688772,56,1,0.138408,111,3711386,-1,500.0,6049332,6049388,2360560,56,35,10,True,True,1.1839333333333333,-0.138408
4613,3688871,53,8,0.367083,111,3711386,-1,4000.0,7102165,7102218,3413294,53,15,8,True,True,15.583177777777777,-0.367083
4614,3688977,11,8,0.582156,111,3711386,-1,4000.0,4717758,4717769,1028781,11,58,11,True,True,1.6710222222222222,-0.582156
4615,3689104,7367,16,0.232994,111,3711386,-1,8000.0,3981784,3989151,292680,7367,71,2,True,True,1341.1825777777776,-0.2318333317100201
4616,3689453,19,1,0.811074,111,3711386,-1,500.0,4321258,4321277,631805,19,60,2,True,True,0.3974430555555556,-0.811074
4617,3690701,14513,16,0.091905,111,3711386,-1,8000.0,7118436,7132949,3427735,14513,12,6,True,True,3217.5365555555554,-0.09030637622310243
4618,3690792,149,32,0.399798,111,3711386,-1,16000.0,7066986,7067135,3376194,149,18,2,True,True,70.60613333333335,-0.399798
4619,3690846,16952,256,0.917882,111,3711386,-1,128000.0,5398305,5415257,1707459,16952,50,12,True,True,79260.54826666666,-0.9109994920382695
4620,3690876,21615,64,0.734266,111,3711386,-1,32000.0,4244096,4265711,553220,21615,68,10,True,True,26880.643111111116,-0.6888497894298967
4621,3690903,30,8,0.723581,111,3711386,-1,4000.0,4521158,4521188,830255,30,63,10,True,True,4.343,-0.723581
4622,3691207,140,16,0.792904,111,3711386,-1,8000.0,4108184,4108324,416977,140,75,6,True,True,54.08977777777778,-0.792904
4623,3691710,20607,32,0.172902,111,3711386,-1,16000.0,7369388,7389995,3677678,20607,1,2,True,True,17073.480222222224,-0.17067532221496157
4624,3691896,6844,35,0.825705,111,3711386,-1,17500.0,6018732,6025576,2326836,6844,41,7,True,True,6226.67325,-0.782028453531178
4625,3692532,17,8,0.689595,111,3711386,-1,4000.0,4585958,4585975,893426,17,65,11,True,True,5.584499999999999,-0.689595
4626,3692654,1207,32,0.576232,111,3711386,-1,16000.0,4286258,4287465,593604,1207,69,7,True,True,574.1564888888889,-0.576232
4627,3692800,10,1,0.907656,111,3711386,-1,500.0,4274258,4274268,581458,10,70,8,True,True,0.1500277777777778,-0.907656
4628,3692903,3,12,0.595231,111,3711386,-1,6000.0,4281858,4281861,588955,3,70,7,True,True,0.5067,-0.595231
4629,3693006,11,21,0.300393,111,3711386,-1,10500.0,7103221,7103232,3410215,11,17,2,True,True,5.308508333333333,-0.300393
4630,3699045,8653,32,0.730789,111,3711386,-1,16000.0,5233136,5241789,1534091,8653,55,10,True,True,4058.674,-0.6997196127474993
4631,3699066,22116,32,0.576284,111,3711386,-1,16000.0,6289262,6311378,2590196,22116,33,1,True,True,32589.78151111111,-0.5751772269549824
4632,3699271,21,1,0.078477,111,3711386,-1,500.0,6913137,6913158,3213866,21,24,8,True,True,0.3287375,-0.078477
4633,3699282,111,18,0.055923,111,3711386,-1,9000.0,7214485,7214596,3515203,111,12,6,True,True,28.066350000000003,-0.055923
4634,3699352,13,4,0.770902,111,3711386,-1,2000.0,4542758,4542771,843406,13,71,0,True,True,0.7347166666666667,-0.770902
4635,3699478,11,4,0.34793,111,3711386,-1,2000.0,4454158,4454169,754680,11,73,11,True,True,0.4250277777777778,-0.34793
4636,3699527,13020,12,0.817142,111,3711386,-1,6000.0,3742786,3755806,43259,13020,102,0,True,True,1776.4367666666665,-0.7686191670620425
4637,3700163,6,11,0.416522,111,3711386,-1,5500.0,5760305,5760311,2060142,6,53,7,True,True,1.3372333333333333,-0.416522
4638,3701086,44,32,0.867831,111,3711386,-1,16000.0,4209496,4209540,508410,44,85,6,True,True,21.730133333333335,-0.867831
4639,3701224,130,1,0.869787,111,3711386,-1,500.0,4032184,4032314,330960,130,93,11,True,True,1.6786249999999998,-0.869787
4640,3701346,187,32,0.226718,111,3711386,-1,16000.0,7295461,7295648,3594115,187,6,1,True,True,93.39195555555557,-0.226718
4641,3712058,24,36,0.652779,112,3713586,-1,18000.0,3988984,3989008,276926,24,95,3,True,True,9.4944,-0.652779
4642,3712151,13959,64,0.602302,112,3713586,-1,32000.0,4279658,4293617,567507,13959,80,8,True,True,13572.539911111111,-0.5911619034954305
4643,3714914,7407,9,0.011434,114,3715786,-1,4500.0,7107780,7115187,3392866,7407,18,1,True,True,1116.727275,-0.011071603934482433
4644,3715223,18,16,0.777419,114,3715786,-1,8000.0,3742786,3742804,27563,18,110,8,True,True,3.6668000000000003,-0.777419
4645,3715324,18,16,0.382487,114,3715786,-1,8000.0,4035784,4035802,320460,18,96,2,True,True,3.7588,-0.382487
4646,3715542,5,8,0.304783,114,3715786,-1,4000.0,6813009,6813014,3097467,5,31,7,True,True,0.6277777777777778,-0.304783
4647,3720730,18,16,0.041182,125,3737386,-1,8000.0,7002837,7002855,3282107,18,26,12,True,True,4.114800000000001,-0.041182
4648,3720939,56,4,0.53993,125,3737386,-1,2000.0,7019037,7019093,3298098,56,25,8,True,True,4.068088888888888,-0.53993
4649,3721655,12,1,0.14958,125,3737386,-1,500.0,6462062,6462074,2740407,12,39,12,True,True,0.3418166666666667,-0.14958
4650,3723113,108,2,0.502402,125,3737386,-1,1000.0,5247105,5247213,1523992,108,64,2,True,True,3.7670999999999997,-0.502402
4651,3723509,38,1,0.220797,125,3737386,-1,500.0,7286964,7287002,3563455,38,7,11,True,True,0.60325,-0.220797
4652,3723658,819,1,0.05052,125,3737386,-1,500.0,7294664,7295483,3571006,819,7,6,True,True,12.782087500000001,-0.05052
4653,3723949,12732,20,0.731579,125,3737386,-1,10000.0,5211536,5224268,1487587,12732,69,12,True,True,4397.569,-0.7232238331915086
4654,3724018,394,4,0.392883,125,3737386,-1,2000.0,5510705,5511099,1786687,394,63,7,True,True,26.719766666666665,-0.392883
4655,3733006,4,16,0.445616,125,3737386,-1,8000.0,5668405,5668409,1935399,4,62,8,True,True,1.1381333333333332,-0.445616
4656,3733414,122,4,0.595132,125,3737386,-1,2000.0,3750404,3750526,16990,122,118,7,True,True,5.869555555555555,-0.595132
4657,3736777,71,3,0.504729,125,3737386,-1,1500.0,4265778,4265849,529001,71,93,2,True,True,3.8283791666666662,-0.504729
4658,3736867,291,2,0.222086,125,3737386,-1,1000.0,5912605,5912896,2175738,291,57,0,True,True,13.39165833333333,-0.222086
4659,3737473,40,1,0.289783,138,3742786,-1,500.0,7216685,7216725,3479212,40,14,6,True,True,0.5618888888888889,-0.289783
4660,3737586,14,4,0.394322,138,3742786,-1,2000.0,5290305,5290319,1552719,14,70,11,True,True,0.8450555555555556,-0.394322
4661,3737606,16503,3,0.132189,138,3742786,-1,1500.0,7170185,7186688,3432579,16503,17,6,True,True,2189.860670833333,-0.12953245790957668
4662,3737796,274,12,0.082545,138,3742786,-1,6000.0,7169085,7169359,3431289,274,18,2,True,True,150.62236666666666,-0.082545
4663,3740770,18193,1,0.571441,138,3742786,-1,500.0,4409858,4428051,669088,18193,92,7,True,True,277.18430000000006,-0.5467858319291204
4664,3740870,2,4,0.049311,138,3742786,-1,2000.0,6914237,6914239,3173367,2,34,6,True,True,0.12523333333333334,-0.049311
4665,3740946,4650,1,0.399191,138,3742786,-1,500.0,6796573,6801223,3055627,4650,42,1,True,True,86.804025,-0.37633103364742776
4666,3741105,22,1,0.085079,138,3742786,-1,500.0,7168536,7168558,3427431,22,19,6,True,True,1.0078138888888888,-0.085079
4667,3741132,20,4,0.501823,138,3742786,-1,2000.0,4141396,4141416,400264,20,109,7,True,True,2.3595555555555556,-0.501823
4668,3741765,21010,1,0.773825,138,3742786,-1,500.0,4542758,4563768,800993,21010,93,10,True,True,420.7239916666666,-0.7516753217087082
4669,3741794,1379,32,0.130375,138,3742786,-1,16000.0,7296561,7297940,3554767,1379,6,6,True,True,696.5308,-0.12912198815566836
4670,3741818,8052,16,0.134871,138,3742786,-1,8000.0,7217569,7225621,3475751,8052,15,2,True,True,1778.4005555555557,-0.13123652441752579
4671,3742130,11773,256,0.559296,138,3742786,-1,128000.0,7024437,7036210,3282307,11773,33,8,True,True,46194.88995555555,-0.5489552204955368
4672,3742226,27737,2,0.487861,138,3742786,-1,1000.0,5246136,5273873,1503910,27737,80,9,True,True,917.4005416666666,-0.4863312553814252
4673,3744910,24,1,0.652248,145,3748204,-1,500.0,4109896,4109920,364986,24,117,6,True,True,0.5795333333333335,-0.652248
4674,3745166,37,4,0.196099,145,3748204,-1,2000.0,6874709,6874746,3129543,37,42,8,True,True,2.818783333333333,-0.196099
4675,3745225,5,16,0.615997,145,3748204,-1,8000.0,6656462,6656467,2911237,5,50,10,True,True,2.6766666666666667,-0.615997
4676,3745556,5180,2,0.735668,145,3748204,-1,1000.0,3904904,3910084,159348,5180,133,8,True,True,153.30190000000002,-0.6387846009823305
4677,3745892,345,7,0.246246,145,3748204,-1,3500.0,4220296,4220641,474404,345,115,9,True,True,63.95054166666667,-0.24624599999999996
4678,3745926,7556,18,0.071644,145,3748204,-1,9000.0,7095665,7103221,3349739,7556,30,2,True,True,5093.14965,-0.07136697940605126
4679,3746126,1346,1,0.776772,145,3748204,-1,500.0,4136996,4138342,390870,1346,119,7,True,True,37.47862222222222,-0.776772
4680,3746157,12869,5,0.323412,145,3748204,-1,2500.0,5234236,5247105,1488079,12869,85,6,True,True,997.2786458333335,-0.3157930764554386
4681,3746241,9785,64,0.924138,145,3748204,-1,32000.0,3977084,3986869,230843,9785,133,7,True,True,7022.370666666667,-0.8050071530996661
4682,3746249,7103,1,0.089595,145,3748204,-1,500.0,7076565,7083668,3330316,7103,32,6,True,True,143.30149722222222,-0.08654096035209653
4683,3755003,82,3,0.671748,245,3836804,-1,1500.0,4265696,4265778,510693,82,113,2,True,True,4.421508333333333,-0.671748
4684,3755163,75,16,0.423541,245,3836804,-1,8000.0,6069932,6070007,2314769,75,61,8,True,True,22.831666666666667,-0.423541
4685,3755216,149,15,0.348308,245,3836804,-1,7500.0,5914805,5914954,2159589,149,71,7,True,True,47.974895833333335,-0.348308
4686,3755303,664,1,0.320738,245,3836804,-1,500.0,6822809,6823473,3067506,664,45,7,True,True,8.037166666666668,-0.320738
4687,3755563,12,7,0.593877,245,3836804,-1,3500.0,4268858,4268870,513295,12,115,7,True,True,1.3507666666666667,-0.593877
4688,3755616,5197,2,0.024207,245,3836804,-1,1000.0,7290264,7295461,3534648,5197,9,7,True,True,166.70364722222223,-0.024155569710269133
4689,3755685,162,1,0.304819,245,3836804,-1,500.0,6022332,6022494,2266647,162,69,2,True,True,4.293,-0.304819
4690,3755779,25,4,0.987652,245,3836804,-1,2000.0,4946936,4946961,1191157,25,96,10,True,True,1.743472222222222,-0.987652
4691,3755886,133,1,0.616221,245,3836804,-1,500.0,3974884,3975017,218998,133,143,10,True,True,2.0326833333333334,-0.616221
4692,3756006,65,1,0.990159,245,3836804,-1,500.0,3909304,3909369,153298,65,147,7,True,True,0.9088263888888888,-0.990159
4693,3756031,311,16,0.44221,245,3836804,-1,8000.0,6705162,6705473,2949131,311,54,6,True,True,122.15388888888889,-0.44221
4694,3756055,4751,128,0.145818,245,3836804,-1,64000.0,7058635,7063386,3302580,4751,35,3,True,True,8071.604444444444,-0.13425956152408308
4695,3756222,13626,35,0.044878,245,3836804,-1,17500.0,7347361,7360987,3591139,13626,6,11,True,True,19510.335444444445,-0.04423810169005714
4696,3756261,33,32,0.818172,245,3836804,-1,16000.0,5441505,5441538,1685244,33,89,11,True,True,18.892133333333334,-0.818172
4697,3756506,69,2,0.199685,245,3836804,-1,1000.0,7304161,7304230,3547655,69,7,7,True,True,2.1206,-0.199685
4698,3756759,40,8,0.373821,245,3836804,-1,4000.0,7213385,7213425,3456626,40,22,11,True,True,4.3933333333333335,-0.373821
4699,3756843,17162,1,0.757734,245,3836804,-1,500.0,4249496,4266658,492653,17162,130,8,True,True,307.98335000000003,-0.7447128634668183
4700,3756862,6542,32,0.852764,245,3836804,-1,16000.0,5311905,5318447,1555043,6542,93,10,True,True,4141.583111111111,-0.8396765407829664
4701,3756895,3,1,0.112372,245,3836804,-1,500.0,6868209,6868212,3111314,3,50,11,True,True,0.05250416666666667,-0.112372
4702,3756915,8,32,0.054538,245,3836804,-1,16000.0,7288064,7288072,3531149,8,12,6,True,True,4.064,-0.054538
4703,3757054,179,8,0.948941,245,3836804,-1,4000.0,4407658,4407837,650604,179,121,12,True,True,19.534866666666666,-0.948941
4704,3757085,210,1,0.92673,245,3836804,-1,500.0,4139196,4139406,382111,210,140,7,True,True,5.847333333333333,-0.92673
4705,3762278,398,1,0.868752,245,3836804,-1,500.0,3894104,3894502,131826,398,162,8,True,True,5.628383333333333,-0.868752
4706,3762315,1072,16,0.820134,245,3836804,-1,8000.0,4165196,4166268,402881,1072,139,7,True,True,333.16400000000004,-0.5251076277604562
4707,3762596,873,2,0.013733,245,3836804,-1,1000.0,7057337,7058210,3294741,873,40,7,True,True,25.125425,-0.013733
4708,3762738,3561,13,0.693795,245,3836804,-1,6500.0,6056932,6060493,2294194,3561,74,8,True,True,1062.865898611111,-0.6922818364536865
4709,3763357,38,8,0.111278,245,3836804,-1,4000.0,7048237,7048275,3284880,38,41,7,True,True,4.113711111111112,-0.111278
4710,3763829,30,16,0.450062,245,3836804,-1,8000.0,6289232,6289262,2525403,30,68,10,True,True,21.932000000000002,-0.450062
4711,3763901,3,1,0.022748,245,3836804,-1,500.0,4498458,4498461,734557,3,123,11,True,True,0.0698625,-0.022748
4712,3764374,127,1,0.20901,245,3836804,-1,500.0,4968536,4968663,1204162,127,109,10,True,True,2.123369444444444,-0.20901
4713,3764568,25,1,0.538005,245,3836804,-1,500.0,7070065,7070090,3305497,25,38,2,True,True,0.3702083333333333,-0.538005
4714,3765006,404,1,0.203801,245,3836804,-1,500.0,7075465,7075869,3310459,404,38,8,True,True,6.0701,-0.203801
4715,3765081,180,8,0.523266,245,3836804,-1,4000.0,4284058,4284238,518977,180,133,7,True,True,21.406000000000002,-0.523266
4716,3765135,8,64,0.258658,245,3836804,-1,32000.0,6050432,6050440,2285297,8,80,6,True,True,10.824533333333333,-0.258658
4717,3765185,10,13,0.483026,245,3836804,-1,6500.0,6267632,6267642,2502447,10,71,12,True,True,2.345416666666667,-0.483026
4718,3766817,15506,16,0.729924,245,3836804,-1,8000.0,6016532,6032038,2249715,15506,86,7,True,True,6632.7880444444445,-0.708516446384126
4719,3767495,22743,32,0.141347,245,3836804,-1,16000.0,6704062,6726805,2936567,22743,65,7,True,True,14416.196888888891,-0.13915404567633816
4720,3767621,8118,85,0.698755,245,3836804,-1,42500.0,5619805,5627923,1852184,8118,99,12,True,True,21120.14892361111,-0.6137213895649001
4721,3767629,340,11,0.018389,245,3836804,-1,5500.0,7096765,7097105,3329136,340,35,6,True,True,149.14288888888888,-0.018389
4722,3767677,4,1,0.583005,245,3836804,-1,500.0,5290305,5290309,1522628,4,108,0,True,True,0.060361111111111115,-0.583005
4723,3767719,4,16,0.663528,245,3836804,-1,8000.0,4672358,4672362,904639,4,129,12,True,True,1.3357333333333334,-0.663528
4724,3767753,19427,32,0.043482,245,3836804,-1,16000.0,7301961,7321388,3534208,19427,8,8,True,True,14578.027377777778,-0.04081770338082379
4725,3770600,21,4,0.17032,245,3836804,-1,2000.0,5246136,5246157,1475536,21,112,0,True,True,1.4649833333333333,-0.17032
4726,3770711,12818,8,0.284014,245,3836804,-1,4000.0,5711605,5724423,1940894,12818,100,11,True,True,2451.7411888888887,-0.2796145368033072
4727,3770842,8241,4,0.789188,245,3836804,-1,2000.0,3978184,3986425,207342,8241,175,6,True,True,354.2364777777778,-0.7548038425138985
4728,3771034,6679,3,0.617965,245,3836804,-1,1500.0,7063386,7070065,3292352,6679,43,6,True,True,292.77425000000005,-0.6171499745454059
4729,3771114,4923,32,0.053085,245,3836804,-1,16000.0,7292464,7297387,3521350,4923,12,7,True,True,2485.0702666666666,-0.05173148991055218
4730,3773534,8,2,0.654758,245,3836804,-1,1000.0,5641405,5641413,1867871,8,104,10,True,True,0.3658,-0.654758
4731,3773691,23,2,0.008334,245,3836804,-1,1000.0,7293564,7293587,3519873,23,12,6,True,True,0.7488416666666666,-0.008334
4732,3775251,3,3,0.388645,245,3836804,-1,1500.0,6051532,6051535,2276281,3,87,6,True,True,0.190275,-0.388645
4733,3775256,74203,8,0.27131,245,3836804,-1,4000.0,3985384,4059587,210128,74203,179,2,True,True,8633.887833333332,-0.2685966118423436
4734,3775461,22,8,0.852083,245,3836804,-1,4000.0,4310058,4310080,534597,22,147,7,True,True,3.3887333333333336,-0.852083
4735,3775465,484,16,0.6601,245,3836804,-1,8000.0,3899504,3899988,124039,484,191,8,True,True,146.50142222222223,-0.6601
4736,3775529,23,11,0.864282,245,3836804,-1,5500.0,5755905,5755928,1980376,23,104,6,True,True,4.640793055555556,-0.864282
4737,3775548,21509,8,0.019078,245,3836804,-1,4000.0,7111380,7132889,3335832,21509,34,2,True,True,2475.842144444445,-0.01865489418944348
4738,3775801,117,16,0.86741,245,3836804,-1,8000.0,5754805,5754922,1979004,117,106,11,True,True,34.3382,-0.86741
4739,3775807,8667,128,0.649411,245,3836804,-1,64000.0,7055137,7063804,3279330,8667,49,2,True,True,15335.580977777778,-0.6153519358333533
4740,3775814,295,1,0.231169,245,3836804,-1,500.0,7088465,7088760,3312651,295,42,6,True,True,4.996972222222222,-0.231169
4741,3775877,598,8,0.380701,245,3836804,-1,4000.0,5486905,5487503,1711028,598,116,11,True,True,92.7830222222222,-0.380701
4742,3775944,10,16,0.976612,245,3836804,-1,8000.0,4042284,4042294,266340,10,183,8,True,True,2.2002222222222225,-0.976612
4743,3780875,22841,128,0.099604,245,3836804,-1,64000.0,7087365,7110206,3306490,22841,43,9,True,True,74790.23591111111,-0.09813231804007176
4744,3780907,14592,1,0.315456,245,3836804,-1,500.0,6886137,6900729,3105230,14592,62,7,True,True,235.46214166666664,-0.30378318420698175
4745,3780940,7,32,0.866773,245,3836804,-1,16000.0,5060336,5060343,1279396,7,134,8,True,True,2.5203111111111114,-0.866773
4746,3780982,152,8,0.531561,245,3836804,-1,4000.0,6820609,6820761,3039627,152,67,8,True,True,17.3432,-0.531561
4747,3781726,10507,128,0.186417,245,3836804,-1,64000.0,7219769,7230276,3438043,10507,22,7,True,True,20383.433777777776,-0.16740407589493578
4748,3781779,44,1,0.500651,245,3836804,-1,500.0,6701862,6701906,2920083,44,78,7,True,True,1.0842944444444444,-0.500651
4749,3782028,63,7,0.457986,245,3836804,-1,3500.0,6803209,6803272,3021181,63,73,8,True,True,6.754037500000001,-0.457986
4750,3782175,100,16,0.92635,245,3836804,-1,8000.0,4036884,4036984,254709,100,191,6,True,True,20.88222222222222,-0.92635
4751,3782239,4,45,0.021488,245,3836804,-1,22500.0,7119536,7119540,3337297,4,32,6,True,True,2.74325,-0.021488
4752,3782343,24,4,0.247392,245,3836804,-1,2000.0,6797809,6797833,3015466,24,75,1,True,True,1.858,-0.247392
4753,3782371,14628,1,0.529415,245,3836804,-1,500.0,6869309,6883937,3086938,14628,67,6,True,True,274.6040694444444,-0.5263067875083737
4754,3782770,17,1,0.33357,245,3836804,-1,500.0,6014332,6014349,2231562,17,106,11,True,True,0.4207972222222222,-0.33357
4755,3782813,3755,4,0.3934,245,3836804,-1,2000.0,5663005,5666760,1880192,3755,121,10,True,True,281.8927777777778,-0.39215784903446704
4756,3782901,7,4,0.157005,245,3836804,-1,2000.0,6883937,6883944,3101036,7,65,2,True,True,0.46246666666666664,-0.157005
4757,3784680,5380,32,0.34678,245,3836804,-1,16000.0,6699662,6705042,2914982,5380,84,11,True,True,4236.981511111111,-0.3467646645561029
4758,3784760,79,2,0.351913,245,3836804,-1,1000.0,4107084,4107163,322324,79,195,10,True,True,3.1913805555555554,-0.351913
4759,3786043,6140,12,0.625231,245,3836804,-1,6000.0,4317658,4323798,531615,6140,167,8,True,True,1541.3747,-0.6250170482408635
4760,3786103,4836,2,0.236205,245,3836804,-1,1000.0,6792973,6797809,3006870,4836,79,6,True,True,191.49033055555554,-0.23545715182733482
4761,3786136,12503,32,0.978244,245,3836804,-1,16000.0,4208396,4220899,422260,12503,187,11,True,True,9802.284355555556,-0.9154782540512569
4762,3786949,7853,25,0.501251,245,3836804,-1,12500.0,6548462,6556315,2761513,7853,88,12,True,True,7733.3090625,-0.5009729177700362
4763,3787888,41,1,0.811893,245,3836804,-1,500.0,4499558,4499599,711670,41,164,6,True,True,0.9547875,-0.811893
4764,3787929,5991,4,0.625792,245,3836804,-1,2000.0,7051537,7057528,3263608,5991,54,7,True,True,346.5404722222222,-0.6174038698028246
4765,3788206,36,16,0.878677,245,3836804,-1,8000.0,4455258,4455294,667052,36,167,6,True,True,5.564,-0.878677
4766,3793189,15235,1,0.890402,245,3836804,-1,500.0,4113196,4128431,320007,15235,197,6,True,True,356.26521249999996,-0.8426642909501492
4767,3793296,24,32,0.814859,245,3836804,-1,16000.0,5758105,5758129,1964809,24,122,7,True,True,14.037333333333333,-0.814859
4768,3793755,43,8,0.029466,245,3836804,-1,4000.0,7358961,7359004,3565206,43,3,7,True,True,14.212455555555557,-0.029466
4769,3794963,722,4,0.554939,245,3836804,-1,2000.0,6878309,6879031,3083346,722,69,2,True,True,53.2154111111111,-0.554939
4770,3795019,219,1,0.280194,245,3836804,-1,500.0,5532305,5532524,1737286,219,133,10,True,True,3.8440583333333334,-0.280194
4771,3795036,1550,1,0.151708,245,3836804,-1,500.0,7124236,7125786,3329200,1550,33,6,True,True,20.70601388888889,-0.14866730827666672
4772,3795334,47,8,0.897175,245,3836804,-1,4000.0,4162996,4163043,367662,47,198,10,True,True,11.4069,-0.897175
4773,3795560,19937,23,0.656932,245,3836804,-1,11500.0,4312258,4332195,516698,19937,178,7,True,True,9305.626254166666,-0.6567193927306096
4774,3795585,72,64,0.087795,245,3836804,-1,32000.0,5054936,5055008,1259351,72,154,12,True,True,55.8464,-0.087795
4775,3795959,6636,4,0.382207,245,3836804,-1,2000.0,6825009,6831645,3029050,6636,74,7,True,True,354.2365,-0.3668964681887875
4776,3796892,6712,4,0.960606,245,3836804,-1,2000.0,3888704,3895416,91812,6712,233,7,True,True,368.52226666666667,-0.8227014410259494
4777,3797073,6565,5,0.612448,245,3836804,-1,2500.0,4739358,4745923,942285,6565,165,0,True,True,820.9027708333333,-0.609144797522781
4778,3797479,5880,31,0.625525,245,3836804,-1,15500.0,4266658,4272538,469179,5880,190,2,True,True,2810.485316666666,-0.6195668651492362
4779,3797575,40203,16,0.227428,245,3836804,-1,8000.0,7105421,7145624,3307846,40203,40,6,True,True,9983.705733333332,-0.21734445136180996
4780,3798522,3,3,0.240361,245,3836804,-1,1500.0,7123136,7123139,3324614,3,34,2,True,True,0.1226875,-0.240361
4781,3798552,43,1,0.152749,245,3836804,-1,500.0,4407658,4407701,609106,43,180,0,True,True,0.5865916666666667,-0.152749
4782,3799182,12567,128,0.970537,245,3836804,-1,64000.0,4410958,4423525,611776,12567,179,6,True,True,24029.580088888888,-0.958187170657211
4783,3799324,9878,1,0.909735,245,3836804,-1,500.0,4739358,4749236,940034,9878,168,10,True,True,245.81258055555557,-0.9079936802160203
4784,3799843,8419,64,0.329285,245,3836804,-1,32000.0,7049337,7057756,3249494,8419,59,6,True,True,7588.746044444445,-0.32244578021658993
3774,2907987,14250,1,0.700882,1,2907987,-1,500.0,2994387,3008637,86400,14250,0,12,True,True,126.15803749999999,-0.6766960383856557
3775,2908151,9396,2,0.072589,43,2994387,-1,1000.0,10702280,10711676,7794129,9396,0,12,True,True,367.24985555555554,-0.06849525837905686
3776,2911601,7,16,0.928048,43,2994387,-1,8000.0,3218916,3218923,307315,7,1,11,True,True,2.2991111111111113,-0.928048
3777,2911671,19274,1,0.106136,43,2994387,-1,500.0,9023923,9043197,6112252,19274,1,8,True,True,183.93252083333334,-0.10612008335955807
3778,2911700,18,20,0.786892,43,2994387,-1,10000.0,3512691,3512709,600991,18,2,11,True,True,11.387,-0.786892
3779,2911760,8450,1,0.301351,43,2994387,-1,500.0,7030905,7039355,4119145,8450,2,12,True,True,32.91919444444444,-0.29729604283936384
3780,2914905,17422,33,0.086505,43,2994387,-1,16500.0,11790295,11807717,8875390,17422,0,12,True,True,10231.003841666665,-0.0859405591367638
3781,2915106,14,1,0.765274,43,2994387,-1,500.0,4557270,4557284,1642164,14,4,10,True,True,0.48288333333333333,-0.765274
3782,2915277,18716,128,0.437676,43,2994387,-1,64000.0,12265495,12284211,9350218,18716,0,12,True,True,36529.635022222225,-0.42736427821194606
3783,2915536,5,8,0.395113,43,2994387,-1,4000.0,3955270,3955275,1039734,5,6,10,True,True,0.33522222222222225,-0.395113
3784,2916128,12127,2,0.660723,43,2994387,-1,1000.0,3374591,3386718,458463,12127,8,11,True,True,331.28127499999994,-0.6507886787256312
3785,2916370,2,16,0.473988,43,2994387,-1,8000.0,3175716,3175718,259346,2,10,2,True,True,0.30724444444444443,-0.473988
3786,2916683,5,1,0.533468,43,2994387,-1,500.0,6036855,6036860,3120172,5,5,0,True,True,0.07399305555555556,-0.533468
3787,2921047,3,1,0.136381,43,2994387,-1,500.0,9781512,9781515,6860465,3,3,11,True,True,0.04734583333333334,-0.136381
3788,2921059,7959,32,0.390993,43,2994387,-1,16000.0,10704480,10712439,7783421,7959,2,7,True,True,5197.4172,-0.3764147722284261
3789,2921234,330,8,0.797485,43,2994387,-1,4000.0,6040455,6040785,3119221,330,7,3,True,True,31.801,-0.797485
3790,2921365,13007,16,0.545724,43,2994387,-1,8000.0,7794105,7807112,4872740,13007,6,1,True,True,1370.4636222222223,-0.5440935947903752
3791,2921446,78,16,0.960134,43,2994387,-1,8000.0,3425191,3425269,503745,78,13,6,True,True,12.9948,-0.960134
3792,2922343,10,16,0.144076,43,2994387,-1,8000.0,3756458,3756468,834115,10,12,2,True,True,0.52,-0.144076
3793,2922366,529,2,0.677289,43,2994387,-1,1000.0,2996587,2997116,74221,529,18,7,True,True,9.762988888888888,-0.677289
3794,2928592,5647,2,0.914169,43,2994387,-1,1000.0,3327791,3333438,399199,5647,16,7,True,True,65.236975,-0.9086793878375227
3795,2944405,473,1,0.795017,43,2994387,-1,500.0,3172116,3172589,227711,473,19,7,True,True,5.044019444444444,-0.795017
3796,2961339,17,8,0.729325,43,2994387,-1,4000.0,3545958,3545975,584619,17,13,8,True,True,1.5407666666666666,-0.729325
3797,2961560,20,32,0.373131,43,2994387,-1,16000.0,7806705,7806725,4845145,20,6,8,True,True,3.385777777777778,-0.373131
3798,2961635,16139,4,0.949465,43,2994387,-1,2000.0,3426291,3442430,464656,16139,16,6,True,True,1126.6970166666667,-0.8578713350738391
3799,2962058,6,2,0.553524,43,2994387,-1,1000.0,4949221,4949227,1987163,6,11,12,True,True,0.14513333333333334,-0.553524
3800,2962145,51,11,0.55507,43,2994387,-1,5500.0,7574505,7574556,4612360,51,8,12,True,True,5.7292125,-0.55507
3801,2962163,751,16,0.123235,43,2994387,-1,8000.0,12351895,12352646,9389732,751,0,12,True,True,346.12755555555555,-0.123235
3802,2963700,1749,1,0.00503,43,2994387,-1,500.0,4177770,4179519,1214070,1749,15,11,True,True,8.230016666666668,-0.00503
3803,2964106,1,8,0.596655,43,2994387,-1,4000.0,2997116,2997117,33010,1,27,1,True,True,0.07382222222222222,-0.596655
3804,2964339,17,3,0.537152,43,2994387,-1,1500.0,3401691,3401708,437352,17,22,7,True,True,0.3236375,-0.537152
3805,2964729,13132,56,0.946979,43,2994387,-1,28000.0,3169916,3183048,205187,13132,28,12,True,True,7555.361333333332,-0.9153973250704195
3806,2964774,9175,20,0.304691,43,2994387,-1,10000.0,10790880,10800055,7826106,9175,3,12,True,True,2873.972361111111,-0.30448478861904754
3807,2964873,338,32,0.748297,43,2994387,-1,16000.0,3716058,3716396,751185,338,19,7,True,True,54.93626666666666,-0.748297
3808,2965028,10775,16,0.903546,43,2994387,-1,8000.0,3253516,3264291,288488,10775,27,9,True,True,2550.6409555555556,-0.8741062495042694
3809,2966203,5734,7,0.343852,43,2994387,-1,3500.0,5667455,5673189,2701252,5734,14,12,True,True,985.4015111111112,-0.3248017402298864
3810,2966671,7,4,0.412654,43,2994387,-1,2000.0,6353655,6353662,3386984,7,12,12,True,True,0.39250555555555555,-0.412654
3811,2969763,1412,32,0.645932,43,2994387,-1,16000.0,3377891,3379303,408128,1412,27,6,True,True,517.3568,-0.645932
3812,2970284,1812,19,0.512553,43,2994387,-1,9500.0,3910258,3912070,939974,1812,20,9,True,True,468.36424999999997,-0.512553
3813,2970596,7173,2,0.160954,43,2994387,-1,1000.0,3083516,3090689,112920,7173,36,12,True,True,339.9678583333333,-0.1561902560042112
3814,2971170,3,32,0.220788,43,2994387,-1,16000.0,4733221,4733224,1762051,3,17,10,True,True,1.2598666666666667,-0.220788
3815,2971241,3,1,0.834748,43,2994387,-1,500.0,3403891,3403894,432650,3,28,7,True,True,0.019908333333333333,-0.834748
3816,2971336,7275,2,0.194326,43,2994387,-1,1000.0,11140080,11147355,8168744,7275,3,0,True,True,270.8942083333333,-0.19198770185688482
3817,2972083,34,46,0.181358,43,2994387,-1,23000.0,11226495,11226529,8254412,34,3,12,True,True,18.516022222222222,-0.181358
3818,3033384,13,4,0.79966,84,3083516,-1,2000.0,3540558,3540571,507174,13,27,2,True,True,0.7293722222222222,-0.79966
3819,3036042,28,16,0.852251,84,3083516,-1,8000.0,5105827,5105855,2069785,28,18,12,True,True,8.0808,-0.852251
3820,3036207,8369,2,0.851388,84,3083516,-1,1000.0,3399491,3407860,363284,8369,34,10,True,True,121.03789166666667,-0.8014073153988944
3821,3038912,116,8,0.93237,84,3083516,-1,4000.0,3522491,3522607,483579,116,29,7,True,True,20.99471111111111,-0.93237
3822,3038993,36,4,0.994313,84,3083516,-1,2000.0,3933670,3933706,894677,36,24,10,True,True,1.7174,-0.994313
3823,3040549,21,16,0.461265,84,3083516,-1,8000.0,9585523,9585544,6544974,21,9,12,True,True,4.186466666666667,-0.461265
3824,3041375,20,8,0.549665,84,3083516,-1,4000.0,5365055,5365075,2323680,20,19,12,True,True,1.3606666666666667,-0.549665
3825,3041510,8394,32,0.290653,84,3083516,-1,16000.0,12395095,12403489,9353585,8394,0,11,True,True,4543.207244444444,-0.28572603522427614
3826,3042985,748,1,0.067363,84,3083516,-1,500.0,7117305,7118053,4074320,748,15,11,True,True,4.153477777777778,-0.067363
3827,3044963,18059,128,0.098202,84,3083516,-1,64000.0,12922495,12940554,9877532,18059,0,12,True,True,46543.74168888889,-0.09712082711649939
3828,3045113,16,128,0.725589,84,3083516,-1,64000.0,7797705,7797721,4752592,16,14,2,True,True,13.3376,-0.725589
3829,3045224,60,4,0.48719,84,3083516,-1,2000.0,9283123,9283183,6237899,60,12,12,True,True,2.4736666666666665,-0.48719
3830,3045578,8846,9,0.330851,84,3083516,-1,4500.0,7401705,7410551,4356127,8846,18,12,True,True,1089.5533,-0.3300225007927622
3831,3045763,297,1,0.128215,84,3083516,-1,500.0,11531095,11531392,8485332,297,5,7,True,True,3.6642375,-0.128215
3832,3046090,5,1,0.655473,84,3083516,-1,500.0,5408255,5408260,2362165,5,26,11,True,True,0.040375,-0.655473
3833,3046231,21291,1,0.100045,84,3083516,-1,500.0,12179095,12200386,9132864,21291,4,11,True,True,231.457225,-0.10004073901850695
3834,3046353,13320,1,0.619516,84,3083516,-1,500.0,5950455,5963775,2904102,13320,26,11,True,True,116.54025,-0.5227990551701666
3835,3046421,243,16,0.900119,84,3083516,-1,8000.0,4559321,4559564,1512900,243,33,2,True,True,125.37180000000001,-0.900119
3836,3046471,28,8,0.317786,84,3083516,-1,4000.0,5192255,5192283,2145784,28,30,12,True,True,2.111822222222222,-0.317786
3837,3046776,105,2,0.450646,84,3083516,-1,1000.0,3762258,3762363,715482,105,40,7,True,True,0.6615,-0.450646
3838,3051388,6907,40,0.616342,84,3083516,-1,20000.0,7138905,7145812,4087517,6907,21,10,True,True,2107.6261666666664,-0.6130971671911951
3839,3076161,6213,28,0.305675,84,3083516,-1,14000.0,7311705,7317918,4235544,6213,21,12,True,True,974.24425,-0.30557894241370764
3840,3076310,9327,256,0.58417,84,3083516,-1,128000.0,8413723,8423050,5337413,9327,16,12,True,True,28506.58808888889,-0.5799910435965074
3841,3076349,116,1,0.565552,84,3083516,-1,500.0,6440055,6440171,3363706,116,26,12,True,True,1.8746888888888888,-0.565552
3842,3076398,1137,16,0.364493,84,3083516,-1,8000.0,10299912,10301049,7223514,1137,12,11,True,True,179.3428,-0.364493
3843,3076422,11420,11,0.316333,84,3083516,-1,5500.0,5581055,5592475,2504633,11420,33,12,True,True,599.409861111111,-0.2625830538176079
3844,3078387,151,1,0.428307,84,3083516,-1,500.0,10794480,10794631,7716093,151,9,1,True,True,2.352244444444444,-0.428307
3845,3078425,648,2,0.004832,84,3083516,-1,1000.0,11312895,11313543,8234470,648,7,12,True,True,16.209,-0.004832
3846,3078695,7,16,0.246175,84,3083516,-1,8000.0,9369523,9369530,6290828,7,17,12,True,True,1.5989555555555557,-0.246175
3847,3078713,5,32,0.221526,84,3083516,-1,16000.0,4819621,4819626,1740908,5,42,11,True,True,2.1879999999999997,-0.221526
3848,3078777,9,1,0.739816,84,3083516,-1,500.0,4289370,4289379,1210593,9,46,1,True,True,0.208325,-0.739816
3849,3078809,68,32,0.436124,84,3083516,-1,16000.0,7074105,7074173,3995296,68,29,11,True,True,12.907911111111112,-0.436124
3850,3078843,30,1,0.84011,84,3083516,-1,500.0,4042770,4042800,963927,30,49,10,True,True,0.1355,-0.84011
3851,3078987,14413,2,0.134306,84,3083516,-1,1000.0,9018523,9032936,5939536,14413,20,12,True,True,166.30167222222224,-0.11113460939407002
3852,3079000,49,1,0.732973,84,3083516,-1,500.0,5726855,5726904,2647855,49,37,11,True,True,0.37484999999999996,-0.732973
3853,3079028,18,2,0.877886,84,3083516,-1,1000.0,3420491,3420509,341463,18,64,1,True,True,0.36995,-0.877886
3854,3079202,45,8,0.462848,84,3083516,-1,4000.0,5278655,5278700,2199453,45,42,12,True,True,6.752,-0.462848
3855,3079221,11740,130,0.358742,84,3083516,-1,65000.0,11528895,11540635,8449674,11740,7,12,True,True,18771.540486111113,-0.35551644570260704
3856,3079456,9793,128,0.305472,84,3083516,-1,64000.0,6771705,6781498,3692249,9793,33,10,True,True,6125.0924444444445,-0.3054301130738338
3857,3079657,6,2,0.551672,84,3083516,-1,1000.0,4776421,4776427,1696764,6,49,11,True,True,0.08626666666666667,-0.551672
3858,3079762,52,32,0.17577,84,3083516,-1,16000.0,11053680,11053732,7973918,52,11,12,True,True,19.480355555555555,-0.17577
3859,3079785,16,1,0.606628,84,3083516,-1,500.0,3409291,3409307,329506,16,70,8,True,True,0.09657777777777778,-0.606628
3860,3079804,24,32,0.841793,84,3083516,-1,16000.0,6267255,6267279,3187451,24,37,8,True,True,3.389866666666667,-0.841793
3861,3079891,14948,1,0.858714,84,3083516,-1,500.0,3416891,3431839,337000,14948,71,7,True,True,160.57790416666668,-0.7523703175645838
3862,3084371,19121,4,0.140002,165,3169916,-1,2000.0,12135895,12155016,9051524,19121,5,12,True,True,849.7732333333332,-0.134653726279649
3863,3084438,7516,16,0.538618,165,3169916,-1,8000.0,7979523,7987039,4895085,7516,25,1,True,True,1390.5843333333332,-0.5286719496183429
3864,3085236,6,1,0.263235,165,3169916,-1,500.0,9954312,9954318,6869076,6,18,12,True,True,0.06193333333333333,-0.263235
3865,3085260,127,1,0.886336,165,3169916,-1,500.0,3705158,3705285,619898,127,67,6,True,True,1.0052402777777778,-0.886336
3866,3115127,186,2,0.076462,165,3169916,-1,1000.0,9196723,9196909,6081596,186,23,12,True,True,2.3859666666666666,-0.076462
3867,3116699,37,1,0.0754,165,3169916,-1,500.0,6750105,6750142,3633406,37,39,8,True,True,0.2424013888888889,-0.0754
3868,3117087,32,1,0.01863,165,3169916,-1,500.0,5880255,5880287,2763168,32,46,7,True,True,0.4854222222222222,-0.01863
3869,3117246,44,1,0.507178,165,3169916,-1,500.0,3424091,3424135,306845,44,77,2,True,True,0.45815,-0.507178
3870,3117543,16767,8,0.031194,165,3169916,-1,4000.0,7801305,7818072,4683762,16767,29,2,True,True,928.9933666666667,-0.03035543466022917
3871,3117657,16541,16,0.58189,165,3169916,-1,8000.0,7225305,7241846,4107648,16541,35,12,True,True,2008.6270888888891,-0.542485387276193
3872,3117832,9,4,0.405134,165,3169916,-1,2000.0,3309391,3309400,191559,9,89,6,True,True,0.18489999999999998,-0.405134
3873,3117984,70,2,0.590036,165,3169916,-1,1000.0,3911358,3911428,793374,70,68,6,True,True,1.9045833333333335,-0.590036
3874,3119439,12175,8,0.906304,165,3169916,-1,4000.0,3514891,3527066,395452,12175,77,7,True,True,2400.5364444444444,-0.8947776357806095
3875,3119671,13017,256,0.551594,165,3169916,-1,128000.0,10529480,10542497,7409809,13017,17,2,True,True,38455.93955555555,-0.5416826358215843
3876,3121027,22596,101,0.543469,165,3169916,-1,50500.0,8932123,8954719,5811096,22596,27,12,True,True,29359.030834722227,-0.5418580725620292
3877,3121239,24557,16,0.998728,165,3169916,-1,8000.0,3610758,3635315,489519,24557,76,10,True,True,6781.252111111111,-0.90984169842176
3878,3121554,144,1,0.472104,165,3169916,-1,500.0,3520291,3520435,398737,144,80,8,True,True,3.9298,-0.472104
3879,3124725,9503,1,0.775197,165,3169916,-1,500.0,4285770,4295273,1161045,9503,66,10,True,True,197.30955138888888,-0.7654341460698398
3880,3124877,70,16,0.365819,165,3169916,-1,8000.0,6442255,6442325,3317378,70,44,7,True,True,8.065555555555555,-0.365819
3881,3125037,15,1,0.223307,165,3169916,-1,500.0,6944505,6944520,3819468,15,42,12,True,True,0.1066875,-0.223307
3882,3125139,15384,4,0.772145,165,3169916,-1,2000.0,4383370,4398754,1258231,15384,67,12,True,True,1025.0297,-0.7378400317506352
3883,3125742,295,4,0.733227,165,3169916,-1,2000.0,3257116,3257411,131374,295,100,2,True,True,18.755444444444443,-0.733227
3884,3125821,5,32,0.290999,165,3169916,-1,16000.0,10515912,10515917,7390091,5,18,12,True,True,1.9293333333333333,-0.290999
3885,3126121,9,1,0.464701,165,3169916,-1,500.0,11531095,11531104,8404974,9,7,0,True,True,0.1110375,-0.464701
3886,3127312,16009,4,0.510412,165,3169916,-1,2000.0,3612958,3628967,485646,16009,82,7,True,True,1146.5311777777779,-0.49552315738643593
3887,3127546,188,2,0.396785,165,3169916,-1,1000.0,3671658,3671846,544112,188,82,2,True,True,2.180277777777778,-0.396785
3888,3128217,30,4,0.502167,165,3169916,-1,2000.0,6701505,6701535,3573288,30,47,12,True,True,0.4086666666666667,-0.502167
3889,3128359,23189,256,0.662678,165,3169916,-1,128000.0,9715123,9738312,6586764,23189,23,11,True,True,61557.31982222222,-0.6330805088664195
3890,3128551,4,32,0.847982,165,3169916,-1,16000.0,5678255,5678259,2549704,4,58,8,True,True,3.090488888888889,-0.847982
3891,3128842,15010,1,0.80654,165,3169916,-1,500.0,5105855,5120865,1977013,15010,65,1,True,True,202.49781249999998,-0.7598434419160326
3892,3129140,11442,1,0.614036,165,3169916,-1,500.0,4954627,4966069,1825487,11442,67,8,True,True,78.40321805555556,-0.5939482159704906
3893,3129548,51,3,0.165844,165,3169916,-1,1500.0,10040712,10040763,6911164,51,21,12,True,True,2.1371124999999997,-0.165844
3894,3130495,1041,8,0.514137,165,3169916,-1,4000.0,3682458,3683499,551963,1041,88,9,True,True,49.319,-0.47124330713944107
3895,3130726,102,2,0.44622,165,3169916,-1,1000.0,3314791,3314893,184065,102,110,8,True,True,1.6829999999999998,-0.44622
3896,3133786,7064,16,0.179145,165,3169916,-1,8000.0,7790505,7797569,4656719,7064,38,12,True,True,829.3955777777778,-0.17905918565680956
3897,3138149,8107,8,0.948712,165,3169916,-1,4000.0,3760058,3768165,621909,8107,86,2,True,True,201.15696666666665,-0.9478439519177702
3898,3138585,45,4,0.659413,165,3169916,-1,2000.0,3221116,3221161,82531,45,116,7,True,True,3.6950000000000003,-0.659413
3899,3141174,50,1,0.967736,165,3169916,-1,500.0,3668058,3668108,526884,50,92,8,True,True,0.2544444444444444,-0.967736
3900,3141629,7049,1,0.73592,165,3169916,-1,500.0,4294770,4301819,1153141,7049,77,8,True,True,138.20085416666666,-0.6927835984613969
3901,3141729,9477,2,0.483503,165,3169916,-1,1000.0,3469491,3478968,327762,9477,102,11,True,True,340.80942500000003,-0.43393591457335934
3902,3141837,630,1,0.358796,165,3169916,-1,500.0,9671923,9672553,6530086,630,25,12,True,True,5.9753750000000005,-0.358796
3903,3141844,9584,128,0.218819,165,3169916,-1,64000.0,5683655,5693239,2541811,9584,61,8,True,True,28424.531911111113,-0.20952776514872473
3904,3141861,17134,3,0.487642,165,3169916,-1,1500.0,6148455,6165589,3006594,17134,56,12,True,True,286.63868333333335,-0.4845781107615461
3905,3141872,22292,32,0.062861,165,3169916,-1,16000.0,12836095,12858387,9694223,22292,1,1,True,True,16566.202311111112,-0.06128693700021686
3906,3142446,49,71,0.369435,165,3169916,-1,35500.0,9499123,9499172,6356677,49,28,11,True,True,28.252379166666664,-0.369435
3907,3142634,5,1,0.042808,165,3169916,-1,500.0,4690021,4690026,1547387,5,79,6,True,True,0.028659722222222225,-0.042808
3908,3142888,15142,1,0.206774,165,3169916,-1,500.0,5901855,5916997,2758967,15142,62,10,True,True,63.207926388888886,-0.1969068440890664
3909,3143000,19,21,0.907726,165,3169916,-1,10500.0,4264170,4264189,1121170,19,87,12,True,True,2.063716666666667,-0.907726
3910,3143277,10,1,0.361251,165,3169916,-1,500.0,6744705,6744715,3601428,10,53,11,True,True,0.0628888888888889,-0.361251
3911,3143287,19,2,0.469674,165,3169916,-1,1000.0,5494655,5494674,2351368,19,70,12,True,True,0.5318944444444444,-0.469674
3912,3143655,266,16,0.454643,165,3169916,-1,8000.0,7488105,7488371,4344450,266,43,12,True,True,72.94311111111112,-0.454643
3913,3143818,18,119,0.046437,165,3169916,-1,59500.0,7704105,7704123,4560287,18,42,11,True,True,20.554275,-0.046437
3914,3145238,13,8,0.98059,165,3169916,-1,4000.0,3526145,3526158,380907,13,110,1,True,True,2.4480444444444442,-0.98059
3915,3145257,67,1,0.324071,165,3169916,-1,500.0,3712758,3712825,567501,67,102,8,True,True,0.5147833333333333,-0.324071
3916,3145276,11371,64,0.703736,165,3169916,-1,32000.0,3749258,3760629,603982,11371,101,10,True,True,2250.646133333333,-0.7003599686116808
3917,3145286,124,6,0.521373,165,3169916,-1,3000.0,4688921,4689045,1543635,124,85,12,True,True,4.264566666666667,-0.521373
3918,3145601,23651,128,0.829647,165,3169916,-1,64000.0,4535670,4559321,1390069,23651,88,10,True,True,108541.62613333332,-0.8092694385619477
3919,3145641,4022,1,0.834872,165,3169916,-1,500.0,4862821,4866843,1717180,4022,81,11,True,True,31.16793611111111,-0.8341554138543428
3920,3145833,13,32,0.263316,165,3169916,-1,16000.0,12486895,12486908,9341062,13,2,8,True,True,4.307333333333333,-0.263316
3921,3145957,16943,4,0.54435,165,3169916,-1,2000.0,6148455,6165398,3002498,16943,62,0,True,True,378.41690555555556,-0.5407814559650198
3922,3145988,5980,1,0.17385,165,3169916,-1,500.0,3727658,3733638,581670,5980,107,7,True,True,20.343466666666664,-0.16275335036009295
3923,3154183,25685,64,0.653675,165,3169916,-1,32000.0,7704105,7729790,4549922,25685,43,0,True,True,13460.474222222223,-0.6147155641660316
3924,3154227,15680,1,0.365297,165,3169916,-1,500.0,8327323,8343003,5173096,15680,37,12,True,True,174.94116805555555,-0.35329061867218875
3925,3154964,3,64,0.653337,165,3169916,-1,32000.0,6234855,6234858,3079891,3,64,12,True,True,0.9975999999999999,-0.653337
3926,3154982,17819,1,0.835469,165,3169916,-1,500.0,3242716,3260535,87734,17819,143,10,True,True,205.62234722222223,-0.7012948392999857
3927,3155084,46368,4,0.516663,165,3169916,-1,2000.0,3704058,3750426,548974,46368,114,10,True,True,857.1482,-0.47636053036678055
3928,3155158,50,2,0.376329,165,3169916,-1,1000.0,6615055,6615105,3459897,50,60,12,True,True,0.3877777777777778,-0.376329
3929,3155276,17218,16,0.907242,165,3169916,-1,8000.0,3536958,3554176,381682,17218,123,0,True,True,3293.4277333333334,-0.8481433057830938
3930,3155303,8295,1,0.516372,165,3169916,-1,500.0,6858105,6866400,3702802,8295,56,12,True,True,36.1813125,-0.5143229447185228
3931,3155323,13,6,0.352898,165,3169916,-1,3000.0,10615880,10615893,7460557,13,20,12,True,True,1.5816666666666668,-0.352898
3932,3155807,14557,16,0.867719,165,3169916,-1,8000.0,3325591,3340148,169784,14557,144,9,True,True,1901.4531333333334,-0.7494317518042044
3933,3155869,18,4,0.486862,165,3169916,-1,2000.0,7979505,7979523,4823636,18,40,12,True,True,0.701,-0.486862
3934,3155965,191,8,0.48211,165,3169916,-1,4000.0,3977970,3978161,822005,191,106,10,True,True,8.985544444444445,-0.3574897304169226
3935,3156106,9,1,0.604211,165,3169916,-1,500.0,3308291,3308300,152185,9,149,1,True,True,0.05632500000000001,-0.604211
3936,3156253,9884,23,0.501837,165,3169916,-1,11500.0,8759323,8769207,5603070,9884,37,12,True,True,2683.0985736111115,-0.5012398696320676
3937,3156525,23,32,0.138968,165,3169916,-1,16000.0,12746095,12746118,9589570,23,2,12,True,True,14.730222222222222,-0.138968
3938,3156593,11878,64,0.165606,165,3169916,-1,32000.0,12573295,12585173,9416702,11878,3,12,True,True,8538.583377777777,-0.16403542996616954
3939,3156607,13568,16,0.077088,165,3169916,-1,8000.0,10515912,10529480,7359305,13568,24,0,True,True,2367.4234666666666,-0.07676225165127927
3940,3156819,25737,128,0.643477,165,3169916,-1,64000.0,4512970,4538707,1356151,25737,103,10,True,True,58081.51111111112,-0.6104700744504671
3941,3156879,8983,2,0.211517,165,3169916,-1,1000.0,11876695,11885678,8719816,8983,10,12,True,True,250.54481666666666,-0.2094105368832375
3942,3156951,13,8,0.186906,165,3169916,-1,4000.0,8065923,8065936,4908972,13,44,12,True,True,0.4700222222222222,-0.186906
3943,3158636,83,3,0.362223,165,3169916,-1,1500.0,6062055,6062138,2903419,83,77,10,True,True,3.2121,-0.362223
3944,3171252,8,7,0.717303,165,3172116,-1,3500.0,3783858,3783866,612606,8,119,10,True,True,0.6978222222222222,-0.717303
3945,3172221,502,64,0.11833,174,3175716,-1,32000.0,11442495,11442997,8270274,502,15,12,True,True,397.27164444444446,-0.11833
3946,3172267,19,1,0.230346,174,3175716,-1,500.0,7660905,7660924,4488638,19,55,12,True,True,0.19907777777777777,-0.230346
3947,3172413,40,8,0.811173,174,3175716,-1,4000.0,3707358,3707398,534945,40,129,7,True,True,2.532888888888889,-0.811173
3948,3172710,24,128,0.720256,174,3175716,-1,64000.0,6036855,6036879,2864145,24,82,0,True,True,45.461333333333336,-0.720256
3949,3172807,24672,16,0.481517,174,3175716,-1,8000.0,5019427,5044099,1846620,24672,98,10,True,True,3525.4824888888893,-0.44794741575790753
3950,3173805,31,1,0.478815,174,3175716,-1,500.0,8154523,8154554,4980718,31,45,12,True,True,0.44519444444444445,-0.478815
3951,3174689,1629,2,0.210704,174,3175716,-1,1000.0,9738312,9739941,6563623,1629,32,8,True,True,34.208999999999996,-0.210704
3952,3174838,26,4,0.161246,174,3175716,-1,2000.0,10386312,10386338,7211474,26,28,12,True,True,1.1116444444444442,-0.161246
3953,3175208,2575,4,0.833365,174,3175716,-1,2000.0,3305716,3308291,130508,2575,167,8,True,True,64.46083333333334,-0.833365
3954,3175685,734,1,0.022446,174,3175716,-1,500.0,11356095,11356829,8180410,734,16,11,True,True,9.367675,-0.022446
3955,3175739,8,9,0.043144,194,3218916,-1,4500.0,12481495,12481503,9305756,8,5,12,True,True,0.7376,-0.043144
3956,3213193,40,32,0.573487,194,3218916,-1,16000.0,3725458,3725498,512265,40,134,7,True,True,6.218666666666667,-0.573487
3957,3213292,7,32,0.161129,194,3218916,-1,16000.0,8500123,8500130,5286831,7,47,12,True,True,2.7779111111111114,-0.161129
3958,3213707,12027,8,0.62954,194,3218916,-1,4000.0,4602521,4614548,1388814,12027,113,11,True,True,557.5058111111111,-0.6181334712672667
3959,3214079,7848,16,0.039191,194,3218916,-1,8000.0,10170312,10178160,6956233,7848,32,12,True,True,1224.8453333333334,-0.038222531976515796
3960,3214664,8,4,0.572269,194,3218916,-1,2000.0,3536958,3536966,322294,8,151,9,True,True,0.5299555555555555,-0.572269
3961,3215048,5,1,0.055912,194,3218916,-1,500.0,11660695,11660700,8445647,5,13,11,True,True,0.06854861111111112,-0.055912
3962,3215258,6398,32,0.25826,194,3218916,-1,16000.0,9110323,9116721,5895065,6398,45,12,True,True,1277.310888888889,-0.25701520715553283
3963,3215295,3413,2,0.180038,194,3218916,-1,1000.0,4134570,4137983,919275,3413,127,8,True,True,34.240183333333334,-0.1726119478761814
3964,3215375,4547,22,0.958238,194,3218916,-1,11000.0,3300316,3304863,84941,4547,178,11,True,True,823.0795833333333,-0.9563323753670969
3965,3215389,12527,8,0.599358,194,3218916,-1,4000.0,7315305,7327832,4099916,12527,68,1,True,True,528.6688222222222,-0.5980841161947441
3966,3215507,23,8,0.563605,194,3218916,-1,4000.0,5907255,5907278,2691748,23,94,8,True,True,0.6969000000000001,-0.563605
3967,3216620,813,1,0.01862,194,3218916,-1,500.0,11703895,11704708,8487275,813,13,11,True,True,11.267954166666668,-0.01862
3968,3216752,5278,1,0.719547,194,3218916,-1,500.0,3656158,3661436,439406,5278,152,11,True,True,22.51636388888889,-0.6210825599623171
3969,3216902,6,8,0.661745,194,3218916,-1,4000.0,3331391,3331397,114489,6,176,2,True,True,0.2746,-0.661745
3970,3216985,24,32,0.283455,194,3218916,-1,16000.0,3956370,3956394,739385,24,133,6,True,True,6.4362666666666675,-0.283455
3971,3217098,6,1,0.085749,194,3218916,-1,500.0,11140080,11140086,7922982,6,23,0,True,True,0.11323333333333334,-0.085749
3972,3218348,9722,16,0.449203,194,3218916,-1,8000.0,6528655,6538377,3310307,9722,84,12,True,True,1247.7100444444443,-0.41495560496307143
3973,3218367,3,5,0.992776,194,3218916,-1,2500.0,3414691,3414694,196324,3,173,8,True,True,0.06895833333333333,-0.992776
3974,3218489,203,4,0.867302,194,3218916,-1,2000.0,3723258,3723461,504769,203,147,2,True,True,3.9449666666666663,-0.867302
3975,3218788,14762,64,0.170567,194,3218916,-1,32000.0,12832495,12847257,9613707,14762,2,12,True,True,19541.617244444446,-0.16163946528821033
3976,3218960,20,4,0.830364,195,3221116,-1,2000.0,3899458,3899478,680498,20,141,10,True,True,1.090888888888889,-0.830364
3977,3219242,5551,4,0.600839,195,3221116,-1,2000.0,4997827,5003378,1778585,5551,114,11,True,True,273.33742777777775,-0.5746703525011021
3978,3223294,128,6,0.794616,246,3242716,-1,3000.0,3589158,3589286,365864,128,162,11,True,True,7.025633333333334,-0.6571776890695632
3979,3225540,754,2,0.820453,246,3242716,-1,1000.0,3872458,3873212,646918,754,143,7,True,True,23.933216666666663,-0.820453
3980,3226332,13412,1,0.181884,246,3242716,-1,500.0,12049495,12062907,8823163,13412,12,12,True,True,145.13982083333335,-0.18074650296992167
3981,3226397,15893,32,0.659649,246,3242716,-1,16000.0,4129170,4145063,902773,15893,136,11,True,True,2634.784133333333,-0.6392436103333072
3982,3226436,332,2,0.264521,246,3242716,-1,1000.0,10880880,10881212,7654444,332,27,12,True,True,5.708555555555555,-0.264521
3983,3226743,4441,256,0.724187,246,3242716,-1,128000.0,9455923,9460364,6229180,4441,47,12,True,True,9363.646933333333,-0.709722756905829
3984,3226844,722,25,0.342671,246,3242716,-1,12500.0,6615105,6615827,3388261,722,87,1,True,True,69.99388888888889,-0.342671
3985,3226926,8998,128,0.45347,246,3242716,-1,64000.0,8068123,8077121,4841197,8998,60,7,True,True,6225.861688888889,-0.4460417097663119
3986,3227019,1061,1,0.590596,246,3242716,-1,500.0,3912070,3913131,685051,1061,146,2,True,True,14.434020833333333,-0.590596
3987,3227040,6,1,0.229814,246,3242716,-1,500.0,3877858,3877864,650818,6,150,8,True,True,0.08965000000000001,-0.229814
3988,3227155,17147,13,0.385462,246,3242716,-1,6500.0,4514070,4531217,1286915,17147,132,6,True,True,3782.0350208333334,-0.3511009726459678
3989,3227187,12,1,0.10857,246,3242716,-1,500.0,11140095,11140107,7912908,12,24,2,True,True,0.22646666666666668,-0.10857
3990,3227201,2,8,0.202349,246,3242716,-1,4000.0,7893105,7893107,4665904,2,65,12,True,True,0.08484444444444444,-0.202349
3991,3227619,4377,16,0.859592,246,3242716,-1,8000.0,3870258,3874635,642639,4377,155,12,True,True,1096.2171999999998,-0.856621612313394
3992,3227639,42,4,0.50436,246,3242716,-1,2000.0,4711621,4711663,1483982,42,128,0,True,True,1.1195333333333333,-0.50436
3993,3227955,27,8,0.419795,246,3242716,-1,4000.0,10967280,10967307,7739325,27,28,12,True,True,3.0966,-0.419795
3994,3228020,9,1,0.149561,246,3242716,-1,500.0,8240923,8240932,5012903,9,61,12,True,True,0.1200625,-0.149561
3995,3228272,12686,117,0.096299,246,3242716,-1,58500.0,12659695,12672381,9431423,12686,4,12,True,True,36575.0827,-0.07915776795429055
3996,3228293,20,32,0.475869,246,3242716,-1,16000.0,5672855,5672875,2444562,20,114,8,True,True,21.418666666666667,-0.475869
3997,3228695,243,1,0.614748,246,3242716,-1,500.0,8672923,8673166,5444228,243,59,12,True,True,2.5947,-0.614748
3998,3230542,15,32,0.039037,246,3242716,-1,16000.0,11140080,11140095,7909538,15,28,12,True,True,9.058666666666666,-0.039037
3999,3230614,9,8,0.783868,246,3242716,-1,4000.0,6240255,6240264,3009641,9,102,8,True,True,0.6043000000000001,-0.783868
4000,3230652,178,18,0.503329,246,3242716,-1,9000.0,5770055,5770233,2539403,178,114,11,True,True,22.2856,-0.503329
4001,3230740,8,16,0.117516,246,3242716,-1,8000.0,12486895,12486903,9256155,8,6,0,True,True,1.3253333333333333,-0.117516
4002,3230930,8191,8,0.482241,246,3242716,-1,4000.0,6036855,6045046,2805925,8191,111,12,True,True,684.5538555555556,-0.37387049835966346
4003,3230950,15,4,0.130329,246,3242716,-1,2000.0,9867912,9867927,6636962,15,46,12,True,True,0.506,-0.130329
4004,3230965,13,16,0.603475,246,3242716,-1,8000.0,3719658,3719671,488693,13,176,2,True,True,0.9796222222222221,-0.603475
4005,3232271,10541,85,0.827522,246,3242716,-1,42500.0,4491370,4501911,1259099,10541,148,10,True,True,29187.805868055555,-0.8069476104277263
4006,3233206,180,32,0.896969,246,3242716,-1,16000.0,4021170,4021350,787964,180,158,11,True,True,26.630666666666666,-0.8326436994329801
4007,3233353,17432,1,0.77487,246,3242716,-1,500.0,4469770,4487202,1236417,17432,149,12,True,True,563.8682305555556,-0.773950753019982
4008,3233362,25,32,0.649232,246,3242716,-1,16000.0,4949227,4949252,1715865,25,134,1,True,True,9.675555555555555,-0.649232
4009,3233466,312,1,0.522044,246,3242716,-1,500.0,3752858,3753170,519392,312,176,2,True,True,0.9321000000000002,-0.522044
4010,3233513,5867,64,0.370377,246,3242716,-1,32000.0,5878055,5883922,2644542,5867,117,12,True,True,5829.771822222222,-0.358535429419135
4011,3233675,21233,1,0.043438,246,3242716,-1,500.0,10256712,10277945,7023037,21233,43,12,True,True,256.07297777777774,-0.043103664703488566
4012,3233900,15,16,0.529817,246,3242716,-1,8000.0,3526158,3526173,292258,15,200,1,True,True,5.649333333333333,-0.529817
4013,3233915,129,11,0.229486,246,3242716,-1,5500.0,6261855,6261984,3027940,129,105,10,True,True,6.342141666666667,-0.229486
4014,3234031,323,1,0.8023,246,3242716,-1,500.0,3661558,3661881,427527,323,193,8,True,True,1.6908152777777776,-0.8023
4015,3234059,24779,2,0.789556,246,3242716,-1,1000.0,4296970,4321749,1062911,24779,155,7,True,True,968.355886111111,-0.7832434920678712
4016,3234226,6230,8,0.381236,246,3242716,-1,4000.0,8586523,8592753,5352297,6230,64,12,True,True,618.0164777777778,-0.37998092817493717
4017,3234243,12,4,0.589048,246,3242716,-1,2000.0,5791655,5791667,2557412,12,121,10,True,True,0.3731333333333334,-0.589048
4018,3234606,47,1,0.741394,246,3242716,-1,500.0,3713858,3713905,479252,47,189,6,True,True,0.3611166666666667,-0.741394
4019,3237061,2,16,0.761539,246,3242716,-1,8000.0,4711621,4711623,1474560,2,146,10,True,True,0.21324444444444443,-0.761539
4020,3237080,18897,16,0.696708,246,3242716,-1,8000.0,3662658,3681555,425578,18897,198,6,True,True,1693.339066666667,-0.6842871526172709
4021,3237244,9,32,0.097717,246,3242716,-1,16000.0,11617495,11617504,8380251,9,19,12,True,True,3.74,-0.097717
4022,3237380,132,16,0.133883,246,3242716,-1,8000.0,11963095,11963227,8725715,132,15,12,True,True,29.802666666666664,-0.133883
4023,3237475,10306,32,0.477141,246,3242716,-1,16000.0,10083912,10094218,6846437,10306,47,11,True,True,3006.6295111111112,-0.4715431387140339
4024,3237506,11946,16,0.232513,246,3242716,-1,8000.0,10429512,10441458,7192006,11946,43,11,True,True,2980.3779999999997,-0.2190574074670938
4025,3237550,36,53,0.859053,246,3242716,-1,26500.0,4085970,4086006,848420,36,170,11,True,True,6.384733333333333,-0.8342382216848044
4026,3237567,54,4,0.283267,246,3242716,-1,2000.0,3526091,3526145,288524,54,215,2,True,True,5.0844,-0.283267
4027,3237605,3,1,0.876766,246,3242716,-1,500.0,3375691,3375694,138086,3,232,6,True,True,0.0374625,-0.876766
4028,3237639,57,1,0.408647,246,3242716,-1,500.0,8845723,8845780,5608084,57,66,12,True,True,0.7574666666666667,-0.408647
4029,3237648,9,8,0.189021,246,3242716,-1,4000.0,3376791,3376800,139143,9,233,6,True,True,0.8991,-0.189021
9049,7067964,113,2,0.771941,1,7067964,-1,1000.0,7154364,7154477,86400,113,0,12,True,True,3.6944722222222226,-0.771941
9050,7067978,16,16,0.257944,141,7154364,-1,8000.0,14416202,14416218,7348224,16,0,12,True,True,5.559466666666667,-0.257944
9051,7068000,5846,32,0.473261,141,7154364,-1,16000.0,10159583,10165429,3091583,5846,1,0,True,True,2318.5768444444448,-0.47189956630851543
9052,7072488,40,16,0.256026,141,7154364,-1,8000.0,9668083,9668123,2595595,40,2,1,True,True,21.120888888888892,-0.256026
9053,7072656,13729,98,0.876658,141,7154364,-1,49000.0,7529546,7543275,456890,13729,3,10,True,True,29869.69657777778,-0.8566831219273671
9054,7073592,28,4,0.650292,141,7154364,-1,2000.0,9711283,9711311,2637691,28,2,11,True,True,0.8955333333333333,-0.650292
9055,7073635,11342,32,0.140447,141,7154364,-1,16000.0,15074402,15085744,8000767,11342,0,7,True,True,1926.6850666666664,-0.13131658874129673
9056,7073725,13964,1,0.123966,141,7154364,-1,500.0,12695490,12709454,5621765,13964,2,12,True,True,102.19746111111111,-0.11665305540895342
9057,7073777,19272,1,0.568733,141,7154364,-1,500.0,9797683,9816955,2723906,19272,4,12,True,True,480.91904027777775,-0.5584814261210207
9058,7074702,11235,77,0.039593,141,7154364,-1,38500.0,15247202,15258437,8172500,11235,0,12,True,True,11742.295415277778,-0.03429756704884646
9059,7074723,299,11,0.859003,141,7154364,-1,5500.0,7380322,7380621,305599,299,9,2,True,True,26.83275833333333,-0.859003
9060,7074773,12,1,0.400939,141,7154364,-1,500.0,10000783,10000795,2926010,12,5,11,True,True,0.42815000000000003,-0.400939
9061,7074936,384,1,0.857001,141,7154364,-1,500.0,7361522,7361906,286586,384,11,6,True,True,3.3712000000000004,-0.857001
9062,7075408,4299,84,0.91714,141,7154364,-1,42000.0,8067196,8071495,991788,4299,9,11,True,True,5007.917483333334,-0.8937862082734791
9063,7075631,4,32,0.128984,141,7154364,-1,16000.0,15160802,15160806,8085171,4,1,12,True,True,1.0545777777777778,-0.128984
9064,7077889,9841,1,0.366732,141,7154364,-1,500.0,7757724,7767565,679835,9841,11,9,True,True,46.796397222222225,-0.3088839488887183
9065,7078039,10,3,0.844836,141,7154364,-1,1500.0,7275983,7275993,197944,10,15,7,True,True,0.42287499999999995,-0.844836
9066,7084626,842,32,0.952045,141,7154364,-1,16000.0,8365796,8366638,1281170,842,10,7,True,True,481.8432,-0.9208530451192216
9067,7086232,13575,8,0.373683,141,7154364,-1,4000.0,13604890,13618465,6518658,13575,4,12,True,True,1106.762,-0.36120467114547644
9068,7086472,105,1,0.682201,141,7154364,-1,500.0,7355022,7355127,268550,105,17,6,True,True,0.6514375,-0.682201
9069,7086917,641,1,0.505942,141,7154364,-1,500.0,7507946,7508587,421029,641,15,7,True,True,11.771252777777777,-0.505942
9070,7089332,130,2,0.262827,141,7154364,-1,1000.0,8759606,8759736,1670274,130,11,1,True,True,6.132027777777777,-0.262827
9071,7093090,2160,2,0.875536,141,7154364,-1,1000.0,8274596,8276756,1181506,2160,13,9,True,True,75.27365555555555,-0.7085165805595571
9072,7106775,4,1,0.682556,141,7154364,-1,500.0,7392922,7392926,286147,4,18,8,True,True,0.05073333333333333,-0.682556
9073,7107032,28,1,0.620614,141,7154364,-1,500.0,9134222,9134250,2027190,28,11,2,True,True,0.742311111111111,-0.620614
9074,7107248,22,9,0.643867,141,7154364,-1,4500.0,9078322,9078344,1971074,22,12,2,True,True,5.87895,-0.643867
9075,7107275,19759,32,0.741043,141,7154364,-1,16000.0,8572105,8591864,1464830,19759,14,1,True,True,5043.611955555556,-0.7126639740576654
9076,7109502,7380,8,0.244817,141,7154364,-1,4000.0,10387483,10394863,3277981,7380,6,6,True,True,1485.242677777778,-0.2272121839514312
9077,7109724,215,1,0.821235,141,7154364,-1,500.0,7505746,7505961,396022,215,22,7,True,True,3.7950486111111115,-0.821235
9078,7111029,2112,5,0.007943,141,7154364,-1,2500.0,7765324,7767436,654295,2112,19,7,True,True,94.65866666666669,-0.007943
9079,7112093,69,16,0.85306,141,7154364,-1,8000.0,7304153,7304222,192060,69,28,1,True,True,15.876133333333334,-0.85306
9080,7112485,34284,1,0.290661,141,7154364,-1,500.0,14675402,14709686,7562917,34284,3,12,True,True,336.16663055555557,-0.2860956788950118
9081,7112504,34188,128,0.158206,141,7154364,-1,64000.0,10400483,10434671,3287979,34188,7,8,True,True,87964.00213333333,-0.1546723956979667
9082,7112573,555,8,0.39928,141,7154364,-1,4000.0,8594958,8595513,1482385,555,17,6,True,True,27.768500000000003,-0.39928
9083,7112578,194,2,0.072979,141,7154364,-1,1000.0,12220290,12220484,5107712,194,7,12,True,True,5.748866666666667,-0.072979
9084,7113672,7824,128,0.388223,141,7154364,-1,64000.0,14769802,14777626,7656130,7824,3,7,True,True,12370.228622222221,-0.3658417856428101
9085,7113827,11316,37,0.462279,141,7154364,-1,18500.0,8020396,8031712,906569,11316,24,2,True,True,5214.485438888888,-0.418874393502692
9086,7114504,1157,32,0.093503,141,7154364,-1,16000.0,10049383,10050540,2934879,1157,12,9,True,True,421.71364444444447,-0.093503
9087,7114587,17747,32,0.465878,141,7154364,-1,16000.0,10016983,10034730,2902396,17747,13,0,True,True,14448.820311111112,-0.44089928894829766
9088,7114913,86,1,0.642484,141,7154364,-1,500.0,9128422,9128508,2013509,86,19,2,True,True,2.7172416666666668,-0.642484
9089,7114996,9,32,0.900127,141,7154364,-1,16000.0,8023996,8024005,909000,9,27,2,True,True,3.7176,-0.900127
9090,7115168,217,4,0.464853,141,7154364,-1,2000.0,9935983,9936200,2820815,217,15,12,True,True,30.879583333333333,-0.4631785549319619
9091,7117993,60,4,0.085823,141,7154364,-1,2000.0,14813002,14813062,7695009,60,3,11,True,True,1.3613333333333335,-0.085823
9092,7118079,105,1,0.731778,141,7154364,-1,500.0,7746924,7747029,628845,105,33,10,True,True,0.28145833333333337,-0.731778
9093,7118118,1402,1,0.91746,141,7154364,-1,500.0,9140326,9141728,2022208,1402,20,2,True,True,34.104905555555554,-0.8202647275102513
9094,7118204,16,16,0.922491,141,7154364,-1,8000.0,8298796,8298812,1180592,16,28,8,True,True,6.375466666666667,-0.922491
9095,7118234,9,4,0.768217,141,7154364,-1,2000.0,7165164,7165173,46930,9,45,9,True,True,0.6039500000000001,-0.768217
9096,7118410,13,8,0.199471,141,7154364,-1,4000.0,14047690,14047703,6929280,13,7,8,True,True,0.4762333333333333,-0.199471
9097,7118430,11342,32,0.328721,141,7154364,-1,16000.0,8363596,8374938,1245166,11342,29,11,True,True,6839.782844444444,-0.32387958516975335
9098,7118548,12493,143,0.317285,141,7154364,-1,71500.0,14042290,14054783,6923742,12493,8,8,True,True,8072.272740277777,-0.3024282664045057
9099,7118583,6223,2,0.996438,141,7154364,-1,1000.0,8014173,8020396,895590,6223,36,11,True,True,179.60798333333332,-0.9956106402330946
9100,7119045,14,4,0.486295,141,7154364,-1,2000.0,9957583,9957597,2838538,14,18,10,True,True,1.1979333333333333,-0.486295
9101,7119078,11505,64,0.702291,141,7154364,-1,32000.0,8643558,8655063,1524480,11505,28,11,True,True,9513.268533333332,-0.6382622913924217
9102,7119093,205,8,0.476219,141,7154364,-1,4000.0,10832483,10832688,3713390,205,12,12,True,True,24.463333333333335,-0.476219
9103,7120629,13,3,0.278375,141,7154364,-1,1500.0,13993690,13993703,6873061,13,9,11,True,True,0.35408750000000005,-0.278375
9104,7120844,9,8,0.038282,141,7154364,-1,4000.0,14899402,14899411,7778558,9,3,12,True,True,0.42090000000000005,-0.038282
9105,7120858,1,16,0.155741,141,7154364,-1,8000.0,10006183,10006184,2885325,1,20,8,True,True,0.5298888888888889,-0.155741
9106,7120917,6726,4,0.469968,141,7154364,-1,2000.0,11529090,11535816,4408173,6726,14,12,True,True,210.86599999999999,-0.46263464002595595
9107,7122370,25,7,0.640216,141,7154364,-1,3500.0,8019973,8019998,897603,25,43,2,True,True,2.5411458333333328,-0.640216
9108,7122396,14,4,0.320187,141,7154364,-1,2000.0,9078308,9078322,1955912,14,32,0,True,True,1.6627333333333334,-0.320187
9109,7123755,233,2,0.031323,141,7154364,-1,1000.0,13691290,13691523,6567535,233,11,12,True,True,2.7021527777777776,-0.031323
9110,7123774,21286,32,0.601077,141,7154364,-1,16000.0,10016983,10038269,2893209,21286,22,9,True,True,16449.275644444446,-0.5576825934776837
9111,7123901,75,32,0.380285,141,7154364,-1,16000.0,11874690,11874765,4750789,75,15,12,True,True,37.43666666666667,-0.380285
9112,7123916,2,32,0.93646,141,7154364,-1,16000.0,7387522,7387524,263606,2,56,2,True,True,0.5217777777777778,-0.93646
9113,7123947,113,16,0.361493,141,7154364,-1,8000.0,11788290,11788403,4664343,113,16,12,True,True,28.51617777777778,-0.361493
9114,7124055,10574,32,0.43011,141,7154364,-1,16000.0,8289796,8300370,1165741,10574,44,9,True,True,7496.450044444445,-0.4180277986745077
9115,7124427,388,39,0.47341,141,7154364,-1,19500.0,14036890,14037278,6912463,388,10,11,True,True,38.14525,-0.47341
9116,7124495,22,1,0.054078,141,7154364,-1,500.0,8276796,8276818,1152301,22,46,7,True,True,0.4737027777777778,-0.054078
9117,7124616,44,5,0.868021,141,7154364,-1,2500.0,8539696,8539740,1415080,44,42,6,True,True,1.7294444444444446,-0.868021
9118,7124801,7,32,0.952645,141,7154364,-1,16000.0,7457046,7457053,332245,7,60,1,True,True,4.9199111111111105,-0.952645
9119,7124812,19,1,0.683671,141,7154364,-1,500.0,8896808,8896827,1771996,19,38,7,True,True,0.135375,-0.683671
9120,7124848,23,1,0.269848,141,7154364,-1,500.0,12738690,12738713,5613842,23,14,11,True,True,0.19821527777777778,-0.269848
9121,7124867,5,66,0.635687,141,7154364,-1,33000.0,7457041,7457046,332174,5,63,1,True,True,7.248083333333334,-0.635687
9122,7125076,17378,8,0.083591,141,7154364,-1,4000.0,10038583,10055961,2913507,17378,25,10,True,True,1962.2684333333334,-0.07603080052445814
9123,7125353,8,1,0.069259,141,7154364,-1,500.0,9426626,9426634,2301273,8,35,10,True,True,0.049433333333333336,-0.069259
9124,7125590,6757,1,0.405068,141,7154364,-1,500.0,9563064,9569821,2437474,6757,35,12,True,True,132.96858472222223,-0.3796564178159754
9125,7125614,3678,1,0.298337,141,7154364,-1,500.0,10746083,10749761,3620469,3678,21,12,True,True,52.18715555555555,-0.29716856424607363
9126,7125662,32562,128,0.712207,141,7154364,-1,64000.0,8561296,8593858,1435634,32562,48,10,True,True,35732.03022222223,-0.7062447556983298
9127,7125680,178,8,0.871289,141,7154364,-1,4000.0,7884524,7884702,758844,178,61,8,True,True,15.258555555555557,-0.871289
9128,7126585,3522,8,0.524778,141,7154364,-1,4000.0,13432090,13435612,6305505,3522,14,12,True,True,165.33088888888892,-0.5101443212149103
9129,7126867,11,56,0.669644,141,7154364,-1,28000.0,8263796,8263807,1136929,11,57,7,True,True,10.712411111111113,-0.669644
9130,7126915,64,2,0.259447,141,7154364,-1,1000.0,13172890,13172954,6045975,64,15,12,True,True,2.6752,-0.259447
9131,7131804,6,36,0.830549,141,7154364,-1,18000.0,7251564,7251570,119760,6,80,12,True,True,3.0342000000000002,-0.830549
9132,7131838,13,1,0.092441,141,7154364,-1,500.0,9451526,9451539,2319688,13,39,6,True,True,0.08728055555555556,-0.092441
9133,7131896,178,6,0.901642,141,7154364,-1,3000.0,7531746,7531924,399850,178,69,6,True,True,24.381549999999997,-0.901642
9134,7132443,7,1,0.342019,141,7154364,-1,500.0,11091683,11091690,3959240,7,22,12,True,True,0.09048472222222222,-0.342019
9135,7132562,60,1,0.753176,141,7154364,-1,500.0,8153596,8153656,1021034,60,61,11,True,True,0.8399166666666668,-0.753176
9136,7132627,24738,7,0.164533,141,7154364,-1,3500.0,14589002,14613740,7456375,24738,7,12,True,True,5864.3890083333345,-0.16420915807627207
9137,7132730,6994,4,0.349276,141,7154364,-1,2000.0,12913690,12920684,5780960,6994,17,7,True,True,252.29505555555556,-0.2617881579134042
9138,7132808,95,4,0.419101,141,7154364,-1,2000.0,9318626,9318721,2185818,95,44,10,True,True,12.684083333333334,-0.419101
9139,7132911,5,4,0.475499,141,7154364,-1,2000.0,11178090,11178095,4045179,5,24,12,True,True,0.23383333333333337,-0.475499
9140,7132920,5350,1,0.68883,141,7154364,-1,500.0,8016373,8021723,883453,5350,70,7,True,True,76.04535555555555,-0.6770961649592919
9141,7132949,22,18,0.160689,141,7154364,-1,9000.0,12609090,12609112,5476141,22,20,12,True,True,5.4818500000000006,-0.160689
9142,7135100,719,1,0.69669,141,7154364,-1,500.0,9056708,9057427,1921608,719,52,6,True,True,19.237244444444443,-0.69669
9143,7135118,16046,32,0.354692,141,7154364,-1,16000.0,11437290,11453336,4302172,16046,25,12,True,True,3431.825422222222,-0.34867384164062426
9144,7135521,26,64,0.692901,141,7154364,-1,32000.0,10051583,10051609,2916062,26,33,7,True,True,14.00071111111111,-0.692901
9145,7135638,30,13,0.389138,141,7154364,-1,6500.0,7874424,7874454,738786,30,77,6,True,True,4.984958333333333,-0.389138
9146,7135868,11419,94,0.009932,141,7154364,-1,47000.0,14681202,14692621,7545334,11419,6,2,True,True,11066.054041666668,-0.009825888250562268
9147,7135905,14386,8,0.783072,141,7154364,-1,4000.0,8756992,8771378,1621087,14386,58,1,True,True,2696.2112000000006,-0.7802630543830154
9148,7136048,8,6,0.597129,141,7154364,-1,3000.0,9140193,9140201,2004145,8,51,7,True,True,1.306,-0.597129
9149,7136179,18,32,0.077809,141,7154364,-1,16000.0,9849583,9849601,2713404,18,43,7,True,True,14.84928888888889,-0.07705187787795799
9150,7137518,161,8,0.667962,141,7154364,-1,4000.0,7501346,7501507,363828,161,89,11,True,True,21.997966666666663,-0.667962
9151,7137677,35,1,0.616512,141,7154364,-1,500.0,12306690,12306725,5169013,35,22,12,True,True,0.22667361111111112,-0.616512
9152,7138185,323,1,0.323733,141,7154364,-1,500.0,11874690,11875013,4736505,323,24,0,True,True,5.038351388888889,-0.323733
9153,7138782,8253,1,0.986368,141,7154364,-1,500.0,7725324,7733577,586542,8253,87,8,True,True,38.99578333333333,-0.871140179507185
9154,7138878,10,16,0.938969,141,7154364,-1,8000.0,7298683,7298693,159805,10,101,6,True,True,2.4964444444444447,-0.938969
9155,7138938,9704,64,0.742836,141,7154364,-1,32000.0,9130622,9140326,1991684,9704,56,7,True,True,16177.202488888888,-0.7420985398551314
9156,7138958,14911,32,0.736719,141,7154364,-1,16000.0,7360422,7375333,221464,14911,100,8,True,True,4481.706666666667,-0.7193088460759433
9157,7139006,14452,32,0.316515,141,7154364,-1,16000.0,12825090,12839542,5686084,14452,19,12,True,True,4902.994222222222,-0.28515211535381496
9158,7139240,23347,128,0.150506,141,7154364,-1,64000.0,13777690,13801037,6638450,23347,14,12,True,True,11571.712,-0.13690758025144112
9159,7139285,12,1,0.458659,141,7154364,-1,500.0,8940008,8940020,1800723,12,63,11,True,True,0.33180000000000004,-0.458659
9160,7139307,18,16,0.147487,141,7154364,-1,8000.0,8894608,8894626,1755301,18,65,11,True,True,2.1388,-0.147487
9161,7139721,6,32,0.864301,141,7154364,-1,16000.0,8593705,8593711,1453984,6,70,10,True,True,1.2008,-0.864301
9162,7139796,465,4,0.113607,141,7154364,-1,2000.0,14243402,14243867,7103606,465,10,12,True,True,34.42291666666667,-0.113607
9163,7139815,33807,64,0.969976,141,7154364,-1,32000.0,9297026,9330833,2157211,33807,56,7,True,True,54966.955822222226,-0.9548454416131883
9164,7140040,275,8,0.406387,141,7154364,-1,4000.0,9448226,9448501,2308186,275,54,10,True,True,14.550555555555556,-0.406387
9165,7140102,3,4,0.520692,141,7154364,-1,2000.0,8495396,8495399,1355294,3,77,12,True,True,0.14393333333333333,-0.520692
9166,7140866,346,4,0.003677,141,7154364,-1,2000.0,13086490,13086836,5945624,346,20,12,True,True,12.536733333333332,-0.003677
9167,7141294,11097,10,0.450559,141,7154364,-1,5000.0,9662567,9673664,2521273,11097,53,8,True,True,3549.7698333333337,-0.4483504100330989
9168,7141690,3596,256,0.832511,141,7154364,-1,128000.0,7588124,7591720,446434,3596,100,10,True,True,14880.007111111112,-0.8122661161681808
9169,7141900,30,8,0.125717,141,7154364,-1,4000.0,12349890,12349920,5207990,30,26,11,True,True,2.2756666666666665,-0.125717
9170,7143944,103,8,0.449329,141,7154364,-1,4000.0,9570664,9570767,2426720,103,55,0,True,True,16.975544444444445,-0.449329
9171,7143981,7296,158,0.969458,141,7154364,-1,79000.0,9026408,9033704,1882427,7296,70,12,True,True,22668.25122222222,-0.8780972387203695
9172,7143987,78,16,0.097446,141,7154364,-1,8000.0,14502602,14502680,7358615,78,9,12,True,True,41.366,-0.097446
9173,7144695,42,4,0.218623,141,7154364,-1,2000.0,7786924,7786966,642229,42,100,10,True,True,1.1669,-0.218623
9174,7147554,19,1,0.979032,141,7154364,-1,500.0,7457022,7457041,309468,19,113,11,True,True,0.4173138888888889,-0.979032
9175,7147640,49,1,0.420176,141,7154364,-1,500.0,9405026,9405075,2257386,49,61,12,True,True,0.9078611111111111,-0.420176
9176,7147674,11,35,0.546086,141,7154364,-1,17500.0,10386383,10386394,3238709,11,41,12,True,True,6.877062500000001,-0.546086
9177,7148673,29,8,0.166101,141,7154364,-1,4000.0,9568464,9568493,2419791,29,58,8,True,True,4.951266666666666,-0.166101
9178,7148736,9465,32,0.377557,141,7154364,-1,16000.0,12047490,12056955,4898754,9465,30,12,True,True,3440.3819999999996,-0.31788180977623254
9179,7148820,116,32,0.348086,141,7154364,-1,16000.0,9667967,9668083,2519147,116,57,8,True,True,122.50115555555556,-0.348086
9180,7149228,9,1,0.952377,141,7154364,-1,500.0,8572096,8572105,1422868,9,86,9,True,True,0.0826375,-0.952377
9181,7149429,13,6,0.971745,141,7154364,-1,3000.0,7297583,7297596,148154,13,128,10,True,True,1.2170166666666666,-0.971745
9182,7149513,14084,1,0.576836,141,7154364,-1,500.0,7413822,7427906,264309,14084,120,8,True,True,183.06483055555555,-0.5429188741945067
9183,7149817,41,1,0.014371,141,7154364,-1,500.0,13864090,13864131,6714273,41,16,12,True,True,0.18222222222222223,-0.014371
9184,7149890,17,1,0.813779,141,7154364,-1,500.0,7503546,7503563,353656,17,117,7,True,True,0.30007361111111114,-0.813779
9185,7150081,4900,36,0.016191,141,7154364,-1,18000.0,9124822,9129722,1974741,4900,74,7,True,True,5365.4539,-0.01614234810022995
9186,7150250,9583,32,0.896655,141,7154364,-1,16000.0,7564324,7573907,414074,9583,114,9,True,True,4159.451466666667,-0.8889239228473468
9187,7150693,31580,2,0.502085,141,7154364,-1,1000.0,11701890,11733470,4551197,31580,35,11,True,True,1074.0760833333336,-0.49948509452260065
9188,7150700,672,8,0.867758,141,7154364,-1,4000.0,8175196,8175868,1024496,672,100,10,True,True,126.4362222222222,-0.7675570907364982
9189,7154274,8,1,0.699317,141,7154364,-1,500.0,9249426,9249434,2095152,8,70,6,True,True,0.24214444444444444,-0.699317
9190,7154312,9,1,0.648912,141,7154364,-1,500.0,9570664,9570673,2416352,9,62,7,True,True,0.1854125,-0.648912
9191,7154448,15210,8,0.455997,165,7165164,-1,4000.0,13259290,13274500,6104842,15210,21,12,True,True,1579.081,-0.44297956716707143
9192,7154533,7486,8,0.410387,165,7165164,-1,4000.0,13000090,13007576,5845557,7486,24,12,True,True,472.0082666666667,-0.39160322482300014
9193,7158859,538,1,0.352211,165,7165164,-1,500.0,9048008,9048546,1889149,538,83,10,True,True,15.097625,-0.352211
9194,7158910,10206,4,0.542467,165,7165164,-1,2000.0,7763124,7773330,604214,10206,117,8,True,True,319.8410333333334,-0.5110296595816979
9195,7159012,38,3,0.52317,165,7165164,-1,1500.0,9134393,9134431,1975381,38,76,2,True,True,3.022266666666667,-0.52317
9196,7159053,7,8,0.765081,165,7165164,-1,4000.0,7873324,7873331,714271,7,116,11,True,True,0.7157888888888889,-0.765081
9197,7159623,5,4,0.11338,165,7165164,-1,2000.0,10395083,10395088,3235460,5,45,7,True,True,0.5057777777777779,-0.11338
9198,7159669,206,12,0.175814,165,7165164,-1,6000.0,11350890,11351096,4191221,206,40,0,True,True,15.6457,-0.175814
9199,7159767,103,1,0.428384,165,7165164,-1,500.0,7553524,7553627,393757,103,127,10,True,True,1.001102777777778,-0.428384
9200,7159820,5750,32,0.176895,165,7165164,-1,16000.0,9450426,9456176,2290606,5750,70,0,True,True,1003.172088888889,-0.1703738740250818
9201,7160054,37473,32,0.594892,165,7165164,-1,16000.0,12133890,12171363,4973836,37473,33,12,True,True,35470.318,-0.59383181128632
9202,7160100,414,8,0.542763,165,7165164,-1,4000.0,8759192,8759606,1599092,414,94,7,True,True,78.1126,-0.542763
9203,7160164,15,1,0.381563,165,7165164,-1,500.0,7305322,7305337,145158,15,147,6,True,True,0.33991666666666664,-0.381563
9204,7160343,14002,5,0.845092,165,7165164,-1,2500.0,7376722,7390724,216379,14002,144,7,True,True,591.1696944444444,-0.8406318589817992
9205,7160436,135,1,0.688551,165,7165164,-1,500.0,7273783,7273918,113347,135,153,1,True,True,2.6469374999999995,-0.688551
9206,7160647,6502,3,0.437494,165,7165164,-1,1500.0,14047703,14054205,6887056,6502,12,1,True,True,89.37797499999999,-0.43747809223525413
9207,7160727,498,9,0.283248,165,7165164,-1,4500.0,8846008,8846506,1685281,498,94,1,True,True,108.05977500000002,-0.283248
9208,7162746,14808,8,0.620376,165,7165164,-1,4000.0,8670558,8685366,1507812,14808,98,8,True,True,2297.1639333333333,-0.5803956016402682
9209,7162966,1,5,0.925136,165,7165164,-1,2500.0,8851408,8851409,1688442,1,94,8,True,True,0.11470833333333334,-0.925136
9210,7162997,11,64,0.856997,165,7165164,-1,32000.0,7674524,7674535,511527,11,132,12,True,True,10.526755555555555,-0.856997
9211,7163649,2114,1,0.995363,165,7165164,-1,500.0,7879124,7881238,715475,2114,124,1,True,True,38.06591111111111,-0.9050158109083856
9212,7163720,4028,4,0.80594,165,7165164,-1,2000.0,8665158,8669186,1501438,4028,100,10,True,True,388.6496333333333,-0.7604081020759198
9213,7164050,224,7,0.103812,165,7165164,-1,3500.0,7830124,7830348,666074,224,128,11,True,True,32.96937777777777,-0.103812
9214,7164332,124,9,0.649625,165,7165164,-1,4500.0,8408996,8409120,1244664,124,109,11,True,True,20.19805,-0.649625
9215,7164528,34,1,0.61626,165,7165164,-1,500.0,8756958,8756992,1592430,34,99,11,True,True,0.7979611111111111,-0.61626
9216,7165397,739,32,0.41128,253,7251564,-1,16000.0,11961090,11961829,4795693,739,36,12,True,True,108.1896,-0.41128
9217,7165501,74,64,0.496405,253,7251564,-1,32000.0,9450426,9450500,2284925,74,74,7,True,True,31.79697777777778,-0.496405
9218,7166578,7417,1,0.751727,253,7251564,-1,500.0,8278996,8286413,1112418,7417,117,7,True,True,165.89398472222223,-0.7473640771027609
9219,7170295,121,4,0.927229,253,7251564,-1,2000.0,7719924,7720045,549629,121,140,7,True,True,3.2992666666666666,-0.927229
9220,7172868,21,5,0.099702,253,7251564,-1,2500.0,13950490,13950511,6777622,21,17,12,True,True,1.4355833333333334,-0.099702
9221,7173828,18,18,0.444103,253,7251564,-1,9000.0,9474464,9474482,2300636,18,73,1,True,True,4.5234,-0.44410300000000014
9222,7173913,321,1,0.581234,253,7251564,-1,500.0,9657167,9657488,2483254,321,69,12,True,True,10.216270833333335,-0.581234
9223,7184070,13,16,0.032636,253,7251564,-1,8000.0,14985802,14985815,7801732,13,3,12,True,True,1.4819999999999998,-0.032636
9224,7184899,1013,4,0.289904,253,7251564,-1,2000.0,10251383,10252396,3066484,1013,54,12,True,True,129.01680555555558,-0.289904
9225,7185016,16239,4,0.420641,253,7251564,-1,2000.0,11442690,11458929,4257674,16239,44,8,True,True,464.34155,-0.4054379428316398
9226,7186069,16,6,0.222879,253,7251564,-1,3000.0,9137993,9138009,1951924,16,89,2,True,True,2.612,-0.222879
9227,7186102,2263,4,0.45463,253,7251564,-1,2000.0,10486883,10489146,3300781,2263,51,12,True,True,211.95509444444446,-0.45463
9228,7186416,8496,64,0.38108,253,7251564,-1,32000.0,10256783,10265279,3070367,8496,56,8,True,True,13751.335377777777,-0.378461186708547
9229,7187747,5,8,0.19556,253,7251564,-1,4000.0,14053103,14053108,6865356,5,13,0,True,True,0.18338888888888888,-0.19556
9230,7187993,11,4,0.469574,253,7251564,-1,2000.0,9226726,9226737,2038733,11,90,12,True,True,1.5565,-0.469574
9231,7188234,11,5,0.124441,253,7251564,-1,2500.0,9292626,9292637,2104392,11,89,11,True,True,0.5125694444444444,-0.124441
9232,7189561,526,8,0.967616,253,7251564,-1,4000.0,7304222,7304748,114661,526,175,1,True,True,83.56644444444444,-0.8479652089483649
9233,7189749,30690,64,0.914029,253,7251564,-1,32000.0,8600358,8631048,1410609,30690,117,8,True,True,49838.70133333333,-0.9085228386882855
9234,7189791,17197,128,0.412935,253,7251564,-1,64000.0,14677602,14694799,7487811,17197,8,7,True,True,22367.419199999997,-0.40975101321989005
9235,7190455,12,1,0.820418,253,7251564,-1,500.0,7531924,7531936,341469,12,159,1,True,True,0.27395,-0.820418
9236,7191158,93,1,0.703835,253,7251564,-1,500.0,7530646,7530739,339488,93,161,6,True,True,2.158116666666667,-0.703835
9237,7191735,12789,2,0.741153,253,7251564,-1,1000.0,7566524,7579313,374789,12789,157,7,True,True,335.9559777777778,-0.7359544277946947
9238,7192149,12,32,0.007605,253,7251564,-1,16000.0,14154802,14154814,6962653,12,14,12,True,True,2.1104000000000003,-0.007605
9239,7192320,16,32,0.374644,253,7251564,-1,16000.0,10299983,10299999,3107663,16,59,11,True,True,14.7008,-0.374644
9240,7192416,30,1,0.223937,253,7251564,-1,500.0,8175196,8175226,982780,30,137,0,True,True,0.6444583333333332,-0.223937
9241,7192636,115,1,0.283604,253,7251564,-1,500.0,10659683,10659798,3467047,115,54,12,True,True,2.935055555555555,-0.283604
9242,7192923,2,3,0.879607,253,7251564,-1,1500.0,8846006,8846008,1653083,2,114,12,True,True,0.14465833333333333,-0.879607
9243,7192945,38,12,0.264499,253,7251564,-1,6000.0,14767602,14767640,7574657,38,7,12,True,True,6.224400000000001,-0.264499
9244,7193263,44,1,0.838484,253,7251564,-1,500.0,9841983,9842027,2648720,44,75,11,True,True,1.3692555555555557,-0.838484
9245,7193967,9,32,0.795138,253,7251564,-1,16000.0,11264490,11264499,4070523,9,51,12,True,True,4.1104,-0.795138
9246,7194119,5,8,0.414717,253,7251564,-1,4000.0,10159583,10159588,2965464,5,66,10,True,True,0.49188888888888893,-0.414717
9247,7194371,1835,1,0.241554,253,7251564,-1,500.0,10918883,10920718,3724512,1835,54,12,True,True,44.78419444444444,-0.241554
9248,7194423,7,1,0.900187,253,7251564,-1,500.0,8538596,8538603,1344173,7,134,11,True,True,0.05148888888888889,-0.900187
9249,7194433,1000,4,0.414557,253,7251564,-1,2000.0,9050208,9051208,1855775,1000,112,7,True,True,111.19511111111112,-0.4106611285246226
9250,7195265,56,39,0.01553,253,7251564,-1,19500.0,14329802,14329858,7134537,56,14,12,True,True,44.0895,-0.01553
9251,7195429,2,16,0.153375,253,7251564,-1,8000.0,11091690,11091692,3896261,2,54,1,True,True,0.4136444444444444,-0.153375
9252,7196751,143,16,0.374406,253,7251564,-1,8000.0,10137983,10138126,2941232,143,70,12,True,True,12.253511111111111,-0.374406
9253,7200934,5663,2,0.816707,253,7251564,-1,1000.0,7875524,7881187,674590,5663,160,6,True,True,199.2436277777778,-0.7914893622927865
9254,7201056,70,1,0.820034,253,7251564,-1,500.0,7304083,7304153,103027,70,198,8,True,True,1.0066388888888889,-0.820034
9255,7201163,33,1,0.599946,253,7251564,-1,500.0,8261596,8261629,1060433,33,149,12,True,True,0.6908458333333333,-0.599946
9256,7201177,268,4,0.33509,253,7251564,-1,2000.0,7273515,7273783,72338,268,204,1,True,True,21.01864444444444,-0.33509
9257,7201192,24047,1,0.959161,253,7251564,-1,500.0,7353922,7377969,152730,24047,196,11,True,True,210.65930277777775,-0.925329048018105
9258,7201286,7837,32,0.992829,253,7251564,-1,16000.0,7403722,7411559,202436,7837,189,9,True,True,4015.8107999999997,-0.9687540698516227
9259,7201325,14831,4,0.241831,253,7251564,-1,2000.0,15072202,15087033,7870877,14831,3,12,True,True,311.29338333333334,-0.23780514752671922
9260,7201383,13,8,0.97349,253,7251564,-1,4000.0,7970973,7970986,769590,13,160,1,True,True,0.5981444444444444,-0.97349
9261,7201427,10394,8,0.19266,253,7251564,-1,4000.0,9570767,9581161,2369340,10394,89,2,True,True,1330.3101444444446,-0.17148282787986663
9262,7201607,11188,2,0.644434,253,7251564,-1,1000.0,9122622,9133810,1921015,11188,114,6,True,True,617.0554055555556,-0.6264007871587556
9263,7202871,7099,1,0.82855,253,7251564,-1,500.0,7404822,7411921,201951,7099,193,6,True,True,117.35627916666667,-0.8187702826145755
9264,7203063,5,18,0.801332,253,7251564,-1,9000.0,7363722,7363727,160659,5,199,7,True,True,1.07875,-0.801332
9265,7203165,11669,8,0.577854,253,7251564,-1,4000.0,10392883,10404552,3189718,11669,64,8,True,True,2135.167388888889,-0.5037061267492032
9266,7204406,19788,1,0.12887,253,7251564,-1,500.0,13518490,13538278,6314084,19788,29,12,True,True,409.033075,-0.1227383951027904
9267,7204441,44,1,0.636273,253,7251564,-1,500.0,9798783,9798827,2594342,44,85,6,True,True,0.4431777777777778,-0.636273
9268,7204550,13130,64,0.977356,253,7251564,-1,32000.0,7458146,7471276,253596,13130,192,6,True,True,19055.813333333335,-0.9729973937390215
9269,7204562,171,1,0.173717,253,7251564,-1,500.0,10573283,10573454,3368721,171,62,12,True,True,3.03335,-0.173717
9270,7204763,49,4,0.904171,253,7251564,-1,2000.0,7970924,7970973,766161,49,167,12,True,True,1.127272222222222,-0.904171
9271,7204775,8028,1,0.517277,253,7251564,-1,500.0,12911490,12919518,5706715,8028,36,12,True,True,74.511925,-0.48751319427486733
9272,7204795,58272,4,0.437402,253,7251564,-1,2000.0,11350890,11409162,4146095,58272,55,12,True,True,1445.1754666666664,-0.43528637351856886
9273,7204807,11697,256,0.099578,253,7251564,-1,128000.0,15258437,15270134,8053630,11697,0,1,True,True,95448.65315555554,-0.0974549770171766
9274,7207802,4,4,0.801172,253,7251564,-1,2000.0,8110396,8110400,902594,4,163,11,True,True,0.2753111111111111,-0.801172
9275,7208040,42,4,0.504257,253,7251564,-1,2000.0,11658690,11658732,4450650,42,52,12,True,True,3.0816333333333334,-0.504257
9276,7208206,7328,1,0.631441,253,7251564,-1,500.0,8293396,8300724,1085190,7328,155,1,True,True,165.6374166666667,-0.6189046800343094
9277,7208246,81,16,0.784281,253,7251564,-1,8000.0,7374522,7374603,166276,81,211,9,True,True,11.5452,-0.784281
9278,7209531,110,1,0.843031,253,7251564,-1,500.0,9248326,9248436,2038795,110,113,10,True,True,3.874619444444445,-0.7890257893379676
9279,7209617,635,32,0.627318,253,7251564,-1,16000.0,7408422,7409057,198805,635,206,1,True,True,340.54706666666664,-0.6221429408270337
9280,7209643,25,1,0.26023,253,7251564,-1,500.0,7310722,7310747,101079,25,219,8,True,True,0.8770138888888889,-0.26023
9281,7209667,9,8,0.552906,253,7251564,-1,4000.0,9078308,9078317,1868641,9,126,10,True,True,2.1378,-0.552906
9282,7209674,336,32,0.9487,253,7251564,-1,16000.0,9055608,9055944,1845934,336,128,8,True,True,287.6757333333333,-0.9487
9283,7209685,26645,16,0.203763,253,7251564,-1,8000.0,11005283,11031928,3795598,26645,62,11,True,True,9364.322755555555,-0.20104155141001961
9284,7209720,15299,64,0.093265,253,7251564,-1,32000.0,14053103,14068402,6843383,15299,20,8,True,True,4393.851644444445,-0.09162575147972728
9285,7209776,26,1,0.437421,253,7251564,-1,500.0,9847383,9847409,2637607,26,91,8,True,True,0.6768666666666666,-0.437421
9286,7210165,12871,16,0.628894,253,7251564,-1,8000.0,9121522,9134393,1911357,12871,127,11,True,True,5643.979066666667,-0.6134626094167184
9287,7210313,11079,64,0.593288,253,7251564,-1,32000.0,13345690,13356769,6135377,11079,33,12,True,True,5247.340088888888,-0.5245933128223303
9288,7210375,5745,32,0.027818,253,7251564,-1,16000.0,10962083,10967828,3751708,5745,65,11,True,True,4822.301066666667,-0.027062415738849637
9289,7210382,28,16,0.707576,253,7251564,-1,8000.0,12436290,12436318,5225908,28,44,12,True,True,2.5772444444444447,-0.707576
9290,7210418,167,32,0.920594,253,7251564,-1,16000.0,8593858,8594025,1383440,167,154,2,True,True,33.422266666666665,-0.920594
9291,7210473,1381,32,0.078773,253,7251564,-1,16000.0,11572290,11573671,4361817,1381,56,11,True,True,271.28977777777783,-0.078773
9292,7210951,22437,1,0.382405,253,7251564,-1,500.0,8713758,8736195,1502807,22437,150,11,True,True,455.433225,-0.3757339808708603
9293,7211068,2274,1,0.74234,253,7251564,-1,500.0,8320396,8322670,1109328,2274,167,10,True,True,46.3896,-0.74234
9294,7211177,56,22,0.130548,253,7251564,-1,11000.0,14047690,14047746,6836513,56,22,0,True,True,5.641533333333333,-0.130548
9295,7212319,6,8,0.453706,253,7251564,-1,4000.0,9476664,9476670,2264345,6,110,7,True,True,0.7244666666666667,-0.453706
9296,7212722,1338,4,0.631502,253,7251564,-1,2000.0,9473126,9474464,2260404,1338,112,10,True,True,74.71986666666666,-0.631502
9297,7212780,4929,4,0.358121,253,7251564,-1,2000.0,12522690,12527619,5309910,4929,45,12,True,True,205.40543333333335,-0.35536717905526893
9298,7212857,57,8,0.239722,253,7251564,-1,4000.0,9294826,9294883,2081969,57,122,7,True,True,4.249666666666666,-0.239722
9299,7212939,2,8,0.897909,253,7251564,-1,4000.0,7383922,7383924,170983,2,229,2,True,True,0.12557777777777776,-0.897909
9300,7213145,15255,32,0.296923,253,7251564,-1,16000.0,14157002,14172257,6943857,15255,18,7,True,True,2669.6950666666667,-0.2848613265073894
9301,7213246,15842,225,0.535417,253,7251564,-1,112500.0,14068402,14084244,6855156,15842,20,7,True,True,16503.233125000002,-0.5176750844124594
9302,7214147,27,1,0.245254,253,7251564,-1,500.0,10164983,10165010,2950836,27,86,8,True,True,0.3378375,-0.245254
9303,7214162,3,4,0.780029,253,7251564,-1,2000.0,7717724,7717727,503562,3,209,11,True,True,0.08315,-0.780029
9304,7214384,351,2,0.786048,253,7251564,-1,1000.0,7273164,7273515,58780,351,252,10,True,True,13.764075,-0.786048
6365,4996152,288,8,0.943162,1,4996152,-1,4000.0,5082552,5082840,86400,288,0,12,True,True,47.5424,-0.943162
6366,4996383,9,1,0.724234,199,5082552,-1,500.0,5897573,5897582,901190,9,0,7,True,True,0.168225,-0.724234
6367,4996738,11299,256,0.14056,199,5082552,-1,128000.0,9040993,9052292,4044255,11299,0,2,True,True,50205.25048888889,-0.13838551239872343
6368,4996862,19,8,0.111932,199,5082552,-1,4000.0,9006558,9006577,4009696,19,1,6,True,True,6.9630777777777775,-0.111932
6369,4997024,11651,2,0.73448,199,5082552,-1,1000.0,5443991,5455642,446967,11651,3,10,True,True,307.38929999999993,-0.7324194723476222
6370,4998240,68,32,0.932935,199,5082552,-1,16000.0,5411620,5411688,413380,68,4,6,True,True,40.074666666666666,-0.932935
6371,4998380,9,2,0.521958,199,5082552,-1,1000.0,5152081,5152090,153701,9,5,7,True,True,0.38310000000000005,-0.521958
6372,5001282,11,1,0.828982,199,5082552,-1,500.0,6145073,6145084,1143791,11,2,7,True,True,0.212575,-0.828982
6373,5001393,8013,2,0.949675,199,5082552,-1,1000.0,5517591,5525604,516198,8013,4,7,True,True,187.37595,-0.9414949016475581
6374,5003634,1429,2,0.931556,199,5082552,-1,1000.0,5136552,5137981,132918,1429,8,8,True,True,62.0043,-0.904255219710597
6375,5003672,396,11,0.251808,199,5082552,-1,5500.0,6191573,6191969,1187901,396,2,11,True,True,66.79804999999999,-0.251808
6376,5003800,518,4,0.884565,199,5082552,-1,2000.0,5513191,5513709,509391,518,6,9,True,True,21.00777777777778,-0.884565
6377,5003985,4,16,0.238077,199,5082552,-1,8000.0,8976766,8976770,3972781,4,2,2,True,True,0.8700444444444444,-0.238077
6378,5004083,382,8,0.122277,199,5082552,-1,4000.0,8979922,8980304,3975839,382,2,2,True,True,70.35591111111111,-0.122277
6379,5004332,179,1,0.806687,199,5082552,-1,500.0,5420191,5420370,415859,179,10,1,True,True,2.1263708333333335,-0.806687
6380,5004346,342,1,0.329286,199,5082552,-1,500.0,7270164,7270506,2265818,342,4,0,True,True,5.50145,-0.329286
6381,5004375,7617,128,0.584326,199,5082552,-1,64000.0,6388173,6395790,1383798,7617,5,10,True,True,21269.742399999996,-0.562011825721405
6382,5004770,7207,53,0.389951,199,5082552,-1,26500.0,8390129,8397336,3385359,7207,4,0,True,True,14166.276661111113,-0.37822678621461225
6383,5008217,92,1,0.748374,199,5082552,-1,500.0,5919173,5919265,910956,92,9,10,True,True,2.0715333333333334,-0.748374
6384,5008449,72,16,0.235938,199,5082552,-1,8000.0,7567863,7567935,2559414,72,5,8,True,True,22.424000000000003,-0.235938
6385,5008526,6200,16,0.422869,199,5082552,-1,8000.0,7672501,7678701,2663975,6200,5,6,True,True,1926.026688888889,-0.42068672573792937
6386,5008573,5,8,0.144278,199,5082552,-1,4000.0,7610163,7610168,2601590,5,6,2,True,True,0.8772222222222222,-0.144278
6387,5009035,112,4,0.175154,199,5082552,-1,2000.0,9107892,9108004,4098857,112,0,11,True,True,19.88531111111111,-0.17337748140060708
6388,5009187,92,16,0.969923,199,5082552,-1,8000.0,6011073,6011165,1001886,92,13,10,True,True,31.940355555555556,-0.969923
6389,5011695,36736,16,0.439475,199,5082552,-1,8000.0,8915866,8952602,3904171,36736,5,11,True,True,13414.100444444444,-0.4306862662295307
6390,5012350,143,32,0.254306,199,5082552,-1,16000.0,8997471,8997614,3985121,143,3,2,True,True,137.98546666666667,-0.254306
6391,5012445,12,8,0.589481,199,5082552,-1,4000.0,6517773,6517785,1505328,12,12,11,True,True,2.0053333333333336,-0.589481
6392,5013079,28,4,0.490359,199,5082552,-1,2000.0,6056473,6056501,1043394,28,16,7,True,True,2.965822222222222,-0.490359
6393,5013666,39,64,0.374705,199,5082552,-1,32000.0,9205592,9205631,4191926,39,0,6,True,True,82.992,-0.374705
6394,5035595,4,1,0.948711,199,5082552,-1,500.0,5611702,5611706,576107,4,21,8,True,True,0.04571666666666667,-0.948711
6395,5035616,49,1,0.31649,199,5082552,-1,500.0,7597163,7597212,2561547,49,11,6,True,True,0.9927944444444443,-0.31649
6396,5035632,6541,32,0.423781,199,5082552,-1,16000.0,5743502,5750043,707870,6541,22,11,True,True,2686.397688888889,-0.4051788159198929
6397,5035672,13689,1,0.682738,199,5082552,-1,500.0,6539373,6553062,1503701,13689,14,10,True,True,182.3050125,-0.5872126725017635
6398,5035701,48,4,0.963315,199,5082552,-1,2000.0,5137981,5138029,102280,48,31,1,True,True,4.2912,-0.963315
6399,5038555,27,25,0.879434,199,5082552,-1,12500.0,5700302,5700329,661747,27,24,7,True,True,8.955,-0.879434
6400,5039384,9,8,0.936972,199,5082552,-1,4000.0,5343950,5343959,304566,9,31,1,True,True,0.8199,-0.936972
6401,5039437,4609,128,0.362998,199,5082552,-1,64000.0,9017758,9022367,3978321,4609,3,8,True,True,27373.94702222222,-0.36178517806615396
6402,5039447,15719,8,0.715671,199,5082552,-1,4000.0,7606563,7622282,2567116,15719,12,7,True,True,2775.0729444444446,-0.7061511424920343
6403,5039464,2,1,0.821365,199,5082552,-1,500.0,6618833,6618835,1579369,2,16,1,True,True,0.044458333333333336,-0.821365
6404,5039486,489,1,0.021074,199,5082552,-1,500.0,5988373,5988862,948887,489,24,7,True,True,13.715770833333332,-0.021074
6405,5039769,60,1,0.966805,199,5082552,-1,500.0,5299645,5299705,259876,60,36,1,True,True,1.3655833333333334,-0.966805
6406,5039891,10,4,0.605815,199,5082552,-1,2000.0,7897601,7897611,2857710,10,10,2,True,True,0.9161666666666667,-0.605815
6407,5039964,11,2,0.841473,199,5082552,-1,1000.0,6142873,6142884,1102909,11,23,12,True,True,0.42515,-0.841473
6408,5040154,8196,8,0.662223,199,5082552,-1,4000.0,6146173,6154369,1106019,8196,22,6,True,True,1300.6674333333333,-0.6512526374296336
6409,5040184,9272,1,0.940848,199,5082552,-1,500.0,5465591,5474863,425407,9272,35,10,True,True,118.27660694444444,-0.9380310261706107
6410,5040190,24297,78,0.690682,199,5082552,-1,39000.0,7613763,7638060,2573573,24297,12,2,True,True,53988.49235000001,-0.6628534108190838
6411,5040213,572,8,0.788803,199,5082552,-1,4000.0,5808973,5809545,768760,572,31,2,True,True,67.04475555555555,-0.788803
6412,5040272,2900,64,0.239676,199,5082552,-1,32000.0,8044529,8047429,3004257,2900,10,6,True,True,7655.4983111111105,-0.23639690272055333
6413,5040327,32,2,0.552728,199,5082552,-1,1000.0,7270164,7270196,2229837,32,19,0,True,True,1.029511111111111,-0.552728
6414,5040396,7193,1,0.309269,199,5082552,-1,500.0,5606302,5613495,565906,7193,37,7,True,True,74.04423888888888,-0.2654255441653729
6415,5040423,9,8,0.958484,199,5082552,-1,4000.0,6542973,6542982,1502550,9,21,1,True,True,0.6949,-0.958484
6416,5040900,48,4,0.362855,199,5082552,-1,2000.0,7600763,7600811,2559863,48,16,3,True,True,3.636266666666667,-0.362855
6417,5040909,7,64,0.81225,199,5082552,-1,32000.0,6256373,6256380,1215464,7,26,11,True,True,7.021155555555556,-0.81225
6418,5041154,752,8,0.122054,199,5082552,-1,4000.0,9203392,9204144,4162238,752,1,7,True,True,140.33991111111112,-0.122054
6419,5041162,10,1,0.866953,199,5082552,-1,500.0,5154538,5154548,113376,10,50,1,True,True,0.21283333333333335,-0.866953
6420,5041194,39,32,0.857647,199,5082552,-1,16000.0,7291464,7291503,2250270,39,20,3,True,True,21.94226666666667,-0.857647
6421,5046220,1,16,0.388471,199,5082552,-1,8000.0,8217329,8217330,3171109,1,11,0,True,True,0.4922666666666667,-0.388471
6422,5046284,15625,4,0.909789,199,5082552,-1,2000.0,5765102,5780727,718818,15625,40,10,True,True,806.7329666666666,-0.8946199628535195
6423,5046317,3,1,0.392976,199,5082552,-1,500.0,7666001,7666004,2619684,3,15,2,True,True,0.05882500000000001,-0.392976
6424,5046332,6729,4,0.977993,199,5082552,-1,2000.0,6148373,6155102,1102041,6729,32,7,True,True,542.2735833333334,-0.9685936885866318
6425,5046363,260,1,0.255534,199,5082552,-1,500.0,6618573,6618833,1572210,260,26,10,True,True,5.779583333333333,-0.255534
6426,5046749,11,9,0.09025,199,5082552,-1,4500.0,9056692,9056703,4009943,11,3,6,True,True,1.3250875,-0.09025
6427,5046809,257,1,0.822708,199,5082552,-1,500.0,5154281,5154538,107472,257,58,7,True,True,5.469816666666667,-0.822708
6428,5046913,11,32,0.23546,199,5082552,-1,16000.0,8969866,8969877,3922953,11,10,11,True,True,4.877644444444445,-0.23546
6429,5047043,14,4,0.210386,199,5082552,-1,2000.0,9255992,9256006,4208949,14,0,11,True,True,1.968711111111111,-0.210386
6430,5047140,22571,16,0.890247,199,5082552,-1,8000.0,5131152,5153723,84012,22571,64,8,True,True,8100.126666666667,-0.8814145637846388
6431,5047202,6,8,0.915891,199,5082552,-1,4000.0,5560902,5560908,513700,6,51,7,True,True,0.5962666666666667,-0.915891
6432,5047254,11,12,0.631353,199,5082552,-1,6000.0,7671401,7671412,2624147,11,18,8,True,True,2.6488,-0.631353
6433,5048161,10364,23,0.879467,199,5082552,-1,11500.0,5989473,5999837,941312,10364,43,6,True,True,8467.12915,-0.8744271255433207
6434,5048205,473,2,0.766741,199,5082552,-1,1000.0,6596973,6597446,1548768,473,31,8,True,True,29.078988888888887,-0.766741
6435,5048623,20,54,0.406289,199,5082552,-1,27000.0,8989471,8989491,3940848,20,9,7,True,True,47.823,-0.406289
6436,5048678,9806,32,0.033882,199,5082552,-1,16000.0,9525992,9535798,4477314,9806,0,12,True,True,10977.489688888889,-0.03347076200554977
6437,5049119,1583,2,0.866445,199,5082552,-1,1000.0,5515391,5516974,466272,1583,58,7,True,True,32.952783333333336,-0.866445
6438,5049130,11094,128,0.823198,199,5082552,-1,64000.0,8476966,8488060,3427836,11094,15,12,True,True,39799.32088888889,-0.8060261228726407
6439,5049135,11,80,0.940495,199,5082552,-1,40000.0,5803173,5803184,754038,11,52,7,True,True,9.444111111111111,-0.940495
6440,5049317,7704,256,0.471091,199,5082552,-1,128000.0,8981767,8989471,3932450,7704,11,2,True,True,65767.47733333333,-0.3858650481400351
6441,5049589,6,8,0.412961,199,5082552,-1,4000.0,8991671,8991677,3942082,6,10,6,True,True,2.1254666666666666,-0.412961
6442,5049619,15133,8,0.841163,199,5082552,-1,4000.0,5293845,5308978,244226,15133,70,6,True,True,2614.918622222222,-0.8406336718477565
6443,5049809,7295,16,0.717386,199,5082552,-1,8000.0,6586173,6593468,1536364,7295,37,11,True,True,3211.0179333333335,-0.6846108648992694
6444,5050464,16097,1,0.876761,199,5082552,-1,500.0,5395850,5411947,345386,16097,69,6,True,True,296.22759722222224,-0.8740960022686515
6445,5050620,3608,128,0.820241,199,5082552,-1,64000.0,5249545,5253153,198925,3608,73,7,True,True,7595.590222222221,-0.795898031902526
6446,5050703,99,4,0.824401,199,5082552,-1,2000.0,5986173,5986272,935470,99,52,7,True,True,11.42735,-0.824401
6447,5050777,49,2,0.698482,199,5082552,-1,1000.0,7293463,7293512,2242686,49,31,2,True,True,1.7230305555555554,-0.698482
6448,5050915,24920,64,0.506335,199,5082552,-1,32000.0,9204492,9229412,4153577,24920,3,6,True,True,40610.01422222222,-0.496717890491366
6449,5051602,7919,2,0.351856,199,5082552,-1,1000.0,8990571,8998490,3938969,7919,12,6,True,True,581.5171333333334,-0.32988268345762806
6450,5051620,4940,16,0.602116,199,5082552,-1,8000.0,7954829,7959769,2903209,4940,23,8,True,True,1709.3394666666666,-0.591966988654462
6451,5051644,11891,128,0.813428,199,5082552,-1,64000.0,7596063,7607954,2544419,11891,33,7,True,True,30564.66062222222,-0.7889746177050048
6452,5051662,10,32,0.737786,199,5082552,-1,16000.0,7553763,7553773,2502101,10,35,10,True,True,7.269777777777778,-0.737786
6453,5051696,12002,128,0.453262,199,5082552,-1,64000.0,9053392,9065394,4001696,12002,7,6,True,True,22023.191822222223,-0.39315701225013244
6454,5051826,9,28,0.027351,199,5082552,-1,14000.0,9061392,9061401,4009566,9,6,2,True,True,3.59485,-0.027351
6455,5051887,12955,4,0.052099,199,5082552,-1,2000.0,8872666,8885621,3820779,12955,21,10,True,True,684.5893722222223,-0.05150952554958614
6456,5051994,549,1,0.641593,199,5082552,-1,500.0,5962373,5962922,910379,549,62,11,True,True,15.7616375,-0.641593
6457,5052030,7192,8,0.630156,199,5082552,-1,4000.0,5247345,5254537,195315,7192,85,10,True,True,949.4052777777778,-0.6251577726478619
6458,5052093,9,1,0.791019,199,5082552,-1,500.0,6726833,6726842,1674740,9,43,10,True,True,0.1763625,-0.791019
6459,5053167,300,16,0.136092,199,5082552,-1,8000.0,7287864,7288164,2234697,300,41,6,True,True,81.95333333333333,-0.136092
6460,5053192,11523,32,0.400662,199,5082552,-1,16000.0,7423063,7434586,2369871,11523,39,12,True,True,6097.760577777778,-0.34325570837235037
6461,5053311,60,4,0.628296,199,5082552,-1,2000.0,8043429,8043489,2990118,60,26,12,True,True,10.036666666666667,-0.628296
6462,5053321,42,1,0.313722,199,5082552,-1,500.0,9002171,9002213,3948850,42,12,2,True,True,1.70625,-0.313722
6463,5053390,9387,32,0.082232,199,5082552,-1,16000.0,8993871,9003258,3940481,9387,14,7,True,True,10609.8668,-0.07990074853890713
6464,5053409,409,1,0.157822,199,5082552,-1,500.0,9003258,9003667,3949849,409,12,2,True,True,16.96300138888889,-0.1428858668722207
6465,5053471,669,40,0.516366,199,5082552,-1,20000.0,7673601,7674270,2620130,669,32,6,True,True,530.0338333333333,-0.516366
6466,5053478,1370,4,0.969665,199,5082552,-1,2000.0,5394750,5396120,341272,1370,89,10,True,True,100.51994444444443,-0.969665
6467,5053524,4,1,0.830621,199,5082552,-1,500.0,7424163,7424167,2370639,4,44,6,True,True,0.055822222222222224,-0.830621
6468,5053546,607,1,0.763163,199,5082552,-1,500.0,5225138,5225745,171592,607,96,1,True,True,12.86249861111111,-0.763163
6469,5053558,18448,160,0.84696,199,5082552,-1,80000.0,5544602,5563050,491044,18448,82,1,True,True,36204.064000000006,-0.8319740152601769
6470,5053616,14,16,0.685753,199,5082552,-1,8000.0,6591573,6591587,1537957,14,55,8,True,True,6.357555555555555,-0.685753
6471,5053649,94,1,0.792642,199,5082552,-1,500.0,6705233,6705327,1651584,94,52,12,True,True,3.599155555555556,-0.792642
6472,5053681,194,8,0.319399,199,5082552,-1,4000.0,8390566,8390760,3336885,194,26,1,True,True,61.15742222222223,-0.319399
6473,5053696,1791,8,0.478365,199,5082552,-1,4000.0,7660343,7662134,2606647,1791,37,1,True,True,308.7371111111111,-0.44076251359143587
6474,5054011,14447,128,0.735172,199,5082552,-1,64000.0,7846401,7860848,2792390,14447,33,12,True,True,47913.18826666667,-0.7293924527531287
6475,5054052,7887,29,0.26068,199,5082552,-1,14500.0,6342773,6350660,1288721,7887,65,12,True,True,5591.2985194444445,-0.25999873649979893
6476,5054099,10840,32,0.687467,199,5082552,-1,16000.0,8606566,8617406,3552467,10840,25,11,True,True,6242.261422222223,-0.6781377850225884
6477,5054492,21,8,0.826769,199,5082552,-1,4000.0,5125752,5125773,71260,21,111,11,True,True,4.249233333333334,-0.826769
6478,5055358,13301,128,0.799529,199,5082552,-1,64000.0,5780727,5794028,725369,13301,83,2,True,True,18070.813155555556,-0.7154585460065919
6479,5055377,15508,140,0.198664,199,5082552,-1,70000.0,9022367,9037875,3966990,15508,10,6,True,True,65303.97338888889,-0.18780365782083702
6480,5055439,17,16,0.414496,199,5082552,-1,8000.0,8785866,8785883,3730427,17,26,6,True,True,3.835577777777778,-0.414496
6481,5055712,8,16,0.181889,199,5082552,-1,8000.0,8829066,8829074,3773354,8,26,11,True,True,1.9505777777777777,-0.181889
6482,5055757,3,8,0.87639,199,5082552,-1,4000.0,5983973,5983976,928216,3,81,10,True,True,0.6925666666666668,-0.87639
6483,5055783,1034,4,0.944757,199,5082552,-1,2000.0,5895373,5896407,839590,1034,85,12,True,True,82.0479,-0.944757
6484,5056411,109,2,0.884341,199,5082552,-1,1000.0,6960133,6960242,1903722,109,58,9,True,True,3.775638888888889,-0.884341
6485,5056458,266,9,0.224487,199,5082552,-1,4500.0,7859401,7859667,2802943,266,37,7,True,True,59.7303,-0.224487
6486,5056472,345,8,0.948109,199,5082552,-1,4000.0,5399720,5400065,343248,345,105,2,True,True,50.504,-0.9310744523605817
6487,5056902,18,10,0.923112,199,5082552,-1,5000.0,5604102,5604120,547200,18,96,11,True,True,1.2605000000000002,-0.9231120000000003
6488,5057043,9038,32,0.647107,199,5082552,-1,16000.0,7656963,7666001,2599920,9038,44,10,True,True,6315.826000000001,-0.5776735586747052
6489,5058075,16,1,0.626627,199,5082552,-1,500.0,7132964,7132980,2074889,16,60,1,True,True,0.2557111111111111,-0.626627
6490,5058146,12,7,0.906845,199,5082552,-1,3500.0,5794028,5794040,735882,12,92,2,True,True,0.6707166666666667,-0.906845
6491,5058434,553,4,0.974128,199,5082552,-1,2000.0,5346150,5346703,287716,553,112,6,True,True,25.345833333333335,-0.974128
6492,5058632,386,1,0.198266,199,5082552,-1,500.0,9005458,9005844,3946826,386,13,7,True,True,17.682552777777776,-0.198266
6493,5058801,18,16,0.701261,199,5082552,-1,8000.0,7591663,7591681,2532862,18,52,6,True,True,5.2828,-0.701261
6494,5058827,10593,1,0.168756,199,5082552,-1,500.0,9434192,9444785,4375365,10593,1,11,True,True,365.00279722222217,-0.15475420531968623
6495,5058866,27,16,0.401035,199,5082552,-1,8000.0,7510563,7510590,2451697,27,56,12,True,True,7.497599999999999,-0.401035
6496,5058919,16733,1,0.428903,199,5082552,-1,500.0,9063592,9080325,4004673,16733,7,6,True,True,643.2505805555556,-0.3876110067775426
6497,5058961,39,1,0.260158,199,5082552,-1,500.0,8736166,8736205,3677205,39,31,11,True,True,0.5240083333333333,-0.260158
6498,5059497,36,30,0.089061,199,5082552,-1,15000.0,9209192,9209228,4149695,36,3,2,True,True,33.071999999999996,-0.08906099999999999
6499,5059573,159,16,0.36792,199,5082552,-1,8000.0,7861601,7861760,2802028,159,42,7,True,True,63.47279999999999,-0.36792
6500,5059943,270,8,0.947244,199,5082552,-1,4000.0,5502391,5502661,442448,270,113,7,True,True,19.344,-0.947244
6501,5059974,12,1,0.117351,199,5082552,-1,500.0,8303729,8303741,3243755,12,37,12,True,True,0.30861666666666665,-0.117351
6502,5060092,437,64,0.718583,199,5082552,-1,32000.0,8390129,8390566,3330037,437,37,12,True,True,1102.0945777777779,-0.718583
6503,5060119,11,3,0.435159,199,5082552,-1,1500.0,7867001,7867012,2806882,11,44,8,True,True,1.0220375000000002,-0.435159
6504,5060145,147,4,0.919989,199,5082552,-1,2000.0,5178338,5178485,118193,147,131,10,True,True,18.388066666666667,-0.919989
6505,5060291,12470,16,0.453708,199,5082552,-1,8000.0,5221538,5234008,161247,12470,131,11,True,True,4277.495288888889,-0.45156480929766296
6506,5060401,102,1,0.67361,199,5082552,-1,500.0,5558702,5558804,498301,102,112,7,True,True,1.2670666666666666,-0.67361
6507,5060515,81,1,0.118512,199,5082552,-1,500.0,8692966,8693047,3632451,81,33,12,True,True,1.1935125,-0.118512
6508,5064225,9,1,0.713564,199,5082552,-1,500.0,5367750,5367759,303525,9,126,10,True,True,0.1566875,-0.713564
6509,5064232,10831,16,0.190544,199,5082552,-1,8000.0,9055592,9066423,3991360,10831,11,7,True,True,2637.5885555555556,-0.17269258793888828
6510,5064330,156,2,0.861937,199,5082552,-1,1000.0,5556502,5556658,492172,156,115,9,True,True,3.7128000000000005,-0.861937
6511,5064361,26471,64,0.782122,199,5082552,-1,32000.0,5770902,5797373,706541,26471,107,2,True,True,19822.015288888888,-0.7713393689852983
6512,5064423,8,16,0.287962,199,5082552,-1,8000.0,7857201,7857209,2792778,8,49,9,True,True,3.3920000000000003,-0.287962
6513,5064462,9,1,0.494168,199,5082552,-1,500.0,7760001,7760010,2695539,9,51,12,True,True,0.17565000000000003,-0.494168
6514,5064563,1019,21,0.130199,199,5082552,-1,10500.0,9010158,9011177,3945595,1019,16,2,True,True,920.8092541666667,-0.1298425464504476
6515,5064589,14234,128,0.856338,199,5082552,-1,64000.0,6906133,6920367,1841544,14234,78,6,True,True,26194.315022222218,-0.8456076688191148
6516,5064614,13897,4,0.600083,199,5082552,-1,2000.0,7590563,7604460,2525949,13897,66,10,True,True,1065.5537722222223,-0.5886476260407567
6517,5064685,14,8,0.995207,199,5082552,-1,4000.0,5420177,5420191,355492,14,130,2,True,True,1.3304666666666667,-0.995207
6518,5064931,36,2,0.282967,199,5082552,-1,1000.0,7226964,7227000,2162033,36,77,8,True,True,1.2375,-0.282967
6519,5064959,9070,16,0.677189,199,5082552,-1,8000.0,5148781,5157851,83822,9070,149,8,True,True,3106.809911111111,-0.6741235956341178
6520,5065030,92,1,0.418331,199,5082552,-1,500.0,7604363,7604455,2539333,92,62,2,True,True,1.8817833333333336,-0.418331
6521,5065053,8649,5,0.408524,199,5082552,-1,2500.0,7562463,7571112,2497410,8649,69,8,True,True,855.8225000000001,-0.40006523039751823
6522,5065866,10726,1,0.145943,199,5082552,-1,500.0,9299192,9309918,4233326,10726,2,11,True,True,232.18984999999998,-0.10790067865568993
6523,5066942,114,32,0.290193,199,5082552,-1,16000.0,5149881,5149995,82939,114,152,6,True,True,80.39786666666667,-0.290193
6524,5067190,7978,1,0.261799,199,5082552,-1,500.0,7221564,7229542,2154374,7978,81,7,True,True,141.48914722222224,-0.2579574185967875
6525,5067817,271,1,0.61768,199,5082552,-1,500.0,7635363,7635634,2567546,271,60,10,True,True,9.52707361111111,-0.4743933514440767
6526,5067939,8,2,0.907328,199,5082552,-1,1000.0,5156738,5156746,88799,8,151,7,True,True,0.3345333333333333,-0.907328
6527,5068033,7742,128,0.369638,199,5082552,-1,64000.0,9196492,9204234,4128459,7742,8,12,True,True,34796.64711111112,-0.3246933091639528
6528,5068245,1090,16,0.684267,199,5082552,-1,8000.0,7659163,7660253,2590918,1090,60,7,True,True,407.85377777777774,-0.684267
6529,5068303,4704,1,0.458164,199,5082552,-1,500.0,7957029,7961733,2888726,4704,47,7,True,True,100.1734,-0.4563929196437095
6530,5068311,8315,32,0.01032,199,5082552,-1,16000.0,9062492,9070807,3994181,8315,11,6,True,True,6614.643733333333,-0.00901765102996637
6531,5068393,5,1,0.133205,199,5082552,-1,500.0,5343945,5343950,275552,5,148,11,True,True,0.0569375,-0.133205
6532,5068451,6988,8,0.323246,199,5082552,-1,4000.0,8563366,8570354,3494915,6988,40,12,True,True,899.5166222222222,-0.31593039621946845
6533,5068510,404,1,0.693024,199,5082552,-1,500.0,6949333,6949737,1880823,404,90,11,True,True,7.007716666666667,-0.693024
6534,5068560,16577,16,0.686852,199,5082552,-1,8000.0,5487191,5503768,418631,16577,139,9,True,True,2472.396022222222,-0.6832167807682794
6535,5070297,55,8,0.713336,199,5082552,-1,4000.0,7593863,7593918,2523566,55,73,7,True,True,8.042222222222222,-0.713336
6536,5070488,21,16,0.708453,199,5082552,-1,8000.0,5422391,5422412,351903,21,143,7,True,True,3.7492000000000005,-0.708453
6537,5070530,24,64,0.736104,199,5082552,-1,32000.0,7270164,7270188,2199634,24,87,11,True,True,24.708266666666667,-0.736104
6538,5070562,127,3,0.256226,199,5082552,-1,1500.0,9024567,9024694,3954005,127,17,7,True,True,17.55880833333333,-0.256226
6539,5070647,163,16,0.095279,199,5082552,-1,8000.0,9197592,9197755,4126945,163,8,6,True,True,107.75024444444445,-0.095279
6540,5070842,18,2,0.058752,199,5082552,-1,1000.0,6054273,6054291,983431,18,115,11,True,True,1.05055,-0.058752
6541,5071043,9435,128,0.332863,199,5082552,-1,64000.0,9612392,9621827,4541349,9435,0,12,True,True,48238.379555555555,-0.3312098126381155
6542,5071157,12,2,0.234841,199,5082552,-1,1000.0,7046533,7046545,1975376,12,94,12,True,True,0.4043666666666667,-0.234841
6543,5071348,14173,32,0.908227,199,5082552,-1,16000.0,7894001,7908174,2822653,14173,55,8,True,True,9532.758177777778,-0.8763041846091764
6544,5075723,4,5,0.996739,199,5082552,-1,2500.0,5396120,5396124,320397,4,155,1,True,True,0.3668611111111111,-0.996739
6545,5075965,6144,4,0.939322,199,5082552,-1,2000.0,5345050,5351194,269085,6144,160,6,True,True,287.8750888888889,-0.9123672455809734
6546,5075987,14922,11,0.96721,199,5082552,-1,5500.0,5300745,5315667,224758,14922,163,6,True,True,3382.6307166666666,-0.9411122320540651
6547,5076045,16635,1,0.598232,199,5082552,-1,500.0,7219364,7235999,2143319,16635,94,12,True,True,296.9795,-0.5966156776573628
6548,5076650,191,16,0.748242,199,5082552,-1,8000.0,6899633,6899824,1822983,191,100,11,True,True,34.507333333333335,-0.748242
6549,5077402,8956,1,0.045512,199,5082552,-1,500.0,8970966,8979922,3893564,8956,35,6,True,True,137.8023472222222,-0.039746177566973115
6550,5077548,1352,24,0.253657,199,5082552,-1,12000.0,9439592,9440944,4362044,1352,2,8,True,True,999.7138666666666,-0.253657
6551,5077564,570,1,0.619658,199,5082552,-1,500.0,7291503,7292073,2213939,570,89,1,True,True,10.021708333333333,-0.619658
6552,5077611,21,1,0.302507,199,5082552,-1,500.0,8779366,8779387,3701755,21,42,11,True,True,0.29152083333333334,-0.302507
6553,5078099,8601,32,0.394697,199,5082552,-1,16000.0,8973166,8981767,3895067,8601,36,7,True,True,4781.232711111111,-0.3866938997444433
6554,5080001,6699,16,0.370901,199,5082552,-1,8000.0,7286764,7293463,2206763,6699,94,2,True,True,1858.1836666666668,-0.3706787211421989
6555,5080498,12679,4,0.968058,199,5082552,-1,2000.0,5143381,5156060,62883,12679,185,8,True,True,1145.0778611111114,-0.9186944311528107
6556,5080698,22,8,0.55956,199,5082552,-1,4000.0,8784766,8784788,3704068,22,43,8,True,True,2.4818444444444445,-0.55956
6557,5080742,9657,4,0.580487,199,5082552,-1,2000.0,5410520,5420177,329778,9657,163,9,True,True,584.7755611111112,-0.5135683942437633
6558,5080766,5194,9,0.260292,199,5082552,-1,4500.0,6905033,6910227,1824267,5194,107,8,True,True,652.2047,-0.2562687916757917
6559,5080810,21,1,0.503747,199,5082552,-1,500.0,9012358,9012379,3931548,21,23,7,True,True,0.9061208333333334,-0.503747
6560,5080885,14224,7,0.930327,199,5082552,-1,3500.0,5800973,5815197,720088,14224,141,2,True,True,1316.3225444444445,-0.9272446669454781
6561,5080936,29582,64,0.877897,199,5082552,-1,32000.0,5774502,5804084,693566,29582,144,2,True,True,21257.237333333334,-0.8465113964894024
6562,5081138,12826,2,0.13192,199,5082552,-1,1000.0,9028167,9040993,3947029,12826,20,2,True,True,515.1982527777777,-0.09910564605876421
6563,5081581,2,1,0.317317,199,5082552,-1,500.0,8845666,8845668,3764085,2,43,8,True,True,0.032825,-0.317317
6564,5082006,14,128,0.530424,199,5082552,-1,64000.0,7901201,7901215,2819195,14,62,2,True,True,37.208888888888886,-0.530424
6565,5083355,53,1,0.141796,219,5125752,-1,500.0,9057792,9057845,3974437,53,16,6,True,True,0.7494347222222222,-0.141796
6566,5085337,14785,1,0.116842,219,5125752,-1,500.0,9212792,9227577,4127455,14785,6,3,True,True,339.67986249999996,-0.11462841197088336
6567,5086109,6977,1,0.044162,219,5125752,-1,500.0,7557063,7564040,2470954,6977,93,6,True,True,149.9387763888889,-0.043706405842349735
6568,5089938,60780,1,0.127871,219,5125752,-1,500.0,9110092,9170872,4020154,60780,13,7,True,True,1493.5410722222223,-0.12173006225189581
6569,5090018,12981,16,0.87168,219,5125752,-1,8000.0,5500191,5513172,410173,12981,167,7,True,True,1920.3396666666667,-0.852128587149836
6570,5091684,9524,128,0.834804,219,5125752,-1,64000.0,5476391,5485915,384707,9524,169,9,True,True,15606.724266666668,-0.8272420344954213
6571,5094406,6929,64,0.747823,219,5125752,-1,32000.0,7555963,7562892,2461557,6929,95,7,True,True,9683.788177777777,-0.7220047847829738
6572,5095444,3,1,0.926237,219,5125752,-1,500.0,5416647,5416650,321203,3,176,6,True,True,0.04077916666666667,-0.926237
6573,5095553,8195,223,0.282926,219,5125752,-1,111500.0,8217329,8225524,3121776,8195,61,12,True,True,71266.65591666667,-0.27943166242382694
6574,5096599,12262,1,0.876936,219,5125752,-1,500.0,5497991,5510253,401392,12262,170,9,True,True,111.95413888888889,-0.8749518331784953
6575,5096743,32,8,0.612932,219,5125752,-1,4000.0,7336663,7336695,2239920,32,101,10,True,True,4.680533333333333,-0.612932
6576,5097070,5,32,0.761564,219,5125752,-1,16000.0,6366573,6366578,1269503,5,131,10,True,True,2.1515555555555554,-0.761564
6577,5100341,7807,1,0.263758,219,5125752,-1,500.0,8834466,8842273,3734125,7807,47,8,True,True,113.74468333333334,-0.2515549065481354
6578,5100628,80,2,0.31301,219,5125752,-1,1000.0,7660263,7660343,2559635,80,81,6,True,True,3.7417777777777776,-0.31301
6579,5100698,194,1,0.892672,219,5125752,-1,500.0,5539191,5539385,438493,194,169,10,True,True,2.5276583333333336,-0.892672
6580,5100889,10353,16,0.315543,219,5125752,-1,8000.0,9304592,9314945,4203703,10353,4,8,True,True,5470.172511111111,-0.2905117421877909
6581,5100985,72,32,0.994565,219,5125752,-1,16000.0,5292745,5292817,191760,72,199,11,True,True,46.726400000000005,-0.994565
6582,5101113,67,1,0.763675,219,5125752,-1,500.0,6856433,6856500,1755320,67,123,12,True,True,1.0004402777777777,-0.763675
6583,5101574,67,1,0.151265,219,5125752,-1,500.0,9030367,9030434,3928793,67,24,7,True,True,1.4445944444444445,-0.151265
6584,5101901,4297,16,0.853034,219,5125752,-1,8000.0,5296045,5300342,194144,4297,200,7,True,True,1488.2150888888887,-0.8201620134674028
6585,5102944,20125,156,0.657419,219,5125752,-1,78000.0,8130929,8151054,3027985,20125,65,12,True,True,144755.73948333334,-0.6547678583867885
6586,5128242,32,1,0.79822,224,5131152,-1,500.0,5545702,5545734,417460,32,172,6,True,True,0.40693333333333337,-0.79822
6587,5128271,14108,1,0.053222,224,5131152,-1,500.0,7283164,7297272,2154893,14108,112,7,True,True,239.69640555555554,-0.05312536053290778
6588,5128407,7,4,0.148621,224,5131152,-1,2000.0,7904801,7904808,2776394,7,70,2,True,True,0.5703833333333332,-0.148621
6589,5130887,635,3,0.229861,224,5131152,-1,1500.0,9064692,9065327,3933805,635,16,6,True,True,39.410537500000004,-0.2161114334474949
6590,5130920,8067,4,0.035862,224,5131152,-1,2000.0,8851066,8859133,3720146,8067,49,8,True,True,627.6338833333333,-0.03422974749496652
6591,5131077,16965,3,0.260224,224,5131152,-1,1500.0,8998571,9015536,3867494,16965,36,6,True,True,2139.7161791666667,-0.25274022036022575
6592,5131166,38503,256,0.705963,231,5136552,-1,128000.0,7916326,7954829,2785160,38503,73,2,True,True,201080.69688888887,-0.702626647097008
6593,5131444,11072,64,0.43643,231,5136552,-1,32000.0,8840266,8851338,3708822,11072,52,2,True,True,12142.0848,-0.42055580894595324
6594,5131824,305,8,0.995202,231,5136552,-1,4000.0,5797373,5797678,665549,305,166,2,True,True,23.61377777777778,-0.995202
6595,5131858,6,2,0.927206,231,5136552,-1,1000.0,5767302,5767308,635444,6,171,7,True,True,0.12781666666666666,-0.927206
6596,5132001,31,1,0.040792,231,5136552,-1,500.0,7132933,7132964,2000932,31,126,12,True,True,0.49544027777777777,-0.040792
6597,5132627,12,2,0.35652,231,5136552,-1,1000.0,8836666,8836678,3704039,12,53,6,True,True,0.34926666666666667,-0.35652
6598,5132646,11,32,0.709029,231,5136552,-1,16000.0,5544591,5544602,411945,11,185,8,True,True,4.476266666666667,-0.709029
6599,5132768,63,4,0.4852,231,5136552,-1,2000.0,8835566,8835629,3702798,63,54,6,True,True,3.6673000000000004,-0.4852
6600,5137437,8,32,0.492989,233,5137981,-1,16000.0,7532163,7532171,2394726,8,111,10,True,True,5.297066666666666,-0.492989
6601,5137751,372,4,0.845838,233,5137981,-1,2000.0,6474573,6474945,1336822,372,147,12,True,True,30.539133333333336,-0.845838
6602,5137821,23,16,0.866879,233,5137981,-1,8000.0,5805373,5805396,667552,23,169,7,True,True,4.5141333333333336,-0.866879
6603,5138159,13620,64,0.123654,250,5143381,-1,32000.0,7280964,7294584,2142805,13620,122,9,True,True,15046.721066666667,-0.12250888853604978
6604,5138310,12092,4,0.093578,250,5143381,-1,2000.0,9201192,9213284,4062882,12092,12,2,True,True,1392.8904000000002,-0.07983246427081071
6605,5138315,44,8,0.868173,250,5143381,-1,4000.0,6770033,6770077,1631718,44,139,11,True,True,6.295911111111112,-0.868173
6606,5138352,14077,1,0.180655,250,5143381,-1,500.0,8926666,8940743,3788314,14077,49,9,True,True,421.68269722222226,-0.17711290056750556
6607,5138365,14606,4,0.168295,250,5143381,-1,2000.0,9390992,9405598,4252627,14606,4,12,True,True,1989.7643777777776,-0.1641445413893579
6608,5138746,14222,1,0.508738,250,5143381,-1,500.0,5225745,5239967,86999,14222,228,1,True,True,290.1498402777778,-0.4907121952440625
6609,5138845,10425,128,0.272792,250,5143381,-1,64000.0,7905901,7916326,2767056,10425,80,6,True,True,24028.401955555557,-0.2721102856230711
6610,5138867,11468,128,0.890895,250,5143381,-1,64000.0,7568963,7580431,2430096,11468,110,6,True,True,28954.429333333333,-0.8883763312748169
6611,5138915,3,51,0.585677,250,5143381,-1,25500.0,7663943,7663946,2525028,3,95,2,True,True,3.2004625000000004,-0.585677
6612,5138991,9793,86,0.583547,250,5143381,-1,43000.0,6213173,6222966,1074182,9793,160,10,True,True,13988.01239722222,-0.5740823885240581
6613,5139051,14,8,0.971627,250,5143381,-1,4000.0,5411947,5411961,272896,14,214,2,True,True,2.0626666666666664,-0.971627
6614,5139119,21313,8,0.526015,250,5143381,-1,4000.0,7888601,7909914,2749482,21313,85,10,True,True,3584.9830999999995,-0.5227933077134138
6615,5139199,13858,1,0.570788,250,5143381,-1,500.0,7315063,7328921,2175864,13858,123,10,True,True,242.0700944444444,-0.5474706442514478
6616,5139261,25,2,0.416419,250,5143381,-1,1000.0,6344973,6344998,1205712,25,160,7,True,True,1.2090277777777776,-0.416419
6617,5139386,84,16,0.076835,250,5143381,-1,8000.0,9052292,9052376,3912906,84,26,6,True,True,18.87946666666667,-0.076835
6618,5139411,23,2,0.768253,250,5143381,-1,1000.0,5698102,5698125,558691,23,194,12,True,True,0.6249611111111111,-0.768253
6619,5139460,37,1,0.676909,250,5143381,-1,500.0,5415547,5415584,276087,37,219,2,True,True,0.5029430555555556,-0.676909
6620,5140670,18710,8,0.887368,250,5143381,-1,4000.0,5373150,5391860,232480,18710,227,8,True,True,3052.8214444444448,-0.8689225947326453
8062,6358221,342,32,0.360206,1,6358221,-1,16000.0,6444621,6444963,86400,342,0,12,True,True,219.5944,-0.360206
8063,6358266,92,20,0.045754,103,6444621,-1,10000.0,16701269,16701361,10343003,92,0,12,True,True,52.26622222222223,-0.045754
8064,6358282,6,2,0.807558,103,6444621,-1,1000.0,7432761,7432767,1074479,6,1,10,True,True,0.24250000000000002,-0.807558
8065,6358418,23,9,0.325525,103,6444621,-1,4500.0,7433861,7433884,1075443,23,1,6,True,True,4.183125,-0.325525
8066,6358437,80,1,0.444306,103,6444621,-1,500.0,9521113,9521193,3162676,80,1,1,True,True,1.3817777777777778,-0.444306
8067,6358476,4851,256,0.606763,103,6444621,-1,128000.0,7211361,7216212,852885,4851,4,7,True,True,6798.0,-0.6048962393080771
8068,6360282,60,1,0.400165,103,6444621,-1,500.0,14996959,14997019,8636677,60,1,12,True,True,1.9445,-0.400165
8069,6360357,119,32,0.612592,103,6444621,-1,16000.0,8615892,8616011,2255535,119,3,0,True,True,34.51528888888889,-0.612592
8070,6360389,6848,16,0.081369,103,6444621,-1,8000.0,15180559,15187407,8820170,6848,1,12,True,True,1566.2905777777778,-0.07804950284466271
8071,6360402,49,8,0.427916,103,6444621,-1,4000.0,12242531,12242580,5882129,49,3,12,True,True,2.833833333333333,-0.427916
8072,6360462,15084,128,0.931483,103,6444621,-1,64000.0,11092331,11107415,4731869,15084,4,12,True,True,7222.785777777778,-0.9083400989059821
8073,6360498,7,1,0.930845,103,6444621,-1,500.0,7563461,7563468,1202963,7,7,12,True,True,0.23401388888888888,-0.930845
8074,6360556,11,8,0.986871,103,6444621,-1,4000.0,7131495,7131506,770939,11,11,6,True,True,0.39746666666666675,-0.986871
8075,6360573,29,16,0.8571,103,6444621,-1,8000.0,7184888,7184917,824315,29,11,9,True,True,1.1767555555555556,-0.8571
8076,6360604,29,1,0.905203,103,6444621,-1,500.0,8127661,8127690,1767057,29,7,11,True,True,0.13791111111111112,-0.905203
8077,6361175,6398,8,0.734278,103,6444621,-1,4000.0,9418466,9424864,3057291,6398,6,10,True,True,475.1968888888889,-0.607508376637677
8078,6361220,21,4,0.293863,103,6444621,-1,2000.0,15656859,15656880,9295639,21,1,6,True,True,0.89705,-0.293863
8079,6361398,70,10,0.195077,103,6444621,-1,5000.0,15959259,15959329,9597861,70,1,12,True,True,17.319166666666664,-0.195077
8080,6361540,15,1,0.143161,103,6444621,-1,500.0,11178731,11178746,4817191,15,6,12,True,True,0.23727083333333332,-0.143161
8081,6366417,26,8,0.520054,103,6444621,-1,4000.0,9961131,9961157,3594714,26,8,11,True,True,0.975,-0.520054
8082,6366489,53,2,0.571893,103,6444621,-1,1000.0,7590461,7590514,1223972,53,13,8,True,True,3.675402777777778,-0.571893
8083,6366594,21937,8,0.856803,103,6444621,-1,4000.0,7111821,7133758,745227,21937,20,6,True,True,802.6264444444445,-0.8425928758436719
8084,6368106,42,1,0.504637,103,6444621,-1,500.0,11697131,11697173,5329025,42,6,12,True,True,0.5664166666666667,-0.504637
8085,6368627,17831,40,0.127861,103,6444621,-1,20000.0,13151931,13169762,6783304,17831,5,12,True,True,7882.497333333334,-0.12228417358464357
8086,6368649,17,16,0.796821,103,6444621,-1,8000.0,8313461,8313478,1944812,17,14,9,True,True,2.868466666666667,-0.796821
8087,6368969,47,8,0.301348,103,6444621,-1,4000.0,12806331,12806378,6437362,47,6,11,True,True,2.7129444444444446,-0.301348
8088,6369032,435,8,0.673062,103,6444621,-1,4000.0,6531021,6531456,161989,435,25,12,True,True,76.28450000000001,-0.673062
8089,6369063,6,16,0.548747,103,6444621,-1,8000.0,9020666,9020672,2651603,6,14,7,True,True,1.2356,-0.548747
8090,6369358,62,16,0.874786,103,6444621,-1,8000.0,8819092,8819154,2449734,62,15,11,True,True,5.147377777777778,-0.874786
8091,6369380,5642,2,0.168053,103,6444621,-1,1000.0,9396866,9402508,3027486,5642,14,12,True,True,148.28205555555556,-0.16595040252998428
8092,6369945,13,1,0.446287,103,6444621,-1,500.0,7819461,7819474,1449516,13,20,11,True,True,0.17060694444444444,-0.446287
8093,6370044,10,4,0.115679,103,6444621,-1,2000.0,16263859,16263869,9893815,10,1,12,True,True,0.6121666666666666,-0.115679
8094,6370359,41,4,0.662642,103,6444621,-1,2000.0,10047531,10047572,3677172,41,12,12,True,True,1.5737166666666669,-0.662642
8095,6370436,80,1,0.240902,103,6444621,-1,500.0,8706692,8706772,2336256,80,19,7,True,True,0.6453333333333333,-0.240902
8096,6370648,4,64,0.211641,103,6444621,-1,32000.0,15872859,15872863,9502211,4,3,11,True,True,5.608533333333334,-0.211641
8097,6370678,7258,32,0.753253,103,6444621,-1,16000.0,6847223,6854481,476545,7258,33,6,True,True,722.3034666666666,-0.7532423399229808
8098,6370994,8385,8,0.659745,103,6444621,-1,4000.0,12048131,12056516,5677137,8385,10,12,True,True,1004.3578111111111,-0.5877555611263703
8099,6371303,23,8,0.089432,103,6444621,-1,4000.0,15083359,15083382,8712056,23,6,12,True,True,3.002266666666667,-0.089432
8100,6371759,2185,2,0.434893,103,6444621,-1,1000.0,15088759,15090944,8717000,2185,6,8,True,True,66.95811111111111,-0.434893
8101,6376479,24,8,0.715765,103,6444621,-1,4000.0,10743131,10743155,4366652,24,16,12,True,True,2.441066666666667,-0.715765
8102,6376561,701,25,0.160235,103,6444621,-1,12500.0,15266959,15267660,8890398,701,5,12,True,True,177.28340277777775,-0.15987371740370895
8103,6376661,203,32,0.928967,103,6444621,-1,16000.0,6918321,6918524,541660,203,38,9,True,True,38.254222222222225,-0.928967
8104,6376712,103,5,0.902649,103,6444621,-1,2500.0,6824821,6824924,448109,103,40,11,True,True,1.3540208333333332,-0.902649
8105,6376806,18812,256,0.766309,103,6444621,-1,128000.0,8819154,8837966,2442348,18812,24,1,True,True,33868.62933333333,-0.7653888831208528
8106,6377084,7,2,0.220376,103,6444621,-1,1000.0,7142295,7142302,765211,7,37,9,True,True,0.05948055555555555,-0.220376
8107,6377095,11908,32,0.257629,103,6444621,-1,16000.0,13308531,13320439,6931436,11908,10,8,True,True,3084.163066666667,-0.20303853471813024
8108,6377131,47,4,0.476302,103,6444621,-1,2000.0,7319361,7319408,942230,47,36,12,True,True,3.5396222222222224,-0.476302
8109,6378238,10,1,0.897511,103,6444621,-1,500.0,7765461,7765471,1387223,10,32,12,True,True,0.09454166666666666,-0.897511
8110,6378720,26,11,0.123098,103,6444621,-1,5500.0,16350269,16350295,9971549,26,1,12,True,True,5.190105555555555,-0.123098
8111,6378935,136,8,0.135756,103,6444621,-1,4000.0,7174088,7174224,795153,136,41,8,True,True,3.619111111111111,-0.135756
8112,6378951,139,64,0.534543,103,6444621,-1,32000.0,12415331,12415470,6036380,139,14,12,True,True,181.0088888888889,-0.534543
8113,6379393,5,2,0.725414,103,6444621,-1,1000.0,8702292,8702297,2322899,5,30,12,True,True,0.14345833333333335,-0.725414
8114,6379472,188,16,0.090442,103,6444621,-1,8000.0,15396559,15396747,9017087,188,6,12,True,True,53.12462222222222,-0.090442
8115,6380095,12873,4,0.691785,103,6444621,-1,2000.0,8356661,8369534,1976566,12873,33,10,True,True,786.1916833333332,-0.6795865148796739
8116,6391925,24763,3,0.871941,103,6444621,-1,1500.0,9016266,9041029,2624341,24763,28,6,True,True,838.9474166666668,-0.8537691967801846
8117,6393083,6,2,0.93178,103,6444621,-1,1000.0,6975621,6975627,582538,6,50,9,True,True,0.1812,-0.93178
8118,6402404,10865,16,0.766337,103,6444621,-1,8000.0,7994461,8005326,1592057,10865,37,12,True,True,2141.4519111111113,-0.7465954700110458
8119,6402494,34078,256,0.600679,103,6444621,-1,128000.0,10133931,10168009,3731437,34078,22,12,True,True,59929.860977777775,-0.5975704644038278
8120,6402669,20,1,0.643987,103,6444621,-1,500.0,8399861,8399881,1997192,20,35,11,True,True,0.2960277777777778,-0.643987
8121,6404470,327,1,0.37701,103,6444621,-1,500.0,8720792,8721119,2316322,327,32,6,True,True,2.6001041666666667,-0.37701
8122,6405043,16695,8,0.717443,103,6444621,-1,4000.0,9786113,9802808,3381070,16695,25,11,True,True,515.5608222222222,-0.692393301880669
8123,6405474,12420,141,0.736002,103,6444621,-1,70500.0,6825921,6838341,420447,12420,58,6,True,True,5168.470150000001,-0.730127382483441
8124,6405788,47,4,0.381651,103,6444621,-1,2000.0,11265131,11265178,4859343,47,19,12,True,True,3.77175,-0.381651
8125,6406712,10245,128,0.642102,103,6444621,-1,64000.0,8732692,8742937,2325980,10245,34,9,True,True,13130.882844444444,-0.6124018768311069
8126,6406866,2,4,0.5619,103,6444621,-1,2000.0,6830621,6830623,423755,2,60,2,True,True,0.023633333333333333,-0.5619
8127,6409679,62,16,0.856141,103,6444621,-1,8000.0,7455461,7455523,1045782,62,48,10,True,True,22.878,-0.856141
8128,6411880,3461,4,0.808447,103,6444621,-1,2000.0,7110721,7114182,698841,3461,58,9,True,True,68.01637777777778,-0.7974907862461694
8129,6412361,433,2,0.223551,103,6444621,-1,1000.0,15482959,15483392,9070598,433,6,12,True,True,12.413869444444444,-0.223551
8130,6412410,16,2,0.11569,103,6444621,-1,1000.0,14305757,14305773,7893347,16,13,12,True,True,0.3902222222222222,-0.11569
8131,6412419,8503,32,0.08768,103,6444621,-1,16000.0,12674531,12683034,6262112,8503,17,12,True,True,3289.645377777778,-0.08625208368304757
8132,6412478,35,4,0.089139,103,6444621,-1,2000.0,10876331,10876366,4463853,35,25,12,True,True,1.3364166666666668,-0.089139
8133,6413657,15493,8,0.740581,103,6444621,-1,4000.0,10568131,10583624,4154474,15493,27,7,True,True,1879.5580222222225,-0.7382475890463859
8134,6413715,7,1,0.937211,103,6444621,-1,500.0,7232961,7232968,819246,7,57,10,True,True,0.03345416666666666,-0.937211
8135,6413904,35,5,0.744618,103,6444621,-1,2500.0,9024266,9024301,2610362,35,35,2,True,True,1.8994791666666668,-0.744618
8136,6414290,126,1,0.116106,103,6444621,-1,500.0,10263531,10263657,3849241,126,28,11,True,True,1.4129583333333333,-0.10464895879182214
8137,6414603,58,4,0.367737,103,6444621,-1,2000.0,14219357,14219415,7804754,58,14,12,True,True,5.382722222222222,-0.367737
8138,6421226,22,8,0.85333,103,6444621,-1,4000.0,7770861,7770883,1349635,22,53,8,True,True,1.7377555555555557,-0.85333
8139,6421316,4,8,0.954069,103,6444621,-1,4000.0,7130395,7130399,709079,4,67,9,True,True,0.14453333333333335,-0.954069
8140,6421412,60,4,0.576917,103,6444621,-1,2000.0,10789931,10789991,4368519,60,27,1,True,True,2.3986666666666663,-0.576917
8141,6421880,8849,32,0.001678,103,6444621,-1,16000.0,16960469,16969318,10538589,8849,0,12,True,True,5151.219066666667,-0.0015920502370688975
8142,6421934,8333,15,0.061885,103,6444621,-1,7500.0,16614869,16623202,10192935,8333,2,12,True,True,3074.6612916666663,-0.05477923213582965
8143,6422009,22,1,0.535603,103,6444621,-1,500.0,7055621,7055643,633612,22,73,6,True,True,0.16115000000000002,-0.535603
8144,6422033,20390,32,0.847119,103,6444621,-1,16000.0,6827021,6847411,404988,20390,78,6,True,True,1972.5748444444446,-0.8384480031779632
8145,6422764,6751,32,0.979849,103,6444621,-1,16000.0,6618521,6625272,195757,6751,81,6,True,True,4597.5705333333335,-0.9032982725887596
8146,6423734,14,1,0.319643,103,6444621,-1,500.0,9872513,9872527,3448779,14,36,12,True,True,0.06434166666666667,-0.319643
8147,6423866,23216,101,0.365024,103,6444621,-1,50500.0,10220331,10243547,3796465,23216,33,12,True,True,23096.164900000003,-0.3475188495017216
8148,6423995,349,4,0.679302,103,6444621,-1,2000.0,7143395,7143744,719400,349,70,6,True,True,6.274244444444444,-0.679302
8149,6424009,34,8,0.796565,103,6444621,-1,4000.0,7193188,7193222,769179,34,68,2,True,True,0.6596000000000001,-0.796565
8150,6424161,8,1,0.519751,103,6444621,-1,500.0,7585061,7585069,1160900,8,61,10,True,True,0.2429,-0.519751
8151,6424189,31,2,0.601618,103,6444621,-1,1000.0,8615892,8615923,2191703,31,52,11,True,True,0.5619611111111111,-0.601618
8152,6424395,7,1,0.222142,103,6444621,-1,500.0,13216731,13216738,6792336,7,18,10,True,True,0.07908055555555556,-0.222142
8153,6424449,25172,64,0.395312,103,6444621,-1,32000.0,15094159,15119331,8669710,25172,12,8,True,True,19227.238755555554,-0.3716759675552554
8154,6424472,20451,2,0.538293,103,6444621,-1,1000.0,10789931,10810382,4365459,20451,31,0,True,True,365.4142333333333,-0.5326807788562388
8155,6424527,15,4,0.460603,103,6444621,-1,2000.0,7144495,7144510,719968,15,76,6,True,True,0.26966666666666667,-0.460603
8156,6425008,71,1,0.144701,103,6444621,-1,500.0,14478557,14478628,8053549,71,16,12,True,True,0.8563388888888889,-0.144701
8157,6425300,7485,4,0.94289,103,6444621,-1,2000.0,6834223,6841708,408923,7485,88,2,True,True,90.11926111111111,-0.9415684407194306
8158,6425396,13324,16,0.837217,103,6444621,-1,8000.0,6998321,7011645,572925,13324,85,10,True,True,2559.5944888888885,-0.7816371846936513
8159,6425461,47,1,0.499833,103,6444621,-1,500.0,7167195,7167242,741734,47,77,10,True,True,0.1607138888888889,-0.499833
8160,6425543,224,1,0.455785,103,6444621,-1,500.0,14910559,14910783,8485016,224,16,12,True,True,4.357733333333333,-0.455785
8161,6425595,2,19,0.601465,103,6444621,-1,9500.0,13528157,13528159,7102562,2,20,12,True,True,0.6484277777777778,-0.601465
8162,6425609,443,1,0.145871,103,6444621,-1,500.0,9137666,9138109,2712057,443,48,8,True,True,8.095209722222222,-0.145871
8163,6426025,8,1,0.665351,103,6444621,-1,500.0,9521105,9521113,3095080,8,46,10,True,True,0.1381777777777778,-0.665351
8164,6426378,7081,128,0.801292,103,6444621,-1,64000.0,10436331,10443412,4009953,7081,38,12,True,True,15525.783288888888,-0.791119877396034
8165,6426457,11,1,0.702967,103,6444621,-1,500.0,8084461,8084472,1658004,11,66,12,True,True,0.08334027777777778,-0.702967
8166,6455460,21180,4,0.59888,174,6531021,-1,2000.0,8259461,8280641,1804001,21180,65,11,True,True,1120.9425,-0.5866530727384744
8167,6455719,12,32,0.308891,174,6531021,-1,16000.0,15829659,15829671,9373940,12,7,12,True,True,8.230933333333335,-0.308891
8168,6455822,29177,128,0.990335,174,6531021,-1,64000.0,6846123,6875300,390301,29177,98,6,True,True,22374.076444444443,-0.9509000843267346
8169,6455887,16,2,0.123464,174,6531021,-1,1000.0,9499505,9499521,3043618,16,49,1,True,True,0.37453333333333333,-0.123464
8170,6456027,100,1,0.996849,174,6531021,-1,500.0,6892623,6892723,436596,100,98,7,True,True,1.3699999999999999,-0.996849
8171,6456047,127,2,0.706522,174,6531021,-1,1000.0,7776261,7776388,1320214,127,72,8,True,True,1.455913888888889,-0.706522
8172,6462804,16,1,0.478283,174,6531021,-1,500.0,13700957,13700973,7238153,16,21,12,True,True,0.32795555555555556,-0.478283
8173,6468167,12202,32,0.828687,174,6531021,-1,16000.0,9737113,9749315,3268946,12202,48,11,True,True,2940.0593333333336,-0.7454104858711037
8174,6468858,69,16,0.495026,174,6531021,-1,8000.0,11351531,11351600,4882673,69,32,12,True,True,20.753666666666664,-0.495026
8175,6468963,23944,16,0.70414,174,6531021,-1,8000.0,7000521,7024465,531558,23944,99,7,True,True,4671.003555555555,-0.6819112825389844
8176,6470414,2,40,0.376709,174,6531021,-1,20000.0,14564957,14564959,8094543,2,18,12,True,True,1.3857777777777778,-0.376709
8177,6471051,30,4,0.981143,174,6531021,-1,2000.0,7145595,7145625,674544,30,92,6,True,True,0.5393333333333333,-0.981143
8178,6472282,19,8,0.333145,174,6531021,-1,4000.0,12328931,12328950,5856649,19,30,12,True,True,2.0684666666666667,-0.333145
8179,6472694,35,2,0.827885,174,6531021,-1,1000.0,8719692,8719727,2246998,35,65,7,True,True,0.5565972222222222,-0.827885
8180,6481475,21285,8,0.210613,174,6531021,-1,4000.0,11524331,11545616,5042856,21285,34,12,True,True,1975.2121444444442,-0.2083377890225817
8181,6482751,3,1,0.732658,174,6531021,-1,500.0,8302661,8302664,1819910,3,74,0,True,True,0.026933333333333337,-0.732658
8182,6482913,22,4,0.810419,174,6531021,-1,2000.0,6898423,6898445,415510,22,109,1,True,True,0.9397666666666668,-0.810419
8183,6483235,9208,8,0.700407,174,6531021,-1,4000.0,10656731,10665939,4173496,9208,43,7,True,True,990.3230777777778,-0.6752794424789539
8184,6484147,1,32,0.052566,174,6531021,-1,16000.0,16874069,16874070,10389922,1,1,12,True,True,0.5823999999999999,-0.052566
8185,6485258,9,16,0.865432,174,6531021,-1,8000.0,8704492,8704501,2219234,9,70,7,True,True,2.0658000000000003,-0.865432
8186,6485563,36,20,0.17902,174,6531021,-1,10000.0,11783531,11783567,5297968,36,34,12,True,True,9.201,-0.17902
8187,6492039,8,26,0.487505,174,6531021,-1,13000.0,12069731,12069739,5577692,8,33,10,True,True,3.2485555555555554,-0.487505
8188,6492231,31,32,0.391808,174,6531021,-1,16000.0,16091059,16091090,9598828,31,6,7,True,True,21.650399999999998,-0.391808
8189,6495591,2,1,0.98439,174,6531021,-1,500.0,6890423,6890425,394832,2,117,11,True,True,0.0274,-0.98439
8190,6495648,26,8,0.65925,174,6531021,-1,4000.0,8775892,8775918,2280244,26,69,11,True,True,5.078955555555555,-0.65925
8191,6495954,8,1,0.848518,174,6531021,-1,500.0,6964821,6964829,468867,8,115,7,True,True,0.1196,-0.848518
8192,6496746,14074,4,0.991063,174,6531021,-1,2000.0,7054521,7068595,557775,14074,112,11,True,True,444.3547277777778,-0.9626538622261127
8193,6498268,835,2,0.547943,174,6531021,-1,1000.0,8486292,8487127,1988024,835,78,12,True,True,9.175722222222223,-0.547943
8194,6498325,12165,64,0.33741,174,6531021,-1,32000.0,15569359,15581524,9071034,12165,11,12,True,True,8156.681422222221,-0.3188101303660438
8195,6498584,9640,64,0.677899,174,6531021,-1,32000.0,11956331,11965971,5457747,9640,37,12,True,True,12140.044355555556,-0.6766278360790905
8196,6498674,14962,32,0.990314,174,6531021,-1,16000.0,7185988,7200950,687314,14962,103,6,True,True,1446.3047111111111,-0.8561104278372778
8197,6501826,1213,32,0.757714,174,6531021,-1,16000.0,9434666,9435879,2932840,1213,63,9,True,True,593.2694666666666,-0.6819045624871061
8198,6502035,6153,1,0.391063,174,6531021,-1,500.0,6650921,6657074,148886,6153,133,9,True,True,38.069744444444446,-0.38783958463346224
8199,6502111,9289,8,0.527844,174,6531021,-1,4000.0,10479531,10488820,3977420,9289,51,11,True,True,1310.465211111111,-0.4885611878840067
8200,6502185,26,1,0.28304,174,6531021,-1,500.0,13351731,13351757,6849546,26,27,11,True,True,0.3996416666666667,-0.28304
8201,6502386,77,27,0.696376,174,6531021,-1,13500.0,6962621,6962698,460235,77,124,6,True,True,31.08105,-0.696376
8202,6504417,98,8,0.195092,174,6531021,-1,4000.0,12156131,12156229,5651714,98,36,12,True,True,9.0552,-0.195092
8203,6506506,16072,16,0.856252,174,6531021,-1,8000.0,8335061,8351133,1828555,16072,87,10,True,True,5211.434222222222,-0.8108369510939886
8204,6506530,393,2,0.393772,174,6531021,-1,1000.0,7168295,7168688,661765,393,111,6,True,True,2.5468583333333332,-0.393772
8205,6506670,9,10,0.130901,174,6531021,-1,5000.0,12979131,12979140,6472461,9,31,12,True,True,0.9817500000000001,-0.130901
8206,6506850,53,32,0.752266,174,6531021,-1,16000.0,7197588,7197641,690738,53,108,7,True,True,7.262177777777777,-0.752266
8207,6506902,10238,16,0.580384,174,6531021,-1,8000.0,9423866,9434104,2916964,10238,68,8,True,True,2377.7602666666667,-0.5436471160024186
8208,6514749,11,4,0.805072,174,6531021,-1,2000.0,8399881,8399892,1885132,11,87,1,True,True,0.6512611111111111,-0.805072
8209,6515182,17122,16,0.84981,174,6531021,-1,8000.0,8216261,8233383,1701079,17122,94,12,True,True,1801.918888888889,-0.7157334525256601
8210,6515205,5924,65,0.709588,174,6531021,-1,32500.0,9607513,9613437,3092308,5924,64,12,True,True,2632.940555555556,-0.6991162431274283
8211,6515302,21,4,0.457533,174,6531021,-1,2000.0,6893723,6893744,378421,21,136,6,True,True,1.1508,-0.457533
8212,6515336,13,4,0.163694,174,6531021,-1,2000.0,7679061,7679074,1163725,13,103,7,True,True,1.5510444444444442,-0.163694
8213,6518831,318,1,0.137561,174,6531021,-1,500.0,12892731,12893049,6373900,318,32,12,True,True,4.690058333333333,-0.137561
8214,6519316,9030,256,0.695956,174,6531021,-1,128000.0,7908061,7917091,1388745,9030,100,7,True,True,41690.713955555555,-0.6292294857194454
8215,6520167,30595,8,0.291082,174,6531021,-1,4000.0,16088859,16119454,9568692,30595,7,11,True,True,4976.500288888889,-0.2882255028960599
8216,6521012,76,8,0.144823,174,6531021,-1,4000.0,13960157,13960233,7439145,76,26,12,True,True,5.641733333333334,-0.144823
8217,6521112,549,11,0.218136,174,6531021,-1,5500.0,13303131,13303680,6782019,549,31,12,True,True,82.44073750000001,-0.218136
8218,6521118,54,4,0.748383,174,6531021,-1,2000.0,9874731,9874785,3353613,54,65,7,True,True,0.9927,-0.748383
8219,6523224,6,4,0.735319,174,6531021,-1,2000.0,9132266,9132272,2609042,6,78,10,True,True,0.19330000000000003,-0.735319
8220,6523228,25123,128,0.009133,174,6531021,-1,64000.0,17133269,17158392,10610041,25123,0,12,True,True,81624.63217777778,-0.008927976808858564
8221,6523268,45,32,0.725958,174,6531021,-1,16000.0,8837966,8838011,2314698,45,83,0,True,True,12.508622222222224,-0.6391282637387388
8222,6523290,5278,1,0.575682,174,6531021,-1,500.0,8399892,8405170,1876602,5278,96,1,True,True,81.82275833333333,-0.5679839169797058
8223,6523551,26792,8,0.678318,174,6531021,-1,4000.0,9224066,9250858,2700515,26792,78,12,True,True,1070.2576888888889,-0.6626501455269477
8224,6523577,26,32,0.988484,174,6531021,-1,16000.0,6830623,6830649,307046,26,154,1,True,True,2.4578666666666664,-0.988484
8225,6523687,13863,2,0.147605,174,6531021,-1,1000.0,13065531,13079394,6541844,13863,35,12,True,True,409.2182583333333,-0.14664159955458764
8226,6523887,47,32,0.950398,174,6531021,-1,16000.0,6694121,6694168,170234,47,160,11,True,True,33.547555555555554,-0.950398
8227,6525544,23,3,0.427111,174,6531021,-1,1500.0,9110666,9110689,2585122,23,82,12,True,True,1.204625,-0.427111
8228,6525619,311,2,0.84166,174,6531021,-1,1000.0,7477061,7477372,951442,311,120,10,True,True,7.560816666666666,-0.8371710260995019
8229,6525992,180,14,0.925985,174,6531021,-1,7000.0,6780521,6780701,254529,180,162,12,True,True,15.088500000000002,-0.925985
8230,6526033,15294,16,0.096048,174,6531021,-1,8000.0,15743259,15758553,9217226,15294,12,12,True,True,4973.179866666666,-0.08548399301740388
8231,6526045,205,1,0.974159,174,6531021,-1,500.0,6617421,6617626,91376,205,167,12,True,True,5.0882708333333335,-0.974159
8232,6526122,1222,1,0.179633,174,6531021,-1,500.0,11869931,11871153,5343809,1222,48,12,True,True,16.035355555555554,-0.179633
8233,6526796,10402,8,0.052472,174,6531021,-1,4000.0,16436669,16447071,9909873,10402,5,12,True,True,835.7602444444445,-0.046746817867298375
8234,6526905,17,2,0.980277,174,6531021,-1,1000.0,6845023,6845040,318118,17,159,9,True,True,0.1105,-0.980277
8235,6526907,11573,6,0.650098,174,6531021,-1,3000.0,13873757,13885330,7346850,11573,30,12,True,True,1111.8604666666665,-0.6299839925174294
8236,6526938,14957,64,0.593392,174,6531021,-1,32000.0,12588131,12603088,6061193,14957,43,12,True,True,10949.1864,-0.5847369790666725
8237,6527026,8,13,0.969727,174,6531021,-1,6500.0,7098821,7098829,571795,8,147,11,True,True,0.34450000000000003,-0.969727
8238,6531734,19,16,0.626973,253,6617421,-1,8000.0,9012966,9012985,2481232,19,91,12,True,True,1.2991777777777778,-0.626973
8239,6531754,102,4,0.403994,253,6617421,-1,2000.0,7905861,7905963,1374107,102,118,12,True,True,5.5794,-0.403994
8240,6533797,30,16,0.033993,253,6617421,-1,8000.0,14392157,14392187,7858360,30,27,12,True,True,5.3646666666666665,-0.033993
8241,6537960,162,32,0.240855,253,6617421,-1,16000.0,16263869,16264031,9725909,162,7,1,True,True,79.3368,-0.240855
8242,6537985,38206,4,0.488626,253,6617421,-1,2000.0,9477866,9516072,2939881,38206,82,10,True,True,1780.038677777778,-0.4584184272574158
8243,6539007,11,16,0.687984,253,6617421,-1,8000.0,7189588,7189599,650581,11,139,1,True,True,0.4209333333333333,-0.687984
8244,6547958,81,1,0.954555,253,6617421,-1,500.0,8572692,8572773,2024734,81,107,12,True,True,0.6714,-0.954555
8245,6547981,6,8,0.652797,253,6617421,-1,4000.0,9456266,9456272,2908285,6,83,10,True,True,0.8902666666666667,-0.652797
8246,6548054,15766,1,0.375372,253,6617421,-1,500.0,15655759,15671525,9107705,15766,16,12,True,True,172.00523333333334,-0.36643566817724016
8247,6548764,1472,6,0.691795,253,6617421,-1,3000.0,9739313,9740785,3190549,1472,78,7,True,True,82.49333333333334,-0.691795
8248,6549100,15973,4,0.795325,253,6617421,-1,2000.0,7195388,7211361,646288,15973,142,7,True,True,327.3817833333333,-0.7456710854860802
8249,6549404,11,16,0.658519,253,6617421,-1,8000.0,9917931,9917942,3368527,11,75,11,True,True,1.6984000000000001,-0.658519
8250,6549461,127,2,0.777731,253,6617421,-1,1000.0,13351757,13351884,6802296,127,36,1,True,True,3.9041916666666667,-0.777731
8251,6549590,12228,128,0.864896,253,6617421,-1,64000.0,11005931,11018159,4456341,12228,63,12,True,True,18168.164088888887,-0.8596474578417892
8252,6550270,447,16,0.650311,253,6617421,-1,8000.0,8302661,8303108,1752391,447,122,11,True,True,64.20906666666666,-0.650311
8253,6550672,574,8,0.275216,253,6617421,-1,4000.0,7119021,7119595,568349,574,160,2,True,True,21.053044444444442,-0.275216
8254,6550906,17,1,0.653195,253,6617421,-1,500.0,9872531,9872548,3321625,17,79,1,True,True,0.07812916666666668,-0.653195
8255,6551317,9,4,0.367323,253,6617421,-1,2000.0,7099921,7099930,548604,9,164,6,True,True,0.09235,-0.367323
8256,6555872,21,16,0.12,253,6617421,-1,8000.0,14564959,14564980,8009087,21,27,1,True,True,5.820266666666667,-0.12
8257,6556914,38837,32,0.082637,253,6617421,-1,16000.0,16528469,16567306,9971555,38837,5,8,True,True,17461.492088888892,-0.08010665901132169
8258,6556980,7,1,0.489218,253,6617421,-1,500.0,13614557,13614564,7057577,7,37,12,True,True,0.07243055555555555,-0.489218
8259,6557207,20,8,0.668792,253,6617421,-1,4000.0,7411161,7411181,853954,20,146,8,True,True,3.0668888888888888,-0.668792
8260,6557226,30122,16,0.509748,253,6617421,-1,8000.0,10565931,10596053,4008705,30122,73,12,True,True,6023.323733333332,-0.49444089541239256
8261,6560365,24923,8,0.023027,253,6617421,-1,4000.0,17306069,17330992,10745704,24923,0,12,True,True,3335.6823000000004,-0.02181688385603416
8262,6561375,4,4,0.572982,253,6617421,-1,2000.0,9015166,9015170,2453791,4,106,7,True,True,0.14,-0.572982
8263,6584225,8636,32,0.572631,253,6617421,-1,16000.0,13787357,13795993,7203132,8636,37,12,True,True,4904.577377777778,-0.5399095010175665
8264,6584326,115,1,0.273725,253,6617421,-1,500.0,11610731,11610846,5026405,115,63,12,True,True,1.6171874999999998,-0.273725
8265,6584470,5285,1,0.745359,253,6617421,-1,500.0,6894823,6900108,310353,5285,184,6,True,True,53.02985694444445,-0.726979069756564
8266,6584524,17,8,0.794344,253,6617421,-1,4000.0,8717492,8717509,2132968,17,117,9,True,True,1.0868666666666666,-0.794344
8267,6586397,15006,2,0.181097,253,6617421,-1,1000.0,16177459,16192465,9591062,15006,11,12,True,True,730.6510361111111,-0.16995532252493906
8268,6595995,36,1,0.484191,253,6617421,-1,500.0,14046557,14046593,7450562,36,36,12,True,True,0.39915,-0.484191
8269,6598188,13,2,0.644597,253,6617421,-1,1000.0,9693913,9693926,3095725,13,93,12,True,True,0.07767500000000001,-0.644597
8270,6598204,29295,1,0.433656,253,6617421,-1,500.0,13441757,13471052,6843553,29295,43,1,True,True,385.92719999999997,-0.4202917408535311
8271,6598230,8526,1,0.571423,253,6617421,-1,500.0,6903921,6912447,305691,8526,188,1,True,True,150.38359583333335,-0.5443314283775622
8272,6598245,6341,32,0.099441,253,6617421,-1,16000.0,16787669,16794010,10189424,6341,4,12,True,True,2930.8664000000003,-0.09023361174668038
8273,6598319,6,32,0.063498,253,6617421,-1,16000.0,17219669,17219675,10621350,6,1,12,True,True,4.249866666666667,-0.063498
8274,6598385,98,4,0.908881,253,6617421,-1,2000.0,6903823,6903921,305438,98,191,8,True,True,6.548577777777777,-0.908881
8275,6598409,63,4,0.795225,253,6617421,-1,2000.0,7119595,7119658,521186,63,177,1,True,True,1.15535,-0.795225
8276,6598586,39,1,0.18489,253,6617421,-1,500.0,9499466,9499505,2900880,39,101,10,True,True,0.4564625,-0.18489
8277,6598637,103,32,0.812868,253,6617421,-1,16000.0,6976721,6976824,378084,103,188,6,True,True,48.78826666666666,-0.796840254870443
8278,6601227,155,32,0.019746,253,6617421,-1,16000.0,11437931,11438086,4836704,155,70,12,True,True,104.38733333333333,-0.019746
8279,6601244,6,11,0.55606,253,6617421,-1,5500.0,14132957,14132963,7531713,6,38,12,True,True,0.7534083333333333,-0.55606
8280,6601275,10,1,0.536417,253,6617421,-1,500.0,9310466,9310476,2709191,10,110,12,True,True,0.04797222222222222,-0.536417
8281,6601296,8,1,0.812196,253,6617421,-1,500.0,10349931,10349939,3748635,8,86,12,True,True,0.10343333333333334,-0.812196
8282,6601430,4,2,0.488563,253,6617421,-1,1000.0,9872527,9872531,3271097,4,95,1,True,True,0.03676666666666667,-0.488563
8283,6601507,326,2,0.518901,253,6617421,-1,1000.0,9742913,9743239,3141406,326,98,2,True,True,4.469822222222223,-0.518901
8284,6601557,3,8,0.584722,253,6617421,-1,4000.0,9018466,9018469,2416909,3,120,7,True,True,0.3089,-0.584722
8285,6601724,7,16,0.713749,253,6617421,-1,8000.0,6907521,6907528,305797,7,200,1,True,True,2.4325777777777775,-0.713749
8286,6601793,12,2,0.790068,253,6617421,-1,1000.0,8926566,8926578,2324773,12,124,7,True,True,0.13516666666666666,-0.790068
8287,6602243,16242,8,0.124089,253,6617421,-1,4000.0,15310159,15326401,8707916,16242,25,11,True,True,1499.3516,-0.11527232739383349
8288,6602328,45256,3,0.752988,253,6617421,-1,1500.0,6640121,6685377,37793,45256,222,10,True,True,1069.2367958333334,-0.6068671659966014
8289,6602357,1768,4,0.965681,253,6617421,-1,2000.0,6961521,6963289,359164,1768,201,11,True,True,108.96405,-0.9375079096547652
8290,6602381,3627,16,0.897602,253,6617421,-1,8000.0,7168688,7172315,566307,3627,179,1,True,True,189.5760222222222,-0.8816787203857781
8291,6602432,111,70,0.180664,253,6617421,-1,35000.0,10919531,10919642,4317099,111,78,11,True,True,72.58475,-0.180664
8292,6602439,5630,63,0.599103,253,6617421,-1,31500.0,14737759,14743389,8135320,5630,33,12,True,True,4800.777712499999,-0.5929335486085533
8293,6602850,587,4,0.179938,253,6617421,-1,2000.0,8924366,8924953,2321516,587,128,12,True,True,12.993738888888888,-0.17680745367634546
8294,6602886,1,8,0.554722,253,6617421,-1,4000.0,7676861,7676862,1073975,1,164,12,True,True,0.3024666666666667,-0.554722
8295,6602918,561,8,0.800513,253,6617421,-1,4000.0,6781621,6782182,178703,561,225,6,True,True,26.871899999999997,-0.800513
8296,6602928,8,1,0.123045,253,6617421,-1,500.0,12501731,12501739,5898803,8,61,12,True,True,0.11042222222222221,-0.123045
8297,6602934,6208,3,0.128816,253,6617421,-1,1500.0,14651359,14657567,8048425,6208,34,12,True,True,388.8302875,-0.12832678810420162
8298,6603044,9451,256,0.20623,253,6617421,-1,128000.0,16045659,16055110,9442615,9451,16,12,True,True,53803.7816888889,-0.20533251117049364
8299,6603431,3571,256,0.16121,253,6617421,-1,128000.0,16523069,16526640,9919638,3571,9,12,True,True,11775.928177777776,-0.1580849395268942
8300,6603479,6939,4,0.562496,253,6617421,-1,2000.0,8302661,8309600,1699182,6939,155,0,True,True,243.66053333333332,-0.5333264666795337
8301,6603637,8,1,0.85145,253,6617421,-1,500.0,8721892,8721900,2118255,8,138,6,True,True,0.0636111111111111,-0.85145
8302,6603653,369,2,0.035005,253,6617421,-1,1000.0,13195131,13195500,6591478,369,57,11,True,True,6.442125,-0.035005
8303,6603719,80,8,0.979928,253,6617421,-1,4000.0,7199788,7199868,596069,80,183,7,True,True,2.7404444444444445,-0.979928
8304,6604464,116,12,0.506148,253,6617421,-1,6000.0,11961731,11961847,5357267,116,72,8,True,True,29.235866666666666,-0.506148
8305,6604573,1322,28,0.36356,253,6617421,-1,14000.0,12760931,12762253,6156358,1322,63,12,True,True,360.1677722222222,-0.32855659589873054
8306,6604621,9127,32,0.544427,253,6617421,-1,16000.0,10654531,10663658,4049910,9127,92,12,True,True,4044.486622222222,-0.5393941964072173
8307,6604631,7934,1,0.423051,253,6617421,-1,500.0,13438157,13446091,6833526,7934,52,12,True,True,117.43703194444444,-0.4226802566238186
8308,6606881,33034,2,0.945228,253,6617421,-1,1000.0,7011321,7044355,404440,33034,212,9,True,True,726.8758527777777,-0.9303794599005318
8309,6606899,42,16,8.6e-05,253,6617421,-1,8000.0,17046869,17046911,10439970,42,3,12,True,True,12.39,-8.6e-05
8310,6606945,21,64,0.3006,253,6617421,-1,32000.0,14824159,14824180,8217214,21,36,12,True,True,25.896266666666666,-0.3006
8311,6606974,17,16,0.946215,253,6617421,-1,8000.0,7998061,7998078,1391087,17,169,1,True,True,3.0747333333333335,-0.946215
8312,6607002,13375,128,0.519443,253,6617421,-1,64000.0,10786331,10799706,4179329,13375,93,11,True,True,16652.016533333335,-0.5163321826514635
8313,6607032,18378,32,0.782802,253,6617421,-1,16000.0,7405761,7424139,798729,18378,188,12,True,True,14476.779866666666,-0.7474671842012796
8314,6607069,163,13,0.659158,253,6617421,-1,6500.0,7115421,7115584,508352,163,211,2,True,True,9.703254166666666,-0.659158
8315,6607310,9106,128,0.44492,253,6617421,-1,64000.0,12763131,12772237,6155821,9106,66,7,True,True,12414.551288888888,-0.44097048556704427
8316,6607654,318,16,0.577071,253,6617421,-1,8000.0,11265131,11265449,4657477,318,86,0,True,True,102.07799999999999,-0.577071
8317,6607660,14,1,0.695101,253,6617421,-1,500.0,8129861,8129875,1522201,14,170,7,True,True,0.07491944444444444,-0.695101
4463,3615840,28,1,0.996973,1,3615840,-1,500.0,3659040,3659068,43200,28,0,11,True,True,0.4525111111111111,-0.996973
4464,3615880,7607,32,0.625132,15,3659040,-1,16000.0,5358052,5365659,1742172,7607,0,8,True,True,1170.0282222222222,-0.6188338455745852
4465,3615923,14759,32,0.059775,15,3659040,-1,16000.0,11342149,11356908,7726226,14759,0,11,True,True,10569.611688888888,-0.05976473891009952
4466,3615992,10,32,0.644575,15,3659040,-1,16000.0,5055247,5055257,1439255,10,2,10,True,True,1.9346666666666668,-0.644575
4467,3627860,12820,256,0.701328,15,3659040,-1,128000.0,6415184,6428004,2787324,12820,1,12,True,True,27840.541866666666,-0.6729955587588609
4468,3628129,6,4,0.791466,15,3659040,-1,2000.0,4075531,4075537,447402,6,4,7,True,True,0.33593333333333336,-0.791466
4469,3628218,19,32,0.125827,15,3659040,-1,16000.0,11774149,11774168,8145931,19,0,11,True,True,9.157155555555555,-0.125827
4470,3628580,26,4,0.232675,15,3659040,-1,2000.0,10601901,10601927,6973321,26,2,12,True,True,1.1620555555555556,-0.232675
4471,3628688,27,16,0.981676,15,3659040,-1,8000.0,3745440,3745467,116752,27,7,12,True,True,9.212399999999999,-0.981676
4472,3628874,34,4,0.788562,15,3659040,-1,2000.0,6177584,6177618,2548710,34,4,12,True,True,1.2053444444444446,-0.7227807621373169
4473,3628952,22,8,0.756698,15,3659040,-1,4000.0,8064501,8064523,4435549,22,3,10,True,True,1.577888888888889,-0.756698
4474,3628991,27,1,0.805525,15,3659040,-1,500.0,3839466,3839493,210475,27,9,0,True,True,0.4367625,-0.805525
4475,3641283,24,10,0.438719,15,3659040,-1,5000.0,4122031,4122055,480748,24,8,6,True,True,2.1159999999999997,-0.438719
4476,3641363,6696,4,0.192965,15,3659040,-1,2000.0,4316431,4323127,675068,6696,8,8,True,True,170.44868333333335,-0.18981335385180798
4477,3643034,67,1,0.68925,15,3659040,-1,500.0,8738501,8738568,5095467,67,3,12,True,True,0.6691624999999999,-0.68925
4478,3643821,17,8,0.358167,15,3659040,-1,4000.0,10234701,10234718,6590880,17,3,11,True,True,1.8673555555555557,-0.358167
4479,3659990,2,4,0.134732,211,3745440,-1,2000.0,4077731,4077733,417741,2,12,7,True,True,0.11197777777777777,-0.134732
4480,3660044,204,25,0.898663,211,3745440,-1,12500.0,5364552,5364756,1704508,204,8,6,True,True,23.43875,-0.898663
4481,3660260,7004,128,0.485302,211,3745440,-1,64000.0,12594949,12601953,8934689,7004,0,12,True,True,19845.521955555556,-0.47110520671200595
4482,3660679,5,16,0.4375,211,3745440,-1,8000.0,6088979,6088984,2428300,5,9,10,True,True,0.6276666666666667,-0.4375
4483,3660746,5,1,0.294715,211,3745440,-1,500.0,4374031,4374036,713285,5,13,9,True,True,0.03796527777777778,-0.294715
4484,3660784,140,34,0.697038,211,3745440,-1,17000.0,7956501,7956641,4295717,140,7,0,True,True,63.26833333333333,-0.697038
4485,3660860,9450,32,0.189776,211,3745440,-1,16000.0,9489501,9498951,5828641,9450,5,12,True,True,2697.4636,-0.18506031818147642
4486,3661028,773,1,0.186627,211,3745440,-1,500.0,3839493,3840266,178465,773,20,1,True,True,12.504348611111112,-0.186627
4487,3661037,3,2,0.347665,211,3745440,-1,1000.0,8479301,8479304,4818264,3,7,12,True,True,0.08486666666666667,-0.347665
4488,3661057,9,16,0.732402,211,3745440,-1,8000.0,3888101,3888110,227044,9,21,11,True,True,1.865,-0.732402
4489,3661097,2714,1,0.275324,211,3745440,-1,500.0,10105101,10107815,6444004,2714,5,11,True,True,32.66428055555556,-0.2747388056507585
4490,3661187,11,16,0.83135,211,3745440,-1,8000.0,6428004,6428015,2766817,11,11,8,True,True,1.3632666666666668,-0.83135
4491,3661202,4,6,0.914474,211,3745440,-1,3000.0,3839462,3839466,178260,4,26,12,True,True,0.3882333333333333,-0.914474
4492,3661241,8,1,0.55452,211,3745440,-1,500.0,6977571,6977579,3316330,8,11,7,True,True,0.11627777777777779,-0.55452
4493,3661274,20842,1,0.068877,211,3745440,-1,500.0,11892949,11913791,8231675,20842,1,12,True,True,429.5354847222222,-0.06688142080960123
4494,3661337,35594,16,0.155025,211,3745440,-1,8000.0,13032357,13067951,9371020,35594,0,12,True,True,5415.140555555556,-0.1540639837091805
4495,3661440,101,8,0.295673,211,3745440,-1,4000.0,12076549,12076650,8415109,101,2,8,True,True,14.354344444444445,-0.295673
4496,3661501,63,1,0.263349,211,3745440,-1,500.0,11385349,11385412,7723848,63,5,11,True,True,1.3187125000000002,-0.263349
4497,3662111,8148,64,0.367113,211,3745440,-1,32000.0,13118757,13126905,9456646,8148,0,12,True,True,9017.658933333332,-0.36587568912682894
4498,3662159,5579,4,0.00072,211,3745440,-1,2000.0,6629734,6635313,2967575,5579,17,11,True,True,93.98141666666666,-0.000719563582613843
4499,3662220,11570,1,0.638026,211,3745440,-1,500.0,4028842,4040412,366622,11570,30,8,True,True,170.16702777777778,-0.6153041399277906
4500,3663788,609,1,0.379044,211,3745440,-1,500.0,4754756,4755365,1090968,609,25,6,True,True,2.777716666666667,-0.379044
4501,3663875,76,8,0.185534,211,3745440,-1,4000.0,10256301,10256377,6592426,76,9,10,True,True,8.054311111111112,-0.185534
4502,3663967,14665,10,0.01872,211,3745440,-1,5000.0,4300231,4314896,636264,14665,29,11,True,True,1174.0839166666667,-0.016527308898117623
4503,3664153,27,2,0.856829,211,3745440,-1,1000.0,3839466,3839493,175313,27,37,1,True,True,0.873525,-0.856829
4504,3664169,5448,2,0.776017,211,3745440,-1,1000.0,5172247,5177695,1508078,5448,25,8,True,True,63.89487777777778,-0.689961223647905
4505,3664201,8450,4,0.238787,211,3745440,-1,2000.0,7870101,7878551,4205900,8450,17,12,True,True,434.1605222222222,-0.18669154379504982
4506,3664343,84,16,0.721004,211,3745440,-1,8000.0,3932642,3932726,268299,84,36,1,True,True,14.084000000000001,-0.721004
4507,3664361,91,1,0.658289,211,3745440,-1,500.0,4874095,4874186,1209734,91,28,1,True,True,1.5626722222222222,-0.658289
4508,3664393,22,2,0.538957,211,3745440,-1,1000.0,10688327,10688349,7023934,22,8,12,True,True,0.5633222222222223,-0.538957
4509,3664433,6,13,0.387491,211,3745440,-1,6500.0,6586534,6586540,2922101,6,21,12,True,True,0.35641666666666666,-0.387491
4510,3664610,111,4,0.52407,211,3745440,-1,2000.0,6456934,6457045,2792324,111,22,8,True,True,2.7700666666666667,-0.52407
4511,3664644,4,32,0.497549,211,3745440,-1,16000.0,4509531,4509535,844887,4,33,11,True,True,1.12,-0.497549
4512,3664668,188,32,0.551468,211,3745440,-1,16000.0,7301571,7301759,3636903,188,19,10,True,True,75.04124444444444,-0.551468
4513,3664712,4,8,0.613039,211,3745440,-1,4000.0,3753062,3753066,88350,4,48,1,True,True,0.47902222222222224,-0.613039
4514,3664784,6124,1,0.3226,211,3745440,-1,500.0,10690549,10696673,7025765,6124,8,7,True,True,69.08130555555556,-0.293383973435944
4515,3664816,16150,121,0.640904,211,3745440,-1,60500.0,4765556,4781706,1100740,16150,34,9,True,True,8432.081624999999,-0.6189737350206587
4516,3665011,232,32,0.110464,211,3745440,-1,16000.0,12162949,12163181,8497938,232,3,12,True,True,255.17937777777777,-0.110464
4517,3665100,33,4,0.523201,211,3745440,-1,2000.0,8107701,8107734,4442601,33,18,11,True,True,0.9254666666666667,-0.523201
4518,3665246,165,101,0.06668,211,3745440,-1,50500.0,13511157,13511322,9845911,165,0,12,True,True,432.8502291666666,-0.06668
4519,3665281,7,64,0.835193,211,3745440,-1,32000.0,4376231,4376238,710950,7,40,7,True,True,3.4016888888888888,-0.835193
4520,3665449,6317,8,0.129774,211,3745440,-1,4000.0,5962979,5969296,2297530,6317,32,12,True,True,942.2468444444444,-0.12428869828521567
4521,3665460,328,4,0.873493,211,3745440,-1,2000.0,4036842,4037170,371382,328,48,2,True,True,18.49737777777778,-0.873493
4522,3665924,9014,74,0.202079,211,3745440,-1,37000.0,10688349,10697363,7022425,9014,11,1,True,True,7790.001686111111,-0.18610224583277477
4523,3665959,15066,4,0.48537,211,3745440,-1,2000.0,5026047,5041113,1360088,15066,38,11,True,True,663.1525499999999,-0.4836367834156313
4524,3665973,7608,3,0.098754,211,3745440,-1,1500.0,7434801,7442409,3768828,7608,24,1,True,True,300.08144999999996,-0.0958641761076501
4525,3666177,10056,113,0.571012,211,3745440,-1,56500.0,12681349,12691405,9015172,10056,3,12,True,True,21851.12592916667,-0.5522465759652427
4526,3666436,7,1,0.8363,211,3745440,-1,500.0,4466331,4466338,799895,7,45,6,True,True,0.11476111111111112,-0.8363
4527,3667058,8,8,0.657921,211,3745440,-1,4000.0,3844893,3844901,177835,8,57,8,True,True,0.8383111111111111,-0.657921
4528,3667074,37,8,0.525821,211,3745440,-1,4000.0,9262701,9262738,5595627,37,19,12,True,True,5.7325333333333335,-0.525821
4529,3668186,12,8,0.701314,211,3745440,-1,4000.0,4703956,4703968,1035770,12,45,11,True,True,0.6596000000000001,-0.701314
4530,3668196,39839,1,0.255939,211,3745440,-1,500.0,11169349,11209188,7501153,39839,11,12,True,True,580.4515430555555,-0.2548731563282911
4531,3668426,38,4,0.366354,211,3745440,-1,2000.0,6006179,6006217,2337753,38,37,11,True,True,1.6460333333333335,-0.366354
4532,3668615,13,64,0.605954,211,3745440,-1,32000.0,9975501,9975514,6306886,13,19,12,True,True,11.215822222222222,-0.605954
4533,3668830,23991,4,0.070874,211,3745440,-1,2000.0,12767749,12791740,9098919,23991,3,12,True,True,1201.4240333333332,-0.06839390157251994
4534,3668847,12081,256,0.930211,211,3745440,-1,128000.0,6500134,6512215,2831287,12081,34,11,True,True,36126.35448888889,-0.9294782055601902
4535,3668865,5,1,0.208738,211,3745440,-1,500.0,8652101,8652106,4983236,5,24,12,True,True,0.052611111111111115,-0.208738
4536,3669374,4541,184,0.491406,211,3745440,-1,92000.0,9889101,9893642,6219727,4541,21,12,True,True,10219.52738888889,-0.4831204736471973
4537,3669407,7819,4,0.889767,211,3745440,-1,2000.0,4033242,4041061,363835,7819,63,6,True,True,462.5719277777778,-0.8548817291423058
4538,3669434,2,4,0.079957,211,3745440,-1,2000.0,7279971,7279973,3610537,2,33,11,True,True,0.10032222222222223,-0.079957
4539,3669546,5723,2,0.80102,211,3745440,-1,1000.0,4251631,4257354,582085,5723,60,9,True,True,354.5788,-0.8000950995509026
4540,3669588,33704,64,0.0607,211,3745440,-1,32000.0,11644549,11678253,7974961,33704,10,12,True,True,56703.644888888884,-0.05972945884762228
4541,3669597,10,1,0.55802,211,3745440,-1,500.0,6451534,6451544,2781937,10,40,10,True,True,0.07302777777777777,-0.55802
4542,3670045,612,43,0.938244,211,3745440,-1,21500.0,5307252,5307864,1637207,612,49,1,True,True,118.89715000000001,-0.938244
4543,3670118,3,16,0.415953,211,3745440,-1,8000.0,7522301,7522304,3852183,3,32,12,True,True,0.6041333333333334,-0.415953
4544,3670126,12,8,0.369069,211,3745440,-1,4000.0,9392301,9392313,5722175,12,24,11,True,True,1.2345333333333335,-0.369069
4545,3670158,26577,128,0.708434,211,3745440,-1,64000.0,7697301,7723878,4027143,26577,33,12,True,True,25921.235200000003,-0.706642093387122
4546,3670351,9,2,0.823643,211,3745440,-1,1000.0,3750840,3750849,80489,9,81,8,True,True,0.337275,-0.823643
4547,3670440,3747,1,0.265816,211,3745440,-1,500.0,7391571,7395318,3721131,3747,36,1,True,True,48.45462083333334,-0.24592699654125746
4548,3672786,28250,128,0.040653,211,3745440,-1,64000.0,13597557,13625807,9924771,28250,0,12,True,True,71901.85404444445,-0.040592287296921874
4549,3672822,13457,128,0.070388,211,3745440,-1,64000.0,11730949,11744406,8058127,13457,11,12,True,True,33840.5744,-0.0688418282931308
4550,3673201,21313,16,0.303905,211,3745440,-1,8000.0,12773149,12794462,9099948,21313,4,8,True,True,4100.294666666667,-0.30265505555686983
4551,3673565,89,1,0.944603,211,3745440,-1,500.0,4405831,4405920,732266,89,66,1,True,True,0.45402361111111106,-0.944603
4552,3673625,16711,4,0.960587,211,3745440,-1,2000.0,4870495,4887206,1196870,16711,61,12,True,True,1003.042011111111,-0.8959963767169679
4553,3673741,75,2,0.097119,211,3745440,-1,1000.0,10429101,10429176,6755360,75,21,12,True,True,2.7620833333333334,-0.097119
4554,3673762,201,1,0.725172,211,3745440,-1,500.0,4432831,4433032,759069,201,68,8,True,True,3.2291208333333334,-0.725172
4555,3673920,5,1,0.531661,211,3745440,-1,500.0,5698379,5698384,2024459,5,55,11,True,True,0.024069444444444442,-0.531661
4556,3674946,25,1,0.18946,211,3745440,-1,500.0,8196301,8196326,4521355,25,33,12,True,True,0.33072916666666663,-0.18946
4557,3674980,12598,32,0.526192,211,3745440,-1,16000.0,8878901,8891499,5203921,12598,30,11,True,True,4096.488177777778,-0.5196934262821641
4558,3675045,21116,45,0.248763,211,3745440,-1,22500.0,12249349,12270465,8574304,21116,8,12,True,True,18296.2595625,-0.24298525377107216
4559,3675284,288,3,0.625325,211,3745440,-1,1500.0,4427431,4427719,752147,288,73,10,True,True,10.4796,-0.625325
4560,3675406,1649,5,0.178898,211,3745440,-1,2500.0,9710901,9712550,6035495,1649,28,11,True,True,191.29545138888892,-0.178898
4561,3675425,101,1,0.749194,211,3745440,-1,500.0,3931301,3931402,255876,101,88,11,True,True,1.0583958333333334,-0.749194
4562,3675572,12,2,0.415185,211,3745440,-1,1000.0,4380631,4380643,705059,12,76,7,True,True,0.24973333333333336,-0.415185
4563,3675590,8667,16,0.105514,211,3745440,-1,8000.0,10823749,10832416,7148159,8667,18,11,True,True,1407.7438,-0.10179043838792794
4564,3675622,29,12,0.638624,211,3745440,-1,6000.0,6263984,6264013,2588362,29,56,12,True,True,3.298916666666667,-0.6268088891533525
4565,3675637,7754,128,0.357963,211,3745440,-1,64000.0,12508549,12516303,8832912,7754,8,12,True,True,24590.129244444444,-0.3529023152301928
4566,3675654,189,32,0.458721,211,3745440,-1,16000.0,6716134,6716323,3040480,189,50,12,True,True,81.1524,-0.458721
4567,3675688,10761,1,0.665242,211,3745440,-1,500.0,4402231,4412992,726543,10761,80,10,True,True,46.72939722222222,-0.5746305308050818
4568,3675741,8744,4,0.882824,211,3745440,-1,2000.0,5166847,5175591,1491106,8744,68,1,True,True,262.89397777777776,-0.8398318992273457
4569,3675872,9308,1,0.166809,211,3745440,-1,500.0,10342701,10352009,6666829,9308,25,12,True,True,165.12777916666664,-0.16138552893383382
4570,3675903,11829,72,0.180397,211,3745440,-1,36000.0,13424757,13436586,9748854,11829,2,1,True,True,24185.5818,-0.17880125877764544
4571,3676012,238,1,0.401557,211,3745440,-1,500.0,9716301,9716539,6040289,238,32,8,True,True,4.898213888888888,-0.3969263052784051
4572,3676024,33,8,0.337513,211,3745440,-1,4000.0,3957542,3957575,281518,33,97,7,True,True,1.5781333333333334,-0.337513
4573,3676082,23,5,0.158176,211,3745440,-1,2500.0,6011579,6011602,2335497,23,64,8,True,True,1.4400555555555556,-0.158176
4574,3676130,45,1,0.998434,211,3745440,-1,500.0,4059542,4059587,383412,45,95,10,True,True,0.4855625,-0.998434
4575,3676133,2356,2,0.443012,211,3745440,-1,1000.0,5522312,5524668,1846179,2356,68,8,True,True,35.39757777777778,-0.44177035454071945
4576,3676184,230,8,0.352324,211,3745440,-1,4000.0,9802701,9802931,6126517,230,32,12,True,True,22.2145,-0.34372865603864744
4577,3677867,53,45,0.315155,211,3745440,-1,22500.0,11984749,11984802,8306882,53,13,8,True,True,43.1155,-0.315155
4578,3677893,32,1,0.991463,211,3745440,-1,500.0,3844901,3844933,167008,32,106,1,True,True,0.41915555555555556,-0.991463
4579,3677973,1043,1,0.324654,211,3745440,-1,500.0,4783052,4784095,1105079,1043,80,1,True,True,4.787659722222221,-0.324654
4580,3677995,13208,38,0.37172,211,3745440,-1,19000.0,8304301,8317509,4626306,13208,43,10,True,True,5689.759633333333,-0.35161928065380404
4581,3678079,1889,4,0.764184,211,3745440,-1,2000.0,4070342,4072231,392263,1889,100,9,True,True,62.29332222222222,-0.7074348773352769
4582,3678090,14913,128,0.430588,211,3745440,-1,64000.0,6088984,6103897,2410894,14913,66,1,True,True,15225.308977777779,-0.4285644001597272
4583,3678108,13165,16,0.725868,211,3745440,-1,8000.0,5163247,5176412,1485139,13165,78,10,True,True,1726.584488888889,-0.6989041893985581
4584,3678125,7,4,0.608413,211,3745440,-1,2000.0,6054779,6054786,2376654,7,68,11,True,True,0.22925,-0.608413
4585,3678176,6,37,0.563145,211,3745440,-1,18500.0,11471749,11471755,7793573,6,18,12,True,True,4.287991666666667,-0.563145
4586,3678377,8869,256,0.213928,211,3745440,-1,128000.0,13334757,13343626,9656380,8869,3,12,True,True,46256.9856,-0.2139191947970321
4587,3678440,12027,210,0.765708,211,3745440,-1,105000.0,6429934,6441961,2751494,12027,64,6,True,True,18855.095583333332,-0.7391537644777063
4588,3679211,14,64,0.926147,211,3745440,-1,32000.0,4778556,4778570,1099345,14,88,9,True,True,3.570311111111111,-0.926147
4589,3679280,44,128,0.254089,211,3745440,-1,64000.0,13248357,13248401,9569077,44,4,12,True,True,60.44231111111111,-0.254089
4590,3679312,4,1,0.961652,211,3745440,-1,500.0,5215447,5215451,1536135,4,81,11,True,True,0.03411666666666666,-0.961652
4591,3679372,7906,32,0.4475,211,3745440,-1,16000.0,10694149,10702055,7014777,7906,25,2,True,True,2414.191422222222,-0.4219429279246768
4592,3680172,1984,32,0.397091,211,3745440,-1,16000.0,9575901,9577885,5895729,1984,40,12,True,True,736.7751555555556,-0.396737973146104
4593,3680281,13,14,0.726313,211,3745440,-1,7000.0,4037942,4037955,357661,13,113,6,True,True,2.5659472222222224,-0.726313
4594,3680922,11742,86,0.982956,211,3745440,-1,43000.0,4784095,4795837,1103173,11742,91,1,True,True,10110.133483333333,-0.976747455846526
4595,3681024,1300,8,0.595763,211,3745440,-1,4000.0,5703779,5705079,2022755,1300,78,8,True,True,67.35444444444445,-0.595763
4596,3681070,19,1,0.517609,211,3745440,-1,500.0,4032142,4032161,351072,19,118,7,True,True,0.27444444444444444,-0.517609
4597,3681095,23,32,0.993412,211,3745440,-1,16000.0,4165231,4165254,484136,23,110,11,True,True,2.4891111111111113,-0.993412
4598,3681213,5,32,0.301842,211,3745440,-1,16000.0,10061901,10061906,6380688,5,35,12,True,True,2.4933333333333336,-0.301842
4599,3681391,13,8,0.300334,211,3745440,-1,4000.0,7150371,7150384,3468980,13,61,12,True,True,1.3427555555555555,-0.300334
4600,3681904,3459,4,0.221887,211,3745440,-1,2000.0,5833379,5836838,2151475,3459,80,11,True,True,177.67665,-0.20038676467235053
4601,3682096,13849,4,0.85572,211,3745440,-1,2000.0,4338031,4351880,655935,13849,110,10,True,True,346.9004611111111,-0.8374699339638855
4602,3682167,19827,32,0.021701,211,3745440,-1,16000.0,12859557,12879384,9177390,19827,7,1,True,True,8317.546133333335,-0.02134638464404675
4603,3682283,6,1,0.82194,211,3745440,-1,500.0,4257031,4257037,574748,6,114,8,True,True,0.16113333333333335,-0.82194
4604,3682525,22,32,0.689719,211,3745440,-1,16000.0,3753040,3753062,70515,22,138,7,True,True,10.538488888888889,-0.689719
4605,3682574,13,1,0.275957,211,3745440,-1,500.0,9176301,9176314,5493727,13,46,8,True,True,0.22309444444444443,-0.275957
4606,3682589,3,4,0.553663,211,3745440,-1,2000.0,4705056,4705059,1022467,3,102,6,True,True,0.08245000000000001,-0.553663
4607,3683826,2914,1,0.556323,211,3745440,-1,500.0,6975371,6978285,3291545,2914,65,12,True,True,44.789434722222225,-0.5265707593897393
4608,3685104,2,1,0.925922,211,3745440,-1,500.0,4023442,4023444,338338,2,130,11,True,True,0.039627777777777776,-0.925922
4609,3688341,561,1,0.154715,211,3745440,-1,500.0,5876579,5877140,2188238,561,83,11,True,True,3.4189833333333333,-0.154715
4610,3688365,19295,64,0.037736,211,3745440,-1,32000.0,12335749,12355044,8647384,19295,13,12,True,True,18405.295288888887,-0.03656871916180803
4611,3688398,12603,8,0.355656,211,3745440,-1,4000.0,5452059,5464662,1763661,12603,89,11,True,True,730.3731,-0.35268175573189237
4612,3688772,56,1,0.138408,211,3745440,-1,500.0,11795749,11795805,8106977,56,19,10,True,True,0.9707444444444444,-0.138408
4613,3688871,53,8,0.367083,211,3745440,-1,4000.0,5495259,5495312,1806388,53,90,11,True,True,4.142833333333333,-0.367083
4614,3688977,11,8,0.582156,211,3745440,-1,4000.0,5028247,5028258,1339270,11,100,7,True,True,0.8677777777777779,-0.582156
4615,3689104,7367,16,0.232994,211,3745440,-1,8000.0,8967501,8974868,5278397,7367,49,12,True,True,1253.8715333333332,-0.23279368532643804
4616,3689453,19,1,0.811074,211,3745440,-1,500.0,4454431,4454450,764978,19,114,10,True,True,0.21250972222222222,-0.811074
4617,3690701,14513,16,0.091905,211,3745440,-1,8000.0,7387971,7402484,3697270,14513,64,12,True,True,3191.5254,-0.08967932690179978
4618,3690792,149,32,0.399798,211,3745440,-1,16000.0,7608701,7608850,3917909,149,61,12,True,True,25.714088888888888,-0.399798
4619,3690846,16952,256,0.917882,211,3745440,-1,128000.0,4965895,4982847,1275049,16952,105,12,True,True,50131.869511111116,-0.7971093073938412
4620,3690876,21615,64,0.734266,211,3745440,-1,32000.0,6328784,6350399,2637908,21615,80,10,True,True,17562.570399999997,-0.7246440474574817
4621,3690903,30,8,0.723581,211,3745440,-1,4000.0,4378431,4378461,687528,30,124,7,True,True,2.497333333333333,-0.723581
4622,3691207,140,16,0.792904,211,3745440,-1,8000.0,3932502,3932642,241295,140,146,6,True,True,23.473333333333336,-0.792904
4623,3691710,20607,32,0.172902,211,3745440,-1,16000.0,10996549,11017156,7304839,20607,27,12,True,True,15098.458311111113,-0.16261137849555787
4624,3691896,6844,35,0.825705,211,3745440,-1,17500.0,5033647,5040491,1341751,6844,105,8,True,True,2557.7347638888887,-0.7970877568216301
4625,3692532,17,8,0.689595,211,3745440,-1,4000.0,4660756,4660773,968224,17,118,1,True,True,0.7795444444444445,-0.689595
4626,3692654,1207,32,0.576232,211,3745440,-1,16000.0,6307184,6308391,2614530,1207,82,11,True,True,279.07106666666664,-0.5750421878780837
4627,3692800,10,1,0.907656,211,3745440,-1,500.0,5365659,5365669,1672859,10,98,2,True,True,0.04595833333333334,-0.907656
4628,3692903,3,12,0.595231,211,3745440,-1,6000.0,8881101,8881104,5188198,3,51,7,True,True,0.35810000000000003,-0.595231
4629,3693006,11,21,0.300393,211,3745440,-1,10500.0,12071149,12071160,8378143,11,17,12,True,True,4.004320833333333,-0.300393
4630,3699045,8653,32,0.730789,211,3745440,-1,16000.0,5516912,5525565,1817867,8653,98,10,True,True,2033.2487111111113,-0.7132158005288115
4631,3699066,22116,32,0.576284,211,3745440,-1,16000.0,10601927,10624043,6902861,22116,34,0,True,True,7294.717422222222,-0.5425079038016284
4632,3699271,21,1,0.078477,211,3745440,-1,500.0,7610901,7610922,3911630,21,65,7,True,True,0.134575,-0.078477
4633,3699282,111,18,0.055923,211,3745440,-1,9000.0,11558149,11558260,7858867,111,24,12,True,True,46.101075,-0.055923
4634,3699352,13,4,0.770902,211,3745440,-1,2000.0,5408859,5408872,1709507,13,104,11,True,True,0.5018,-0.770902
4635,3699478,11,4,0.34793,211,3745440,-1,2000.0,10780549,10780560,7081071,11,31,12,True,True,0.47709444444444443,-0.34793
4636,3699527,13020,12,0.817142,211,3745440,-1,6000.0,4219231,4232251,519704,13020,145,9,True,True,1461.1192333333333,-0.8064292510072187
4637,3700163,6,11,0.416522,211,3745440,-1,5500.0,4465231,4465237,765068,6,131,9,True,True,1.0820333333333334,-0.4165220000000001
4638,3701086,44,32,0.867831,211,3745440,-1,16000.0,4073331,4073375,372245,44,151,6,True,True,12.539022222222224,-0.867831
4639,3701224,130,1,0.869787,211,3745440,-1,500.0,4341631,4341761,640407,130,141,1,True,True,1.0149027777777777,-0.869787
4640,3701346,187,32,0.226718,211,3745440,-1,16000.0,12945957,12946144,9244611,187,7,12,True,True,54.56244444444445,-0.226718
4641,3712058,24,36,0.652779,211,3745440,-1,18000.0,8109901,8109925,4397843,24,63,7,True,True,6.0576,-0.652779
4642,3712151,13959,64,0.602302,211,3745440,-1,32000.0,8392901,8406860,4680750,13959,61,12,True,True,9055.026133333335,-0.5919309893422489
4643,3714914,7407,9,0.011434,211,3745440,-1,4500.0,10910149,10917556,7195235,7407,31,12,True,True,2458.6808,-0.010738942332214747
4644,3715223,18,16,0.777419,211,3745440,-1,8000.0,4120931,4120949,405708,18,154,11,True,True,3.3532,-0.777419
4645,3715324,18,16,0.382487,211,3745440,-1,8000.0,9667701,9667719,5952377,18,51,8,True,True,3.216,-0.382487
4646,3715542,5,8,0.304783,211,3745440,-1,4000.0,5307247,5307252,1591705,5,115,12,True,True,0.18072222222222223,-0.304783
4647,3720730,18,16,0.041182,211,3745440,-1,8000.0,11979349,11979367,8258619,18,20,12,True,True,5.9216,-0.041182
4648,3720939,56,4,0.53993,211,3745440,-1,2000.0,6428834,6428890,2707895,56,91,1,True,True,1.7350666666666668,-0.53993
4649,3721655,12,1,0.14958,211,3745440,-1,500.0,9170901,9170913,5449246,12,58,12,True,True,0.1704166666666667,-0.14958
4650,3723113,108,2,0.502402,211,3745440,-1,1000.0,3980242,3980350,257129,108,171,6,True,True,1.1868,-0.502402
4651,3723509,38,1,0.220797,211,3745440,-1,500.0,9349101,9349139,5625592,38,56,12,True,True,0.5853583333333333,-0.220797
4652,3723658,819,1,0.05052,211,3745440,-1,500.0,6428015,6428834,2704357,819,94,1,True,True,6.3438375,-0.05052
4653,3723949,12732,20,0.731579,211,3745440,-1,10000.0,6063779,6076511,2339830,12732,103,1,True,True,3960.9304722222223,-0.7309819512095386
4654,3724018,394,4,0.392883,211,3745440,-1,2000.0,8282701,8283095,4558683,394,68,12,True,True,14.429155555555555,-0.392883
4655,3733006,4,16,0.445616,211,3745440,-1,8000.0,8976501,8976505,5243495,4,60,8,True,True,0.5954666666666666,-0.445616
4656,3733414,122,4,0.595132,211,3745440,-1,2000.0,5525565,5525687,1792151,122,114,2,True,True,3.6762666666666672,-0.595132
4657,3736777,71,3,0.504729,211,3745440,-1,1500.0,4748256,4748327,1011479,71,141,11,True,True,1.0505041666666666,-0.504729
4658,3736867,291,2,0.222086,211,3745440,-1,1000.0,11082949,11083240,7346082,291,31,12,True,True,11.150958333333332,-0.222086
4659,3737473,40,1,0.289783,211,3745440,-1,500.0,8306501,8306541,4569028,40,69,7,True,True,0.47755555555555557,-0.289783
4660,3737586,14,4,0.394322,211,3745440,-1,2000.0,5611965,5611979,1874379,14,116,12,True,True,0.1980222222222222,-0.394322
4661,3737606,16503,3,0.132189,211,3745440,-1,1500.0,12422149,12438652,8684543,16503,14,12,True,True,871.7184541666667,-0.12660864691481935
4662,3737796,274,12,0.082545,211,3745440,-1,6000.0,11212549,11212823,7474753,274,31,11,True,True,51.74946666666666,-0.08254500000000001
4663,3740770,18193,1,0.571441,211,3745440,-1,500.0,6888971,6907164,3148201,18193,92,12,True,True,226.35723472222224,-0.5638400240105751
4664,3740870,2,4,0.049311,211,3745440,-1,2000.0,10601927,10601929,6861057,2,43,1,True,True,0.08938888888888889,-0.049311
4665,3740946,4650,1,0.399191,211,3745440,-1,500.0,8749301,8753951,5008355,4650,68,9,True,True,43.602359722222225,-0.39683855178022026
4666,3741105,22,1,0.085079,211,3745440,-1,500.0,4753656,4753678,1012551,22,149,8,True,True,0.10034444444444446,-0.085079
4667,3741132,20,4,0.501823,211,3745440,-1,2000.0,5352652,5352672,1611520,20,131,11,True,True,0.3915555555555556,-0.501823
4668,3741765,21010,1,0.773825,211,3745440,-1,500.0,4617531,4638541,875766,21010,155,12,True,True,322.7149305555556,-0.6877996182513679
4669,3741794,1379,32,0.130375,211,3745440,-1,16000.0,8835701,8837080,5093907,1379,68,12,True,True,846.0931111111112,-0.130375
4670,3741818,8052,16,0.134871,211,3745440,-1,8000.0,4240831,4248883,499013,8052,175,10,True,True,1523.1469111111112,-0.1245537422214977
4671,3742130,11773,256,0.559296,211,3745440,-1,128000.0,11806549,11818322,8064419,11773,23,9,True,True,71316.0256,-0.5591761783186345
4672,3742226,27737,2,0.487861,211,3745440,-1,1000.0,5220847,5248584,1478621,27737,136,8,True,True,425.78414722222226,-0.4794806586846701
4673,3744910,24,1,0.652248,211,3745440,-1,500.0,5790179,5790203,2045269,24,121,12,True,True,0.15033333333333335,-0.652248
4674,3745166,37,4,0.196099,211,3745440,-1,2000.0,6802534,6802571,3057368,37,97,12,True,True,2.2613166666666666,-0.196099
4675,3745225,5,16,0.615997,211,3745440,-1,8000.0,5141647,5141652,1396422,5,143,12,True,True,0.6948888888888889,-0.615997
4676,3745556,5180,2,0.735668,217,3750840,-1,1000.0,6067379,6072559,2321823,5180,115,1,True,True,170.8958888888889,-0.7274820339109023
4677,3745892,345,7,0.246246,217,3750840,-1,3500.0,3954242,3954587,208350,345,199,10,True,True,16.103354166666666,-0.246246
4678,3745926,7556,18,0.071644,217,3750840,-1,9000.0,13161957,13169513,9416031,7556,5,11,True,True,1683.5509249999998,-0.07090604872003094
4679,3746126,1346,1,0.776772,217,3750840,-1,500.0,4781706,4783052,1035580,1346,155,2,True,True,6.178513888888888,-0.776772
4680,3746157,12869,5,0.323412,217,3750840,-1,2500.0,6802571,6815440,3056414,12869,98,1,True,True,910.3752013888889,-0.3137815110630798
4681,3746241,9785,64,0.924138,217,3750840,-1,32000.0,7063971,7073756,3317730,9785,95,12,True,True,7655.358755555556,-0.9207255457182729
4682,3746249,7103,1,0.089595,217,3750840,-1,500.0,7435901,7443004,3689652,7103,89,6,True,True,94.2391638888889,-0.08749220175503158
4683,3755003,82,3,0.671748,250,3839462,-1,1500.0,4531131,4531213,776128,82,168,10,True,True,2.4306166666666664,-0.671748
4684,3755163,75,16,0.423541,250,3839462,-1,8000.0,7956501,7956576,4201338,75,84,12,True,True,15.95,-0.423541
4685,3755216,149,15,0.348308,250,3839462,-1,7500.0,9662301,9662450,5907085,149,59,12,True,True,34.965354166666664,-0.34077509334123024
4686,3755303,664,1,0.320738,250,3839462,-1,500.0,4363231,4363895,607928,664,183,10,True,True,4.503211111111111,-0.320738
4687,3755563,12,7,0.593877,250,3839462,-1,3500.0,9084501,9084513,5328938,12,67,10,True,True,0.7894833333333334,-0.593877
4688,3755616,5197,2,0.024207,250,3839462,-1,1000.0,4767756,4772953,1012140,5197,163,7,True,True,46.45443055555556,-0.02418734911080013
4689,3755685,162,1,0.304819,250,3839462,-1,500.0,5309452,5309614,1553767,162,144,7,True,True,0.731925,-0.304819
4690,3755779,25,4,0.987652,250,3839462,-1,2000.0,4660731,4660756,904952,25,172,11,True,True,0.5731944444444445,-0.987652
4691,3755886,133,1,0.616221,250,3839462,-1,500.0,7236771,7236904,3480885,133,98,12,True,True,1.6346069444444444,-0.616221
4692,3756006,65,1,0.990159,250,3839462,-1,500.0,4982847,4982912,1226841,65,158,7,True,True,1.0010902777777777,-0.990159
4693,3756031,311,16,0.44221,250,3839462,-1,8000.0,8565701,8566012,4809670,311,76,12,True,True,84.47451111111111,-0.44221
4694,3756055,4751,128,0.145818,250,3839462,-1,64000.0,13421157,13425908,9665102,4751,3,12,True,True,17251.475911111113,-0.14217668931818916
4695,3756222,13626,35,0.044878,250,3839462,-1,17500.0,5611979,5625605,1855757,13626,136,1,True,True,1915.0111944444443,-0.04411958404787737
4696,3756261,33,32,0.818172,250,3839462,-1,16000.0,3955342,3955375,199081,33,217,6,True,True,7.0414666666666665,-0.818172
4697,3756506,69,2,0.199685,250,3839462,-1,1000.0,10191501,10191570,6434995,69,52,12,True,True,2.1075666666666666,-0.199685
4698,3756759,40,8,0.373821,250,3839462,-1,4000.0,4879495,4879535,1122736,40,164,8,True,True,4.741777777777778,-0.373821
4699,3756843,17162,1,0.757734,250,3839462,-1,500.0,3931402,3948564,174559,17162,223,1,True,True,160.42455833333332,-0.7498792744092638
4700,3756862,6542,32,0.852764,250,3839462,-1,16000.0,5363452,5369994,1606590,6542,147,8,True,True,967.156888888889,-0.8315296634820603
4701,3756895,3,1,0.112372,250,3839462,-1,500.0,8971101,8971104,5214206,3,71,1,True,True,0.03206666666666667,-0.112372
4702,3756915,8,32,0.054538,250,3839462,-1,16000.0,12859549,12859557,9102634,8,11,12,True,True,4.714666666666666,-0.054538
4703,3757054,179,8,0.948941,250,3839462,-1,4000.0,4208431,4208610,451377,179,206,11,True,True,11.444066666666666,-0.948941
4704,3757085,210,1,0.92673,250,3839462,-1,500.0,3979142,3979352,222057,210,222,10,True,True,1.1538333333333335,-0.92673
4705,3762278,398,1,0.868752,250,3839462,-1,500.0,4029942,4030340,267664,398,219,6,True,True,5.965577777777778,-0.868752
4706,3762315,1072,16,0.820134,250,3839462,-1,8000.0,4072231,4073303,309916,1072,213,1,True,True,152.74808888888887,-0.820134
4707,3762596,873,2,0.013733,250,3839462,-1,1000.0,8042901,8043774,4280305,873,90,12,True,True,18.073525,-0.013733
4708,3762738,3561,13,0.693795,250,3839462,-1,6500.0,6091184,6094745,2328446,3561,127,7,True,True,356.870475,-0.6816907174913572
4709,3763357,38,8,0.111278,250,3839462,-1,4000.0,9403101,9403139,5639744,38,65,9,True,True,3.5171111111111113,-0.111278
4710,3763829,30,16,0.450062,250,3839462,-1,8000.0,7434771,7434801,3670942,30,101,11,True,True,6.214666666666666,-0.450062
4711,3763901,3,1,0.022748,250,3839462,-1,500.0,7783701,7783704,4019800,3,95,12,True,True,0.0209125,-0.022748
4712,3764374,127,1,0.20901,250,3839462,-1,500.0,9062901,9063028,5298527,127,72,12,True,True,0.8704791666666667,-0.20901
4713,3764568,25,1,0.538005,250,3839462,-1,500.0,5495312,5495337,1730744,25,150,1,True,True,0.2442708333333333,-0.538005
4714,3765006,404,1,0.203801,250,3839462,-1,500.0,11298949,11299353,7533943,404,35,12,True,True,9.499611111111111,-0.203801
4715,3765081,180,8,0.523266,250,3839462,-1,4000.0,4311031,4311211,545950,180,209,9,True,True,7.472,-0.523266
4716,3765135,8,64,0.258658,250,3839462,-1,32000.0,10515501,10515509,6750366,8,50,12,True,True,8.388977777777777,-0.258658
4717,3765185,10,13,0.483026,250,3839462,-1,6500.0,5655179,5655189,1889994,10,147,11,True,True,0.7964305555555556,-0.483026
4718,3766817,15506,16,0.729924,250,3839462,-1,8000.0,6060179,6075685,2293362,15506,138,8,True,True,3738.4092888888886,-0.7231087977545401
2412,2106290,17,16,0.418239,1,2106290,-1,8000.0,2192690,2192707,86400,17,0,12,True,True,8.974488888888889,-0.418239
2413,2106514,39,2,0.137867,146,2192690,-1,1000.0,8598890,8598929,6492376,39,0,12,True,True,0.2680166666666667,-0.137867
2414,2107603,2989,8,0.38371,146,2192690,-1,4000.0,6100470,6103459,3992867,2989,1,12,True,True,359.4121666666667,-0.3628245703139559
2415,2108333,8303,4,0.185754,146,2192690,-1,2000.0,9814021,9822324,7705688,8303,0,12,True,True,526.7829722222223,-0.17095126631875698
2416,2108437,24111,8,0.635502,146,2192690,-1,4000.0,3088352,3112463,979915,24111,3,6,True,True,1434.5754000000002,-0.6166312806164936
2417,2108484,12,32,0.693433,146,2192690,-1,16000.0,3091952,3091964,983468,12,3,2,True,True,3.305066666666667,-0.693433
2418,2108758,197,16,0.64526,146,2192690,-1,8000.0,5214661,5214858,3105903,197,3,8,True,True,14.976377777777778,-0.64526
2419,2108788,39,8,0.9999,146,2192690,-1,4000.0,2279090,2279129,170302,39,6,12,True,True,5.399333333333333,-0.9999
2420,2108947,3,8,0.554913,146,2192690,-1,4000.0,2602444,2602447,493497,3,6,6,True,True,0.6074333333333334,-0.554913
2421,2108974,32,32,0.489642,146,2192690,-1,16000.0,5552861,5552893,3443887,32,3,7,True,True,5.630577777777778,-0.489642
2422,2109516,18,16,0.140297,146,2192690,-1,8000.0,10332767,10332785,8223251,18,0,12,True,True,3.3764,-0.140297
2423,2111377,14909,1,0.31458,146,2192690,-1,500.0,3870604,3885513,1759227,14909,6,1,True,True,80.52295416666666,-0.2811587980227653
2424,2112022,3,1,0.451001,146,2192690,-1,500.0,2544344,2544347,432322,3,10,6,True,True,0.07953333333333333,-0.451001
2425,2112643,18751,1,0.053611,146,2192690,-1,500.0,3861604,3880355,1748961,18751,7,11,True,True,116.31280972222221,-0.04864735635320584
2426,2113179,13130,1,0.359039,146,2192690,-1,500.0,2336031,2349161,222852,13130,12,2,True,True,148.7705527777778,-0.30460385275154894
2427,2113265,28,16,0.009583,146,2192690,-1,8000.0,10937567,10937595,8824302,28,0,12,True,True,7.701244444444444,-0.009583
2428,2113530,9,2,0.136535,146,2192690,-1,1000.0,3379752,3379761,1266222,9,9,12,True,True,0.298925,-0.136535
2429,2113630,12319,142,0.815216,146,2192690,-1,71000.0,3387004,3399323,1273374,12319,9,2,True,True,50538.04554166667,-0.750758309171918
2430,2113724,4,14,0.963829,146,2192690,-1,7000.0,2782944,2782948,669220,4,13,8,True,True,0.6322555555555556,-0.963829
2431,2113880,30,1,0.505438,146,2192690,-1,500.0,3008187,3008217,894307,30,13,11,True,True,0.24179166666666665,-0.505438
2432,2113923,63,1,0.49497,146,2192690,-1,500.0,3009287,3009350,895364,63,13,6,True,True,0.5077625,-0.49497
2433,2114019,3743,64,0.684697,146,2192690,-1,32000.0,2734344,2738087,620325,3743,16,9,True,True,3063.8536000000004,-0.6657884200608827
2434,2114322,7782,32,0.41563,146,2192690,-1,16000.0,4627461,4635243,2513139,7782,7,6,True,True,2604.3784,-0.39639758664179225
2435,2114423,162,1,0.839892,146,2192690,-1,500.0,3061887,3062049,947464,162,14,2,True,True,1.6337249999999999,-0.839892
2436,2114439,8491,1,0.4887,146,2192690,-1,500.0,6273270,6281761,4158831,8491,4,12,True,True,54.632329166666665,-0.4839424005007405
2437,2114630,20986,16,0.082671,146,2192690,-1,8000.0,10159967,10180953,8045337,20986,2,12,True,True,4303.826444444445,-0.08115208990121094
2438,2114633,6696,8,0.030861,146,2192690,-1,4000.0,3991804,3998500,1877171,6696,10,10,True,True,249.75577777777778,-0.024364665046088484
2439,2115210,34,1,0.761057,146,2192690,-1,500.0,2651144,2651178,535934,34,22,6,True,True,0.3622888888888889,-0.761057
2440,2115263,60,1,0.29209,146,2192690,-1,500.0,6532470,6532530,4417207,60,5,0,True,True,0.3605,-0.29209
2441,2115285,85,1,0.274853,146,2192690,-1,500.0,5464261,5464346,3348976,85,9,12,True,True,1.1748888888888889,-0.274853
2442,2117492,9,14,0.537609,146,2192690,-1,7000.0,7367690,7367699,5250198,9,5,12,True,True,0.9567250000000002,-0.5376089999999999
2443,2117508,17722,1,0.168209,146,2192690,-1,500.0,2474844,2492566,357336,17722,28,8,True,True,426.0007527777778,-0.1595553415730457
2444,2117559,200,4,0.457321,146,2192690,-1,2000.0,3957004,3957204,1839445,200,14,12,True,True,6.837777777777777,-0.457321
2445,2117770,10177,85,0.742518,146,2192690,-1,42500.0,3221652,3231829,1103882,10177,19,2,True,True,26139.757340277774,-0.7265795631288231
2446,2117824,8,32,0.76592,146,2192690,-1,16000.0,3557004,3557012,1439180,8,17,12,True,True,1.544888888888889,-0.76592
2447,2117897,13108,8,0.549726,146,2192690,-1,4000.0,3395004,3408112,1277107,13108,18,2,True,True,3439.6657777777777,-0.5487012752448786
2448,2117914,7364,8,0.113211,146,2192690,-1,4000.0,10419167,10426531,8301253,7364,1,12,True,True,781.1702888888889,-0.1129079830697951
2449,2117989,8629,5,0.114207,146,2192690,-1,2500.0,9900767,9909396,7782778,8629,4,1,True,True,456.56697222222226,-0.11295246084278979
2450,2118041,4874,32,0.775113,146,2192690,-1,16000.0,2790944,2795818,672903,4874,29,3,True,True,2098.3934222222224,-0.7177764754151049
2451,2118061,719,4,0.823283,146,2192690,-1,2000.0,2601344,2602063,483283,719,34,6,True,True,72.79076111111111,-0.823283
2452,2118189,8698,1,0.366862,146,2192690,-1,500.0,6532470,6541168,4414281,8698,9,12,True,True,55.43308333333333,-0.3636369759252208
2453,2119686,8688,2,0.822611,146,2192690,-1,1000.0,3082087,3090775,962401,8688,27,9,True,True,138.660575,-0.8060022168790348
2454,2119735,139,1,0.041611,146,2192690,-1,500.0,5792670,5792809,3672935,139,12,11,True,True,2.572465277777778,-0.041611
2455,2119857,8904,106,0.71898,146,2192690,-1,53000.0,6843890,6852794,4724033,8904,8,12,True,True,15127.023855555555,-0.6824766102799376
2456,2120189,19141,1,0.546353,146,2192690,-1,500.0,6186870,6206011,4066681,19141,12,12,True,True,108.3642361111111,-0.5440825008322181
2457,2120488,210,59,0.989776,146,2192690,-1,29500.0,2594444,2594654,473956,210,40,2,True,True,224.29341666666667,-0.989776
2458,2120501,11,4,0.102416,146,2192690,-1,2000.0,4950061,4950072,2829560,11,18,11,True,True,0.5038,-0.102416
2459,2120528,857,1,0.830071,146,2192690,-1,500.0,3391404,3392261,1270876,857,26,7,True,True,24.341180555555553,-0.830071
2460,2120571,19559,9,0.751345,146,2192690,-1,4500.0,3867004,3886563,1746433,19559,23,8,True,True,1038.5845124999998,-0.7081587092186368
2461,2120598,31,4,0.297709,146,2192690,-1,2000.0,8773890,8773921,6653292,31,6,12,True,True,1.0217944444444444,-0.297709
2462,2121350,12,1,0.999313,146,2192690,-1,500.0,2334652,2334664,213302,12,48,1,True,True,0.18686666666666668,-0.999313
2463,2121572,14650,128,0.449732,146,2192690,-1,64000.0,3293352,3308002,1171780,14650,31,7,True,True,26989.085866666665,-0.4394170676994387
2464,2121578,235,1,0.348577,146,2192690,-1,500.0,5884470,5884705,3762892,235,15,8,True,True,4.059951388888889,-0.348577
2465,2124500,112,2,0.816729,146,2192690,-1,1000.0,2600244,2600356,475744,112,46,7,True,True,5.669377777777777,-0.816729
2466,2124543,239,4,0.43907,146,2192690,-1,2000.0,3773004,3773243,1648461,239,27,12,True,True,13.85536111111111,-0.43907
2467,2124689,6917,15,0.993958,146,2192690,-1,7500.0,3067687,3074604,942998,6917,38,3,True,True,1079.5720833333332,-0.9857140575893586
2468,2124740,12,1,0.775632,146,2192690,-1,500.0,4364957,4364969,2240217,12,22,12,True,True,0.1298,-0.775632
2469,2124925,6261,128,0.236946,146,2192690,-1,64000.0,9640121,9646382,7515196,6261,6,11,True,True,4135.843911111111,-0.23265818729835705
2470,2124997,143,4,0.810703,146,2192690,-1,2000.0,3084287,3084430,959290,143,39,7,True,True,4.420288888888889,-0.810703
2471,2125054,13211,4,0.587924,146,2192690,-1,2000.0,5209261,5222472,3084207,13211,21,12,True,True,272.5184888888889,-0.5837599733319466
2472,2125176,104,4,0.350631,146,2192690,-1,2000.0,10591967,10592071,8466791,104,1,12,True,True,2.1782222222222223,-0.350631
2473,2125179,31,1,0.710754,146,2192690,-1,500.0,2964987,2965018,839808,31,47,11,True,True,0.14983333333333332,-0.710754
2474,2125414,19212,16,0.632771,146,2192690,-1,8000.0,3058287,3077499,932873,19212,45,2,True,True,3086.4757333333337,-0.6226201838720515
2475,2132350,15615,1,0.165982,146,2192690,-1,500.0,5550661,5566276,3418311,15615,20,12,True,True,81.44214166666667,-0.14904946629049434
2476,2132729,25,64,0.139235,146,2192690,-1,32000.0,5281661,5281686,3148932,25,22,10,True,True,12.11111111111111,-0.139235
2477,2132819,14871,256,0.20662,146,2192690,-1,128000.0,8080490,8095361,5947671,14871,10,12,True,True,25319.90151111111,-0.20182030687547695
2478,2134008,14246,1,0.206943,146,2192690,-1,500.0,4256957,4271203,2122949,14246,29,12,True,True,125.59112777777779,-0.2065809050187279
2479,2134043,15,2,0.059358,146,2192690,-1,1000.0,8166890,8166905,6032847,15,10,12,True,True,0.171625,-0.059358
2480,2134317,25475,128,0.350815,146,2192690,-1,64000.0,11023967,11049442,8889650,25475,0,12,True,True,27831.005333333334,-0.33330554475245155
2481,2134804,225,8,0.281085,146,2192690,-1,4000.0,5287061,5287286,3152257,225,25,8,True,True,13.83,-0.281085
2482,2134927,18621,64,0.538769,146,2192690,-1,32000.0,3052487,3071108,917560,18621,53,9,True,True,13057.874222222223,-0.512530895093708
2483,2134934,7127,2,0.323654,146,2192690,-1,1000.0,7194890,7202017,5059956,7127,14,12,True,True,142.71966111111112,-0.2722666124887508
2484,2134970,77,1,0.704054,146,2192690,-1,500.0,2650044,2650121,515074,77,62,7,True,True,0.8204777777777778,-0.704054
2485,2135214,3631,41,0.289333,146,2192690,-1,20500.0,7950890,7954521,5815676,3631,13,12,True,True,3238.8108875,-0.2616957118817593
2486,2135239,16457,1,0.267343,146,2192690,-1,500.0,4722861,4739318,2587622,16457,32,12,True,True,327.56506666666667,-0.25604463962857854
2487,2135398,391,8,0.858017,146,2192690,-1,4000.0,2899072,2899463,763674,391,60,8,True,True,24.75898888888889,-0.858017
2488,2135495,20,64,0.985488,146,2192690,-1,32000.0,2723544,2723564,588049,20,64,10,True,True,19.454222222222224,-0.985488
2489,2135551,18,1,0.679299,146,2192690,-1,500.0,2880644,2880662,745093,18,61,6,True,True,0.200075,-0.679299
2490,2135886,4,32,0.095225,146,2192690,-1,16000.0,10246367,10246371,8110481,4,5,11,True,True,1.3667555555555555,-0.095225
2491,2136844,10695,140,0.962772,146,2192690,-1,70000.0,5879070,5889765,3742226,10695,24,12,True,True,29073.78541666667,-0.911338147399968
2492,2139597,62,2,0.785691,146,2192690,-1,1000.0,2280190,2280252,140593,62,78,6,True,True,2.145888888888889,-0.785691
2493,2139648,15967,16,0.918769,146,2192690,-1,8000.0,3086487,3102454,946839,15967,53,7,True,True,1974.977133333333,-0.905124333299425
2494,2139768,17844,2,0.992486,146,2192690,-1,1000.0,2285652,2303496,145884,17844,79,8,True,True,564.1634666666666,-0.9306645583163953
2495,2139994,19,10,0.867048,146,2192690,-1,5000.0,2893653,2893672,753659,19,64,9,True,True,1.3883194444444444,-0.867048
2496,2140004,18,1,0.126888,146,2192690,-1,500.0,2426244,2426262,286240,18,78,1,True,True,0.282725,-0.126888
2497,2140073,70,32,0.866079,146,2192690,-1,16000.0,2893672,2893742,753599,70,64,1,True,True,16.367555555555555,-0.866079
2498,2140389,2,16,0.249677,146,2192690,-1,8000.0,6935690,6935692,4795301,2,17,8,True,True,0.366,-0.249677
2499,2140483,10688,1,0.711395,146,2192690,-1,500.0,3379752,3390440,1239269,10688,49,0,True,True,216.68741111111112,-0.6925951157095811
2500,2147589,73,8,0.828482,146,2192690,-1,4000.0,3470604,3470677,1323015,73,46,8,True,True,3.4829111111111106,-0.828482
2501,2148088,63,16,0.761474,146,2192690,-1,8000.0,2401931,2401994,253843,63,83,11,True,True,20.0466,-0.761474
2502,2148106,8109,128,0.676235,146,2192690,-1,64000.0,6537890,6545999,4389784,8109,19,1,True,True,5502.291733333333,-0.6718535715109778
2503,2148766,53,2,0.489459,146,2192690,-1,1000.0,4170504,4170557,2021738,53,40,12,True,True,0.8318055555555556,-0.489459
2504,2150347,22243,64,0.577426,146,2192690,-1,32000.0,7022090,7044333,4871743,22243,17,12,True,True,21069.05262222222,-0.5633144209429491
2505,2150391,9,1,0.268717,146,2192690,-1,500.0,5563661,5563670,3413270,9,29,9,True,True,0.04485,-0.268717
2506,2150734,417,32,0.414225,146,2192690,-1,16000.0,7108490,7108907,4957756,417,17,12,True,True,158.16346666666666,-0.414225
2507,2150755,1489,1,0.451992,146,2192690,-1,500.0,4818261,4819750,2667506,1489,39,12,True,True,14.28405972222222,-0.451992
2508,2151909,206,1,0.633628,146,2192690,-1,500.0,4061404,4061610,1909495,206,45,9,True,True,1.8319694444444445,-0.633628
2509,2155978,12334,64,0.880125,146,2192690,-1,32000.0,2588644,2600978,432666,12334,87,8,True,True,17723.913066666668,-0.8368567244710666
2510,2156228,71,1,0.093095,146,2192690,-1,500.0,6359670,6359741,4203442,71,24,12,True,True,0.3822166666666666,-0.093095
2511,2156396,10,2,0.515613,146,2192690,-1,1000.0,7756490,7756500,5600094,10,15,11,True,True,0.08916666666666667,-0.515613
2512,2156730,10,2,0.278226,146,2192690,-1,1000.0,5576670,5576680,3419940,10,32,7,True,True,0.11875000000000001,-0.278226
2513,2159566,9504,4,0.936336,146,2192690,-1,2000.0,2900187,2909691,740621,9504,76,1,True,True,234.17180000000002,-0.8461328666213879
2514,2159629,64,2,0.369071,146,2192690,-1,1000.0,4726461,4726525,2566832,64,43,1,True,True,2.6752,-0.369071
2515,2160021,9,16,0.950254,146,2192690,-1,8000.0,3470604,3470613,1310583,9,57,0,True,True,0.8588,-0.950254
2516,2160104,10,1,0.327289,146,2192690,-1,500.0,5289261,5289271,3129157,10,37,7,True,True,0.05079166666666667,-0.327289
2517,2160248,10513,32,0.002473,146,2192690,-1,16000.0,6624290,6634803,4464042,10513,22,12,True,True,1688.6848444444445,-0.002147282139944509
2518,2168533,11303,32,0.774135,146,2192690,-1,16000.0,3994004,4005307,1825471,11303,52,7,True,True,2345.217688888889,-0.705743577218525
2519,2170528,45,1,0.732724,146,2192690,-1,500.0,2921787,2921832,751259,45,81,10,True,True,0.209625,-0.732724
2520,2171776,42,1,0.730932,146,2192690,-1,500.0,2280252,2280294,108476,42,105,1,True,True,0.7268333333333333,-0.730932
2521,2172033,50,32,0.458449,146,2192690,-1,16000.0,3041687,3041737,869654,50,78,9,True,True,12.751111111111111,-0.458449
2522,2177531,42,1,0.664144,146,2192690,-1,500.0,4050604,4050646,1873073,42,52,7,True,True,0.4260083333333334,-0.664144
2523,2177773,9989,34,0.358223,146,2192690,-1,17000.0,9596921,9606910,7419148,9989,10,12,True,True,1234.0970555555555,-0.34139970621947413
2524,2178120,19,1,0.063331,146,2192690,-1,500.0,4170557,4170576,1992437,19,51,1,True,True,0.14909722222222221,-0.063331
2525,2179651,3,2,0.534424,146,2192690,-1,1000.0,4084104,4084107,1904453,3,53,6,True,True,0.037866666666666667,-0.534424
2526,2179836,44885,1,0.21783,146,2192690,-1,500.0,9119521,9164406,6939685,44885,11,12,True,True,400.9221763888889,-0.21544881946540215
2527,2180791,11359,1,0.429643,146,2192690,-1,500.0,6446070,6457429,4265279,11359,28,12,True,True,89.88931666666667,-0.39830024898924965
2528,2180801,34,4,0.211851,146,2192690,-1,2000.0,8512490,8512524,6331689,34,14,12,True,True,0.9476555555555556,-0.211851
2529,2180879,7170,1,0.268537,146,2192690,-1,500.0,2645644,2652814,464765,7170,101,10,True,True,78.78375,-0.24561223056915496
2530,2181396,263,8,0.828344,146,2192690,-1,4000.0,2879544,2879807,698148,263,95,7,True,True,18.99152222222222,-0.828344
2531,2181471,25629,33,0.337755,146,2192690,-1,16500.0,10073567,10099196,7892096,25629,7,12,True,True,11214.1671125,-0.3336538809764122
2532,2181633,26487,1,0.577934,146,2192690,-1,500.0,3291152,3317639,1109519,26487,76,10,True,True,499.38119027777776,-0.5480922651318755
2533,2181686,17746,1,0.566142,146,2192690,-1,500.0,2777544,2795290,595858,17746,100,11,True,True,209.3914611111111,-0.5412613033265491
2534,2181740,275,8,0.485338,146,2192690,-1,4000.0,5036461,5036736,2854721,275,48,12,True,True,37.15555555555556,-0.485338
2535,2183780,63,32,0.34374,146,2192690,-1,16000.0,8687490,8687553,6503710,63,14,12,True,True,9.7048,-0.34374
2536,2186989,42441,32,0.682552,146,2192690,-1,16000.0,4632861,4675302,2445872,42441,54,8,True,True,25158.264400000004,-0.6648717283634252
2537,2187170,35360,128,0.048409,146,2192690,-1,64000.0,11113967,11149327,8926797,35360,0,12,True,True,48415.23857777778,-0.04676057155423865
2538,2187180,3613,4,0.099575,146,2192690,-1,2000.0,7281290,7284903,5094110,3613,23,12,True,True,213.34153888888886,-0.0721446627841058
2539,2187316,13,42,0.78389,146,2192690,-1,21000.0,3383404,3383417,1196088,13,78,1,True,True,9.534525,-0.78389
2540,2187337,81,16,0.459582,146,2192690,-1,8000.0,5377861,5377942,3190524,81,46,12,True,True,17.7552,-0.459582
2541,2187483,4,1,0.124237,146,2192690,-1,500.0,4537757,4537761,2350274,4,59,11,True,True,0.028544444444444445,-0.124237
2542,2187802,222,4,0.857652,146,2192690,-1,2000.0,2598044,2598266,410242,222,117,2,True,True,22.121066666666668,-0.857652
2543,2187819,142,16,0.441286,146,2192690,-1,8000.0,5260061,5260203,3072242,142,50,11,True,True,12.230933333333331,-0.441286
2544,2187867,9,1,0.000676,146,2192690,-1,500.0,8253290,8253299,6065423,9,18,12,True,True,0.0454,-0.000676
2545,2188238,603,1,0.958032,146,2192690,-1,500.0,2469444,2470047,281206,603,124,11,True,True,14.716333333333333,-0.9580178952268023
2546,2189734,3130,32,0.202318,146,2192690,-1,16000.0,8946721,8949851,6756987,3130,14,12,True,True,1411.0935111111112,-0.19115514675987869
2547,2189831,55185,1,0.688592,146,2192690,-1,500.0,4037204,4092389,1847373,55185,70,11,True,True,532.8875527777778,-0.6601706067995956
2548,2190353,4,32,0.131913,146,2192690,-1,16000.0,6757490,6757494,4567137,4,31,1,True,True,1.2186666666666666,-0.131913
2549,2190388,645,6,0.649997,146,2192690,-1,3000.0,2478444,2479089,288056,645,126,1,True,True,82.543875,-0.649997
2550,2190559,1,8,0.158977,146,2192690,-1,4000.0,2784044,2784045,593485,1,112,6,True,True,0.09032222222222223,-0.158977
2551,2190639,2713,2,0.932726,146,2192690,-1,1000.0,2423531,2426244,232892,2713,131,10,True,True,85.22588055555556,-0.932726
2552,2190992,4281,32,0.274019,146,2192690,-1,16000.0,8860321,8864602,6669329,4281,15,12,True,True,810.4583111111111,-0.269887563488383
2553,2191522,74,1,0.654588,146,2192690,-1,500.0,5216861,5216935,3025339,74,55,7,True,True,0.4053555555555555,-0.654588
2554,2191699,664,1,0.250389,146,2192690,-1,500.0,9208121,9208785,7016422,664,13,12,True,True,8.686411111111111,-0.250389
2555,2192292,119,8,0.371844,146,2192690,-1,4000.0,5291461,5291580,3099169,119,52,7,True,True,4.835366666666666,-0.371844
2556,2192359,69,1,0.9038,146,2192690,-1,500.0,2357631,2357700,165272,69,137,10,True,True,1.625045833333333,-0.9038
2557,2192404,5243,16,0.165525,146,2192690,-1,8000.0,9510521,9515764,7318117,5243,13,12,True,True,916.3068444444444,-0.16276697625867706
2558,2192462,6613,128,0.396342,146,2192690,-1,64000.0,6014070,6020683,3821608,6613,44,12,True,True,6352.1685333333335,-0.39089080962723044
2559,2193211,15,4,0.305509,254,2279090,-1,2000.0,3195352,3195367,1002141,15,97,7,True,True,1.1135,-0.305509
2560,2193371,9234,32,0.699441,254,2279090,-1,16000.0,3181952,3191186,988581,9234,98,12,True,True,5939.271822222222,-0.6746754905873686
2561,2193805,9,1,0.234144,254,2279090,-1,500.0,3218052,3218061,1024247,9,97,6,True,True,0.1771,-0.234144
2562,2193848,46,8,0.655485,254,2279090,-1,4000.0,2694344,2694390,500496,46,126,11,True,True,5.167333333333334,-0.655485
2563,2193938,41,1,0.703698,254,2279090,-1,500.0,4624161,4624202,2430223,41,69,12,True,True,0.2643930555555556,-0.703698
2564,2193984,79,1,0.001086,254,2279090,-1,500.0,7540490,7540569,5346506,79,27,11,True,True,0.7890124999999999,-0.001086
2565,2193987,10037,32,0.476807,254,2279090,-1,16000.0,7864490,7874527,5670503,10037,26,12,True,True,4646.9032,-0.45185133067248306
2566,2193998,237,32,0.1327,254,2279090,-1,16000.0,5563670,5563907,3369672,237,51,1,True,True,37.7936,-0.1327
2567,2194621,25,1,0.226191,254,2279090,-1,500.0,9121721,9121746,6927100,25,15,7,True,True,0.13788194444444443,-0.226191
2568,2194663,77,1,0.679983,254,2279090,-1,500.0,3095552,3095629,900889,77,105,2,True,True,0.6213472222222222,-0.679983
2569,2194709,10,32,0.009287,254,2279090,-1,16000.0,10764767,10764777,8570058,10,3,12,True,True,2.013333333333333,-0.009287
2570,2194764,859,1,0.695597,254,2279090,-1,500.0,2286752,2287611,91988,859,153,6,True,True,18.83596111111111,-0.695597
2571,2194836,28342,1,0.817109,254,2279090,-1,500.0,2543244,2571586,348408,28342,144,11,True,True,582.5555333333333,-0.780078651605111
2572,2194945,9,8,0.988155,254,2279090,-1,4000.0,2500044,2500053,305099,9,145,10,True,True,2.0580000000000003,-0.988155
2573,2194955,18693,16,0.422314,254,2279090,-1,8000.0,5749470,5768163,3554515,18693,52,12,True,True,2033.5574,-0.323165225840401
2574,2195011,19,1,0.132175,254,2279090,-1,500.0,9337721,9337740,7142710,19,15,11,True,True,0.23264444444444443,-0.132175
2575,2195223,77,16,0.070828,254,2279090,-1,8000.0,4906861,4906938,2711638,77,71,0,True,True,10.632844444444444,-0.070828
2576,2195238,15430,32,0.38307,254,2279090,-1,16000.0,5927670,5943100,3732432,15430,50,11,True,True,11837.434666666666,-0.3794188689772101
2577,2195505,32,4,0.730763,254,2279090,-1,2000.0,3222752,3222784,1027247,32,106,6,True,True,3.584711111111111,-0.730763
2578,2195658,10815,128,0.102427,254,2279090,-1,64000.0,11243567,11254382,9047909,10815,0,12,True,True,14526.608888888888,-0.10113648282574668
2579,2195893,78,4,0.313351,254,2279090,-1,2000.0,4906861,4906939,2710968,78,74,12,True,True,2.6927333333333334,-0.313351
2580,2206570,9594,128,0.880989,254,2279090,-1,64000.0,3054687,3064281,848117,9594,122,7,True,True,13180.160533333335,-0.8297639828549589
2581,2206573,16617,3,0.137129,254,2279090,-1,1500.0,9727621,9744238,7521048,16617,13,11,True,True,694.0411666666668,-0.1347471941951384
2582,2206646,72,32,0.77346,254,2279090,-1,16000.0,4278557,4278629,2071911,72,84,10,True,True,16.8384,-0.77346
2583,2206689,13325,2,0.753158,254,2279090,-1,1000.0,3187752,3201077,981063,13325,114,7,True,True,514.8591638888888,-0.7404474002952139
2584,2206734,10,1,0.133146,254,2279090,-1,500.0,3465204,3465214,1258470,10,102,11,True,True,0.0676388888888889,-0.133146
2585,2206764,18494,1,0.99294,254,2279090,-1,500.0,2329952,2348446,123188,18494,167,11,True,True,244.01555000000002,-0.9210610505882062
2586,2206779,1110,4,0.142853,254,2279090,-1,2000.0,4048404,4049514,1841625,1110,91,2,True,True,51.83083333333333,-0.142853
2587,2206857,26637,32,0.530508,254,2279090,-1,16000.0,6930290,6956927,4723433,26637,40,12,True,True,6676.963155555555,-0.5262857485027628
2588,2207013,25,32,0.008475,254,2279090,-1,16000.0,7994090,7994115,5787077,25,30,11,True,True,5.031111111111111,-0.008475
2589,2207065,18862,128,0.65002,254,2279090,-1,64000.0,4636461,4655323,2429396,18862,81,2,True,True,38968.2704,-0.557785700878689
2590,2207184,21992,4,0.440099,254,2279090,-1,2000.0,3216952,3238944,1009768,21992,118,10,True,True,2564.0190222222222,-0.4329204532016557
2591,2207357,15,2,0.722432,254,2279090,-1,1000.0,2900172,2900187,692815,15,139,6,True,True,0.23745833333333333,-0.722432
2592,2208090,232,1,0.62808,254,2279090,-1,500.0,2579644,2579876,371554,232,161,8,True,True,6.2553,-0.62808
2593,2208115,17,13,0.151374,254,2279090,-1,6500.0,9641221,9641238,7433106,17,14,6,True,True,1.1516555555555557,-0.151374
2594,2208129,286,16,0.41171,254,2279090,-1,8000.0,4537761,4538047,2329632,286,86,1,True,True,32.65484444444444,-0.41171
2595,2208414,12148,4,0.686566,254,2279090,-1,2000.0,2882853,2895001,674439,12148,145,1,True,True,438.70902777777775,-0.6240212799953619
2596,2208490,9,1,0.859963,254,2279090,-1,500.0,2882844,2882853,674354,9,146,7,True,True,0.1000375,-0.859963
2597,2208498,3658,1,0.086688,254,2279090,-1,500.0,9684421,9688079,7475923,3658,14,11,True,True,51.71744027777778,-0.08361151457887749
2598,2208577,29,29,0.100465,254,2279090,-1,14500.0,9294521,9294550,7085944,29,20,12,True,True,6.1906944444444445,-0.100465
2599,2208764,14,2,0.752446,254,2279090,-1,1000.0,3226352,3226366,1017588,14,119,2,True,True,0.8604944444444445,-0.752446
2600,2208837,20,45,0.589574,254,2279090,-1,22500.0,6537870,6537890,4329033,20,49,8,True,True,5.19375,-0.589574
2601,2208985,23370,128,0.384032,254,2279090,-1,64000.0,11027567,11050937,8818582,23370,2,1,True,True,27036.208533333334,-0.37821856234870677
2602,2208989,13,16,0.963249,254,2279090,-1,8000.0,2358731,2358744,149742,13,180,6,True,True,4.484711111111111,-0.963249
2603,2209089,77,2,0.314504,254,2279090,-1,1000.0,7497290,7497367,5288201,77,39,12,True,True,0.658136111111111,-0.314504
2604,2209115,20024,16,0.13983,254,2279090,-1,8000.0,11329967,11349991,9120852,20024,0,12,True,True,4477.202466666667,-0.13847274529665635
2605,2209312,12,8,0.276968,254,2279090,-1,4000.0,8773921,8773933,6564609,12,28,1,True,True,0.7910666666666667,-0.276968
2606,2209681,7,8,0.084249,254,2279090,-1,4000.0,8339690,8339697,6130009,7,33,12,True,True,0.27727777777777773,-0.084249
2607,2209843,7,4,0.553397,254,2279090,-1,2000.0,3389204,3389211,1179361,7,119,7,True,True,0.6852222222222222,-0.553397
2608,2209869,14334,200,0.600008,254,2279090,-1,100000.0,5574470,5588804,3364601,14334,69,9,True,True,11237.641666666665,-0.5591804236060209
2609,2210022,15128,16,0.607593,254,2279090,-1,8000.0,2574244,2589372,364222,15128,177,10,True,True,5724.314222222222,-0.5820589482285552
2610,2210067,27,1,0.77897,254,2279090,-1,500.0,2696544,2696571,486477,27,166,7,True,True,0.5116125,-0.77897
2611,2210090,13392,4,0.690476,254,2279090,-1,2000.0,2624044,2637436,413954,13392,171,10,True,True,1450.7711555555557,-0.6368398963401561
2612,2210114,5508,64,0.847892,254,2279090,-1,32000.0,3071287,3076795,861173,5508,141,2,True,True,3348.6712888888887,-0.8353652527129407
2613,2210138,12475,95,0.658405,254,2279090,-1,47500.0,3193152,3205627,983014,12475,133,8,True,True,20687.9801875,-0.5990405947430292
2614,2210185,85,1,0.301649,254,2279090,-1,500.0,9033121,9033206,6822936,85,26,12,True,True,0.5938194444444443,-0.301649
2615,2210269,8658,16,0.517749,254,2279090,-1,8000.0,4451357,4460015,2241088,8658,98,12,True,True,1240.8782,-0.5175884108799811
2616,2210293,1166,14,0.509523,254,2279090,-1,7000.0,8601090,8602256,6390797,1166,32,7,True,True,57.72347777777778,-0.509523
2617,2210526,487,5,0.747844,254,2279090,-1,2500.0,3087252,3087739,876726,487,142,2,True,True,19.124895833333333,-0.747844
2618,2210579,16,2,0.295542,254,2279090,-1,1000.0,4494557,4494573,2283978,16,99,11,True,True,0.26639999999999997,-0.295542
2619,2210710,57968,83,0.054569,254,2279090,-1,41500.0,10678367,10736335,8467657,57968,7,12,True,True,35503.255302777776,-0.052983757789583454
2620,2210889,7752,64,0.897913,254,2279090,-1,32000.0,2786244,2793996,575355,7752,169,7,True,True,5987.006933333334,-0.7942270192822709
2621,2210918,5,2,0.954672,254,2279090,-1,1000.0,2647844,2647849,436926,5,179,7,True,True,0.11093055555555556,-0.954672
2622,2211017,122,4,0.494888,254,2279090,-1,2000.0,3959404,3959526,1748387,122,114,7,True,True,4.171044444444445,-0.494888
2623,2211488,280,3,0.112744,254,2279090,-1,1500.0,4820461,4820741,2608973,280,91,7,True,True,6.948666666666667,-0.11274400000000002
2624,2211789,27,2,0.499583,254,2279090,-1,1000.0,3686604,3686631,1474815,27,121,11,True,True,1.12755,-0.499583
2625,2211797,10983,64,0.59393,254,2279090,-1,32000.0,9424121,9435104,7212324,10983,22,12,True,True,5469.2518222222225,-0.5885263048922563
2626,2211812,15454,1,0.528287,254,2279090,-1,500.0,3071287,3086741,859475,15454,152,0,True,True,131.59587083333335,-0.5224736748691402
2627,2211845,4,4,0.977697,254,2279090,-1,2000.0,2552644,2552648,340799,4,195,6,True,True,0.3214444444444445,-0.977697
2628,2211964,343,32,0.986883,254,2279090,-1,16000.0,3269552,3269895,1057588,343,136,11,True,True,217.38577777777778,-0.986883
2629,2211969,76,4,0.933924,254,2279090,-1,2000.0,2877344,2877420,665375,76,174,12,True,True,2.744022222222222,-0.933924
2630,2211985,12454,1,0.131983,254,2279090,-1,500.0,5663070,5675524,3451085,12454,72,12,True,True,33.146816666666666,-0.13096236345203344
2631,2212785,6,32,0.860814,254,2279090,-1,16000.0,3775204,3775210,1562419,6,122,7,True,True,2.7826666666666666,-0.860814
2632,2217450,13,4,0.56838,254,2279090,-1,2000.0,4044804,4044817,1827354,13,114,8,True,True,0.6209666666666667,-0.56838
2633,2217922,28,64,0.365412,254,2279090,-1,32000.0,8426090,8426118,6208168,28,37,12,True,True,8.173511111111111,-0.365412
2634,2218080,3,8,0.682942,254,2279090,-1,4000.0,3422004,3422007,1203924,3,131,8,True,True,0.3902333333333333,-0.682942
2635,2218177,21171,128,0.762726,254,2279090,-1,64000.0,6753890,6775061,4535713,21171,57,11,True,True,27544.885866666664,-0.754641101457221
2636,2218200,4916,16,0.954453,254,2279090,-1,8000.0,2547944,2552860,329744,4916,204,2,True,True,1745.9915555555556,-0.9391222717213464
2637,2218257,19,32,0.770367,254,2279090,-1,16000.0,2590844,2590863,372587,19,200,7,True,True,13.965422222222223,-0.770367
2638,2218294,549,1,0.016689,254,2279090,-1,500.0,10505567,10506116,8287273,549,9,12,True,True,6.649,-0.016689
2639,2218364,346,27,0.067533,254,2279090,-1,13500.0,9900421,9900767,7682057,346,16,12,True,True,100.68599999999998,-0.067533
2640,2218378,6,1,0.262185,254,2279090,-1,500.0,7713290,7713296,5494912,6,48,12,True,True,0.020541666666666666,-0.262185
2641,2218446,1149,8,0.039827,254,2279090,-1,4000.0,7626890,7628039,5408444,1149,49,12,True,True,207.64983333333333,-0.039827
2642,2220087,297,16,0.060469,254,2279090,-1,8000.0,10203167,10203464,7983080,297,13,11,True,True,53.94180000000001,-0.060469
2643,2220171,31,13,0.78929,254,2279090,-1,6500.0,3030887,3030918,810716,31,172,10,True,True,3.6029319444444448,-0.78929
2644,2220465,52,4,0.506611,254,2279090,-1,2000.0,3383352,3383404,1162887,52,143,2,True,True,3.6322,-0.506611
2645,2223616,112,7,0.628571,254,2279090,-1,3500.0,4083004,4083116,1859388,112,118,10,True,True,4.947911111111111,-0.628571
2646,2223755,4483,1,0.501049,254,2279090,-1,500.0,5122861,5127344,2899106,4483,96,12,True,True,38.92131388888889,-0.5004128622666477
2647,2223976,4,6,0.415432,254,2279090,-1,3000.0,7410890,7410894,5186914,4,53,11,True,True,0.13516666666666666,-0.415432
2648,2224069,34,3,0.701811,254,2279090,-1,1500.0,3818404,3818438,1594335,34,133,11,True,True,2.0033083333333335,-0.701811
2649,2224162,9841,64,0.082428,254,2279090,-1,32000.0,10851167,10861008,8627005,9841,6,12,True,True,5770.3895999999995,-0.08103587120337122
2650,2224894,3827,1,0.536565,254,2279090,-1,500.0,3185552,3189379,960658,3827,162,1,True,True,74.596,-0.5316972620051293
2651,2224911,713,4,0.616047,254,2279090,-1,2000.0,2551544,2552257,326633,713,218,2,True,True,63.78181111111112,-0.616047
2652,2224927,116,8,0.277468,254,2279090,-1,4000.0,6710690,6710806,4485763,116,65,12,True,True,7.6456888888888885,-0.277468
2653,2226269,118,8,0.309907,254,2279090,-1,4000.0,4626361,4626479,2400092,118,111,7,True,True,7.5756000000000006,-0.309907
2654,2226296,4979,17,0.511305,254,2279090,-1,8500.0,2331052,2336031,104756,4979,235,6,True,True,1427.4509944444444,-0.4729144235211419
2655,2226375,73,4,0.203197,254,2279090,-1,2000.0,7778090,7778163,5551715,73,49,10,True,True,2.3027444444444445,-0.203197
2656,2226742,2595,16,0.80806,254,2279090,-1,8000.0,3643404,3645999,1416662,2595,141,12,True,True,1079.1163333333334,-0.80806
2657,2226774,23165,1,0.53639,254,2279090,-1,500.0,3064087,3087252,837313,23165,178,7,True,True,211.2725597222222,-0.5327803102379638
2658,2227829,24,4,0.390732,254,2279090,-1,2000.0,2701944,2701968,474115,24,206,8,True,True,1.9450666666666667,-0.390732
2659,2228113,10,8,0.634294,254,2279090,-1,4000.0,3416604,3416614,1188491,10,147,10,True,True,1.4791111111111113,-0.634294
2660,2228175,6,16,0.834526,254,2279090,-1,8000.0,3970204,3970210,1742029,6,132,9,True,True,0.4426666666666667,-0.834526
2661,2228383,432,32,0.681056,254,2279090,-1,16000.0,4039404,4039836,1811021,432,129,7,True,True,198.91199999999998,-0.681056
2662,2228637,7092,1,0.066115,254,2279090,-1,500.0,11157167,11164259,8928530,7092,2,11,True,True,87.31888194444444,-0.06579501148240462
2663,2229278,185,1,0.698676,254,2279090,-1,500.0,4731861,4732046,2502583,185,108,8,True,True,3.8068888888888885,-0.698676
2664,2229642,11216,1,0.729958,254,2279090,-1,500.0,2787344,2798560,557702,11216,205,6,True,True,148.1494,-0.7120547452073316
2665,2229695,804,2,0.846468,254,2279090,-1,1000.0,3957204,3958008,1727509,804,137,1,True,True,13.743933333333333,-0.846468
2666,2229769,19826,32,0.057906,254,2279090,-1,16000.0,9987167,10006993,7757398,19826,18,12,True,True,7831.7696,-0.057121065015938235
2667,2229799,5,1,0.086213,254,2279090,-1,500.0,2583244,2583249,353445,5,229,2,True,True,0.11091666666666666,-0.086213
5518,4447222,5,1,0.647793,1,4447222,-1,500.0,4533622,4533627,86400,5,0,12,True,True,0.06496527777777777,-0.647793
5519,4447274,9180,256,0.176618,166,4533622,-1,128000.0,13084769,13093949,8637495,9180,0,12,True,True,33924.397511111114,-0.13410889419087055
5520,4447328,14,32,0.039331,166,4533622,-1,16000.0,12992969,12992983,8545641,14,1,12,True,True,2.2319111111111107,-0.039331
5521,4447560,21273,4,0.384164,166,4533622,-1,2000.0,9060895,9082168,4613335,21273,2,8,True,True,1171.9892166666668,-0.3779161903522111
5522,4447584,229,4,0.191003,166,4533622,-1,2000.0,5876915,5877144,1429331,229,3,2,True,True,17.546488888888884,-0.191003
5523,4447982,25979,118,0.695882,166,4533622,-1,59000.0,6603133,6629112,2155151,25979,3,12,True,True,52390.321777777775,-0.6906153384574082
5524,4448069,22,1,0.896461,166,4533622,-1,500.0,4855318,4855340,407249,22,5,7,True,True,0.2771694444444444,-0.896461
5525,4448097,102,16,0.630617,166,4533622,-1,8000.0,8582095,8582197,4133998,102,3,12,True,True,15.449599999999998,-0.630617
5526,4448179,5,15,0.359261,166,4533622,-1,7500.0,11539671,11539676,7091492,5,2,11,True,True,1.3940625000000002,-0.359261
5527,4448207,22666,32,0.084862,166,4533622,-1,16000.0,9067395,9090061,4619188,22666,3,8,True,True,10847.777288888889,-0.08299768405453355
5528,4448248,31,4,0.632791,166,4533622,-1,2000.0,4600292,4600323,152044,31,9,7,True,True,2.109722222222222,-0.632791
5529,4448319,7814,128,0.735324,166,4533622,-1,64000.0,4619622,4627436,171303,7814,9,7,True,True,21281.821155555554,-0.6903716308337842
5530,4448730,31,16,0.139943,166,4533622,-1,8000.0,12431369,12431400,7982639,31,2,11,True,True,4.8112,-0.139943
5531,4448774,16,4,0.193093,166,4533622,-1,2000.0,7731995,7732011,3283221,16,7,10,True,True,1.557688888888889,-0.193093
5532,4448838,33,2,0.719739,166,4533622,-1,1000.0,5029606,5029639,580768,33,10,10,True,True,1.4058000000000002,-0.719739
5533,4449247,7918,1,0.592945,166,4533622,-1,500.0,5873315,5881233,1424068,7918,10,1,True,True,149.6375138888889,-0.5878545064053777
5534,4449408,16395,12,0.489233,166,4533622,-1,6000.0,9626871,9643266,5177463,16395,4,9,True,True,4946.017250000001,-0.48616657840159977
5535,4449879,56,1,0.062993,166,4533622,-1,500.0,4967718,4967774,517839,56,13,7,True,True,0.9465555555555556,-0.062993
5536,4449895,2398,16,0.540552,166,4533622,-1,8000.0,9163195,9165593,4713300,2398,5,12,True,True,704.5324,-0.540552
5537,4450351,3163,1,0.307731,166,4533622,-1,500.0,10500671,10503834,6050320,3163,4,12,True,True,45.22067638888889,-0.30635224545035655
5538,4450360,14342,4,0.53394,166,4533622,-1,2000.0,8495695,8510037,4045335,14342,10,12,True,True,898.5243222222223,-0.5265293191582925
5539,4450400,39,8,0.83425,166,4533622,-1,4000.0,5333215,5333254,882815,39,15,7,True,True,6.279000000000001,-0.83425
5540,4450560,13230,1,0.449307,166,4533622,-1,500.0,7710395,7723625,3259835,13230,12,12,True,True,310.00090277777775,-0.41188338803810237
5541,4450635,25896,1,0.995834,166,4533622,-1,500.0,4853118,4879014,402483,25896,20,10,True,True,394.3642833333333,-0.9710260669244606
5542,4450670,16527,32,0.037043,166,4533622,-1,16000.0,5481915,5498442,1031245,16527,16,8,True,True,11808.629733333333,-0.03635375986520477
5543,4450960,155,9,0.056054,166,4533622,-1,4500.0,5499915,5500070,1048955,155,16,2,True,True,32.302,-0.056054
5544,4451396,7764,4,0.787779,166,4533622,-1,2000.0,5818915,5826679,1367519,7764,16,12,True,True,433.45565555555555,-0.7329101020747244
5545,4451584,107,82,0.042815,166,4533622,-1,41000.0,13430369,13430476,8978785,107,0,12,True,True,149.1701861111111,-0.042815
5546,4451620,44,32,0.118187,166,4533622,-1,16000.0,6706840,6706884,2255220,44,14,12,True,True,25.19537777777778,-0.118187
5547,4451634,8215,9,0.807104,166,4533622,-1,4500.0,5179815,5188030,728181,8215,22,1,True,True,1354.4378125,-0.7489916805782978
5548,4452803,26155,4,0.667316,166,4533622,-1,2000.0,5170406,5196561,717603,26155,23,2,True,True,1883.940938888889,-0.6612414319138774
5549,4452848,156,2,0.45837,166,4533622,-1,1000.0,7494340,7494496,3041492,156,14,12,True,True,3.747466666666667,-0.45837
5550,4453339,29,8,0.678078,166,4533622,-1,4000.0,4694222,4694251,240883,29,29,9,True,True,3.6340222222222223,-0.678078
5551,4453369,15,7,0.874255,166,4533622,-1,3500.0,4999995,5000010,546626,15,26,2,True,True,1.7077083333333334,-0.874255
5552,4453378,6,32,0.148954,166,4533622,-1,16000.0,11410071,11410077,6956693,6,5,12,True,True,1.8504,-0.148954
5553,4453717,113,1,0.579346,166,4533622,-1,500.0,6988740,6988853,2535023,113,16,11,True,True,2.195495833333333,-0.579346
5554,4453925,74,8,0.924816,166,4533622,-1,4000.0,4577376,4577450,123451,74,35,1,True,True,11.97731111111111,-0.924816
5555,4453933,9,1,0.036878,166,4533622,-1,500.0,12215369,12215378,7761436,9,4,12,True,True,0.08539999999999999,-0.036878
5556,4453955,12221,8,0.14159,166,4533622,-1,4000.0,10716671,10728892,6262716,12221,7,12,True,True,1919.934077777778,-0.12121292265265383
5557,4454014,19588,16,0.653832,166,4533622,-1,8000.0,8060395,8079983,3606381,19588,15,12,True,True,5390.045044444444,-0.6284027868175917
5558,4454143,24945,32,0.47122,166,4533622,-1,16000.0,7537540,7562485,3083397,24945,18,11,True,True,11896.17977777778,-0.4637448819393944
5559,4454163,5965,16,0.918019,166,4533622,-1,8000.0,4603022,4608987,148859,5965,38,7,True,True,1570.8212444444446,-0.8069423620778687
5560,4454391,10287,188,0.045802,166,4533622,-1,94000.0,11815071,11825358,7360680,10287,5,12,True,True,33076.44896666666,-0.038112466074366955
5561,4454436,55,16,0.701297,166,4533622,-1,8000.0,7623940,7623995,3169504,55,19,12,True,True,13.856333333333334,-0.701297
5562,4454459,501,64,0.130538,166,4533622,-1,32000.0,13127969,13128470,8673510,501,1,11,True,True,740.5002666666667,-0.130538
5563,4454483,14827,128,0.172249,166,4533622,-1,64000.0,10891671,10906498,6437188,14827,9,12,True,True,27613.9616,-0.1588213110583871
5564,4454632,15,32,0.049958,166,4533622,-1,16000.0,6168933,6168948,1714301,15,27,10,True,True,6.582666666666666,-0.049958
5565,4454811,9,1,0.307337,166,4533622,-1,500.0,8322895,8322904,3868084,9,18,12,True,True,0.2169125,-0.307337
5566,4454844,13049,16,0.793697,166,4533622,-1,8000.0,4716922,4729971,262078,13049,42,6,True,True,3842.5197333333335,-0.7933289770764818
5567,4455102,16479,32,0.456185,166,4533622,-1,16000.0,9715471,9731950,5260369,16479,12,12,True,True,10422.911688888888,-0.40572344716525094
5568,4455208,4,32,0.170689,166,4533622,-1,16000.0,8841295,8841299,4386087,4,17,11,True,True,1.309688888888889,-0.170689
5569,4455263,5,16,0.591042,166,4533622,-1,8000.0,7317140,7317145,2861877,5,27,12,True,True,1.488,-0.591042
5570,4455308,375,2,0.8178,166,4533622,-1,1000.0,4683422,4683797,228114,375,47,6,True,True,12.704352777777778,-0.7592901121802679
5571,4455339,34906,1,0.106331,166,4533622,-1,500.0,13343969,13378875,8888630,34906,1,12,True,True,961.2083527777777,-0.10496125406964088
5572,4455394,18,4,0.497143,166,4533622,-1,2000.0,7930795,7930813,3475401,18,23,12,True,True,1.6149388888888887,-0.48575481851336444
5573,4455785,17910,1,0.799175,166,4533622,-1,500.0,6609633,6627543,2153848,17910,32,6,True,True,312.3023708333333,-0.7984540084920404
5574,4455800,37228,37,0.220573,166,4533622,-1,18500.0,9629071,9666299,5173271,37228,14,7,True,True,31892.410130555556,-0.21366360749022273
5575,4455844,11896,34,0.804454,166,4533622,-1,17000.0,4715822,4727718,259978,11896,50,10,True,True,7489.442650000001,-0.8039450813517249
5576,4455958,137,1,0.426211,166,4533622,-1,500.0,8409295,8409432,3953337,137,22,12,True,True,3.386754166666667,-0.426211
5577,4457648,36,1,0.811521,166,4533622,-1,500.0,7119440,7119476,2661792,36,32,6,True,True,0.67585,-0.811521
5578,4463451,4177,64,0.982193,166,4533622,-1,32000.0,4995818,4999995,532367,4177,48,6,True,True,4261.464177777778,-0.974054893243201
5579,4463634,4,1,0.678398,166,4533622,-1,500.0,6750040,6750044,2286406,4,34,10,True,True,0.07913333333333333,-0.678398
5580,4463694,276,4,0.324235,166,4533622,-1,2000.0,6608533,6608809,2144839,276,37,8,True,True,17.72073333333333,-0.324235
5581,4463947,536,24,0.975853,166,4533622,-1,12000.0,4750418,4750954,286471,536,54,6,True,True,183.34773333333334,-0.975853
5582,4464265,6,8,0.575967,166,4533622,-1,4000.0,5075006,5075012,610741,6,48,7,True,True,0.7430000000000001,-0.575967
5583,4464805,14525,1,0.137329,166,4533622,-1,500.0,6728440,6742965,2263635,14525,35,10,True,True,242.55602777777776,-0.12968677744560692
5584,4464867,73,1,0.836427,166,4533622,-1,500.0,5599315,5599388,1134448,73,44,3,True,True,1.2349166666666667,-0.836427
5585,4464895,499,4,0.793102,166,4533622,-1,2000.0,4600323,4600822,135428,499,64,1,True,True,33.83481111111111,-0.7901848014612082
5586,4465011,103,8,0.764228,166,4533622,-1,4000.0,4942818,4942921,477807,103,55,12,True,True,13.911866666666667,-0.764228
5587,4465046,13,2,0.593085,166,4533622,-1,1000.0,9443271,9443284,4978225,13,16,12,True,True,0.4466583333333333,-0.593085
5588,4465557,56,8,0.335504,166,4533622,-1,4000.0,7319340,7319396,2853783,56,32,7,True,True,8.899644444444444,-0.335504
5589,4465601,18274,1,0.120745,166,4533622,-1,500.0,6147333,6165607,1681732,18274,43,12,True,True,223.25452916666666,-0.1172628888280806
5590,4465636,78,2,0.141237,166,4533622,-1,1000.0,10414271,10414349,5948635,78,13,12,True,True,1.3762666666666667,-0.141237
5591,4476701,15193,1,0.415154,166,4533622,-1,500.0,11064471,11079664,6587770,15193,10,12,True,True,165.82261666666665,-0.39768386772364533
5592,4476870,237,1,0.696296,166,4533622,-1,500.0,9720871,9721108,5244001,237,15,8,True,True,4.7014875,-0.696296
5593,4476890,59,2,0.553408,166,4533622,-1,1000.0,10066471,10066530,5589581,59,15,12,True,True,1.981252777777778,-0.553408
5594,4477000,18387,1,0.438661,166,4533622,-1,500.0,8798095,8816482,4321095,18387,25,12,True,True,327.0768958333333,-0.4309678204497848
5595,4477331,7032,32,0.925676,166,4533622,-1,16000.0,4994718,5001750,517387,7032,62,10,True,True,3508.8498666666665,-0.9256601715626475
5596,4477589,2634,1,0.040699,166,4533622,-1,500.0,6060933,6063567,1583344,2634,49,1,True,True,53.006320833333334,-0.0361311146980866
5597,4479098,38,36,0.099968,166,4533622,-1,18000.0,12998369,12998407,8519271,38,4,8,True,True,8.8597,-0.099968
5598,4479574,116,32,0.847367,166,4533622,-1,16000.0,4592176,4592292,112602,116,78,3,True,True,73.29137777777777,-0.847367
5599,4479759,23,1,0.612442,166,4533622,-1,500.0,4720522,4720545,240763,23,70,1,True,True,0.44591250000000004,-0.612442
5600,4479965,23122,85,0.777662,166,4533622,-1,42500.0,4586376,4609498,106411,23122,80,1,True,True,35201.49955555556,-0.7237343512247053
5601,4479974,874,1,0.01563,166,4533622,-1,500.0,10543871,10544745,6063897,874,14,11,True,True,8.912340277777778,-0.01432289674041569
5602,4480013,903,2,0.486967,166,4533622,-1,1000.0,9227271,9228174,4747258,903,23,7,True,True,36.25545,-0.486967
5603,4480707,9507,16,0.00635,166,4533622,-1,8000.0,4582776,4592283,102069,9507,83,8,True,True,3157.6618666666673,-0.006339508909907236
5604,4480767,60,1,0.179413,166,4533622,-1,500.0,8927695,8927755,4446928,60,27,12,True,True,0.48633333333333334,-0.179413
5605,4480810,29,1,0.089141,166,4533622,-1,500.0,12128969,12128998,7648159,29,8,12,True,True,0.2820652777777778,-0.089141
5606,4480861,9072,3,0.651756,166,4533622,-1,1500.0,5869715,5878787,1388854,9072,57,10,True,True,519.5466624999999,-0.6517447883621116
5607,4482498,10,121,0.886915,166,4533622,-1,60500.0,8236495,8236505,3753997,10,35,12,True,True,20.247333333333337,-0.8869150000000002
5608,4483981,53,28,0.416222,166,4533622,-1,14000.0,11944671,11944724,7460690,53,9,12,True,True,34.94201666666667,-0.416222
5609,4485144,20673,1,0.807412,166,4533622,-1,500.0,5072806,5093479,587662,20673,68,11,True,True,392.5275847222223,-0.8034956632073638
5610,4487909,4,1,0.772563,166,4533622,-1,500.0,4558522,4558526,70613,4,91,7,True,True,0.07317777777777777,-0.772563
5611,4487985,15,64,0.692358,166,4533622,-1,32000.0,5287815,5287830,799830,15,65,10,True,True,17.770666666666667,-0.692358
5612,4510866,85,16,0.20616,166,4533622,-1,8000.0,12906569,12906654,8395703,85,6,12,True,True,12.039777777777777,-0.20616
5613,4510882,3,3,0.639826,166,4533622,-1,1500.0,4588576,4588579,77694,3,90,7,True,True,0.18881250000000002,-0.639826
5614,4511154,16606,8,0.523087,166,4533622,-1,4000.0,5842715,5859321,1331561,16606,61,7,True,True,2269.3141444444445,-0.474718639812302
5615,4511179,215,32,0.412031,166,4533622,-1,16000.0,8958295,8958510,4447116,215,30,2,True,True,122.99911111111112,-0.412031
5616,4511310,19035,8,0.93809,166,4533622,-1,4000.0,5355915,5374950,844605,19035,67,6,True,True,2779.557333333333,-0.9075949594760323
5617,4511499,4827,1,0.610538,166,4533622,-1,500.0,7822795,7827622,3311296,4827,41,12,True,True,111.60038194444444,-0.5816098215967294
5618,4511753,13257,16,0.037621,166,4533622,-1,8000.0,12733769,12747026,8222016,13257,7,12,True,True,3283.9217777777776,-0.03714499632104449
5619,4511871,26313,256,0.18,166,4533622,-1,128000.0,5642515,5668828,1130644,26313,66,11,True,True,97519.4599111111,-0.17514793129526912
5620,4511897,9,1,0.499888,166,4533622,-1,500.0,5172606,5172615,660709,9,74,7,True,True,0.13921250000000002,-0.499888
5621,4512052,29,1,0.950298,166,4533622,-1,500.0,4555222,4555251,43170,29,102,10,True,True,0.6187472222222222,-0.950298
5622,4512336,7,4,0.627192,166,4533622,-1,2000.0,4600822,4600829,88486,7,94,1,True,True,0.43664444444444445,-0.627192
5623,4512344,10183,128,0.782583,166,4533622,-1,64000.0,5732515,5742698,1220171,10183,66,1,True,True,25194.91537777778,-0.7086808258239887
5624,4512484,6867,1,0.347854,166,4533622,-1,500.0,10718871,10725738,6206387,6867,17,7,True,True,138.42567083333333,-0.307692776095484
5625,4512523,10641,4,0.00457,166,4533622,-1,2000.0,11237271,11247912,6724748,10641,15,12,True,True,607.23205,-0.004011327109826332
5626,4512568,9408,20,0.235639,166,4533622,-1,10000.0,8938495,8947903,4425927,9408,34,9,True,True,2003.799777777778,-0.2222359089699717
5627,4513133,10312,256,0.117508,166,4533622,-1,128000.0,13257569,13267881,8744436,10312,2,12,True,True,43401.30915555555,-0.11735887543957155
5628,4513172,278,8,0.530199,166,4533622,-1,4000.0,11323671,11323949,6810499,278,16,12,True,True,39.53777777777778,-0.530199
5629,4513229,131,1,0.095684,166,4533622,-1,500.0,8954695,8954826,4441466,131,36,9,True,True,2.3059638888888885,-0.095684
5630,4513502,29923,8,0.361901,166,4533622,-1,4000.0,9270471,9300394,4756969,29923,31,11,True,True,4785.678466666667,-0.3563968122990013
5631,4513893,115,4,0.761128,166,4533622,-1,2000.0,7973995,7974110,3460102,115,48,11,True,True,8.988861111111111,-0.6993212918605676
5632,4513961,12531,206,0.539723,166,4533622,-1,103000.0,5880515,5893046,1366554,12531,69,3,True,True,47772.608247222226,-0.5368474112841768
5633,4514005,12786,1,0.219276,166,4533622,-1,500.0,11728671,11741457,7214666,12786,14,12,True,True,153.25122083333335,-0.18996736315880816
5634,4516809,8,128,0.770331,166,4533622,-1,64000.0,5503515,5503523,986706,8,79,2,True,True,21.654755555555553,-0.770331
5635,4516825,14,2,0.659327,166,4533622,-1,1000.0,4856418,4856432,339593,14,96,6,True,True,0.31317222222222224,-0.659327
5636,4516932,25708,1,0.276427,166,4533622,-1,500.0,10805271,10830979,6288339,25708,21,12,True,True,315.46333888888887,-0.2605188927151061
5637,4517075,17,1,0.193719,166,4533622,-1,500.0,11550471,11550488,7033396,17,15,8,True,True,0.33218472222222223,-0.193719
5638,4517257,2,1,0.796613,166,4533622,-1,500.0,4635822,4635824,118565,2,107,9,True,True,0.04156111111111111,-0.796613
5639,4517345,1051,16,0.685244,166,4533622,-1,8000.0,5008006,5009057,490661,1051,93,6,True,True,351.5711777777778,-0.685244
5640,4517516,8846,64,0.968574,166,4533622,-1,32000.0,5592115,5600961,1074599,8846,81,7,True,True,9488.125777777777,-0.9670917526658431
5641,4517639,67,16,0.474413,166,4533622,-1,8000.0,9616071,9616138,5098432,67,33,0,True,True,24.300155555555556,-0.474413
5642,4518334,13,4,0.176324,166,4533622,-1,2000.0,8625295,8625308,4106961,13,46,11,True,True,0.44171111111111105,-0.176324
5643,4518433,41,4,0.670143,166,4533622,-1,2000.0,5354815,5354856,836382,41,88,10,True,True,3.2904777777777783,-0.670143
5644,4519280,15706,216,0.043116,166,4533622,-1,108000.0,12517769,12533475,7998489,15706,9,12,True,True,78756.93480000002,-0.04165188017140299
5645,4520412,26,4,0.644861,166,4533622,-1,2000.0,5968015,5968041,1447603,26,75,6,True,True,2.0655555555555556,-0.644861
5646,4521523,8,1,0.285065,166,4533622,-1,500.0,9061995,9062003,4540472,8,40,6,True,True,0.10637777777777777,-0.285065
5647,4521690,260,24,0.434672,166,4533622,-1,12000.0,11555871,11556131,7034181,260,16,8,True,True,120.58776666666665,-0.41368088271493214
5648,4521909,11,2,0.334295,166,4533622,-1,1000.0,7623995,7624006,3102086,11,61,1,True,True,0.3464083333333334,-0.334295
5649,4522729,3,1,0.805154,166,4533622,-1,500.0,4724122,4724125,201393,3,112,2,True,True,0.05709166666666667,-0.805154
5650,4522899,35,3,0.758408,166,4533622,-1,1500.0,4726322,4726357,203423,35,112,7,True,True,1.9982083333333336,-0.758408
5651,4522924,5,1,0.043317,166,4533622,-1,500.0,7407940,7407945,2885016,5,65,7,True,True,0.06570833333333334,-0.043317
5652,4522944,39,8,0.740417,166,4533622,-1,4000.0,6343933,6343972,1820989,39,76,12,True,True,4.8026333333333335,-0.740417
5653,4522957,35,16,0.924861,166,4533622,-1,8000.0,4999418,4999453,476461,35,106,1,True,True,9.107777777777777,-0.924861
5654,4523140,9578,16,0.175888,166,4533622,-1,8000.0,9055495,9065073,4532355,9578,43,12,True,True,2022.2220444444445,-0.1745931137498898
5655,4523250,9,1,0.785492,166,4533622,-1,500.0,5476515,5476524,953265,9,95,12,True,True,0.1516625,-0.785492
5656,4523363,12532,2,0.485061,166,4533622,-1,1000.0,5589915,5602447,1066552,12532,92,12,True,True,423.6876361111111,-0.4715010901983806
5657,4524246,9,3,0.116065,166,4533622,-1,1500.0,9529671,9529680,5005425,9,36,12,True,True,0.6261375,-0.116065
5658,4524794,22,8,0.895079,166,4533622,-1,4000.0,4965518,4965540,440724,22,114,10,True,True,2.974888888888889,-0.895079
5659,4526009,18052,32,0.721403,166,4533622,-1,16000.0,6706840,6724892,2180831,18052,74,0,True,True,9686.714488888889,-0.713316262315348
5660,4526106,312,1,0.592707,166,4533622,-1,500.0,7405740,7406052,2879634,312,68,12,True,True,4.1002,-0.592707
5661,4526425,95,4,0.325972,166,4533622,-1,2000.0,4598092,4598187,71667,95,135,7,True,True,6.465277777777778,-0.325972
5662,4528509,10985,7,0.198751,166,4533622,-1,3500.0,11150871,11161856,6622362,10985,22,12,True,True,1647.9784513888887,-0.1922504232609575
5663,4528532,13,2,0.676853,166,4533622,-1,1000.0,4682322,4682335,153790,13,130,7,True,True,0.4743555555555556,-0.676853
5664,4528542,6902,256,0.325685,166,4533622,-1,128000.0,7736395,7743297,3207853,6902,62,7,True,True,40165.702755555554,-0.3146024323199372
5665,4528627,58,1,0.778975,166,4533622,-1,500.0,4679022,4679080,150395,58,132,11,True,True,0.9556305555555555,-0.778975
5666,4528643,5,16,0.326132,166,4533622,-1,8000.0,5973415,5973420,1444772,5,86,8,True,True,1.5496666666666667,-0.326132
5667,4528671,7501,2,0.098064,166,4533622,-1,1000.0,10978071,10985572,6449400,7501,24,12,True,True,148.43144722222223,-0.08950482409925767
5668,4529621,14,2,0.737748,166,4533622,-1,1000.0,6516733,6516747,1987112,14,83,11,True,True,0.5138777777777777,-0.737748
5669,4529931,4,6,0.869886,166,4533622,-1,3000.0,4565726,4565730,35795,4,148,2,True,True,0.45399999999999996,-0.869886
5670,4530007,7692,8,0.375532,166,4533622,-1,4000.0,6473533,6481225,1943526,7692,84,12,True,True,964.2621555555556,-0.34358140110808794
5671,4530554,17,10,0.220663,166,4533622,-1,5000.0,6859140,6859157,2328586,17,76,12,True,True,3.096361111111111,-0.220663
5672,4530578,845,1,0.47099,166,4533622,-1,500.0,8147895,8148740,3617317,845,59,12,True,True,21.56040972222222,-0.47099
5673,4530844,8764,4,0.484408,166,4533622,-1,2000.0,9168595,9177359,4637751,8764,42,8,True,True,646.6381833333334,-0.44036570969879446
5674,4531169,3,32,0.890489,166,4533622,-1,16000.0,4625022,4625025,93853,3,141,8,True,True,2.166666666666667,-0.890489
5675,4531344,21,1,0.144941,166,4533622,-1,500.0,12301769,12301790,7770425,21,11,12,True,True,0.14099166666666668,-0.144941
5676,4531526,20,16,0.927887,166,4533622,-1,8000.0,4606622,4606642,75096,20,144,2,True,True,4.994222222222223,-0.927887
5677,4531638,26,1,0.454991,166,4533622,-1,500.0,9807271,9807297,5275633,26,34,12,True,True,0.44308333333333333,-0.454991
5678,4531659,557,1,0.38733,166,4533622,-1,500.0,7230740,7231297,2699081,557,78,6,True,True,13.36722638888889,-0.38733
5679,4531671,7658,4,0.136405,166,4533622,-1,2000.0,10325671,10333329,5794000,7658,33,12,True,True,584.9757222222223,-0.13406287404402786
5680,4531782,62,1,0.719821,166,4533622,-1,500.0,5390115,5390177,858333,62,113,10,True,True,1.0023333333333333,-0.719821
5681,4531933,1006,32,0.632021,166,4533622,-1,16000.0,10152871,10153877,5620938,1006,34,12,True,True,462.93884444444444,-0.632021
5682,4532622,14,1,0.975556,166,4533622,-1,500.0,4973118,4973132,440496,14,130,8,True,True,0.2664083333333333,-0.975556
5683,4532680,5732,128,0.202211,166,4533622,-1,64000.0,13603169,13608901,9070489,5732,0,12,True,True,9834.992177777778,-0.19831448240492744
5684,4532800,98,8,0.127212,166,4533622,-1,4000.0,12560969,12561067,8028169,98,10,11,True,True,6.268733333333333,-0.127212
5685,4534150,9493,16,0.692211,254,4555222,-1,8000.0,5003306,5012799,469156,9493,128,1,True,True,3158.3848222222223,-0.6307951410667353
5686,4534165,11917,32,0.059652,254,4555222,-1,16000.0,11858271,11870188,7324106,11917,17,11,True,True,3142.269955555556,-0.05545312565801322
5687,4534238,47,1,0.136501,254,4555222,-1,500.0,5331015,5331062,796777,47,121,11,True,True,0.9898722222222222,-0.136501
5688,4534246,13,16,0.851651,254,4555222,-1,8000.0,6751140,6751153,2216894,13,87,6,True,True,4.114933333333333,-0.851651
5689,4534395,78,41,0.458579,254,4555222,-1,20500.0,9893671,9893749,5359276,78,39,12,True,True,68.6504,-0.458579
5690,4534431,2356,32,0.171201,254,4555222,-1,16000.0,9073195,9075551,4538764,2356,52,2,True,True,963.4469333333335,-0.171201
5691,4534672,3,4,0.343576,254,4555222,-1,2000.0,7844395,7844398,3309723,3,73,10,True,True,0.30705,-0.343576
5692,4534701,127,1,0.886409,254,4555222,-1,500.0,4831518,4831645,296817,127,146,6,True,True,1.5811499999999998,-0.886409
5693,4534756,8,1,0.603636,254,4555222,-1,500.0,5492715,5492723,957959,8,119,9,True,True,0.18775555555555554,-0.603636
5694,4534783,7493,13,0.789547,254,4555222,-1,6500.0,4830418,4837911,295635,7493,148,7,True,True,1242.0414319444444,-0.7821246594555473
5695,4535473,14324,32,0.637999,254,4555222,-1,16000.0,6387133,6401457,1851660,14324,100,11,True,True,6986.619244444444,-0.6017701723362967
5696,4536952,7,2,0.611528,254,4555222,-1,1000.0,6620433,6620440,2083481,7,95,2,True,True,0.2556555555555555,-0.611528
5697,4537101,22782,64,0.169935,254,4555222,-1,32000.0,8061495,8084277,3524394,22782,70,6,True,True,25172.1872,-0.16858845272328776
5698,4537167,10152,2,0.970136,254,4555222,-1,1000.0,5001095,5011247,463928,10152,139,6,True,True,376.29850277777774,-0.796619761112355
5699,4537238,12,4,0.855004,254,4555222,-1,2000.0,5166806,5166818,629568,12,134,8,True,True,0.5758666666666666,-0.855004
5700,4537337,23,4,0.086474,254,4555222,-1,2000.0,9980071,9980094,5442734,23,39,12,True,True,1.7366277777777779,-0.086474
5701,4537344,189,1,0.856974,254,4555222,-1,500.0,4804418,4804607,267074,189,155,8,True,True,3.248175,-0.856974
5702,4537367,11498,256,0.489213,254,4555222,-1,128000.0,12031071,12042569,7493704,11498,16,12,True,True,49009.491555555556,-0.43085696268673335
5703,4537480,15,12,0.995664,254,4555222,-1,6000.0,4828218,4828233,290738,15,156,10,True,True,2.0785,-0.995664
5704,4537510,203,32,0.591581,254,4555222,-1,16000.0,6945540,6945743,2408030,203,92,12,True,True,92.58604444444445,-0.591581
5705,4537875,9,1,0.836989,254,4555222,-1,500.0,5361315,5361324,823440,9,129,8,True,True,0.1492375,-0.836989
5706,4537929,4,4,0.279171,254,4555222,-1,2000.0,9616071,9616075,5078142,4,48,12,True,True,0.3626888888888889,-0.279171
5707,4537994,9,2,0.730018,254,4555222,-1,1000.0,4562126,4562135,24132,9,186,1,True,True,0.324425,-0.730018
5708,4538286,7597,2,0.736179,254,4555222,-1,1000.0,8963695,8971292,4425409,7597,60,8,True,True,261.38517222222225,-0.628023402902752
5709,4538325,12320,1,0.246654,254,4555222,-1,500.0,8150095,8162415,3611770,12320,73,7,True,True,271.81347222222223,-0.2351438686509355
5710,4538828,2,16,0.327296,254,4555222,-1,8000.0,12042569,12042571,7503741,2,16,8,True,True,0.6063555555555555,-0.327296
5711,4538836,3,4,0.579467,254,4555222,-1,2000.0,6772740,6772743,2233904,3,98,10,True,True,0.1839,-0.579467
5712,4539024,19,4,0.891823,254,4555222,-1,2000.0,5368515,5368534,829491,19,134,2,True,True,1.327888888888889,-0.891823
5713,4539041,7308,2,0.591772,254,4555222,-1,1000.0,7031940,7039248,2492899,7308,95,11,True,True,241.84933333333333,-0.5910216029199862
5714,4539072,11767,4,0.14897,254,4555222,-1,2000.0,11496471,11508238,6957399,11767,25,12,True,True,630.1530222222223,-0.14539663528291027
5715,4539154,266,4,0.573701,254,4555222,-1,2000.0,4799018,4799284,259864,266,168,8,True,True,17.47028888888889,-0.573701
5716,4539197,12,32,0.005078,254,4555222,-1,16000.0,9356871,9356883,4817674,12,53,12,True,True,7.8368,-0.005078
5717,4539250,24,1,0.980184,254,4555222,-1,500.0,4727718,4727742,188468,24,171,2,True,True,0.4166,-0.980184
5718,4539326,9,1,0.040059,254,4555222,-1,500.0,12388169,12388178,7848843,9,13,12,True,True,0.0791625,-0.040059
5719,4539362,12486,128,0.470653,254,4555222,-1,64000.0,11858271,11870757,7318909,12486,20,0,True,True,13281.214933333335,-0.44248676286733574
5720,4539386,549,16,0.768606,254,4555222,-1,8000.0,5848115,5848664,1308729,549,126,8,True,True,154.1348,-0.768606
5721,4539400,38,11,0.033621,254,4555222,-1,5500.0,10630271,10630309,6090871,38,38,12,True,True,1.2180055555555556,-0.033621
5722,4539428,6673,11,0.531122,254,4555222,-1,5500.0,4566492,4573165,27064,6673,199,2,True,True,1403.3589930555554,-0.5224306120559596
5723,4539570,29,1,0.479269,254,4555222,-1,500.0,7734195,7734224,3194625,29,88,7,True,True,0.6730013888888889,-0.479269
5724,4539617,41,4,0.798018,254,4555222,-1,2000.0,5595715,5595756,1056098,41,134,2,True,True,2.732422222222222,-0.798018
5725,4539651,11,4,0.821291,254,4555222,-1,2000.0,5003295,5003306,463644,11,159,7,True,True,0.6551111111111112,-0.821291
5726,4539700,12,8,0.452441,254,4555222,-1,4000.0,5006906,5006918,467206,12,158,2,True,True,1.8228000000000002,-0.452441
5727,4539973,16323,2,0.240511,254,4555222,-1,1000.0,9069595,9085918,4529622,16323,62,7,True,True,486.7722583333333,-0.2381119635137038
5728,4540032,20468,8,0.558487,254,4555222,-1,4000.0,8943895,8964363,4403863,20468,70,8,True,True,2528.7225,-0.5218649272388572
5729,4540119,7,1,0.012423,254,4555222,-1,500.0,7143240,7143247,2603121,7,102,7,True,True,0.1275652777777778,-0.012423
5730,4540204,452,2,0.731786,254,4555222,-1,1000.0,7118340,7118792,2578136,452,104,12,True,True,16.971344444444444,-0.731786
5731,4540698,84,4,0.949934,254,4555222,-1,2000.0,4577292,4577376,36594,84,207,8,True,True,6.797933333333333,-0.949934
5732,4540838,16624,128,0.132712,254,4555222,-1,64000.0,13646369,13662993,9105531,16624,0,11,True,True,40070.23413333333,-0.1264327366468337
5733,4541331,1361,16,0.29579,254,4555222,-1,8000.0,11642271,11643632,7100940,1361,25,12,True,True,369.4775333333333,-0.2880875493700641
5734,4542711,39803,32,0.64764,254,4555222,-1,16000.0,7141040,7180843,2598329,39803,105,10,True,True,22658.03955555556,-0.6242514468928069
5735,4542733,93,16,0.09073,254,4555222,-1,8000.0,6616833,6616926,2074100,93,119,1,True,True,22.991666666666667,-0.09073
5736,4542757,20619,20,0.479783,254,4555222,-1,10000.0,6613233,6633852,2070476,20619,120,2,True,True,7066.324749999999,-0.47960848306853704
5737,4542826,24541,128,0.304837,254,4555222,-1,64000.0,5161406,5185947,618580,24541,163,12,True,True,53754.365155555555,-0.2933607050154655
5738,4542922,7192,32,0.703304,254,4555222,-1,16000.0,4806618,4813810,263696,7192,186,7,True,True,4735.420444444444,-0.6077653719121732
5739,4545593,10098,1,0.857922,254,4555222,-1,500.0,4558526,4568624,12933,10098,218,1,True,True,186.16096666666667,-0.8426838183449034
5740,4545652,134,1,0.747287,254,4555222,-1,500.0,6257533,6257667,1711881,134,128,7,True,True,1.735486111111111,-0.747287
5741,4545678,8,3,0.024413,254,4555222,-1,1500.0,13171169,13171177,8625491,8,5,11,True,True,0.4157333333333333,-0.024413
5742,4546241,62,1,0.454841,254,4555222,-1,500.0,4592292,4592354,46051,62,211,2,True,True,1.2241555555555554,-0.454841
5743,4546266,5,8,0.771835,254,4555222,-1,4000.0,5266215,5266220,719949,5,161,12,True,True,0.7048333333333334,-0.771835
5744,4546278,312,1,0.874199,254,4555222,-1,500.0,4617422,4617734,71144,312,206,9,True,True,6.096566666666667,-0.874199
5745,4546309,18,2,0.40536,254,4555222,-1,1000.0,6060915,6060933,1514606,18,133,12,True,True,0.6516,-0.40536
5746,4546313,22560,16,0.789859,254,4555222,-1,8000.0,6620440,6643000,2074127,22560,119,1,True,True,5903.246222222222,-0.7811346280981742
5747,4546388,15476,256,0.37042,254,4555222,-1,128000.0,9211795,9227271,4665407,15476,62,11,True,True,75246.25386666668,-0.3532497826678876
5748,4547692,5567,32,0.464296,254,4555222,-1,16000.0,5364915,5370482,817223,5567,158,2,True,True,3151.712888888889,-0.46233928951046754
5749,4547799,23,32,0.633402,254,4555222,-1,16000.0,6255333,6255356,1707534,23,132,12,True,True,9.666133333333335,-0.633402
5750,4548559,15,2,0.860383,254,4555222,-1,1000.0,4680122,4680137,131563,15,207,6,True,True,0.5473333333333333,-0.860383
5751,4548601,49,1,0.070699,254,4555222,-1,500.0,10239271,10239320,5690670,49,46,12,True,True,0.3994861111111111,-0.070699
5752,4548870,23,4,0.893434,254,4555222,-1,2000.0,4749318,4749341,200448,23,199,10,True,True,1.3112555555555556,-0.893434
5753,4548920,25,8,0.332906,254,4555222,-1,4000.0,8969095,8969120,4420175,25,72,8,True,True,3.1980555555555554,-0.332906
5754,4548991,127,32,0.032714,254,4555222,-1,16000.0,12820169,12820296,8271178,127,11,12,True,True,74.30346666666665,-0.032714
5755,4549079,9,1,0.425902,254,4555222,-1,500.0,5966915,5966924,1417836,9,142,12,True,True,0.17875,-0.425902
5756,4549091,7,8,0.269789,254,4555222,-1,4000.0,11545071,11545078,6995980,7,30,8,True,True,1.2739222222222222,-0.269789
5757,4550800,140,2,0.946095,254,4555222,-1,1000.0,4793618,4793758,242818,140,202,11,True,True,3.105277777777778,-0.946095
5758,4550857,10170,8,0.542435,254,4555222,-1,4000.0,4556322,4566492,5465,10170,238,6,True,True,1520.1564,-0.517320451024997
5759,4551076,11945,4,0.794479,254,4555222,-1,2000.0,5176215,5188160,625139,11945,173,2,True,True,901.6008888888889,-0.7565433893949057
5760,4551090,221,8,0.787692,254,4555222,-1,4000.0,4595892,4596113,44802,221,227,2,True,True,30.610955555555556,-0.787692
5761,4551512,47,1,0.080959,254,4555222,-1,500.0,7229640,7229687,2678128,47,110,12,True,True,1.1279347222222222,-0.080959
5762,4551543,9,2,0.880847,254,4555222,-1,1000.0,4571892,4571901,20349,9,236,8,True,True,0.34204999999999997,-0.880847
5763,4551700,51326,1,0.735761,254,4555222,-1,500.0,5172615,5223941,620915,51326,175,1,True,True,967.7432291666668,-0.7234655802033003
5764,4551709,72,4,0.054812,254,4555222,-1,2000.0,9076795,9076867,4525086,72,68,2,True,True,4.307200000000001,-0.054812
5765,4551801,1050,2,0.945322,254,4555222,-1,1000.0,4943918,4944968,392117,1050,196,6,True,True,35.455000000000005,-0.945322
5766,4551830,14819,1,0.674653,254,4555222,-1,500.0,5496315,5511134,944485,14819,161,2,True,True,322.5027194444444,-0.6582892079499945
5767,4553656,7380,16,0.887978,254,4555222,-1,8000.0,5974515,5981895,1420859,7380,143,6,True,True,1934.665,-0.8109549575579114
5768,4554141,18,6,0.110967,254,4555222,-1,3000.0,13516769,13516787,8962628,18,2,12,True,True,2.8229999999999995,-0.110967
5769,4554431,72,1,0.365591,254,4555222,-1,500.0,5840515,5840587,1286084,72,154,10,True,True,1.6027000000000002,-0.365591
5770,4554453,5978,128,0.619133,254,4555222,-1,64000.0,5728915,5734893,1174462,5978,157,12,True,True,13559.604266666667,-0.5772699266033727
5771,4554771,52873,10,0.365571,254,4555222,-1,5000.0,12647369,12700242,8092598,52873,14,12,True,True,15979.523055555554,-0.3635447576249439
5772,4554882,283,32,0.175267,254,4555222,-1,16000.0,10327871,10328154,5772989,283,49,7,True,True,187.2956888888889,-0.175267
5773,4554941,70,8,0.55879,254,4555222,-1,4000.0,8711695,8711765,4156754,70,87,12,True,True,7.647888888888889,-0.55879
862,803344,420,32,0.443679,1,803344,-1,16000.0,889744,890164,86400,420,0,12,True,True,261.408,-0.443679
863,803495,6902,4,0.694001,85,889744,-1,2000.0,1140448,1147350,336953,6902,0,12,True,True,428.03173333333336,-0.6717286220058813
864,803568,20120,2,0.903424,85,889744,-1,1000.0,1441420,1461540,637852,20120,0,10,True,True,885.3890555555555,-0.875785251388264
865,803679,7452,128,0.045991,85,889744,-1,64000.0,5706742,5714194,4903063,7452,0,8,True,True,14545.92711111111,-0.03896435744768587
866,804449,15046,128,0.796143,85,889744,-1,64000.0,3254616,3269662,2450167,15046,1,6,True,True,44090.96675555556,-0.7792582375434052
867,804482,33606,16,0.293368,85,889744,-1,8000.0,5538079,5571685,4733597,33606,1,7,True,True,8750.658577777778,-0.28801857051317936
868,805102,62,32,0.374841,85,889744,-1,16000.0,5355627,5355689,4550525,62,2,12,True,True,39.09031111111111,-0.374841
869,805220,10332,32,0.14557,85,889744,-1,16000.0,5512427,5522759,4707207,10332,2,11,True,True,4731.892711111112,-0.14405170899951208
870,805230,29,1,0.531166,85,889744,-1,500.0,2793925,2793954,1988695,29,5,7,True,True,0.5583708333333333,-0.531166
871,805243,4,1,0.565928,85,889744,-1,500.0,1397120,1397124,591877,4,7,8,True,True,0.12611111111111112,-0.565928
872,805292,77,5,0.792519,85,889744,-1,2500.0,978344,978421,173052,77,9,12,True,True,6.079256944444444,-0.792519
873,811926,8,12,0.169984,85,889744,-1,6000.0,4306427,4306435,3494501,8,4,9,True,True,2.2450666666666663,-0.169984
874,812010,19832,32,0.078968,85,889744,-1,16000.0,5833966,5853798,5021956,19832,0,11,True,True,23810.0624,-0.07360171747908717
875,812082,21614,3,0.87084,85,889744,-1,1500.0,1863020,1884634,1050938,21614,8,10,True,True,1353.3473333333336,-0.863063579981956
876,812749,20,16,0.61971,85,889744,-1,8000.0,3938416,3938436,3125667,20,6,7,True,True,5.626222222222222,-0.61971
877,812915,14297,64,0.24083,85,889744,-1,32000.0,5373427,5387724,4560512,14297,4,7,True,True,13945.6224,-0.22448308389657248
878,813568,1417,1,0.912829,85,889744,-1,500.0,1054048,1055465,240480,1417,14,7,True,True,32.5602,-0.843507735609915
879,813725,9665,1,0.143118,85,889744,-1,500.0,2605525,2615190,1791800,9665,10,2,True,True,246.60061805555554,-0.12813843689568138
880,813919,40458,1,0.46115,85,889744,-1,500.0,4310827,4351285,3496908,40458,6,7,True,True,776.7176916666665,-0.4571080327286217
881,822832,22853,1,0.253977,85,889744,-1,500.0,2252020,2274873,1429188,22853,12,2,True,True,289.4573138888889,-0.251030819368366
882,822838,110,64,0.255327,85,889744,-1,32000.0,5137427,5137537,4314589,110,6,6,True,True,222.29777777777775,-0.255327
883,822900,33,32,0.009397,85,889744,-1,16000.0,4765827,4765860,3942927,33,7,12,True,True,22.5456,-0.009397
884,822952,4,8,0.804633,85,889744,-1,4000.0,1042444,1042448,219492,4,20,1,True,True,0.5807111111111111,-0.804633
885,822990,16,1,0.901209,85,889744,-1,500.0,1346320,1346336,523330,16,18,1,True,True,0.6671555555555556,-0.901209
886,823196,6103,1,0.677611,85,889744,-1,500.0,1190248,1196351,367052,6103,19,2,True,True,108.70005416666666,-0.6703647786888421
887,823236,17,8,0.157976,85,889744,-1,4000.0,5422427,5422444,4599191,17,4,6,True,True,1.8428,-0.157976
888,825223,23,6,0.44173,85,889744,-1,3000.0,3516016,3516039,2690793,23,12,12,True,True,2.2218000000000004,-0.44173
889,825864,1998,1,0.345566,85,889744,-1,500.0,3968716,3970714,3142852,1998,11,10,True,True,35.833575,-0.345566
890,825996,5,1,0.587572,85,889744,-1,500.0,1269720,1269725,443724,5,22,10,True,True,0.08319444444444445,-0.587572
891,826016,18972,12,0.638939,85,889744,-1,6000.0,2824288,2843260,1998272,18972,15,10,True,True,4182.7137999999995,-0.6219939116159462
892,826170,219,16,0.424309,85,889744,-1,8000.0,3938416,3938635,3112246,219,12,0,True,True,61.60713333333334,-0.424309
893,826200,20,1,0.250098,85,889744,-1,500.0,5517127,5517147,4690927,20,3,2,True,True,0.28497222222222224,-0.250098
894,826364,216,7,0.845304,85,889744,-1,3500.0,1271920,1272136,445556,216,25,7,True,True,26.2101,-0.845304
895,826367,752,1,0.199217,85,889744,-1,500.0,4500027,4500779,3673660,752,10,6,True,True,21.28055555555556,-0.199217
896,849581,23,1,0.384693,85,889744,-1,500.0,1248120,1248143,398539,23,28,10,True,True,0.30880694444444445,-0.384693
897,855437,12693,16,0.483208,85,889744,-1,8000.0,1172848,1185541,317411,12693,30,9,True,True,4089.9984000000004,-0.472354234758219
898,855480,6,16,0.237206,85,889744,-1,8000.0,1046048,1046054,190568,6,33,3,True,True,1.6796,-0.237206
899,855897,7,2,0.571923,85,889744,-1,1000.0,2800488,2800495,1944591,7,19,6,True,True,0.275275,-0.571923
900,855953,8,6,0.574812,85,889744,-1,3000.0,1644820,1644828,788867,8,24,11,True,True,0.6234,-0.574812
901,856547,12,3,0.992692,85,889744,-1,1500.0,1274120,1274132,417573,12,28,7,True,True,0.62405,-0.992692
902,856672,8973,256,0.295231,85,889744,-1,128000.0,5692369,5701342,4835697,8973,2,11,True,True,39064.91946666667,-0.2803419891582845
903,856901,5276,1,0.977944,85,889744,-1,500.0,1042448,1047724,185547,5276,38,1,True,True,93.37270555555556,-0.9573701329113455
904,857055,2147,1,0.65823,85,889744,-1,500.0,4111738,4113885,3254683,2147,14,7,True,True,89.38378472222222,-0.65823
905,857294,280,4,0.27448,85,889744,-1,2000.0,5378127,5378407,4520833,280,7,2,True,True,18.159244444444443,-0.2737951485943775
906,857423,10533,256,0.565929,85,889744,-1,128000.0,4020938,4031471,3163515,10533,16,0,True,True,58005.71626666667,-0.5592721320438928
907,857764,2,16,0.685799,85,889744,-1,8000.0,3947116,3947118,3089352,2,18,7,True,True,0.5197333333333333,-0.685799
908,857872,23,32,0.744669,85,889744,-1,16000.0,5136327,5136350,4278455,23,11,10,True,True,21.535155555555555,-0.744669
909,857926,13543,41,0.049044,85,889744,-1,20500.0,5790766,5804309,4932840,13543,1,7,True,True,13149.145533333334,-0.03987298689748744
910,858044,130,2,0.606406,85,889744,-1,1000.0,1140448,1140578,282404,130,41,0,True,True,3.44175,-0.606406
911,858080,14815,32,0.496727,85,889744,-1,16000.0,1574620,1589435,716540,14815,32,11,True,True,14028.218888888889,-0.4951846532254495
912,858233,4292,256,0.904155,85,889744,-1,128000.0,1391720,1396012,533487,4292,35,10,True,True,30357.65475555555,-0.8908276993184675
913,858316,633,8,0.286194,85,889744,-1,4000.0,2828988,2829621,1970672,633,25,2,True,True,111.12743333333334,-0.28464663203464496
914,858633,5104,16,0.79886,85,889744,-1,8000.0,1367920,1373024,509287,5104,37,10,True,True,2393.624533333333,-0.6940188652169991
915,869045,28,4,0.607065,85,889744,-1,2000.0,4410327,4410355,3541282,28,15,11,True,True,2.264577777777778,-0.607065
916,872125,2,4,0.352321,85,889744,-1,2000.0,4502227,4502229,3630102,2,14,7,True,True,0.2263888888888889,-0.352321
917,872597,2,8,0.636618,85,889744,-1,4000.0,3123916,3123918,2251319,2,27,1,True,True,0.3283777777777778,-0.636618
918,872822,7,1,0.620891,85,889744,-1,500.0,3429616,3429623,2556794,7,26,12,True,True,0.13143472222222222,-0.620891
919,874005,8,3,0.677764,85,889744,-1,1500.0,3046088,3046096,2172083,8,29,12,True,True,0.6276999999999999,-0.677764
920,874367,121,4,0.720928,85,889744,-1,2000.0,3849816,3849937,2975449,121,25,11,True,True,9.467577777777779,-0.720928
921,874462,30081,118,0.659182,85,889744,-1,59000.0,5523627,5553708,4649165,30081,5,8,True,True,48830.92175833334,-0.6557176810260301
922,874661,25,8,0.838337,85,889744,-1,4000.0,2354720,2354745,1480059,25,37,6,True,True,2.4766666666666666,-0.838337
923,875287,124,1,0.628248,85,889744,-1,500.0,1531420,1531544,656133,124,42,12,True,True,2.1574277777777775,-0.628248
924,875915,116,1,0.903404,85,889744,-1,500.0,1331920,1332036,456005,116,48,7,True,True,4.764211111111111,-0.8839431054244566
925,876833,31818,22,0.646341,85,889744,-1,11000.0,2607725,2639543,1730892,31818,36,7,True,True,20899.461672222224,-0.6208608864287659
926,879025,6633,4,0.308933,85,889744,-1,2000.0,5363227,5369860,4484202,6633,11,7,True,True,472.80506111111106,-0.2980500722280791
927,879294,29,1,0.440823,85,889744,-1,500.0,5025027,5025056,4145733,29,15,11,True,True,0.8209819444444445,-0.440823
928,879729,170,1,0.579574,85,889744,-1,500.0,3691016,3691186,2811287,170,29,12,True,True,2.9705138888888887,-0.579574
929,880101,14947,8,0.73236,85,889744,-1,4000.0,2165520,2180467,1285419,14947,43,11,True,True,1437.1244333333334,-0.7213462755140809
930,880390,8887,73,0.090133,85,889744,-1,36500.0,5757942,5766829,4877552,8887,2,6,True,True,14032.541293055554,-0.08028634913947601
931,880414,11490,32,0.29511,85,889744,-1,16000.0,5513527,5525017,4633113,11490,8,6,True,True,5133.118755555555,-0.2871847181501086
932,880813,36514,15,0.747481,85,889744,-1,7500.0,2017820,2054334,1137007,36514,46,10,True,True,10741.270958333333,-0.7459716625849169
933,881078,5,8,0.17564,85,889744,-1,4000.0,5637179,5637184,4756101,5,5,7,True,True,1.5594444444444444,-0.17564
934,881223,28,16,0.13216,85,889744,-1,8000.0,4455727,4455755,3574504,28,22,11,True,True,9.311555555555556,-0.13216
935,881791,19419,2,0.539408,85,889744,-1,1000.0,3604616,3624035,2722825,19419,34,7,True,True,641.7807333333334,-0.534730921986318
936,882069,133,32,0.97149,85,889744,-1,16000.0,2248420,2248553,1366351,133,48,1,True,True,29.998888888888892,-0.97149
937,883386,108,31,0.530852,85,889744,-1,15500.0,2791725,2791833,1908339,108,44,7,True,True,64.70009999999999,-0.530852
938,883775,287,2,0.913487,85,889744,-1,1000.0,1215720,1216007,331945,287,66,1,True,True,7.540127777777777,-0.913487
939,883852,219,2,0.830473,85,889744,-1,1000.0,2020020,2020239,1136168,219,51,7,True,True,9.909141666666667,-0.830473
940,883929,246,8,0.25697,85,889744,-1,4000.0,2256420,2256666,1372491,246,48,7,True,True,15.085266666666666,-0.25697
941,884401,10356,1,0.82469,85,889744,-1,500.0,891944,902300,7543,10356,78,7,True,True,194.16031111111113,-0.8084423899848866
942,886266,17,42,0.481848,85,889744,-1,21000.0,4367127,4367144,3480861,17,24,7,True,True,15.322241666666665,-0.481848
943,886308,10,16,0.806488,85,889744,-1,8000.0,2025820,2025830,1139512,10,53,2,True,True,3.2431111111111113,-0.806488
944,887364,49,8,0.746559,85,889744,-1,4000.0,2166620,2166669,1279256,49,52,6,True,True,4.080066666666666,-0.746559
945,887483,4,16,0.338715,85,889744,-1,8000.0,3123912,3123916,2236429,4,40,1,True,True,1.3135111111111113,-0.338715
946,888404,19181,64,0.11517,85,889744,-1,32000.0,5788566,5807747,4900162,19181,2,6,True,True,32626.614133333333,-0.09891471308673631
947,888428,7,4,0.962893,85,889744,-1,2000.0,1176448,1176455,288020,7,75,1,True,True,0.5908388888888889,-0.962893
948,890340,32,8,0.140757,86,891944,-1,4000.0,5710042,5710074,4819702,32,4,6,True,True,3.6519111111111107,-0.140757
949,890943,933,1,0.9665,86,891944,-1,500.0,1445020,1445953,554077,933,64,1,True,True,24.312425,-0.9665
950,898449,8685,8,0.860141,230,978344,-1,4000.0,2244820,2253505,1346371,8685,55,11,True,True,487.8554444444444,-0.860139138947393
951,898487,4,31,0.724217,230,978344,-1,15500.0,2122320,2122324,1223833,4,58,6,True,True,1.6128611111111113,-0.724217
952,899563,16,16,0.979942,230,978344,-1,8000.0,1226520,1226536,326957,16,77,9,True,True,3.300977777777778,-0.979942
953,899573,6726,4,0.96727,230,978344,-1,2000.0,1370120,1376846,470547,6726,70,7,True,True,677.4572999999999,-0.8651750391164622
954,899742,37,1,0.804588,230,978344,-1,500.0,2353620,2353657,1453878,37,52,9,True,True,0.4488819444444444,-0.804588
955,900455,21812,4,0.365775,230,978344,-1,2000.0,5634979,5656791,4734524,21812,8,6,True,True,3446.0571222222225,-0.34974023318340824
956,900532,88,64,0.790682,230,978344,-1,32000.0,2574020,2574108,1673488,88,52,12,True,True,128.46435555555556,-0.790682
957,900557,1004,1,0.013919,230,978344,-1,500.0,5518227,5519231,4617670,1004,11,6,True,True,14.08591527777778,-0.01370524679923449
958,900601,3,2,0.536572,230,978344,-1,1000.0,2487620,2487623,1587019,3,54,10,True,True,0.08249166666666667,-0.536572
959,900967,2394,2,0.454786,230,978344,-1,1000.0,2034820,2037214,1133853,2394,64,2,True,True,104.0326,-0.454786
960,900973,1191,16,0.672828,230,978344,-1,8000.0,2121220,2122411,1220247,1191,64,12,True,True,247.86033333333333,-0.672828
961,901023,7663,1,0.672341,230,978344,-1,500.0,2789525,2797188,1888502,7663,51,12,True,True,147.8148527777778,-0.6718872426412978
962,901302,88,4,0.58456,230,978344,-1,2000.0,2466020,2466108,1564718,88,56,6,True,True,3.8226222222222224,-0.58456
963,901346,11,2,0.822417,230,978344,-1,1000.0,2199420,2199431,1298074,11,63,8,True,True,0.2651,-0.822417
964,901612,8,1,0.940292,230,978344,-1,500.0,2342820,2342828,1441208,8,59,12,True,True,0.11088888888888888,-0.940292
965,901663,23878,7,0.108346,230,978344,-1,3500.0,1181148,1205026,279485,23878,92,2,True,True,2819.2538111111107,-0.10772782264291351
966,902461,19,2,0.233822,230,978344,-1,1000.0,5525017,5525036,4622556,19,10,1,True,True,0.4943694444444445,-0.233822
967,902471,1293,1,0.025025,230,978344,-1,500.0,2602920,2604213,1700449,1293,55,7,True,True,28.185604166666668,-0.025025
968,902499,7017,42,0.884235,230,978344,-1,21000.0,1733420,1740437,830921,7017,76,7,True,True,5433.134875000001,-0.8770443991522641
969,902511,126,8,0.561407,230,978344,-1,4000.0,4200427,4200553,3297916,126,32,1,True,True,26.777800000000003,-0.561407
970,902522,52,1,0.915256,230,978344,-1,500.0,1050748,1050800,148226,52,102,2,True,True,0.9323166666666667,-0.915256
971,902557,23,32,0.221367,230,978344,-1,16000.0,5646579,5646602,4744022,23,7,2,True,True,22.19346666666667,-0.221367
972,902661,93,1,0.063217,230,978344,-1,500.0,4498927,4499020,3596266,93,28,11,True,True,2.302008333333333,-0.063217
973,903095,8782,32,0.823855,230,978344,-1,16000.0,989144,997926,86049,8782,108,9,True,True,4952.995022222222,-0.7389578675922754
974,903110,860,16,0.909388,230,978344,-1,8000.0,1275220,1276080,372110,860,91,6,True,True,244.45022222222224,-0.909388
975,903135,6,16,0.30219,230,978344,-1,8000.0,5374527,5374533,4471392,6,19,6,True,True,1.9008,-0.30219
976,903148,44954,1,0.408296,230,978344,-1,500.0,5269227,5314181,4366079,44954,23,11,True,True,727.0549416666667,-0.39363368189676506
977,903524,11752,256,0.139777,230,978344,-1,128000.0,5776814,5788566,4873290,11752,3,7,True,True,47255.37066666667,-0.13812867526105402
978,903601,92,1,0.946262,230,978344,-1,500.0,1051848,1051940,148247,92,108,6,True,True,1.9603666666666666,-0.946262
979,903638,68,1,0.304365,230,978344,-1,500.0,4359427,4359495,3455789,68,35,8,True,True,1.1793277777777778,-0.304365
980,903680,4122,32,0.492625,230,978344,-1,16000.0,2597120,2601242,1693440,4122,63,2,True,True,3262.2995555555553,-0.46482626209161665
981,903718,45,8,0.097192,230,978344,-1,4000.0,3944916,3944961,3041198,45,43,8,True,True,5.8355,-0.097192
982,904017,60,2,0.887259,230,978344,-1,1000.0,1868420,1868480,964403,60,84,8,True,True,2.5753333333333335,-0.887259
983,904225,19,1,0.135664,230,978344,-1,500.0,4295627,4295646,3391402,19,38,11,True,True,0.6235166666666667,-0.135664
984,904339,39,33,0.453644,230,978344,-1,16500.0,2600720,2600759,1696381,39,65,2,True,True,29.225625000000004,-0.453644
985,905570,22716,12,0.670486,230,978344,-1,6000.0,1038844,1061560,133274,22716,119,8,True,True,5595.093733333334,-0.6647936242039759
986,905590,9,4,0.74314,230,978344,-1,2000.0,1418720,1418729,513130,9,94,10,True,True,1.1359000000000001,-0.74314
987,905623,13136,1,0.945974,230,978344,-1,500.0,1033444,1046580,127821,13136,121,6,True,True,223.99202777777776,-0.9394559429165752
988,906078,9022,64,0.419127,230,978344,-1,32000.0,4011916,4020938,3105838,9022,42,11,True,True,10323.727111111111,-0.4184058868794854
989,906231,66,8,0.742269,230,978344,-1,4000.0,3806616,3806682,2900385,66,49,7,True,True,10.463933333333333,-0.742269
990,906267,19,2,0.154523,230,978344,-1,1000.0,4226427,4226446,3320160,19,39,7,True,True,0.7605277777777778,-0.154523
991,906314,10719,32,0.414885,230,978344,-1,16000.0,2800488,2811207,1894174,10719,61,0,True,True,7151.456933333333,-0.4142312002346474
992,906561,65,1,0.099022,230,978344,-1,500.0,2031220,2031285,1124659,65,87,8,True,True,1.2570277777777776,-0.099022
993,906605,6836,4,0.489347,230,978344,-1,2000.0,5026127,5032963,4119522,6836,27,6,True,True,1038.4397666666669,-0.4617310180956939
994,906648,38,16,0.408116,230,978344,-1,8000.0,3343216,3343254,2436568,38,56,12,True,True,18.844622222222224,-0.408116
995,907346,10685,256,0.951522,230,978344,-1,128000.0,1205026,1215711,297680,10685,115,8,True,True,39151.832888888894,-0.9322099791505379
996,907418,22137,186,0.032716,230,978344,-1,93000.0,5835066,5857203,4927648,22137,0,6,True,True,150721.43890000004,-0.030348514320512863
997,907611,11406,130,0.37053,230,978344,-1,65000.0,2356920,2368326,1449309,11406,77,7,True,True,18402.817333333332,-0.3696161434842332
998,907659,13541,8,0.443383,230,978344,-1,4000.0,3712616,3726157,2804957,13541,53,10,True,True,1579.282011111111,-0.4290661045337571
999,908719,13369,32,0.950555,230,978344,-1,16000.0,2253120,2266489,1344401,13369,83,6,True,True,4654.089555555556,-0.8946875837754366
1000,908991,87,16,0.85545,230,978344,-1,8000.0,1307020,1307107,398029,87,112,6,True,True,26.011066666666665,-0.85545
1001,909120,27,4,0.099355,230,978344,-1,2000.0,5371227,5371254,4462107,27,23,7,True,True,2.1384,-0.099355
1002,909179,43100,1,0.68568,230,978344,-1,500.0,2873288,2916388,1964109,43100,64,6,True,True,671.3988611111113,-0.6714568004715923
1003,909201,123,2,0.544466,230,978344,-1,1000.0,3080688,3080811,2171487,123,63,8,True,True,11.17865,-0.544466
1004,909536,33,1,0.977843,230,978344,-1,500.0,1580020,1580053,670484,33,104,8,True,True,1.0080583333333333,-0.977843
1005,909593,16765,128,0.358674,230,978344,-1,64000.0,4202627,4219392,3293034,16765,43,7,True,True,44877.68764444444,-0.35366903873724304
1006,909608,12,4,0.39814,230,978344,-1,2000.0,4852227,4852239,3942619,12,31,12,True,True,0.8251333333333334,-0.39814
1007,909629,54,39,0.189809,230,978344,-1,19500.0,5633879,5633933,4724250,54,12,12,True,True,58.026149999999994,-0.189809
1008,909664,402,8,0.12216,230,978344,-1,4000.0,4354027,4354429,3444363,402,41,11,True,True,54.94446666666667,-0.12216
1009,909671,508,32,0.848033,230,978344,-1,16000.0,2697725,2698233,1788054,508,77,12,True,True,454.5132444444444,-0.848033
1010,909734,7262,128,0.454717,230,978344,-1,64000.0,5530817,5538079,4621083,7262,14,2,True,True,12558.749866666667,-0.43345661322165685
1011,910051,9,1,0.662769,230,978344,-1,500.0,4981827,4981836,4071776,9,33,11,True,True,0.42525,-0.662769
1012,910264,145,32,0.641704,230,978344,-1,16000.0,4248027,4248172,3337763,145,47,10,True,True,87.87644444444446,-0.641704
1013,912627,17,11,0.597146,230,978344,-1,5500.0,4108438,4108455,3195811,17,52,6,True,True,5.5874041666666665,-0.597146
1014,913063,10,8,0.021357,230,978344,-1,4000.0,2167720,2167730,1254657,10,100,6,True,True,0.914888888888889,-0.021357
1015,913159,10,2,0.786795,230,978344,-1,1000.0,2172420,2172430,1259261,10,100,2,True,True,0.24927777777777776,-0.786795
1016,913181,4,32,0.243569,230,978344,-1,16000.0,5361027,5361031,4447846,4,27,8,True,True,2.3585777777777777,-0.243569
1017,913189,52,2,0.125924,230,978344,-1,1000.0,4938627,4938679,4025438,52,35,12,True,True,1.8978555555555552,-0.125924
1018,913206,10652,32,0.564578,230,978344,-1,16000.0,4679427,4690079,3766221,10652,38,7,True,True,9401.127377777777,-0.5421917445411427
1019,913376,10586,4,0.06861,230,978344,-1,2000.0,5545279,5555865,4631903,10586,13,2,True,True,606.2945444444445,-0.0660416353955085
1020,913679,13,1,0.765157,230,978344,-1,500.0,2585920,2585933,1672241,13,91,9,True,True,0.2321763888888889,-0.765157
1021,913776,5090,128,0.207157,230,978344,-1,64000.0,5641879,5646969,4728103,5090,10,6,True,True,21773.049955555558,-0.20255723456315655
1022,913837,8334,86,0.215951,230,978344,-1,43000.0,1419820,1428154,505983,8334,126,6,True,True,24826.836422222223,-0.21001347897207331
1023,913856,34,1,0.869695,230,978344,-1,500.0,1601620,1601654,687764,34,121,10,True,True,1.0862527777777777,-0.869695
1024,913878,12987,102,0.32856,230,978344,-1,51000.0,5547479,5560466,4633601,12987,14,7,True,True,19702.241516666665,-0.3266907603268011
1025,914416,1453,8,0.147554,230,978344,-1,4000.0,3145516,3146969,2231100,1453,75,10,True,True,303.571,-0.13873303369435505
1026,914447,10233,26,0.900531,230,978344,-1,13000.0,1278520,1288753,364073,10233,138,6,True,True,4142.476036111111,-0.8837458358094201
1027,917303,12378,32,0.002836,230,978344,-1,16000.0,5646969,5659347,4729666,12378,9,2,True,True,16490.190666666665,-0.0027113155639247113
1028,917615,29897,224,0.858406,230,978344,-1,112000.0,2703125,2733022,1785510,29897,89,8,True,True,174239.9739111111,-0.8373586132538288
1029,917671,30,8,0.144688,230,978344,-1,4000.0,4362727,4362757,3445056,30,49,7,True,True,3.6233333333333335,-0.144688
1030,917677,24,1,0.129992,230,978344,-1,500.0,1308120,1308144,390443,24,140,6,True,True,0.4484666666666667,-0.129992
1031,918317,103,8,0.250654,230,978344,-1,4000.0,4113938,4114041,3195621,103,59,7,True,True,34.304722222222225,-0.250654
1032,918364,38,2,0.174497,230,978344,-1,1000.0,3253516,3253554,2335152,38,78,12,True,True,2.23725,-0.174497
1033,918775,3,9,0.661058,230,978344,-1,4500.0,3069888,3069891,2151113,3,83,7,True,True,1.1086875,-0.661058
1034,919307,9385,1,0.02578,230,978344,-1,500.0,5541679,5551064,4622372,9385,17,2,True,True,129.8532236111111,-0.025370944248909996
1035,919364,89,32,0.01486,230,978344,-1,16000.0,4200338,4200427,3280974,89,60,12,True,True,75.65791111111112,-0.01486
1036,919452,3,64,0.789985,230,978344,-1,32000.0,1873820,1873823,954368,3,127,8,True,True,4.068533333333334,-0.789985
1037,920324,34,8,0.237932,230,978344,-1,4000.0,2611325,2611359,1691001,34,97,2,True,True,7.809044444444445,-0.237932
1038,920891,48,2,0.323771,230,978344,-1,1000.0,3167116,3167164,2246225,48,81,10,True,True,2.0053333333333336,-0.323771
1039,920971,97,16,0.174246,230,978344,-1,8000.0,5369027,5369124,4448056,97,31,2,True,True,25.633866666666666,-0.174246
1040,921010,137,32,0.052399,230,978344,-1,16000.0,5713642,5713779,4792632,137,6,2,True,True,96.46626666666667,-0.052399
1041,921138,19,32,0.741718,230,978344,-1,16000.0,2799388,2799407,1878250,19,95,7,True,True,11.9548,-0.741718
1042,921155,4,16,0.526086,230,978344,-1,8000.0,5114727,5114731,4193572,4,39,7,True,True,1.6537777777777778,-0.526086
1043,921476,16,2,0.745665,230,978344,-1,1000.0,1329720,1329736,408244,16,152,10,True,True,1.3012444444444444,-0.745665
1044,922091,7318,1,0.476246,230,978344,-1,500.0,1888220,1895538,966129,7318,133,9,True,True,133.8678388888889,-0.4514238979748809
1045,922453,8,32,0.778017,230,978344,-1,16000.0,1282120,1282128,359667,8,156,1,True,True,4.462577777777778,-0.778017
1046,923100,8145,4,0.513238,230,978344,-1,2000.0,3804416,3812561,2881316,8145,76,12,True,True,665.1747388888889,-0.5110273225452883
1047,923295,14,4,0.109054,230,978344,-1,2000.0,5223827,5223841,4300532,14,37,12,True,True,0.9351999999999999,-0.109054
1048,924235,1805,4,0.503839,230,978344,-1,2000.0,1162048,1163853,237813,1805,172,10,True,True,159.9093111111111,-0.49146908385835236
1049,924270,4,4,0.945416,230,978344,-1,2000.0,1305920,1305924,381650,4,158,10,True,True,0.2815111111111111,-0.945416
1050,924347,478,32,0.043365,230,978344,-1,16000.0,5756842,5757320,4832495,478,6,11,True,True,491.1078222222222,-0.043365
1051,924458,5852,24,0.783227,230,978344,-1,12000.0,1047148,1053000,122690,5852,180,6,True,True,2659.3948,-0.7412291011030452
1052,924597,126,1,0.866981,230,978344,-1,500.0,1909820,1909946,985223,126,136,10,True,True,2.4935750000000003,-0.866981
1053,924998,6,8,0.521451,230,978344,-1,4000.0,4252427,4252433,3327429,6,61,7,True,True,0.9818000000000001,-0.521451
1054,925011,39,16,0.458043,230,978344,-1,8000.0,2872188,2872227,1947177,39,96,11,True,True,11.160066666666667,-0.458043
1055,936420,9172,256,0.964026,230,978344,-1,128000.0,2201620,2210792,1265200,9172,126,6,True,True,28608.853333333333,-0.9262910018139902
1056,940082,17,1,0.060825,230,978344,-1,500.0,4588627,4588644,3648545,17,49,12,True,True,0.35813333333333336,-0.060825
1057,946443,136,4,0.478982,230,978344,-1,2000.0,4677227,4677363,3730784,136,49,7,True,True,11.265333333333333,-0.478982
1058,947436,101,4,0.401617,230,978344,-1,2000.0,4107338,4107439,3159902,101,72,12,True,True,11.204266666666667,-0.401617
1059,948335,228,2,0.686097,230,978344,-1,1000.0,4412527,4412755,3464192,228,55,7,True,True,9.220066666666668,-0.686097
1060,948427,60,128,0.490269,230,978344,-1,64000.0,1284320,1284380,335893,60,168,7,True,True,133.87733333333333,-0.490269
1061,950872,20,1,0.909701,230,978344,-1,500.0,1277420,1277440,326548,20,171,7,True,True,0.35530555555555554,-0.909701
1062,951596,93,6,0.073491,230,978344,-1,3000.0,5226027,5226120,4274431,93,38,7,True,True,9.3186,-0.073491
1063,952049,4,1,0.08079,230,978344,-1,500.0,5642979,5642983,4690930,4,13,6,True,True,0.1433722222222222,-0.08079
1064,954290,6001,1,0.608297,230,978344,-1,500.0,1877420,1883421,923130,6001,147,2,True,True,125.25369444444445,-0.5854022168133406
1065,954364,14892,1,0.065682,230,978344,-1,500.0,5534417,5549309,4580053,14892,22,2,True,True,207.39183611111113,-0.06474795764111246
1066,958951,49,2,0.275016,230,978344,-1,1000.0,2797188,2797237,1838237,49,109,2,True,True,1.917125,-0.2736173172282263
1067,959062,1,16,0.633077,230,978344,-1,8000.0,2200520,2200521,1241458,1,135,6,True,True,0.19217777777777778,-0.633077
1068,960718,5,1,0.548356,230,978344,-1,500.0,3067688,3067693,2106970,5,101,10,True,True,0.20531249999999998,-0.548356
1069,961037,26,1,0.325185,230,978344,-1,500.0,4250227,4250253,3289190,26,68,7,True,True,0.49241111111111113,-0.325185
1070,961492,11010,4,0.994628,230,978344,-1,2000.0,1342720,1353730,381228,11010,171,9,True,True,1768.5823333333335,-0.9714859045557946
1071,962758,3023,14,0.530557,230,978344,-1,7000.0,5469227,5472250,4506469,3023,30,11,True,True,762.7323861111112,-0.524770988647697
1072,964846,8,16,0.453715,230,978344,-1,8000.0,5426027,5426035,4461181,8,31,2,True,True,1.776888888888889,-0.453715
1073,965817,8624,1,0.605427,230,978344,-1,500.0,1996220,2004844,1030403,8624,152,11,True,True,109.22494444444445,-0.6013707544159328
1074,967377,34871,32,0.099178,230,978344,-1,16000.0,4675027,4709898,3707650,34871,55,12,True,True,38139.31102222222,-0.09420388027943384
1075,967509,1078,4,0.701779,230,978344,-1,2000.0,2802688,2803766,1835179,1078,111,7,True,True,90.26453333333333,-0.701779
1076,968389,9,5,0.852793,230,978344,-1,2500.0,1215711,1215720,247322,9,193,6,True,True,0.591125,-0.852793
1077,968414,72,16,0.650917,230,978344,-1,8000.0,3075288,3075360,2106874,72,104,8,True,True,54.4848,-0.650917
1078,969769,154,39,0.768963,230,978344,-1,19500.0,3256816,3256970,2287047,154,97,7,True,True,181.15597499999998,-0.768963
1079,971202,34,2,0.72084,230,978344,-1,1000.0,2022220,2022254,1051018,34,154,7,True,True,1.5384055555555554,-0.72084
1080,971335,38,5,0.215023,230,978344,-1,2500.0,5527217,5527255,4555882,38,24,7,True,True,2.4581250000000003,-0.215023
1081,971395,4,1,0.451555,230,978344,-1,500.0,1032344,1032348,60949,4,215,11,True,True,0.05853333333333333,-0.451555
1082,971409,19,16,0.228494,230,978344,-1,8000.0,2443320,2443339,1471911,19,134,12,True,True,2.4273555555555557,-0.228494
1083,972347,8440,4,0.338932,230,978344,-1,2000.0,5365427,5373867,4393080,8440,39,7,True,True,609.9408333333333,-0.3262952149800493
1084,972419,46,64,0.453499,230,978344,-1,32000.0,4364927,4364973,3392508,46,66,7,True,True,51.22151111111111,-0.453499
1085,972472,202,7,0.41599,230,978344,-1,3500.0,2825388,2825590,1852916,202,115,6,True,True,27.600494444444443,-0.41599
1086,972562,9,16,0.095086,230,978344,-1,8000.0,4308627,4308636,3336065,9,71,7,True,True,3.3676,-0.095086
1087,973330,8268,1,0.426764,230,978344,-1,500.0,5421327,5429595,4447997,8268,34,11,True,True,113.260525,-0.42348904198047244
1088,976350,1795,8,0.665108,230,978344,-1,4000.0,2168820,2170615,1192470,1795,153,6,True,True,164.22255555555557,-0.665108
1089,977243,39,1,0.374301,230,978344,-1,500.0,3718016,3718055,2740773,39,96,8,True,True,0.55575,-0.374301
1090,977252,11,1,0.152639,230,978344,-1,500.0,3602416,3602427,2625164,11,100,12,True,True,0.18782500000000002,-0.152639
1091,977766,685,12,0.922985,230,978344,-1,6000.0,1731220,1731905,753454,685,175,12,True,True,159.39483333333334,-0.8673580999838364
1092,977881,13472,8,0.067133,230,978344,-1,4000.0,5763342,5776814,4785461,13472,5,8,True,True,1816.9744000000003,-0.06330177532722636
1093,977908,132,1,0.831772,230,978344,-1,500.0,2194020,2194152,1216112,132,155,10,True,True,1.6786,-0.831772
1094,978328,59,16,0.09323,230,978344,-1,8000.0,5708942,5709001,4730614,59,10,7,True,True,13.348422222222224,-0.09323
1095,978363,3,8,0.096564,252,989144,-1,4000.0,3939516,3939519,2961153,3,93,6,True,True,0.4219666666666667,-0.096564
1096,978418,13818,1,0.738796,252,989144,-1,500.0,1755020,1768838,776602,13818,178,10,True,True,383.71587222222223,-0.7251322333011622
1097,978486,10996,1,0.811769,252,989144,-1,500.0,2464920,2475916,1486434,10996,144,10,True,True,122.83732222222223,-0.8072425644323766
1098,978991,526,1,0.556371,252,989144,-1,500.0,1185548,1186074,206557,526,216,7,True,True,9.50891111111111,-0.556371
1099,980530,24,4,0.586465,252,989144,-1,2000.0,3123888,3123912,2143358,24,114,11,True,True,1.9702666666666668,-0.586465
1100,980556,14205,5,0.561586,252,989144,-1,2500.0,2591320,2605525,1610764,14205,141,8,True,True,1690.0313541666667,-0.5597841247677867
1101,980782,174,1,0.329646,252,989144,-1,500.0,4360527,4360701,3379745,174,71,6,True,True,2.626916666666667,-0.329646
1102,981035,110,1,0.122231,252,989144,-1,500.0,3936216,3936326,2955181,110,97,12,True,True,1.8780972222222223,-0.122231
1103,981285,15835,1,0.353598,252,989144,-1,500.0,2959688,2975523,1978403,15835,122,12,True,True,320.4851513888889,-0.3402735753607842
1104,981445,6,1,0.665341,252,989144,-1,500.0,1953020,1953026,971575,6,178,11,True,True,0.13343333333333335,-0.665341
1105,982056,602,32,0.750284,252,989144,-1,16000.0,2593520,2594122,1611464,602,144,7,True,True,465.17208888888894,-0.750284
1106,982101,37,4,0.868092,252,989144,-1,2000.0,1841420,1841457,859319,37,186,12,True,True,2.6101444444444444,-0.868092
1107,982123,110,8,0.721061,252,989144,-1,4000.0,1177548,1177658,195425,110,226,6,True,True,18.093777777777778,-0.721061
1108,982164,7,8,0.968399,252,989144,-1,4000.0,1183348,1183355,201184,7,225,7,True,True,1.0785444444444443,-0.968399
1109,982252,5,1,0.60041,252,989144,-1,500.0,2575120,2575125,1592868,5,147,6,True,True,0.11404861111111111,-0.60041
1110,982290,4761,32,0.351646,252,989144,-1,16000.0,4224227,4228988,3241937,4761,82,10,True,True,3032.544622222222,-0.35075121555415395
1111,982603,17270,32,0.577919,252,989144,-1,16000.0,2254220,2271490,1271617,17270,159,6,True,True,6877.228,-0.5753463733176699
1112,982610,6,1,0.212739,252,989144,-1,500.0,5112527,5112533,4129917,6,52,12,True,True,0.1550416666666667,-0.212739
1113,982622,638,32,0.656736,252,989144,-1,16000.0,4109538,4110176,3126916,638,89,6,True,True,610.0130666666666,-0.656736
1114,982989,235,32,0.224245,252,989144,-1,16000.0,5649169,5649404,4666180,235,13,7,True,True,305.5,-0.224245
1115,983056,39,1,0.108218,252,989144,-1,500.0,5640779,5640818,4657723,39,18,2,True,True,1.7269416666666666,-0.108218
1116,983155,9737,1,0.845373,252,989144,-1,500.0,1186648,1196385,203493,9737,231,6,True,True,172.43296805555553,-0.8304054504885515
1117,983164,29666,2,0.367561,252,989144,-1,1000.0,5701342,5731008,4718178,29666,12,6,True,True,1792.2929888888889,-0.3643371131515433
8108,6377131,47,4,0.476302,1,6377131,-1,2000.0,6379331,6379378,2200,47,0,7,True,True,2.040061111111111,-0.476302
8109,6378238,10,1,0.897511,4,6379331,-1,500.0,6486316,6486326,108078,10,0,6,True,True,0.14808333333333334,-0.897511
8110,6378720,26,11,0.123098,4,6379331,-1,5500.0,6969278,6969304,590558,26,0,7,True,True,10.94665,-0.123098
8111,6378935,136,8,0.135756,4,6379331,-1,4000.0,6424731,6424867,45796,136,2,11,True,True,17.589333333333336,-0.135756
8112,6378951,139,64,0.534543,4,6379331,-1,32000.0,6381531,6381670,2580,139,3,7,True,True,96.53395555555555,-0.534543
8113,6379393,5,2,0.725414,6,6381531,-1,1000.0,6381531,6381536,2138,5,3,0,True,True,0.10851388888888888,-0.725414
8114,6379472,188,16,0.090442,6,6381531,-1,8000.0,8134683,8134871,1755211,188,0,7,True,True,135.58977777777778,-0.090442
8115,6380095,12873,4,0.691785,6,6381531,-1,2000.0,6590216,6603089,210121,12873,2,6,True,True,2279.466033333333,-0.6812073905184615
8116,6391925,24763,3,0.871941,44,6424731,-1,1500.0,6579316,6604079,187391,24763,3,6,True,True,3199.8220916666664,-0.8511690505380772
8117,6393083,6,2,0.93178,44,6424731,-1,1000.0,6479931,6479937,86848,6,5,6,True,True,0.1549666666666667,-0.93178
8118,6402404,10865,16,0.766337,44,6424731,-1,8000.0,6578216,6589081,175812,10865,4,7,True,True,6968.389244444444,-0.7134867341020594
8119,6402494,34078,256,0.600679,44,6424731,-1,128000.0,7759828,7793906,1357334,34078,1,2,True,True,219404.3392,-0.6002847511331719
8120,6402669,20,1,0.643987,44,6424731,-1,500.0,7544853,7544873,1142184,20,2,3,True,True,0.5551944444444444,-0.643987
8121,6404470,327,1,0.37701,44,6424731,-1,500.0,7858228,7858555,1453758,327,1,7,True,True,5.929145833333334,-0.37701
8122,6405043,16695,8,0.717443,44,6424731,-1,4000.0,7410953,7427648,1005910,16695,4,7,True,True,2747.156677777778,-0.6873964977688176
8123,6405474,12420,141,0.736002,44,6424731,-1,70500.0,7446053,7458473,1040579,12420,4,7,True,True,68375.48387083334,-0.7329816344943815
8124,6405788,47,4,0.381651,44,6424731,-1,2000.0,8315083,8315130,1909295,47,0,8,True,True,6.723872222222222,-0.381651
8125,6406712,10245,128,0.642102,44,6424731,-1,64000.0,6602654,6612899,195942,10245,8,6,True,True,49546.78186666667,-0.63193230776664
8126,6406866,2,4,0.5619,44,6424731,-1,2000.0,6433431,6433433,26565,2,14,7,True,True,0.14528888888888888,-0.5619
8127,6409679,62,16,0.856141,44,6424731,-1,8000.0,6728651,6728713,318972,62,8,7,True,True,19.456977777777777,-0.856141
8128,6411880,3461,4,0.808447,44,6424731,-1,2000.0,7254951,7258412,843071,3461,7,7,True,True,742.7874055555556,-0.8062338113468972
8129,6412361,433,2,0.223551,44,6424731,-1,1000.0,6724251,6724684,311890,433,10,7,True,True,14.398452777777777,-0.223551
8130,6412410,16,2,0.11569,44,6424731,-1,1000.0,7642685,7642701,1230275,16,4,0,True,True,0.7586222222222222,-0.11569
8131,6412419,8503,32,0.08768,44,6424731,-1,16000.0,9777732,9786235,3365313,8503,0,11,True,True,5126.772311111112,-0.08764870697906618
8132,6412478,35,4,0.089139,44,6424731,-1,2000.0,7593585,7593620,1181107,35,6,2,True,True,3.1750833333333333,-0.089139
8133,6413657,15493,8,0.740581,44,6424731,-1,4000.0,6507916,6523409,94259,15493,18,10,True,True,3645.9189888888886,-0.7401642485389225
8134,6413715,7,1,0.937211,44,6424731,-1,500.0,6478831,6478838,65116,7,21,7,True,True,0.09039722222222223,-0.937211
8135,6413904,35,5,0.744618,44,6424731,-1,2500.0,6795651,6795686,381747,35,12,6,True,True,3.467916666666667,-0.744618
8136,6414290,126,1,0.116106,44,6424731,-1,500.0,7564961,7565087,1150671,126,7,7,True,True,3.0541000000000005,-0.116106
8137,6414603,58,4,0.367737,44,6424731,-1,2000.0,7619585,7619643,1204982,58,6,6,True,True,4.859755555555555,-0.367737
8138,6421226,22,8,0.85333,44,6424731,-1,4000.0,6430131,6430153,8905,22,26,8,True,True,3.7013777777777777,-0.85333
8139,6421316,4,8,0.954069,44,6424731,-1,4000.0,6431231,6431235,9915,4,26,6,True,True,0.6729777777777777,-0.954069
8140,6421412,60,4,0.576917,44,6424731,-1,2000.0,7386053,7386113,964641,60,12,8,True,True,6.176666666666667,-0.576917
8141,6421880,8849,32,0.001678,44,6424731,-1,16000.0,9642346,9651195,3220466,8849,1,5,True,True,4986.170577777777,-0.0016409378235866972
8142,6421934,8333,15,0.061885,44,6424731,-1,7500.0,9627546,9635879,3205612,8333,2,2,True,True,2338.0356875,-0.060583138305255496
8143,6422009,22,1,0.535603,44,6424731,-1,500.0,7379553,7379575,957544,22,15,10,True,True,0.5599916666666668,-0.535603
8144,6422033,20390,32,0.847119,44,6424731,-1,16000.0,6974778,6995168,552745,20390,17,7,True,True,22613.560533333337,-0.8151009331055639
8145,6422764,6751,32,0.979849,44,6424731,-1,16000.0,7006951,7013702,584187,6751,17,7,True,True,9517.103777777776,-0.9583889306236121
8146,6423734,14,1,0.319643,44,6424731,-1,500.0,8617483,8617497,2193749,14,3,12,True,True,0.2058972222222222,-0.319643
8147,6423866,23216,101,0.365024,44,6424731,-1,50500.0,9146683,9169899,2722817,23216,3,12,True,True,38818.00431527778,-0.34247761338230515
8148,6423995,349,4,0.679302,44,6424731,-1,2000.0,6975878,6976227,551883,349,20,6,True,True,48.9298,-0.679302
8149,6424009,34,8,0.796565,44,6424731,-1,4000.0,7534653,7534687,1110644,34,14,7,True,True,8.056111111111111,-0.796565
8150,6424161,8,1,0.519751,44,6424731,-1,500.0,7617385,7617393,1193224,8,11,10,True,True,0.18885555555555555,-0.519751
8151,6424189,31,2,0.601618,44,6424731,-1,1000.0,6997151,6997182,572962,31,22,9,True,True,2.4812916666666665,-0.601618
8152,6424395,7,1,0.222142,44,6424731,-1,500.0,6957178,6957185,532783,7,26,8,True,True,0.2590486111111111,-0.222142
8153,6424449,25172,64,0.395312,44,6424731,-1,32000.0,7885228,7910400,1460779,25172,7,8,True,True,46525.68071111111,-0.3759718988048206
8154,6424472,20451,2,0.538293,44,6424731,-1,1000.0,6847978,6868429,423506,20451,28,7,True,True,1646.5861972222224,-0.5349244321171979
8155,6424527,15,4,0.460603,44,6424731,-1,2000.0,6700451,6700466,275924,15,32,2,True,True,1.083,-0.460603
8156,6425008,71,1,0.144701,53,6430131,-1,500.0,8973883,8973954,2548875,71,4,12,True,True,1.3284888888888888,-0.144701
8157,6425300,7485,4,0.94289,53,6430131,-1,2000.0,6476631,6484116,51331,7485,42,11,True,True,412.29196666666667,-0.8923112898735296
8158,6425396,13324,16,0.837217,53,6430131,-1,8000.0,6695929,6709253,270533,13324,34,2,True,True,3584.3958222222223,-0.7865403332458268
8159,6425461,47,1,0.499833,53,6430131,-1,500.0,7556261,7556308,1130800,47,16,7,True,True,1.5062847222222222,-0.499833
8160,6425543,224,1,0.455785,53,6430131,-1,500.0,6597416,6597640,171873,224,37,4,True,True,9.659688888888889,-0.455785
8161,6425595,2,19,0.601465,53,6430131,-1,9500.0,7541253,7541255,1115658,2,18,6,True,True,1.0464250000000002,-0.601465
8162,6425609,443,1,0.145871,53,6430131,-1,500.0,7879828,7880271,1454219,443,9,10,True,True,8.016454166666666,-0.145871
8163,6426025,8,1,0.665351,53,6430131,-1,500.0,6484116,6484124,58091,8,45,2,True,True,0.11846666666666668,-0.665351
8164,6426378,7081,128,0.801292,53,6430131,-1,64000.0,6642029,6649110,215651,7081,38,7,True,True,16406.51928888889,-0.7969613617899554
8165,6426457,11,1,0.702967,53,6430131,-1,500.0,6576016,6576027,149559,11,44,10,True,True,0.39427361111111114,-0.702967
8166,6455460,21180,4,0.59888,64,6476631,-1,2000.0,7140351,7161531,684891,21180,26,12,True,True,3510.9478833333337,-0.5867559617431106
8167,6455719,12,32,0.308891,64,6476631,-1,16000.0,7166351,7166363,710632,12,26,7,True,True,16.392533333333336,-0.308891
8168,6455822,29177,128,0.990335,64,6476631,-1,64000.0,6554416,6583593,98594,29177,47,6,True,True,115002.98559999999,-0.9657057106940954
8169,6455887,16,2,0.123464,64,6476631,-1,1000.0,7566061,7566077,1110174,16,16,6,True,True,0.7756444444444445,-0.123464
8170,6456027,100,1,0.996849,64,6476631,-1,500.0,6482131,6482231,26104,100,52,7,True,True,1.442361111111111,-0.996849
8171,6456047,127,2,0.706522,64,6476631,-1,1000.0,6626329,6626456,170282,127,42,7,True,True,6.052961111111111,-0.706522
8172,6462804,16,1,0.478283,64,6476631,-1,500.0,7931728,7931744,1468924,16,8,6,True,True,0.2359111111111111,-0.478283
8173,6468167,12202,32,0.828687,64,6476631,-1,16000.0,7342451,7354653,874284,12202,27,12,True,True,12552.642133333335,-0.8162160691590624
8174,6468858,69,16,0.495026,64,6476631,-1,8000.0,6485216,6485285,16358,69,54,6,True,True,16.348399999999998,-0.495026
8175,6468963,23944,16,0.70414,64,6476631,-1,8000.0,7018951,7042895,549988,23944,31,7,True,True,11334.704444444442,-0.6721928013436262
8176,6470414,2,40,0.376709,64,6476631,-1,20000.0,7850628,7850630,1380214,2,12,7,True,True,1.3453333333333333,-0.376709
8177,6471051,30,4,0.981143,64,6476631,-1,2000.0,7002551,7002581,531500,30,34,8,True,True,2.685666666666666,-0.981143
8178,6472282,19,8,0.333145,64,6476631,-1,4000.0,7439453,7439472,967171,19,25,7,True,True,5.945944444444444,-0.333145
8179,6472694,35,2,0.827885,64,6476631,-1,1000.0,6551116,6551151,78422,35,56,11,True,True,0.9699861111111111,-0.827885
8180,6481475,21285,8,0.210613,62,6482131,-1,4000.0,8622883,8644168,2141408,21285,5,8,True,True,4050.518088888889,-0.19437672930942862
8181,6482751,3,1,0.732658,64,6484116,-1,500.0,6959378,6959381,476627,3,41,6,True,True,0.06755833333333333,-0.732658
8182,6482913,22,4,0.810419,64,6484116,-1,2000.0,6486316,6486338,3403,22,60,0,True,True,1.3031333333333335,-0.810419
8183,6483235,9208,8,0.700407,64,6484116,-1,4000.0,7535753,7544961,1052518,9208,24,6,True,True,2079.1089222222226,-0.6945762467584558
8184,6484147,1,32,0.052566,64,6485216,-1,16000.0,9645946,9645947,3161799,1,1,2,True,True,0.5484888888888889,-0.052566
8185,6485258,9,16,0.865432,65,6486316,-1,8000.0,6979478,6979487,494220,9,40,2,True,True,4.8762,-0.865432
8186,6485563,36,20,0.17902,65,6486316,-1,10000.0,8628283,8628319,2142720,36,6,8,True,True,13.915000000000001,-0.17902
8187,6492039,8,26,0.487505,84,6507916,-1,13000.0,6645329,6645337,153290,8,53,6,True,True,2.9671777777777772,-0.487505
8188,6492231,31,32,0.391808,84,6507916,-1,16000.0,7632585,7632616,1140354,31,18,8,True,True,22.36271111111111,-0.391808
8189,6495591,2,1,0.98439,84,6507916,-1,500.0,6585816,6585818,90225,2,60,0,True,True,0.09161944444444443,-0.98439
8190,6495648,26,8,0.65925,84,6507916,-1,4000.0,6658429,6658455,162781,26,54,6,True,True,10.296,-0.65925
8191,6495954,8,1,0.848518,84,6507916,-1,500.0,6986078,6986086,490124,8,42,7,True,True,0.2685111111111111,-0.848518
8192,6496746,14074,4,0.991063,84,6507916,-1,2000.0,6632929,6647003,136183,14074,58,7,True,True,830.3967944444445,-0.9045054704891343
8193,6498268,835,2,0.547943,84,6507916,-1,1000.0,6967078,6967913,468810,835,47,7,True,True,63.91925,-0.547943
8194,6498325,12165,64,0.33741,84,6507916,-1,32000.0,9638746,9650911,3140421,12165,3,2,True,True,14028.713955555557,-0.3335608970191343
8195,6498584,9640,64,0.677899,84,6507916,-1,32000.0,9233083,9242723,2734499,9640,5,12,True,True,9280.235111111111,-0.6657440272381496
8196,6498674,14962,32,0.990314,84,6507916,-1,16000.0,6659529,6674491,160855,14962,58,6,True,True,21641.54666666667,-0.9668946225364574
8197,6501826,1213,32,0.757714,84,6507916,-1,16000.0,6604079,6605292,102253,1213,64,2,True,True,1788.8784888888888,-0.757714
8198,6502035,6153,1,0.391063,84,6507916,-1,500.0,7749694,7755847,1247659,6153,19,6,True,True,137.13915416666666,-0.38482966017092296
8199,6502111,9289,8,0.527844,84,6507916,-1,4000.0,6588016,6597305,85905,9289,69,7,True,True,3200.662588888889,-0.5275236781166566
8200,6502185,26,1,0.28304,84,6507916,-1,500.0,7644885,7644911,1142700,26,20,7,True,True,0.6176083333333333,-0.28304
8201,6502386,77,27,0.696376,84,6507916,-1,13500.0,7009151,7009228,506765,77,43,7,True,True,89.4681375,-0.6604314876301196
8202,6504417,98,8,0.195092,84,6507916,-1,4000.0,8531083,8531181,2026666,98,11,12,True,True,15.499244444444443,-0.195092
8203,6506506,16072,16,0.856252,84,6507916,-1,8000.0,6799278,6815350,292772,16072,57,6,True,True,6287.186711111111,-0.8019847441685998
8204,6506530,393,2,0.393772,84,6507916,-1,1000.0,6798178,6798571,291648,393,58,2,True,True,16.037675,-0.393772
8205,6506670,9,10,0.130901,84,6507916,-1,5000.0,7930628,7930637,1423958,9,15,0,True,True,1.388125,-0.130901
8206,6506850,53,32,0.752266,84,6507916,-1,16000.0,6638729,6638782,131879,53,69,2,True,True,23.98191111111111,-0.752266
8207,6506902,10238,16,0.580384,84,6507916,-1,8000.0,6589116,6599354,82214,10238,76,6,True,True,7090.564399999999,-0.5660036942759776
8208,6514749,11,4,0.805072,130,6551116,-1,2000.0,6958278,6958289,443529,11,56,6,True,True,1.6283055555555557,-0.805072
8209,6515182,17122,16,0.84981,130,6551116,-1,8000.0,6683329,6700451,168147,17122,66,6,True,True,8069.027733333333,-0.7777327745035361
8210,6515205,5924,65,0.709588,130,6551116,-1,32500.0,7587661,7593585,1072456,5924,28,10,True,True,8928.817715277779,-0.7022570818744805
8211,6515302,21,4,0.457533,130,6551116,-1,2000.0,7052851,7052872,537549,21,45,7,True,True,1.2384166666666667,-0.457533
8212,6515336,13,4,0.163694,130,6551116,-1,2000.0,7443853,7443866,928517,13,37,6,True,True,1.9143222222222223,-0.163694
8213,6518831,318,1,0.137561,130,6551116,-1,500.0,7441653,7441971,922822,318,38,7,True,True,11.706816666666667,-0.137561
8214,6519316,9030,256,0.695956,130,6551116,-1,128000.0,6612899,6621929,93583,9030,78,2,True,True,40996.59982222221,-0.6266310020476645
8215,6520167,30595,8,0.291082,130,6551116,-1,4000.0,7014551,7045146,494384,30595,49,8,True,True,7465.016922222222,-0.27889119197423967
8216,6521012,76,8,0.144823,130,6551116,-1,4000.0,7653977,7654053,1132965,76,22,2,True,True,13.551644444444443,-0.144823
8217,6521112,549,11,0.218136,130,6551116,-1,5500.0,7645985,7646534,1124873,549,23,6,True,True,142.02859305555558,-0.21597242323958762
8218,6521118,54,4,0.748383,130,6551116,-1,2000.0,7344651,7344705,823533,54,45,7,True,True,7.356599999999999,-0.748383
8219,6523224,6,4,0.735319,130,6551116,-1,2000.0,6601554,6601560,78330,6,85,7,True,True,1.1205,-0.735319
8220,6523228,25123,128,0.009133,130,6551116,-1,64000.0,9734532,9759655,3211304,25123,1,12,True,True,69294.92480000001,-0.008130418639682026
8221,6523268,45,32,0.725958,130,6551116,-1,16000.0,7637985,7638030,1114717,45,27,8,True,True,34.112,-0.725958
8222,6523290,5278,1,0.575682,130,6551116,-1,500.0,7415653,7420931,892363,5278,44,2,True,True,103.62730694444446,-0.5554059506006092
8223,6523551,26792,8,0.678318,130,6551116,-1,4000.0,7627185,7653977,1103634,26792,29,6,True,True,4889.225288888889,-0.6746028070859873
8224,6523577,26,32,0.988484,130,6551116,-1,16000.0,6796751,6796777,273174,26,73,6,True,True,16.487466666666666,-0.988484
8225,6523687,13863,2,0.147605,130,6551116,-1,1000.0,9521483,9535346,2997796,13863,6,12,True,True,394.59961944444444,-0.14512733374215495
8226,6523887,47,32,0.950398,130,6551116,-1,16000.0,6729751,6729798,205864,47,76,6,True,True,29.49928888888889,-0.950398
8227,6525544,23,3,0.427111,130,6551116,-1,1500.0,6629629,6629652,104085,23,88,7,True,True,0.9473125,-0.427111
8228,6525619,311,2,0.84166,130,6551116,-1,1000.0,7355753,7356064,830134,311,50,6,True,True,18.279888888888888,-0.84166
8229,6525992,180,14,0.925985,130,6551116,-1,7000.0,6584716,6584896,58724,180,100,8,True,True,115.4405,-0.9259850000000002
8230,6526033,15294,16,0.096048,130,6551116,-1,8000.0,9648132,9663426,3122099,15294,2,6,True,True,3658.7526666666663,-0.09561908322511443
8231,6526045,205,1,0.974159,130,6551116,-1,500.0,6593816,6594021,67771,205,97,4,True,True,8.845465277777778,-0.974159
8232,6526122,1222,1,0.179633,130,6551116,-1,500.0,7351851,7353073,825729,1222,52,2,True,True,36.44954444444444,-0.179633
8233,6526796,10402,8,0.052472,130,6551116,-1,4000.0,9389683,9400085,2862887,10402,8,11,True,True,1242.731088888889,-0.05238184551339481
8234,6526905,17,2,0.980277,130,6551116,-1,1000.0,6621929,6621946,95024,17,94,6,True,True,0.5287472222222223,-0.980277
8235,6526907,11573,6,0.650098,130,6551116,-1,3000.0,6842478,6854051,315571,11573,76,10,True,True,2723.5759916666666,-0.6480061911979789
8236,6526938,14957,64,0.593392,130,6551116,-1,32000.0,7848428,7863385,1321490,14957,24,7,True,True,18215.12097777778,-0.5303012817271031
8237,6527026,8,13,0.969727,130,6551116,-1,6500.0,6849078,6849086,322052,8,76,6,True,True,4.076655555555556,-0.969727
8238,6531734,19,16,0.626973,130,6551116,-1,8000.0,6585816,6585835,54082,19,108,6,True,True,13.926155555555555,-0.626973
8239,6531754,102,4,0.403994,130,6551116,-1,2000.0,7930628,7930730,1398874,102,20,11,True,True,6.292833333333333,-0.403994
8240,6533797,30,16,0.033993,130,6551116,-1,8000.0,7657577,7657607,1123780,30,28,4,True,True,10.146666666666667,-0.033993
8241,6537960,162,32,0.240855,130,6551116,-1,16000.0,7648185,7648347,1110225,162,30,7,True,True,118.1376,-0.240855
8242,6537985,38206,4,0.488626,130,6551116,-1,2000.0,9435083,9473289,2897098,38206,8,11,True,True,2881.4351888888887,-0.48673502095579557
8243,6539007,11,16,0.687984,130,6551116,-1,8000.0,6599354,6599365,60347,11,106,2,True,True,8.217,-0.687984
8244,6547958,81,1,0.954555,130,6551116,-1,500.0,6553316,6553397,5358,81,119,7,True,True,1.13805,-0.954555
8245,6547981,6,8,0.652797,130,6551116,-1,4000.0,6630729,6630735,82748,6,99,6,True,True,0.659,-0.652797
8246,6548054,15766,1,0.375372,130,6551116,-1,500.0,7547161,7562927,999107,15766,45,7,True,True,498.65081666666674,-0.3748169496939676
8247,6548764,1472,6,0.691795,130,6551116,-1,3000.0,6627429,6628901,78665,1472,102,0,True,True,131.62002499999997,-0.4326195689940313
8248,6549100,15973,4,0.795325,130,6551116,-1,2000.0,6970378,6986351,421278,15973,76,6,True,True,2194.6902555555553,-0.7874280509988292
8249,6549404,11,16,0.658519,130,6551116,-1,8000.0,7022551,7022562,473147,11,66,2,True,True,5.4225111111111115,-0.658519
8250,6549461,127,2,0.777731,130,6551116,-1,1000.0,6649729,6649856,100268,127,98,7,True,True,9.979377777777778,-0.777731
8251,6549590,12228,128,0.864896,130,6551116,-1,64000.0,7659994,7672222,1110404,12228,29,2,True,True,31186.30897777778,-0.8259002010129894
8252,6550270,447,16,0.650311,130,6551116,-1,8000.0,6950678,6951125,400408,447,84,9,True,True,290.7685333333333,-0.650311
8253,6550672,574,8,0.275216,130,6551116,-1,4000.0,7588761,7589335,1038089,574,42,6,True,True,106.81685555555556,-0.2718125180217738
8254,6550906,17,1,0.653195,130,6551116,-1,500.0,6726451,6726468,175545,17,95,7,True,True,0.2532055555555556,-0.653195
8255,6551317,9,4,0.367323,130,6553316,-1,2000.0,7561661,7561670,1010344,9,46,8,True,True,1.12765,-0.367323
8256,6555872,21,16,0.12,135,6576016,-1,8000.0,7050651,7050672,494779,21,69,8,True,True,5.8604,-0.12
8257,6556914,38837,32,0.082637,135,6576016,-1,16000.0,9864132,9902969,3307218,38837,0,12,True,True,29231.462266666673,-0.08171629073918812
8258,6556980,7,1,0.489218,135,6576016,-1,500.0,7980428,7980435,1423448,7,20,7,True,True,0.24821805555555554,-0.489218
8259,6557207,20,8,0.668792,135,6576016,-1,4000.0,6699529,6699549,142322,20,102,2,True,True,2.690888888888889,-0.668792
8260,6557226,30122,16,0.509748,135,6576016,-1,8000.0,7642685,7672807,1085459,30122,38,4,True,True,10349.20428888889,-0.4941533304121507
8261,6560365,24923,8,0.023027,135,6576016,-1,4000.0,7639085,7664008,1078720,24923,39,6,True,True,4438.930755555556,-0.02242843358884798
8262,6561375,4,4,0.572982,135,6576016,-1,2000.0,7537953,7537957,976578,4,55,7,True,True,0.47484444444444446,-0.572982
8263,6584225,8636,32,0.572631,136,6584716,-1,16000.0,7746394,7755030,1162169,8636,31,12,True,True,6200.642577777777,-0.5680893863315268
8264,6584326,115,1,0.273725,136,6584716,-1,500.0,7747494,7747609,1163168,115,31,6,True,True,2.6205624999999997,-0.273725
8265,6584470,5285,1,0.745359,136,6584716,-1,500.0,7540153,7545438,955683,5285,57,7,True,True,146.2996875,-0.7451756344487909
8266,6584524,17,8,0.794344,136,6584716,-1,4000.0,6688729,6688746,104205,17,110,8,True,True,6.098466666666667,-0.794344
8267,6586397,15006,2,0.181097,134,6588016,-1,1000.0,7548261,7563267,961864,15006,54,6,True,True,952.1036333333334,-0.18095811266022221
8268,6595995,36,1,0.484191,131,6597416,-1,500.0,7932828,7932864,1336833,36,21,6,True,True,0.5307999999999999,-0.484191
8269,6598188,13,2,0.644597,139,6599354,-1,1000.0,7562761,7562774,964573,13,53,6,True,True,0.8144138888888889,-0.644597
8270,6598204,29295,1,0.433656,139,6599354,-1,500.0,8444683,8473978,1846479,29295,18,11,True,True,1068.5956569444443,-0.4285585129676456
8271,6598230,8526,1,0.571423,139,6599354,-1,500.0,7357953,7366479,759723,8526,73,7,True,True,249.27121666666667,-0.5637037985736505
8272,6598245,6341,32,0.099441,139,6599354,-1,16000.0,9391883,9398224,2793638,6341,10,7,True,True,3026.7737777777775,-0.09902933175014228
8273,6598319,6,32,0.063498,139,6599354,-1,16000.0,6844678,6844684,246359,6,104,7,True,True,7.2088,-0.063498
8274,6598385,98,4,0.908881,139,6599354,-1,2000.0,7003651,7003749,405266,98,89,6,True,True,8.773177777777777,-0.908881
8275,6598409,63,4,0.795225,139,6599354,-1,2000.0,6660629,6660692,62220,63,120,6,True,True,11.570300000000001,-0.795225
8276,6598586,39,1,0.18489,139,6599354,-1,500.0,7437253,7437292,838667,39,70,10,True,True,1.5375750000000001,-0.18489
8277,6598637,103,32,0.812868,139,6599354,-1,16000.0,6722051,6722154,123414,103,116,10,True,True,54.800577777777775,-0.812868
8278,6601227,155,32,0.019746,144,6601554,-1,16000.0,7978228,7978383,1377001,155,23,11,True,True,175.88022222222222,-0.019746
8279,6601244,6,11,0.55606,144,6601554,-1,5500.0,8024728,8024734,1423484,6,22,11,True,True,1.5973833333333332,-0.55606
8280,6601275,10,1,0.536417,144,6601554,-1,500.0,6820878,6820888,219603,10,110,10,True,True,0.34622222222222226,-0.536417
8281,6601296,8,1,0.812196,144,6601554,-1,500.0,6657329,6657337,56033,8,128,8,True,True,0.39599999999999996,-0.812196
8282,6601430,4,2,0.488563,144,6601554,-1,1000.0,7532453,7532457,931023,4,68,12,True,True,0.23694444444444446,-0.488563
8283,6601507,326,2,0.518901,144,6601554,-1,1000.0,7380653,7380979,779146,326,77,6,True,True,17.39843888888889,-0.518901
8284,6601557,3,8,0.584722,152,6602654,-1,4000.0,7442753,7442756,841196,3,71,6,True,True,0.8835333333333334,-0.584722
8285,6601724,7,16,0.713749,152,6602654,-1,8000.0,6960478,6960485,358754,7,105,6,True,True,2.5221777777777774,-0.713749
8286,6601793,12,2,0.790068,152,6602654,-1,1000.0,6644229,6644241,42436,12,135,7,True,True,0.34236666666666665,-0.790068
8287,6602243,16242,8,0.124089,152,6602654,-1,4000.0,7550461,7566703,948218,16242,60,7,True,True,3944.9651888888893,-0.12171275491580741
8288,6602328,45256,3,0.752988,152,6602654,-1,1500.0,7004751,7050007,402423,45256,96,6,True,True,4283.90455,-0.7454720939108064
8289,6602357,1768,4,0.965681,152,6602654,-1,2000.0,6692329,6694097,89972,1768,129,2,True,True,144.58611111111114,-0.6149205895149347
8290,6602381,3627,16,0.897602,152,6602654,-1,8000.0,6794551,6798178,192170,3627,121,10,True,True,1162.954,-0.8817653829028363
8291,6602432,111,70,0.180664,152,6602654,-1,35000.0,6964878,6964989,362446,111,107,7,True,True,281.57616666666667,-0.180664
8292,6602439,5630,63,0.599103,152,6602654,-1,31500.0,7554061,7559691,951622,5630,60,2,True,True,11358.107075,-0.5989168197242624
8293,6602850,587,4,0.179938,162,6604079,-1,2000.0,6624129,6624716,21279,587,149,7,True,True,55.95414444444445,-0.179938
8294,6602886,1,8,0.554722,162,6604079,-1,4000.0,6939878,6939879,336992,1,114,12,True,True,0.2775444444444444,-0.554722
8295,6602918,561,8,0.800513,162,6604079,-1,4000.0,6651929,6652490,49011,561,140,7,True,True,176.32853333333333,-0.800513
8296,6602928,8,1,0.123045,162,6604079,-1,500.0,7592361,7592369,989433,8,53,2,True,True,0.18592222222222224,-0.123045
8297,6602934,6208,3,0.128816,162,6604079,-1,1500.0,9060283,9066491,2457349,6208,14,12,True,True,280.35147500000005,-0.12851309315417786
8298,6603044,9451,256,0.20623,162,6604079,-1,128000.0,9535346,9544797,2932302,9451,8,0,True,True,37099.24764444445,-0.1982646733231379
8299,6603431,3571,256,0.16121,162,6604079,-1,128000.0,8131112,8134683,1527681,3571,24,2,True,True,41467.87164444444,-0.15943728120018313
8300,6603479,6939,4,0.562496,162,6604079,-1,2000.0,7045251,7052190,441772,6939,96,10,True,True,480.91679999999997,-0.5622750262682346
8301,6603637,8,1,0.85145,162,6604079,-1,500.0,6983878,6983886,380241,8,107,7,True,True,0.2584111111111111,-0.85145
8302,6603653,369,2,0.035005,162,6604079,-1,1000.0,7354653,7355022,751000,369,88,2,True,True,21.818033333333332,-0.034695122261643556
8303,6603719,80,8,0.979928,162,6604079,-1,4000.0,7016751,7016831,413032,80,100,0,True,True,23.595555555555556,-0.979928
8304,6604464,116,12,0.506148,194,6612899,-1,6000.0,7887428,7887544,1282964,116,32,7,True,True,24.91873333333333,-0.506148
8305,6604573,1322,28,0.36356,194,6612899,-1,14000.0,8887483,8888805,2282910,1322,17,12,True,True,772.6867944444444,-0.3482124503365273
8306,6604621,9127,32,0.544427,194,6612899,-1,16000.0,7412053,7421180,807432,9127,84,6,True,True,5610.811600000001,-0.5295328472319941
8307,6604631,7934,1,0.423051,194,6612899,-1,500.0,7751894,7759828,1147263,7934,40,7,True,True,176.39924722222224,-0.4229380655174128
8308,6606881,33034,2,0.945228,194,6612899,-1,1000.0,7256051,7289085,649170,33034,96,6,True,True,3261.4234944444447,-0.9338436166423404
8309,6606899,42,16,8.6e-05,194,6612899,-1,8000.0,9324883,9324925,2717984,42,13,12,True,True,8.246,-8.6e-05
8310,6606945,21,64,0.3006,194,6612899,-1,32000.0,8801083,8801104,2194138,21,19,12,True,True,26.000799999999998,-0.3006
8311,6606974,17,16,0.946215,194,6612899,-1,8000.0,6639829,6639846,32855,17,160,6,True,True,3.8461555555555558,-0.946215
8312,6607002,13375,128,0.519443,194,6612899,-1,64000.0,8113328,8126703,1506326,13375,28,7,True,True,78839.40888888888,-0.5151580862569258
8313,6607032,18378,32,0.782802,194,6612899,-1,16000.0,7015651,7034029,408619,18378,109,6,True,True,18597.62991111111,-0.7147150239093648
8314,6607069,163,13,0.659158,194,6612899,-1,6500.0,7016751,7016914,409682,163,109,6,True,True,78.12340972222222,-0.659158
8315,6607310,9106,128,0.44492,194,6612899,-1,64000.0,9389683,9398789,2782373,9106,12,0,True,True,17398.707555555557,-0.4442751754845353
8316,6607654,318,16,0.577071,194,6612899,-1,8000.0,7748594,7748912,1140940,318,46,6,True,True,115.94279999999999,-0.577071
8317,6607660,14,1,0.695101,194,6612899,-1,500.0,7053951,7053965,446291,14,105,6,True,True,0.2064027777777778,-0.695101
8318,6607677,12718,2,0.522666,194,6612899,-1,1000.0,6853478,6866196,245801,12718,136,7,True,True,1056.6965277777779,-0.5132187913741001
8319,6607681,77,32,0.98602,194,6612899,-1,16000.0,6647529,6647606,39848,77,164,7,True,True,54.218266666666665,-0.98602
8320,6608094,151,1,0.352117,194,6612899,-1,500.0,6772951,6773102,164857,151,147,11,True,True,6.016091666666667,-0.352117
8321,6608243,24,4,0.538209,194,6612899,-1,2000.0,7164151,7164175,555908,24,104,7,True,True,4.098133333333334,-0.538209
8322,6608269,17286,72,0.20984,194,6612899,-1,36000.0,9629746,9647032,3021477,17286,7,7,True,True,22783.6356,-0.20288371978926484
8323,6608636,12173,33,0.099009,194,6612899,-1,16500.0,9647032,9659205,3038396,12173,4,2,True,True,6281.103720833334,-0.0955636760553517
8324,6608641,7850,2,0.819763,194,6612899,-1,1000.0,7023651,7031501,415010,7850,112,6,True,True,441.9459166666667,-0.7572286839717709
8325,6608689,14,16,0.2371,194,6612899,-1,8000.0,7935028,7935042,1326339,14,35,7,True,True,4.019866666666667,-0.2371
8326,6609037,2902,32,0.188074,194,6612899,-1,16000.0,9346483,9349385,2737446,2902,16,10,True,True,1286.7663555555557,-0.1875598537284604
8327,6609647,18,32,0.299709,194,6612899,-1,16000.0,8714683,8714701,2105036,18,24,12,True,True,14.4912,-0.299709
8328,6609672,8,1,0.832628,194,6612899,-1,500.0,7408753,7408761,799081,8,97,6,True,True,0.1425,-0.832628
8329,6609718,136,8,0.957423,194,6612899,-1,4000.0,7348251,7348387,738533,136,105,2,True,True,35.038133333333334,-0.957423
8330,6609805,11572,2,0.602144,194,6612899,-1,1000.0,6635129,6646701,25324,11572,180,7,True,True,340.53602777777775,-0.5345233774688063
8331,6609811,28668,16,0.21604,194,6612899,-1,8000.0,9635146,9663814,3025335,28668,8,8,True,True,7549.248622222222,-0.21264975942936284
8332,6610311,17,16,0.359065,194,6612899,-1,8000.0,8223283,8223300,1612972,17,32,12,True,True,11.913222222222224,-0.359065
8333,6610437,18881,16,0.128492,194,6612899,-1,8000.0,9629746,9648627,3019309,18881,9,0,True,True,5499.432888888889,-0.12435799391102634
8334,6610602,61,2,0.622313,194,6612899,-1,1000.0,7544961,7545022,934359,61,84,2,True,True,3.3866861111111115,-0.622313
8335,6610813,6518,1,0.07436,194,6612899,-1,500.0,7981528,7988046,1370715,6518,38,6,True,True,274.8889972222222,-0.0741044565434922
8336,6611122,34,5,0.254967,194,6612899,-1,2500.0,7618485,7618519,1007363,34,71,6,True,True,3.5610277777777775,-0.254967
8337,6615704,17343,3,0.381782,207,6621929,-1,1500.0,6845778,6863121,230074,17343,154,6,True,True,2148.4929,-0.37818206144323785
8338,6615735,16,22,0.90366,207,6621929,-1,11000.0,7161951,7161967,546216,16,118,10,True,True,14.91648888888889,-0.90366
8339,6616571,166,1,0.400059,207,6621929,-1,500.0,6627429,6627595,10858,166,193,6,True,True,3.9558722222222222,-0.400059
8340,6616591,14827,128,0.083254,207,6621929,-1,64000.0,7624985,7639812,1008394,14827,70,8,True,True,42218.24142222222,-0.08135316557901769
8341,6617362,14120,2,0.254179,207,6621929,-1,1000.0,8401483,8415603,1784121,14120,32,12,True,True,849.8628222222222,-0.24877290688315176
8342,6617493,51,13,0.425343,207,6621929,-1,6500.0,8309683,8309734,1692190,51,34,12,True,True,24.123070833333333,-0.425343
8343,6618406,2,4,0.694515,207,6621929,-1,2000.0,6981678,6981680,363272,2,142,7,True,True,0.2584111111111111,-0.694515
8344,6618418,23,16,0.535904,207,6621929,-1,8000.0,6851278,6851301,232860,23,157,7,True,True,15.346111111111112,-0.535904
8345,6618438,11672,2,0.070558,207,6621929,-1,1000.0,7595785,7607457,977347,11672,76,7,True,True,532.7167666666667,-0.06910565932202081
8346,6618468,4,1,0.732675,207,6621929,-1,500.0,7846228,7846232,1227760,4,54,12,True,True,0.0615,-0.732675
8347,6618580,26,32,0.995359,207,6621929,-1,16000.0,6682229,6682255,63649,26,183,10,True,True,35.373866666666665,-0.995359
8348,6619963,33909,64,0.696803,207,6621929,-1,32000.0,7626085,7659994,1006122,33909,73,6,True,True,48978.74311111111,-0.6967948460170327
8349,6619988,15803,16,0.192627,207,6621929,-1,8000.0,9623946,9639749,3003958,15803,12,7,True,True,4819.825733333333,-0.19015808542046322
8350,6620056,9,1,0.372142,207,6621929,-1,500.0,8119128,8119137,1499072,9,39,2,True,True,0.42815,-0.372142
8351,6622312,5,1,0.657318,210,6624129,-1,500.0,6951778,6951783,329466,5,159,6,True,True,0.211,-0.657318
8352,6622397,12,8,0.820508,210,6624129,-1,4000.0,7407653,7407665,785256,12,112,10,True,True,1.7100000000000002,-0.820508
8353,6622983,8,1,0.604945,210,6624129,-1,500.0,7252751,7252759,629768,8,125,12,True,True,0.3949666666666667,-0.604945
8354,6622999,19984,1,0.419686,210,6624129,-1,500.0,8111128,8131112,1488129,19984,41,12,True,True,909.8110444444443,-0.4172738701541037
8355,6630985,28,1,0.153491,209,6632929,-1,500.0,8136883,8136911,1505898,28,37,7,True,True,1.2218111111111112,-0.153491
8356,6632064,10,2,0.992449,209,6632929,-1,1000.0,6962678,6962688,330614,10,159,7,True,True,0.7247777777777779,-0.992449
8357,6632105,2358,32,0.433627,209,6632929,-1,16000.0,9238483,9240841,2606378,2358,21,8,True,True,1166.8432,-0.433627
8358,6632456,13,1,0.02591,209,6632929,-1,500.0,7856028,7856041,1223572,13,57,8,True,True,0.2357152777777778,-0.02591
8359,6632537,232,1,0.603607,209,6632929,-1,500.0,6986351,6986583,353814,232,151,2,True,True,7.786822222222222,-0.603607
8360,6633392,16,64,0.077525,210,6635129,-1,32000.0,8115528,8115544,1482136,16,42,7,True,True,45.959111111111106,-0.077525
8361,6633783,55,8,0.124621,210,6635129,-1,4000.0,7650385,7650440,1016602,55,71,7,True,True,9.901222222222222,-0.124621
8362,6635342,7653,128,0.10999,211,6638729,-1,64000.0,9621746,9629399,2986404,7653,13,12,True,True,19986.963911111114,-0.10960388517168586
8363,6635459,66,1,0.548369,211,6638729,-1,500.0,6972578,6972644,337119,66,161,7,True,True,2.4649166666666664,-0.548369
6249,4878338,11,32,0.304912,1,4878338,-1,16000.0,4964738,4964749,86400,11,0,12,True,True,5.814844444444445,-0.304912
6250,4879071,26,2,0.337594,65,4964738,-1,1000.0,9722259,9722285,4843188,26,0,12,True,True,0.28231666666666666,-0.337594
6251,4879130,60,2,0.019712,65,4964738,-1,1000.0,12610259,12610319,7731129,60,0,12,True,True,1.3559999999999999,-0.019712
6252,4879180,6680,256,0.326117,65,4964738,-1,128000.0,12523859,12530539,7644679,6680,1,8,True,True,21256.065777777778,-0.29096941925578607
6253,4879208,137,1,0.460909,65,4964738,-1,500.0,7373219,7373356,2494011,137,3,7,True,True,2.1023791666666667,-0.460909
6254,4879296,7,1,0.863369,65,4964738,-1,500.0,5782103,5782110,902807,7,4,12,True,True,0.17959861111111108,-0.863369
6255,4879534,312,1,0.568049,65,4964738,-1,500.0,7422219,7422531,2542685,312,3,2,True,True,9.168033333333334,-0.568049
6256,4879804,7273,2,0.90141,65,4964738,-1,1000.0,5389676,5396949,509872,7273,6,7,True,True,266.2871,-0.8799988876505015
6257,4879828,53,5,0.266619,65,4964738,-1,2500.0,6237079,6237132,1357251,53,5,6,True,True,5.5160486111111116,-0.266619
6258,4879844,274,4,0.695958,65,4964738,-1,2000.0,4964738,4965012,84894,274,8,0,True,True,18.105311111111114,-0.695958
6259,4879850,72,16,0.587989,65,4964738,-1,8000.0,5393276,5393348,513426,72,7,2,True,True,20.326400000000003,-0.587989
6260,4880161,38027,32,0.985765,65,4964738,-1,16000.0,5657676,5695703,777515,38027,7,11,True,True,20006.445244444447,-0.9153064037482337
6261,4880191,17280,16,0.377738,65,4964738,-1,8000.0,11860659,11877939,6980468,17280,2,12,True,True,4045.5211999999997,-0.35119613221482315
6262,4880221,16,8,0.390301,65,4964738,-1,4000.0,7711719,7711735,2831498,16,4,12,True,True,3.3004444444444445,-0.390301
6263,4880293,160,16,0.572539,65,4964738,-1,8000.0,9765459,9765619,4885166,160,3,11,True,True,20.29866666666667,-0.572539
6264,4887016,13116,4,0.808327,65,4964738,-1,2000.0,8669719,8682835,3782703,13116,5,12,True,True,974.1275388888889,-0.7905558397756566
6265,4887503,7015,8,0.100057,65,4964738,-1,4000.0,10197459,10204474,5309956,7015,3,12,True,True,1213.6725000000001,-0.09833019840461543
6266,4887513,78,16,0.675111,65,4964738,-1,8000.0,5988813,5988891,1101300,78,11,1,True,True,37.53706666666667,-0.675111
6267,4887636,911,32,0.335967,65,4964738,-1,16000.0,10715859,10716770,5828223,911,3,12,True,True,152.6026222222222,-0.335967
6268,4887999,37,1,0.502769,65,4964738,-1,500.0,11601459,11601496,6713460,37,3,12,True,True,1.5605777777777778,-0.502769
6269,4888110,373,16,0.764904,65,4964738,-1,8000.0,6620280,6620653,1732170,373,12,2,True,True,109.9471111111111,-0.7341526886239393
6270,4888363,310,8,0.339539,65,4964738,-1,4000.0,7467619,7467929,2579256,310,10,11,True,True,55.08355555555555,-0.339539
6271,4888651,28881,256,0.614828,65,4964738,-1,128000.0,5695703,5724584,807052,28881,17,2,True,True,150451.50364444446,-0.5951730483731357
6272,4888977,17,4,0.363334,65,4964738,-1,2000.0,10975059,10975076,6086082,17,4,12,True,True,0.755838888888889,-0.363334
6273,4889116,13,16,0.435991,65,4964738,-1,8000.0,7305119,7305132,2416003,13,14,8,True,True,4.803644444444444,-0.435991
6274,4890037,71,32,0.496952,65,4964738,-1,16000.0,8680519,8680590,3790482,71,9,9,True,True,38.19168888888888,-0.496952
6275,4890192,3313,1,0.847334,65,4964738,-1,500.0,5051138,5054451,160946,3313,24,12,True,True,42.65785416666667,-0.8452049479153373
6276,4890349,18465,16,0.78715,65,4964738,-1,8000.0,5399076,5417541,508727,18465,22,7,True,True,4988.187133333333,-0.728131807857492
6277,4890532,7,16,0.84038,65,4964738,-1,8000.0,7129319,7129326,2238787,7,16,11,True,True,2.4840666666666666,-0.84038
6278,4890539,85,1,0.535834,65,4964738,-1,500.0,9247059,9247144,4356520,85,9,12,True,True,1.2451319444444444,-0.535834
6279,4890755,96,32,0.287356,65,4964738,-1,16000.0,11947059,11947155,7056304,96,2,12,True,True,28.33066666666667,-0.287356
6280,4890793,21669,4,0.047531,65,4964738,-1,2000.0,13570159,13591828,8679366,21669,0,12,True,True,662.4133333333335,-0.0462425953445208
6281,4891211,34,16,0.996228,65,4964738,-1,8000.0,5658776,5658810,767565,34,25,6,True,True,9.757244444444444,-0.996228
6282,4891255,335,1,0.402027,65,4964738,-1,500.0,10629459,10629794,5738204,335,8,12,True,True,1.6247500000000001,-0.402027
6283,4891280,34,1,0.225886,65,4964738,-1,500.0,8581119,8581153,3689839,34,15,11,True,True,0.21788333333333335,-0.225886
6284,4891308,16879,123,0.742888,65,4964738,-1,61500.0,6071122,6088001,1179814,16879,24,7,True,True,55027.67815833333,-0.7155035802479701
6285,4891483,14135,2,0.091958,65,4964738,-1,1000.0,10283859,10297994,5392376,14135,9,12,True,True,487.08765555555556,-0.08611114951915737
6286,4891580,37,14,0.844187,65,4964738,-1,7000.0,5218638,5218675,327058,37,34,10,True,True,8.48225,-0.844187
6287,4891601,32005,16,0.094734,65,4964738,-1,8000.0,13138159,13170164,8246558,32005,1,11,True,True,3741.8982666666666,-0.08817664625208926
6288,4891744,15533,256,0.336838,65,4964738,-1,128000.0,13483759,13499292,8592015,15533,1,12,True,True,52535.42257777778,-0.3074748911305359
6289,4891751,25,1,0.06727,65,4964738,-1,500.0,12125259,12125284,7233508,25,5,12,True,True,0.4478472222222222,-0.06727
6290,4891772,333,1,0.801186,65,4964738,-1,500.0,5108438,5108771,216666,333,38,9,True,True,1.9873625,-0.801186
6291,4892703,136,1,0.475268,65,4964738,-1,500.0,5563276,5563412,670573,136,34,6,True,True,1.426488888888889,-0.475268
6292,4892784,23,1,0.209739,65,4964738,-1,500.0,6466079,6466102,1573295,23,27,9,True,True,0.1497555555555556,-0.209739
6293,4892987,5403,13,0.795652,65,4964738,-1,6500.0,5880921,5886324,987934,5403,31,10,True,True,1597.901825,-0.7901685010953917
6294,4893037,9824,2,0.651537,65,4964738,-1,1000.0,7327819,7337643,2434782,9824,24,6,True,True,501.35473333333334,-0.6119324223904216
6295,4893058,119,4,0.301847,65,4964738,-1,2000.0,6990121,6990240,2097063,119,27,11,True,True,5.8852111111111105,-0.301847
6296,4893092,3,4,0.804127,65,4964738,-1,2000.0,5277691,5277694,384599,3,42,7,True,True,0.21368333333333336,-0.804127
6297,4893139,107,2,0.43291,65,4964738,-1,1000.0,7033321,7033428,2140182,107,27,11,True,True,7.3723,-0.43291
6298,4893163,21,32,0.539948,65,4964738,-1,16000.0,7184119,7184140,2290956,21,26,2,True,True,3.3945333333333334,-0.539948
6299,4893256,25,16,0.200077,65,4964738,-1,8000.0,7205719,7205744,2312463,25,26,10,True,True,4.007222222222222,-0.200077
6300,4893306,12864,64,0.402301,65,4964738,-1,32000.0,6615580,6628444,1722274,12864,32,2,True,True,13521.26791111111,-0.3973612260517536
6301,4893349,211,8,0.624964,65,4964738,-1,4000.0,6925321,6925532,2031972,211,31,11,True,True,29.589233333333333,-0.624964
6302,4894139,371,1,0.453229,65,4964738,-1,500.0,9938259,9938630,5044120,371,14,12,True,True,3.1756569444444445,-0.453229
6303,4894205,48,32,0.763442,65,4964738,-1,16000.0,7294319,7294367,2400114,48,27,11,True,True,35.6224,-0.763442
6304,4894231,44,8,0.180601,65,4964738,-1,4000.0,9376659,9376703,4482428,44,17,12,True,True,3.5107111111111116,-0.180601
6305,4895612,10,32,0.018603,65,4964738,-1,16000.0,13397359,13397369,8501747,10,2,12,True,True,5.434666666666667,-0.018603
6306,4895622,11994,8,0.703332,65,4964738,-1,4000.0,7798119,7810113,2902497,11994,23,12,True,True,1586.7350666666666,-0.6572021529281378
6307,4895882,3,1,0.86271,65,4964738,-1,500.0,5562176,5562179,666294,3,49,10,True,True,0.031466666666666664,-0.86271
6308,4895968,23,2,0.576843,65,4964738,-1,1000.0,9463059,9463082,4567091,23,18,12,True,True,0.23498333333333335,-0.576843
6309,4895984,8,16,0.212953,65,4964738,-1,8000.0,8898719,8898727,4002735,8,21,7,True,True,2.3665777777777777,-0.212953
6310,4895993,11,8,0.962117,65,4964738,-1,4000.0,5224038,5224049,328045,11,56,8,True,True,1.3811111111111112,-0.962117
6311,4896003,16,41,0.742208,65,4964738,-1,20500.0,7054921,7054937,2158918,16,36,10,True,True,21.14688888888889,-0.742208
6312,4896291,3098,16,0.467295,65,4964738,-1,8000.0,7076521,7079619,2180230,3098,36,10,True,True,670.2873333333333,-0.3608299700043638
6313,4896671,17362,128,0.937163,65,4964738,-1,64000.0,5783203,5800565,886532,17362,48,6,True,True,52709.52906666667,-0.9274510324891106
6314,4896798,333,2,0.532719,65,4964738,-1,1000.0,8581119,8581452,3684321,333,24,0,True,True,4.26795,-0.532719
6315,4964811,8,1,0.614422,197,5051138,-1,500.0,5902321,5902329,937510,8,48,6,True,True,0.15577777777777777,-0.614422
6316,4964818,13609,128,0.769119,197,5051138,-1,64000.0,10111059,10124668,5146241,13609,15,12,True,True,18370.685333333335,-0.6846096833115493
6317,4964905,4,16,0.433724,197,5051138,-1,8000.0,6685171,6685175,1720266,4,43,2,True,True,2.1016,-0.433724
6318,4965079,16,7,0.566116,197,5051138,-1,3500.0,5890021,5890037,924942,16,51,7,True,True,2.638377777777778,-0.566116
6319,4965091,8164,1,0.626758,197,5051138,-1,500.0,6208722,6216886,1243631,8164,48,7,True,True,134.23218055555554,-0.5754671612728484
6320,4965152,13,1,0.52227,197,5051138,-1,500.0,7180519,7180532,2215367,13,37,7,True,True,0.09858333333333333,-0.52227
6321,4965209,19140,13,0.364275,197,5051138,-1,6500.0,8810119,8829259,3844910,19140,23,11,True,True,4464.692772222223,-0.3458980363980085
6322,4965225,5348,8,0.147744,197,5051138,-1,4000.0,11687859,11693207,6722634,5348,9,12,True,True,280.87212222222223,-0.14560844519127197
6323,4965337,26,32,0.150473,197,5051138,-1,16000.0,11428659,11428685,6463322,26,11,12,True,True,16.18702222222222,-0.150473
6324,4965341,44,16,0.685307,197,5051138,-1,8000.0,5887821,5887865,922480,44,57,7,True,True,16.078577777777777,-0.685307
6325,4965528,13,1,0.300276,197,5051138,-1,500.0,8987859,8987872,4022331,13,24,12,True,True,0.07007361111111111,-0.300276
6326,4965570,9,1,0.435389,197,5051138,-1,500.0,7078721,7078730,2113151,9,43,7,True,True,0.1025125,-0.435389
6327,4966013,54,4,0.318653,197,5051138,-1,2000.0,6163322,6163376,1197309,54,55,2,True,True,5.7264,-0.318653
6328,4966019,111,29,0.830214,197,5051138,-1,14500.0,5338365,5338476,372346,111,72,0,True,True,67.48722916666667,-0.830214
6329,4966028,14475,1,0.064428,197,5051138,-1,500.0,12917059,12931534,7951031,14475,4,12,True,True,186.3620958333333,-0.05817393761894162
6330,4967530,350,16,0.203558,197,5051138,-1,8000.0,6771571,6771921,1804041,350,50,12,True,True,203.04711111111112,-0.2021337687290116
6331,4967600,6113,1,0.412438,197,5051138,-1,500.0,7510819,7516932,2543219,6113,34,11,True,True,172.72474305555554,-0.4099537973384925
6332,4968036,187,16,0.823711,197,5051138,-1,8000.0,5130038,5130225,162002,187,79,9,True,True,60.517355555555554,-0.823711
6333,4968040,16106,16,0.646043,197,5051138,-1,8000.0,5197038,5213144,228998,16106,79,7,True,True,4779.355244444445,-0.5917704551988772
6334,4968931,5,1,0.256447,197,5051138,-1,500.0,12432059,12432064,7463128,5,7,12,True,True,0.026527777777777782,-0.256447
6335,4969066,8270,24,0.601232,197,5051138,-1,12000.0,7625319,7633589,2656253,8270,35,12,True,True,6518.995266666667,-0.5878017202958434
6336,4969076,22,1,0.405866,197,5051138,-1,500.0,12038859,12038881,7069783,22,9,12,True,True,0.1630138888888889,-0.405866
6337,4972025,54,16,0.113559,197,5051138,-1,8000.0,12612459,12612513,7640434,54,5,7,True,True,8.6184,-0.113559
6338,4972673,518,8,0.191916,197,5051138,-1,4000.0,12830659,12831177,7857986,518,5,12,True,True,29.73895555555556,-0.191916
6339,4972718,376,1,0.245587,197,5051138,-1,500.0,12518459,12518835,7545741,376,9,12,True,True,4.532366666666667,-0.245587
6340,4975919,5657,2,0.827229,197,5051138,-1,1000.0,6230322,6235979,1254403,5657,63,10,True,True,252.19420277777778,-0.7904336555817989
6341,4976027,259,4,0.46416,197,5051138,-1,2000.0,6771921,6772180,1795894,259,57,1,True,True,37.82838888888889,-0.46416
6342,4976257,34,8,0.559825,197,5051138,-1,4000.0,6068922,6068956,1092665,34,68,8,True,True,5.425266666666667,-0.559825
6343,4976907,30,2,0.436133,197,5051138,-1,1000.0,5331865,5331895,354958,30,85,8,True,True,1.2421666666666666,-0.436133
6344,4977065,26811,64,0.646922,197,5051138,-1,32000.0,12919259,12946070,7942194,26811,4,7,True,True,24368.94853333333,-0.6213619407876185
6345,4978639,12,2,0.037004,197,5051138,-1,1000.0,11255859,11255871,6277220,12,19,12,True,True,0.4793,-0.037004
6346,4978779,16654,94,0.159358,197,5051138,-1,47000.0,13843287,13859941,8864508,16654,0,12,True,True,6398.737841666667,-0.15741271443578292
6347,4978840,91,32,0.136431,197,5051138,-1,16000.0,6685080,6685171,1706240,91,63,11,True,True,95.6228,-0.136431
6348,4986046,13928,256,0.258397,197,5051138,-1,128000.0,13742959,13756887,8756913,13928,1,12,True,True,13576.398222222222,-0.2399217132242686
6349,4986058,7,8,0.803538,197,5051138,-1,4000.0,5273291,5273298,287233,7,92,6,True,True,0.9645222222222223,-0.803538
6350,4986134,20,4,0.658671,197,5051138,-1,2000.0,6012613,6012633,1026479,20,74,0,True,True,1.368,-0.658671
6351,4986480,6,53,0.175985,197,5051138,-1,26500.0,7538919,7538925,2552439,6,44,8,True,True,8.877058333333334,-0.175985
6352,4987189,67,64,0.852521,197,5051138,-1,32000.0,6159722,6159789,1172533,67,73,7,True,True,102.11395555555555,-0.852521
6353,4987212,14787,128,0.963787,197,5051138,-1,64000.0,5386376,5401163,399164,14787,92,1,True,True,36223.50755555556,-0.9341856311347113
6354,4987740,78,1,0.485842,197,5051138,-1,500.0,6232522,6232600,1244782,78,70,7,True,True,1.9315833333333334,-0.485842
6355,4987840,365,4,0.019909,197,5051138,-1,2000.0,12257059,12257424,7269219,365,14,11,True,True,14.374916666666667,-0.019909
6356,4989169,109,8,0.859584,197,5051138,-1,4000.0,6018013,6018122,1028844,109,78,8,True,True,17.739144444444445,-0.859584
6357,4989371,31,8,0.08393,197,5051138,-1,4000.0,12742059,12742090,7752688,31,9,11,True,True,5.803544444444444,-0.08393
6358,4989557,10336,8,0.6016,197,5051138,-1,4000.0,6467179,6477515,1477622,10336,70,6,True,True,752.1075333333333,-0.6002737514009594
6359,4989575,14084,1,0.867172,197,5051138,-1,500.0,6641880,6655964,1652305,14084,68,10,True,True,93.12719444444444,-0.6612971482147614
6360,4990729,108,2,0.900575,197,5051138,-1,1000.0,6580679,6580787,1589950,108,71,12,True,True,2.0829,-0.900575
6361,4990830,666,2,0.407007,197,5051138,-1,1000.0,9635859,9636525,4645029,666,33,12,True,True,9.3943,-0.407007
6362,4991259,16734,1,0.363434,197,5051138,-1,500.0,12213859,12230593,7222600,16734,16,12,True,True,293.38422083333336,-0.3360000104441779
6363,4991313,1000,3,0.657431,197,5051138,-1,1500.0,5400176,5401176,408863,1000,98,6,True,True,60.175,-0.657431
6364,4991342,21,8,0.090306,197,5051138,-1,4000.0,5885621,5885642,894279,21,90,2,True,True,3.8072999999999997,-0.090306
6365,4996152,288,8,0.943162,197,5051138,-1,4000.0,5173238,5173526,177086,288,111,11,True,True,16.1888,-0.943162
6366,4996383,9,1,0.724234,197,5051138,-1,500.0,5324265,5324274,327882,9,106,10,True,True,0.19155000000000003,-0.724234
6367,4996738,11299,256,0.14056,197,5051138,-1,128000.0,13756887,13768186,8760149,11299,1,7,True,True,11779.181866666666,-0.1400691462875144
6368,4996862,19,8,0.111932,197,5051138,-1,4000.0,8680519,8680538,3683657,19,42,0,True,True,2.555077777777778,-0.111932
6369,4997024,11651,2,0.73448,197,5051138,-1,1000.0,5076038,5087689,79014,11651,117,6,True,True,285.0813805555556,-0.7314440197037169
6370,4998240,68,32,0.932935,197,5051138,-1,16000.0,5274391,5274459,276151,68,110,6,True,True,39.46115555555556,-0.932935
6371,4998380,9,2,0.521958,197,5051138,-1,1000.0,8901459,8901468,3903079,9,40,2,True,True,0.29267499999999996,-0.521958
6372,5001282,11,1,0.828982,197,5051138,-1,500.0,7511919,7511930,2510637,11,52,6,True,True,0.31421805555555554,-0.828982
6373,5001393,8013,2,0.949675,197,5051138,-1,1000.0,5339576,5347589,338183,8013,108,6,True,True,323.24230555555556,-0.9455951841848939
6374,5003634,1429,2,0.931556,197,5051138,-1,1000.0,6206522,6207951,1202888,1429,84,11,True,True,58.08091111111111,-0.931556
6375,5003672,396,11,0.251808,197,5051138,-1,5500.0,11147859,11148255,6144187,396,26,11,True,True,11.0473,-0.25180799999999987
6376,5003800,518,4,0.884565,197,5051138,-1,2000.0,5804803,5805321,801003,518,98,10,True,True,51.22732222222222,-0.884565
6377,5003985,4,16,0.238077,197,5051138,-1,8000.0,10802259,10802263,5798274,4,28,0,True,True,0.19333333333333333,-0.238077
6378,5004083,382,8,0.122277,197,5051138,-1,4000.0,8766919,8767301,3762836,382,45,12,True,True,32.94537777777778,-0.122277
6379,5004332,179,1,0.806687,197,5051138,-1,500.0,5614476,5614655,610144,179,106,2,True,True,1.3638805555555555,-0.806687
6380,5004346,342,1,0.329286,197,5051138,-1,500.0,7299719,7300061,2295373,342,62,8,True,True,7.940575,-0.329286
6381,5004375,7617,128,0.584326,197,5051138,-1,64000.0,7178319,7185936,2173944,7617,67,2,True,True,6095.785066666666,-0.5278222728235981
6382,5004770,7207,53,0.389951,197,5051138,-1,26500.0,10543059,10550266,5538289,7207,31,12,True,True,4250.617077777778,-0.3791339980449128
6383,5008217,92,1,0.748374,197,5051138,-1,500.0,5988721,5988813,980504,92,98,12,True,True,2.7671555555555556,-0.748374
6384,5008449,72,16,0.235938,197,5051138,-1,8000.0,11104659,11104731,6096210,72,27,12,True,True,4.8944,-0.235938
6385,5008526,6200,16,0.422869,197,5051138,-1,8000.0,11515059,11521259,6506533,6200,24,12,True,True,3317.004088888889,-0.41217099644438987
6386,5008573,5,8,0.144278,197,5051138,-1,4000.0,6490979,6490984,1482406,5,86,10,True,True,0.2122777777777778,-0.144278
6387,5009035,112,4,0.175154,197,5051138,-1,2000.0,6613079,6613191,1604044,112,85,9,True,True,4.3456,-0.175154
6388,5009187,92,16,0.969923,197,5051138,-1,8000.0,5279905,5279997,270718,92,126,1,True,True,26.211822222222224,-0.969923
6389,5011695,36736,16,0.439475,197,5051138,-1,8000.0,9074259,9110995,4062564,36736,44,12,True,True,12133.949755555555,-0.4315476689342879
6390,5012350,143,32,0.254306,197,5051138,-1,16000.0,10802259,10802402,5789909,143,31,12,True,True,13.823333333333332,-0.254306
6391,5012445,12,8,0.589481,197,5051138,-1,4000.0,5396876,5396888,384431,12,121,2,True,True,1.7749333333333335,-0.589481
6392,5013079,28,4,0.490359,197,5051138,-1,2000.0,6685080,6685108,1672001,28,83,0,True,True,3.6778,-0.490359
6393,5013666,39,64,0.374705,197,5051138,-1,32000.0,6063522,6063561,1049856,39,102,10,True,True,59.18293333333334,-0.374705
6394,5035595,4,1,0.948711,197,5051138,-1,500.0,5564376,5564380,528781,4,119,6,True,True,0.04195555555555555,-0.948711
6395,5035616,49,1,0.31649,197,5051138,-1,500.0,12962459,12962508,7926843,49,7,11,True,True,0.189875,-0.31649
6396,5035632,6541,32,0.423781,197,5051138,-1,16000.0,7416419,7422960,2380787,6541,65,11,True,True,4977.704933333333,-0.41637886510993244
6397,5035672,13689,1,0.682738,197,5051138,-1,500.0,7371019,7384708,2335347,13689,67,11,True,True,231.02476805555557,-0.6405671845523898
6398,5035701,48,4,0.963315,197,5051138,-1,2000.0,5610876,5610924,575175,48,122,6,True,True,1.4541333333333335,-0.963315
6399,5038555,27,25,0.879434,197,5051138,-1,12500.0,5267238,5267265,228683,27,140,11,True,True,10.9265625,-0.879434
6400,5039384,9,8,0.936972,197,5051138,-1,4000.0,6020322,6020331,980938,9,106,7,True,True,1.2915,-0.936972
6401,5039437,4609,128,0.362998,197,5051138,-1,64000.0,12744259,12748868,7704822,4609,11,7,True,True,10384.436622222223,-0.3559169279890122
6402,5039447,15719,8,0.715671,197,5051138,-1,4000.0,6258679,6274398,1219232,15719,97,10,True,True,4329.086877777778,-0.7138480773565008
6403,5039464,2,1,0.821365,197,5051138,-1,500.0,5816121,5816123,776657,2,118,9,True,True,0.02821111111111111,-0.821365
6404,5039486,489,1,0.021074,197,5051138,-1,500.0,9160659,9161148,4121173,489,47,12,True,True,8.238291666666667,-0.021074
6405,5039769,60,1,0.966805,197,5051138,-1,500.0,5302605,5302665,262836,60,141,10,True,True,1.0165,-0.966805
6406,5039891,10,4,0.605815,197,5051138,-1,2000.0,5338476,5338486,298585,10,138,2,True,True,0.8386111111111111,-0.605815
6407,5039964,11,2,0.841473,197,5051138,-1,1000.0,5194838,5194849,154874,11,151,10,True,True,0.1706527777777778,-0.841473
6408,5040154,8196,8,0.662223,197,5051138,-1,4000.0,7418619,7426815,2378465,8196,67,7,True,True,1717.9109,-0.6327176165214046
6409,5040184,9272,1,0.940848,197,5051138,-1,500.0,6157522,6166794,1117338,9272,107,12,True,True,246.667075,-0.897685290333489
6410,5040190,24297,78,0.690682,197,5051138,-1,39000.0,11169459,11193756,6129269,24297,29,10,True,True,10413.13325,-0.6805118340558286
6411,5040213,572,8,0.788803,197,5051138,-1,4000.0,7174719,7175291,2134506,572,80,6,True,True,28.66755555555556,-0.7630276601845507
6412,5040272,2900,64,0.239676,197,5051138,-1,32000.0,13092059,13094959,8051787,2900,7,11,True,True,1786.3408,-0.1915023218225408
6413,5040327,32,2,0.552728,197,5051138,-1,1000.0,5805321,5805353,764994,32,125,1,True,True,1.582311111111111,-0.552728
6414,5040396,7193,1,0.309269,197,5051138,-1,500.0,12698859,12706052,7658463,7193,14,12,True,True,73.60036805555555,-0.2862856030026505
6415,5040423,9,8,0.958484,197,5051138,-1,4000.0,6882121,6882130,1841698,9,90,10,True,True,1.5461000000000003,-0.958484
6416,5040900,48,4,0.362855,197,5051138,-1,2000.0,11018259,11018307,5977359,48,34,11,True,True,1.4064,-0.362855
6417,5040909,7,64,0.81225,197,5051138,-1,32000.0,5338365,5338372,297456,7,149,6,True,True,9.392444444444443,-0.81225
6418,5041154,752,8,0.122054,197,5051138,-1,4000.0,12343459,12344211,7302305,752,20,12,True,True,94.9608888888889,-0.122054
6419,5041162,10,1,0.866953,197,5051138,-1,500.0,5337265,5337275,296103,10,151,8,True,True,0.20965277777777777,-0.866953
6420,5041194,39,32,0.857647,197,5051138,-1,16000.0,5566576,5566615,525382,39,138,7,True,True,9.179733333333333,-0.857647
6421,5046220,1,16,0.388471,197,5051138,-1,8000.0,7326719,7326720,2280499,1,77,10,True,True,0.46540000000000004,-0.388471
6422,5046284,15625,4,0.909789,197,5051138,-1,2000.0,5387476,5403101,341192,15625,148,6,True,True,1192.3512555555556,-0.8840994467042141
6423,5046317,3,1,0.392976,197,5051138,-1,500.0,8583319,8583322,3537002,3,62,7,True,True,0.01976666666666667,-0.392976
6424,5046332,6729,4,0.977993,197,5051138,-1,2000.0,5281005,5287734,234673,6729,159,6,True,True,484.7007166666666,-0.9533077355120577
6425,5046363,260,1,0.255534,197,5051138,-1,500.0,8446119,8446379,3399756,260,65,12,True,True,1.4567222222222223,-0.255534
6426,5046749,11,9,0.09025,197,5051138,-1,4500.0,12345659,12345670,7298910,11,20,7,True,True,1.1286,-0.09025
6427,5046809,257,1,0.822708,197,5051138,-1,500.0,6431479,6431736,1384670,257,110,12,True,True,5.767865277777778,-0.822708
6428,5046913,11,32,0.23546,197,5051138,-1,16000.0,5275491,5275502,228578,11,165,6,True,True,6.383422222222222,-0.23546
6429,5047043,14,4,0.210386,197,5051138,-1,2000.0,9851859,9851873,4804816,14,47,12,True,True,0.5441333333333332,-0.210386
6430,5047140,22571,16,0.890247,197,5051138,-1,8000.0,5896521,5919092,849381,22571,130,6,True,True,5582.475288888888,-0.7751240874513516
6431,5047202,6,8,0.915891,197,5051138,-1,4000.0,5074938,5074944,27736,6,179,7,True,True,0.7045333333333335,-0.915891
6432,5047254,11,12,0.631353,197,5051138,-1,6000.0,6012613,6012624,965359,11,127,10,True,True,2.2572,-0.631353
6433,5048161,10364,23,0.879467,197,5051138,-1,11500.0,5609776,5620140,561615,10364,146,11,True,True,1750.9935777777778,-0.7610747774346938
6434,5048205,473,2,0.766741,197,5051138,-1,1000.0,6018122,6018595,969917,473,125,1,True,True,19.244530555555556,-0.766741
6435,5048623,20,54,0.406289,197,5051138,-1,27000.0,7086119,7086139,2037496,20,91,8,True,True,9.561,-0.406289
6436,5048678,9806,32,0.033882,197,5051138,-1,16000.0,13310959,13320765,8262281,9806,6,12,True,True,1449.9986222222221,-0.03001379211743955
6437,5049119,1583,2,0.866445,197,5051138,-1,1000.0,5895421,5897004,846302,1583,135,8,True,True,78.59158888888888,-0.8432791657845494
6438,5049130,11094,128,0.823198,197,5051138,-1,64000.0,7970919,7982013,2921789,11094,69,12,True,True,42172.562666666665,-0.8155664380397365
6439,5049135,11,80,0.940495,197,5051138,-1,40000.0,5540576,5540587,491441,11,156,12,True,True,10.343666666666667,-0.940495
6440,5049317,7704,256,0.471091,197,5051138,-1,128000.0,6946921,6954625,1897604,7704,99,10,True,True,66779.79946666666,-0.4684150825421792
6441,5049589,6,8,0.412961,197,5051138,-1,4000.0,11342259,11342265,6292670,6,33,12,True,True,1.1110666666666666,-0.412961
6442,5049619,15133,8,0.841163,197,5051138,-1,4000.0,7248919,7264052,2199300,15133,88,11,True,True,817.7179888888888,-0.773301784145866
6443,5049809,7295,16,0.717386,197,5051138,-1,8000.0,6616680,6623975,1566871,7295,111,6,True,True,2078.9648888888887,-0.7157184102904728
6444,5050464,16097,1,0.876761,197,5051138,-1,500.0,5382776,5398873,332312,16097,168,10,True,True,320.8267333333333,-0.8628275793880893
6445,5050620,3608,128,0.820241,197,5051138,-1,64000.0,6469379,6472987,1418759,3608,116,7,True,True,4671.200355555555,-0.8049751636294438
6446,5050703,99,4,0.824401,197,5051138,-1,2000.0,5072738,5072837,22035,99,194,10,True,True,5.8124,-0.824401
6447,5050777,49,2,0.698482,197,5051138,-1,1000.0,7080719,7080768,2029942,49,96,6,True,True,1.1162472222222222,-0.698482
6448,5050915,24920,64,0.506335,197,5051138,-1,32000.0,8537919,8562839,3487004,24920,69,8,True,True,15202.195555555558,-0.49432690339092766
6449,5051602,7919,2,0.351856,252,5072738,-1,1000.0,8273319,8281238,3221717,7919,71,12,True,True,219.77585555555555,-0.34546321968799354
6450,5051620,4940,16,0.602116,252,5072738,-1,8000.0,8896519,8901459,3844899,4940,61,12,True,True,1380.7907777777777,-0.588154201673055
6451,5051644,11891,128,0.813428,252,5072738,-1,64000.0,7079619,7091510,2027975,11891,100,2,True,True,13368.74328888889,-0.7607132451878381
6452,5051662,10,32,0.737786,252,5072738,-1,16000.0,8014119,8014129,2962457,10,73,11,True,True,9.525333333333334,-0.737786
6453,5051696,12002,128,0.453262,252,5072738,-1,64000.0,6860521,6872523,1808825,12002,110,7,True,True,56418.19875555555,-0.4370370845308324
6454,5051826,9,28,0.027351,252,5072738,-1,14000.0,6433679,6433688,1381853,9,126,7,True,True,4.6690000000000005,-0.027351
6455,5051887,12955,4,0.052099,252,5072738,-1,2000.0,12127459,12140414,7075572,12955,25,7,True,True,891.2386000000001,-0.050984967157742374
6456,5051994,549,1,0.641593,252,5072738,-1,500.0,6455279,6455828,1403285,549,127,10,True,True,3.3923625,-0.641593
6457,5052030,7192,8,0.630156,252,5072738,-1,4000.0,9290259,9297451,4238229,7192,56,11,True,True,1000.7924222222222,-0.5980546717928332
6458,5052093,9,1,0.791019,252,5072738,-1,500.0,5302665,5302674,250572,9,188,1,True,True,0.152475,-0.791019
6459,5053167,300,16,0.136092,252,5072738,-1,8000.0,11774259,11774559,6721092,300,30,12,True,True,59.193333333333335,-0.136092
6460,5053192,11523,32,0.400662,252,5072738,-1,16000.0,7173619,7185142,2120427,11523,101,6,True,True,2315.844488888889,-0.4004859926102355
6461,5053311,60,4,0.628296,252,5072738,-1,2000.0,5454176,5454236,400865,60,175,9,True,True,2.7873333333333337,-0.628296
6462,5053321,42,1,0.313722,252,5072738,-1,500.0,6345079,6345121,1291758,42,133,12,True,True,1.2128666666666668,-0.313722
6463,5053390,9387,32,0.082232,252,5072738,-1,16000.0,13656559,13665946,8603169,9387,3,12,True,True,1244.5343555555555,-0.0786477071373406
6464,5053409,409,1,0.157822,252,5072738,-1,500.0,8532519,8532928,3479110,409,75,12,True,True,5.432883333333333,-0.157822
6465,5053471,669,40,0.516366,252,5072738,-1,20000.0,5326465,5327134,272994,669,193,7,True,True,568.1296666666667,-0.516366
6466,5053478,1370,4,0.969665,252,5072738,-1,2000.0,5350376,5351746,296898,1370,187,9,True,True,111.79199999999999,-0.969665
6467,5053524,4,1,0.830621,252,5072738,-1,500.0,6492079,6492083,1438555,4,128,6,True,True,0.02122777777777778,-0.830621
6468,5053546,607,1,0.763163,252,5072738,-1,500.0,5901221,5901828,847675,607,157,6,True,True,11.819638888888887,-0.763163
6469,5053558,18448,160,0.84696,252,5072738,-1,80000.0,10024659,10043107,4971101,18448,51,12,True,True,23994.130666666668,-0.8365292445556127
6470,5053616,14,16,0.685753,252,5072738,-1,8000.0,5279891,5279905,226275,14,203,7,True,True,3.9887555555555556,-0.685753
6471,5053649,94,1,0.792642,252,5072738,-1,500.0,5097638,5097732,43989,94,216,10,True,True,1.3564722222222223,-0.792642
6472,5053681,194,8,0.319399,252,5072738,-1,4000.0,5882021,5882215,828340,194,164,6,True,True,35.605466666666665,-0.319399
6473,5053696,1791,8,0.478365,252,5072738,-1,4000.0,7424419,7426210,2370723,1791,88,7,True,True,362.3392,-0.478365
6474,5054011,14447,128,0.735172,252,5072738,-1,64000.0,6041922,6056369,987911,14447,151,10,True,True,19054.08622222222,-0.6418788279077957
6475,5054052,7887,29,0.26068,252,5072738,-1,14500.0,11952459,11960346,6898407,7887,29,8,True,True,2643.7545499999997,-0.25993293191745176
6476,5054099,10840,32,0.687467,252,5072738,-1,16000.0,7079619,7090459,2025520,10840,110,0,True,True,3079.669377777778,-0.639383184611039
6477,5054492,21,8,0.826769,252,5072738,-1,4000.0,5900121,5900142,845629,21,163,2,True,True,3.3959333333333332,-0.826769
6478,5055358,13301,128,0.799529,252,5072738,-1,64000.0,6602279,6615580,1546921,13301,131,10,True,True,21987.76408888889,-0.6360524626991317
6479,5055377,15508,140,0.198664,252,5072738,-1,70000.0,8100519,8116027,3045142,15508,80,12,True,True,60474.807944444445,-0.19600225073215408
6480,5055439,17,16,0.414496,252,5072738,-1,8000.0,6858321,6858338,1802882,17,122,12,True,True,7.858911111111111,-0.414496
6481,5055712,8,16,0.181889,252,5072738,-1,8000.0,13094959,13094967,8039247,8,9,1,True,True,1.0309333333333333,-0.181889
6482,5055757,3,8,0.87639,252,5072738,-1,4000.0,6494279,6494282,1438522,3,136,7,True,True,0.12736666666666668,-0.87639
6483,5055783,1034,4,0.944757,252,5072738,-1,2000.0,5272191,5273225,216408,1034,219,1,True,True,71.23685555555555,-0.944757
6484,5056411,109,2,0.884341,252,5072738,-1,1000.0,5443376,5443485,386965,109,193,11,True,True,3.510405555555556,-0.884341
6485,5056458,266,9,0.224487,252,5072738,-1,4500.0,10888659,10888925,5832201,266,45,12,True,True,6.749750000000001,-0.224487
6486,5056472,345,8,0.948109,252,5072738,-1,4000.0,7251119,7251464,2194647,345,103,7,True,True,15.417666666666667,-0.948109
6487,5056902,18,10,0.923112,252,5072738,-1,5000.0,5991013,5991031,934111,18,166,7,True,True,4.7275,-0.923112
6488,5057043,9038,32,0.647107,252,5072738,-1,16000.0,10456659,10465697,5399616,9038,51,12,True,True,2108.7630222222224,-0.6273944004145006
6489,5058075,16,1,0.626627,252,5072738,-1,500.0,5859321,5859337,801246,16,180,11,True,True,0.36513333333333337,-0.626627
6490,5058146,12,7,0.906845,252,5072738,-1,3500.0,5988813,5988825,930667,12,168,0,True,True,2.5265333333333335,-0.906845
6491,5058434,553,4,0.974128,252,5072738,-1,2000.0,5271638,5272191,213204,553,227,7,True,True,38.09862777777778,-0.974128
6492,5058632,386,1,0.198266,252,5072738,-1,500.0,10370259,10370645,5311627,386,52,12,True,True,2.614613888888889,-0.198266
6493,5058801,18,16,0.701261,252,5072738,-1,8000.0,6235979,6235997,1177178,18,152,2,True,True,5.994800000000001,-0.701261
6494,5058827,10593,1,0.168756,252,5072738,-1,500.0,13048859,13059452,7990032,10593,11,12,True,True,70.19547222222222,-0.16020420056291448
6495,5058866,27,16,0.401035,252,5072738,-1,8000.0,7172519,7172546,2113653,27,114,11,True,True,2.1521999999999997,-0.401035
6496,5058919,16733,1,0.428903,252,5072738,-1,500.0,7884519,7901252,2825600,16733,88,12,True,True,330.0350111111111,-0.4266507117420321
6497,5058961,39,1,0.260158,252,5072738,-1,500.0,5361176,5361215,302215,39,213,9,True,True,0.8515541666666667,-0.260158
6498,5059497,36,30,0.089061,252,5072738,-1,15000.0,13224559,13224595,8165062,36,8,12,True,True,4.926,-0.089061
6499,5059573,159,16,0.36792,252,5072738,-1,8000.0,8359719,8359878,3300146,159,85,12,True,True,28.277266666666666,-0.36792
6500,5059943,270,8,0.947244,252,5072738,-1,4000.0,5119238,5119508,59295,270,243,9,True,True,53.238,-0.947244
6501,5059974,12,1,0.117351,252,5072738,-1,500.0,8186919,8186931,3126945,12,87,12,True,True,0.28498333333333337,-0.117351
6502,5060092,437,64,0.718583,252,5072738,-1,32000.0,9549459,9549896,4489367,437,64,12,True,True,255.4799111111111,-0.718583
6503,5060119,11,3,0.435159,252,5072738,-1,1500.0,7533519,7533530,2473400,11,97,10,True,True,0.7181166666666667,-0.435159
6504,5060145,147,4,0.919989,252,5072738,-1,2000.0,5269438,5269585,209293,147,239,7,True,True,9.51825,-0.919989
