job_id,submit_time,request_time,request_processors,carbon_consideration,queue_length_at_submission,submission_timestamp,user_id,power,scheduled_time,completion_time,wait_time,actual_runtime,action1,action2,scheduled,completed,carbon_emissions,carbon_reward
7599,6084716,8396,8,0.537604,1,6084716,-1,168.0,6086516,6094912,1800,8396,0,7,True,True,51.769685333333335,-0.5208198009956992
7600,6085683,12,4,0.32608,4,6086516,-1,120.0,11329389,11329401,5243706,12,0,7,True,True,0.026052,-0.32608
7601,6085768,291,64,0.02324,4,6086516,-1,2944.0,8799948,8800239,2714180,291,1,7,True,True,28.18080213333333,-0.02324
7602,6085843,31,32,0.785358,4,6086516,-1,256.0,6758855,6758886,673012,31,2,2,True,True,0.299584,-0.785358
7603,6085865,8087,26,0.922144,4,6086516,-1,858.0,6130716,6138803,44851,8087,3,11,True,True,171.7372657,-0.8690839194111382
7604,6093970,4,2,0.153691,106,6130716,-1,22.0,14308025,14308029,8214055,4,0,12,True,True,0.0008357555555555554,-0.153691
7605,6094137,1277,1,0.952638,106,6130716,-1,17.0,6803055,6804332,708918,1277,3,11,True,True,0.7638500444444445,-0.9365866765249682
7606,6094181,836,16,0.330251,106,6130716,-1,432.0,14219889,14220725,8125708,836,1,12,True,True,8.190043200000002,-0.3134684689545948
7607,6094592,4818,1,0.629839,106,6130716,-1,8.0,7764643,7769461,1670051,4818,4,12,True,True,1.558692688888889,-0.6260908812338799
7608,6094727,8,8,0.603003,106,6130716,-1,120.0,7337443,7337451,1242716,8,5,7,True,True,0.035458666666666666,-0.603003
7609,6094907,18787,2,0.607837,106,6130716,-1,84.0,8318348,8337135,2223441,18787,4,1,True,True,54.73173440000001,-0.5999176204047705
7610,6094978,10,4,0.866945,106,6130716,-1,116.0,6750406,6750416,655428,10,9,9,True,True,0.04321,-0.866945
7611,6095254,11,44,0.980172,106,6130716,-1,528.0,7445943,7445954,1350689,11,6,10,True,True,0.23527240000000005,-0.980172
7612,6095273,34,1,0.204205,106,6130716,-1,8.0,7243643,7243677,1148370,34,8,10,True,True,0.010734933333333335,-0.204205
7613,6095276,750,8,0.390636,106,6130716,-1,120.0,13657289,13658039,7562013,750,2,12,True,True,4.17175,-0.390636
7614,6095281,697,1,0.534491,106,6130716,-1,33.0,10491389,10492086,4396108,697,4,7,True,True,0.7346902750000001,-0.5344910000000002
7615,6095288,87,1,0.188339,106,6130716,-1,36.0,11470789,11470876,5375501,87,3,0,True,True,0.12026009999999998,-0.188339
7616,6095300,5354,8,0.108638,106,6130716,-1,208.0,13136889,13142243,7041589,5354,3,0,True,True,32.82180662222222,-0.10458755073423172
7617,6095363,19008,8,0.569515,106,6130716,-1,312.0,6937255,6956263,841892,19008,13,8,True,True,193.81327506666668,-0.5530947869640531
7618,6095534,31,4,0.451535,106,6130716,-1,80.0,7055950,7055981,960416,31,13,2,True,True,0.0758948888888889,-0.451535
7619,6095582,113,2,0.894744,106,6130716,-1,62.0,6132516,6132629,36934,113,18,7,True,True,0.17960659444444446,-0.894744
7620,6095896,137,32,0.093242,106,6130716,-1,320.0,13830089,13830226,7734193,137,2,12,True,True,2.3545733333333336,-0.093242
7621,6095972,9,2,0.104313,106,6130716,-1,96.0,14891325,14891334,8795353,9,0,11,True,True,0.0118224,-0.104313
7622,6095994,6961,17,0.552907,106,6130716,-1,833.0,11377189,11384150,5281195,6961,7,7,True,True,166.23204307499998,-0.5472193177020166
7623,6096053,39045,8,0.032059,106,6130716,-1,80.0,15236925,15275970,9140872,39045,0,12,True,True,47.28249666666667,-0.02990152023659048
7624,6096103,12315,4,0.689025,106,6130716,-1,132.0,9351886,9364201,3255783,12315,11,10,True,True,30.39762586666667,-0.5104337968889545
7625,6096127,23680,2,0.488613,106,6130716,-1,66.0,6255403,6279083,159276,23680,23,7,True,True,45.164078666666676,-0.47005573214516116
7626,6096190,11,1,0.186692,106,6130716,-1,30.0,10798389,10798400,4702199,11,10,12,True,True,0.013709666666666667,-0.186692
7627,6096215,699,18,0.069491,106,6130716,-1,666.0,15064125,15064824,8967910,699,1,12,True,True,31.433890199999997,-0.069491
7628,6096769,50,1,0.962995,106,6130716,-1,9.0,7066750,7066800,969981,50,20,2,True,True,0.012468749999999997,-0.962995
7629,6096778,13995,36,0.283818,106,6130716,-1,972.0,11327589,11341584,5230811,13995,11,12,True,True,378.3712905,-0.24143580620432223
7630,6096933,51,1,0.233039,106,6130716,-1,17.0,13570889,13570940,7473956,51,7,12,True,True,0.04754531666666667,-0.233039
7631,6096961,72,4,0.65957,106,6130716,-1,68.0,7861143,7861215,1764182,72,18,10,True,True,0.222972,-0.65957
7632,6097020,8852,128,0.069979,106,6130716,-1,5504.0,13353889,13362741,7256869,8852,8,12,True,True,1597.5242122666666,-0.06873408167903954
7633,6097126,33,8,0.057453,106,6130716,-1,56.0,9355486,9355519,3258360,33,16,8,True,True,0.04198553333333333,-0.057453
7634,6097130,279,4,0.518532,106,6130716,-1,132.0,9205948,9206227,3108818,279,18,12,True,True,1.0057113000000002,-0.518532
7635,6097184,6985,8,0.171826,106,6130716,-1,240.0,13398089,13405074,7300905,6985,8,11,True,True,93.28558866666668,-0.16421518766416385
7636,6097211,410,4,0.859707,106,6130716,-1,160.0,6130716,6131126,33505,410,35,0,True,True,1.7053608888888891,-0.8158314151965416
7637,6097271,3,8,0.410861,106,6130716,-1,80.0,12301589,12301592,6204318,3,11,9,True,True,0.00476,-0.410861
7638,6097277,278,2,0.157035,106,6130716,-1,34.0,10971189,10971467,4873912,278,16,12,True,True,0.20418945555555554,-0.157035
7639,6097332,23,4,0.110744,106,6130716,-1,20.0,14133489,14133512,8036157,23,5,11,True,True,0.012132500000000001,-0.110744
7640,6097351,23,32,0.536453,106,6130716,-1,704.0,6136116,6136139,38765,23,37,2,True,True,0.39193635555555556,-0.536453
7641,6098046,203,8,0.478251,106,6130716,-1,200.0,10711989,10712192,4613943,203,19,11,True,True,0.7278677777777779,-0.478251
7642,6098145,19,1,0.068763,106,6130716,-1,26.0,10664189,10664208,4566044,19,20,12,True,True,0.006734866666666666,-0.068763
7643,6098202,1062,2,0.955097,106,6130716,-1,20.0,6757606,6758668,659404,1062,37,2,True,True,0.80181,-0.955097
7644,6098431,6,1,0.865699,106,6130716,-1,49.0,6506201,6506207,407770,6,39,7,True,True,0.008652583333333333,-0.865699
7645,6098546,4961,16,0.129932,106,6130716,-1,480.0,15415125,15420086,9316579,4961,0,12,True,True,45.56329466666667,-0.12455073312547844
7646,6098955,14,1,0.205677,106,6130716,-1,28.0,13484489,13484503,7385534,14,10,12,True,True,0.023309844444444443,-0.205677
7647,6100368,8,26,0.432201,106,6130716,-1,442.0,12305189,12305197,6204821,8,14,8,True,True,0.07072,-0.432201
7648,6100373,624,1,0.709672,106,6130716,-1,39.0,9441886,9442510,3341513,624,25,12,True,True,1.1836084,-0.709672
7649,6100434,3,2,0.47478,106,6130716,-1,32.0,6651206,6651209,550772,3,43,10,True,True,0.0037978666666666668,-0.47478
7650,6100512,20254,16,0.603709,106,6130716,-1,736.0,11380789,11401043,5280277,20254,17,8,True,True,419.92762746666665,-0.5975558062454364
7651,6100987,28,2,0.939154,106,6130716,-1,14.0,6473301,6473329,372314,28,46,6,True,True,0.008510755555555555,-0.939154
7652,6101020,9091,128,0.587492,106,6130716,-1,2816.0,12916289,12925380,6815269,9091,14,0,True,True,958.8129877333333,-0.5631935693277177
7653,6101026,128,16,0.502475,106,6130716,-1,800.0,11989189,11989317,5888163,128,17,12,True,True,5.645653333333334,-0.502475
7654,6101073,7,1,0.684836,106,6130716,-1,29.0,9968489,9968496,3867416,7,28,12,True,True,0.005642272222222223,-0.684836
7655,6106453,89,16,0.275441,106,6130716,-1,576.0,14310725,14310814,8204272,89,4,6,True,True,0.5788559999999999,-0.27544100000000005
7656,6106775,9486,8,0.007443,106,6130716,-1,328.0,14494325,14503811,8387550,9486,4,8,True,True,42.625158,-0.007364559960910288
7657,6106898,10,16,0.142692,106,6130716,-1,672.0,15523625,15523635,9416727,10,0,10,True,True,0.08134933333333334,-0.142692
7658,6107010,66,32,0.06397,106,6130716,-1,1568.0,15501525,15501591,9394515,66,1,12,True,True,0.8129557333333334,-0.06396999999999999
7659,6107212,15,1,0.399237,106,6130716,-1,21.0,7766443,7766458,1659231,15,40,7,True,True,0.012768875,-0.399237
7660,6107349,5513,1,0.807566,106,6130716,-1,41.0,7476143,7481656,1368794,5513,42,0,True,True,9.065533575,-0.7851432793893337
7661,6107760,42,4,0.525857,106,6130716,-1,100.0,9882089,9882131,3774329,42,33,12,True,True,0.15065166666666668,-0.525857
7662,6107783,6,4,0.910303,106,6130716,-1,36.0,7134243,7134249,1026460,6,47,11,True,True,0.007161,-0.910303
7663,6108059,58,1,0.879239,106,6130716,-1,48.0,9033148,9033206,2925089,58,38,8,True,True,0.053445066666666666,-0.879239
7664,6108112,537,1,0.460205,106,6130716,-1,38.0,11470789,11471326,5362677,537,23,12,True,True,0.7835337166666666,-0.460205
7665,6108162,11,4,0.576133,106,6130716,-1,200.0,9594586,9594597,3486424,11,35,12,True,True,0.11264611111111114,-0.5761329999999999
7666,6108299,73,1,0.737291,106,6130716,-1,32.0,8220243,8220316,2111944,73,43,0,True,True,0.06392853333333333,-0.737291
7667,6109439,8251,8,0.287912,106,6130716,-1,344.0,7476143,7484394,1366704,8251,48,3,True,True,114.73896495555555,-0.28392346418576003
7668,6110021,745,2,0.880994,106,6130716,-1,70.0,6137916,6138661,27895,745,64,7,True,True,1.204225166666667,-0.840448840183428
7669,6110292,24,16,0.456307,106,6130716,-1,144.0,12035189,12035213,5924897,24,21,7,True,True,0.1627488,-0.456307
7670,6110560,683,2,0.700317,106,6130716,-1,82.0,6225203,6225886,114643,683,65,12,True,True,1.5334753944444444,-0.700317
7671,6110618,475,1,0.711648,106,6130716,-1,50.0,7090043,7090518,979425,475,54,10,True,True,1.0165659722222224,-0.711648
7672,6111648,10744,4,0.297449,106,6130716,-1,104.0,14221625,14232369,8109977,10744,9,6,True,True,23.213837400000003,-0.2849631794872948
7673,6111677,29494,4,0.613028,106,6130716,-1,180.0,7839043,7868537,1727366,29494,47,6,True,True,243.08111799999998,-0.6086799224342558
7674,6112290,396,7,0.809985,106,6130716,-1,63.0,6618306,6618702,506016,396,65,7,True,True,0.7659729000000001,-0.809985
7675,6112402,206,1,0.175126,106,6130716,-1,42.0,7868343,7868549,1755941,206,46,9,True,True,0.43795943333333337,-0.175126
7676,6112602,13650,14,0.249135,106,6130716,-1,126.0,12392489,12406139,6279887,13650,20,6,True,True,18.01299535,-0.22522965209013462
7677,6112924,20785,193,0.899965,106,6130716,-1,7334.0,8625348,8646133,2512424,20785,45,12,True,True,4786.768423061111,-0.8631657647389639
7678,6116203,5,8,0.733244,106,6130716,-1,160.0,8046543,8046548,1930340,5,48,12,True,True,0.032733333333333337,-0.733244
7679,6116352,1695,8,0.457828,106,6130716,-1,400.0,7040755,7042450,924403,1695,63,8,True,True,19.357933333333335,-0.45709639452780154
7680,6116390,8,4,0.910833,106,6130716,-1,96.0,7584643,7584651,1468253,8,54,10,True,True,0.015940266666666668,-0.910833
7681,6116853,16547,64,0.183444,106,6130716,-1,2048.0,13050489,13067036,6933636,16547,19,12,True,True,1055.7604238222223,-0.17439029174596152
7682,6117029,5,2,0.568615,106,6130716,-1,90.0,8318343,8318348,2201314,5,48,12,True,True,0.01144125,-0.568615
7683,6118255,11693,41,0.393551,106,6130716,-1,1230.0,12391589,12403282,6273334,11693,22,12,True,True,159.4742696666667,-0.38310117211858585
7684,6118441,9726,24,0.945687,106,6130716,-1,312.0,6138803,6148529,20362,9726,79,2,True,True,75.63163399999999,-0.9445079029575006
7685,6118880,394,1,0.239695,106,6130716,-1,19.0,11729989,11730383,5611109,394,27,12,True,True,0.2111883777777778,-0.239695
7686,6118914,18,1,0.87054,106,6130716,-1,21.0,6695406,6695424,576492,18,74,11,True,True,0.0119784,-0.87054
7687,6118928,95,1,0.273776,106,6130716,-1,12.0,8219343,8219438,2100415,95,52,12,True,True,0.031197999999999997,-0.273776
7688,6119064,23817,2,0.628083,106,6130716,-1,10.0,8222043,8245860,2102979,23817,51,7,True,True,9.102902333333333,-0.5987180935600331
7689,6119108,9,4,0.29189,106,6130716,-1,152.0,7870143,7870152,1751035,9,55,7,True,True,0.0694526,-0.29189
7690,6123749,14,4,0.916296,106,6130716,-1,92.0,7035355,7035369,911606,14,72,6,True,True,0.03697633333333333,-0.916296
7691,6123915,18,4,0.698044,106,6130716,-1,196.0,7960143,7960161,1836228,18,55,7,True,True,0.1751358,-0.698044
7692,6124059,81,1,0.722409,106,6130716,-1,45.0,7045150,7045231,921091,81,72,7,True,True,0.10618212499999999,-0.7016756848472998
7693,6124598,92,2,0.217255,106,6130716,-1,36.0,14667125,14667217,8542527,92,6,12,True,True,0.1292232,-0.217255
7694,6124770,8,1,0.493488,106,6130716,-1,36.0,8889948,8889956,2765178,8,48,8,True,True,0.0052824,-0.493488
7695,6125092,2,5,0.99239,106,6130716,-1,115.0,6227003,6227005,101911,2,88,7,True,True,0.006297527777777778,-0.99239
7696,6125214,4,4,0.552824,106,6130716,-1,140.0,11816389,11816393,5691175,4,28,12,True,True,0.021808888888888888,-0.552824
7697,6125511,10193,16,0.995316,106,6130716,-1,672.0,7057750,7067943,932239,10193,74,7,True,True,183.38366853333338,-0.9693278077999211
7698,6125774,15531,128,0.076534,106,6130716,-1,3328.0,14400725,14416256,8274951,15531,8,12,True,True,756.9986481777777,-0.07575559975949214
7699,6126004,10,16,0.105225,106,6130716,-1,240.0,14580725,14580735,8454721,10,7,12,True,True,0.09344,-0.105225
7700,6126999,20414,256,0.766539,106,6130716,-1,9728.0,9709289,9729703,3582290,20414,45,8,True,True,9814.3792896,-0.7599056810791147
7701,6127255,15208,4,0.326013,106,6130716,-1,192.0,11902789,11917997,5775534,15208,30,0,True,True,124.50176746666668,-0.3100294113410136
7702,6127551,151,16,0.450936,106,6130716,-1,96.0,12033389,12033540,5905838,151,29,11,True,True,0.7550000000000001,-0.450936
7703,6128779,3,1,0.252767,106,6130716,-1,26.0,7245443,7245446,1116664,3,75,7,True,True,0.0030784000000000002,-0.252767
7704,6128835,200,32,0.506065,106,6130716,-1,1184.0,8985348,8985548,2856513,200,54,7,True,True,5.360888888888888,-0.506065
7705,6128855,154,2,0.462167,106,6130716,-1,66.0,7247243,7247397,1118388,154,76,7,True,True,0.4310665333333334,-0.462167
7706,6129010,26,32,0.073195,106,6130716,-1,288.0,11064789,11064815,4935779,26,40,12,True,True,0.14262559999999996,-0.073195
7707,6130829,3,5,0.694486,105,6132516,-1,35.0,7472543,7472546,1341714,3,75,6,True,True,0.0045885000000000006,-0.694486
7708,6132809,32539,37,0.749736,112,6136116,-1,1591.0,7468043,7500582,1335234,32539,76,10,True,True,2062.137014011111,-0.7313540351952391
7709,6133298,352,1,0.381156,112,6136116,-1,34.0,13267489,13267841,7134191,352,21,12,True,True,0.36927928888888895,-0.381156
7710,6133568,34,106,0.745957,112,6136116,-1,4028.0,9209548,9209582,3075980,34,54,8,True,True,4.208611044444444,-0.745957
7711,6133731,53,4,0.855773,112,6136116,-1,32.0,7042450,7042503,908719,53,90,1,True,True,0.04850088888888889,-0.855773
7712,6133928,6435,4,0.396674,112,6136116,-1,140.0,12565289,12571724,6431361,6435,25,12,True,True,8.680622611111113,-0.35570655551132535
7713,6134348,3,8,0.010737,112,6136116,-1,336.0,12478889,12478892,6344541,3,26,12,True,True,0.0168336,-0.010737
7714,6134461,109,4,0.114683,112,6136116,-1,140.0,14002889,14002998,7868428,109,15,12,True,True,0.8564251111111112,-0.11468299999999998
7715,6134542,144,8,0.917137,112,6136116,-1,152.0,6428201,6428345,293659,144,106,7,True,True,0.6322592,-0.9171369999999998
7716,6157938,30,8,0.32711,224,6225203,-1,264.0,11151189,11151219,4993251,30,44,12,True,True,0.173492,-0.32711
7717,6158059,72,1,0.748676,224,6225203,-1,50.0,6374101,6374173,216042,72,108,11,True,True,0.09384,-0.748676
7718,6158070,1194,32,0.484759,224,6225203,-1,448.0,9969389,9970583,3811319,1194,51,6,True,True,14.867581866666667,-0.4847590000000001
7719,6158142,61,8,0.068237,224,6225203,-1,224.0,12919889,12919950,6761747,61,25,8,True,True,0.4832121777777778,-0.068237
7720,6166540,36,1,0.548429,224,6225203,-1,25.0,9326186,9326222,3159646,36,60,10,True,True,0.0310975,-0.548429
7721,6166801,8740,64,0.242294,224,6225203,-1,384.0,15328725,15337465,9161924,8740,3,12,True,True,28.922592,-0.22718842350346397
7722,6167111,15477,8,0.950018,224,6225203,-1,64.0,6253603,6269080,86492,15477,114,6,True,True,26.50188337777778,-0.9184611028712772
7723,6167127,12518,64,0.140256,224,6225203,-1,832.0,14220725,14233243,8053598,12518,14,1,True,True,217.22509351111114,-0.13771120860697353
7724,6167151,6896,1,0.820427,224,6225203,-1,22.0,7220643,7227539,1053492,6896,93,12,True,True,5.248226866666666,-0.6675352325250188
7725,6167179,4606,42,0.841563,224,6225203,-1,630.0,7814243,7818849,1647064,4606,81,8,True,True,163.81486625,-0.8121581425822012
7726,6167293,35,32,0.170589,224,6225203,-1,1152.0,6889455,6889490,722162,35,105,12,True,True,1.65928,-0.170589
7727,6167321,2351,32,0.018066,224,6225203,-1,576.0,8711748,8714099,2544427,2351,69,12,True,True,25.900807999999998,-0.017503157114644913
7728,6167402,3,64,0.100515,224,6225203,-1,448.0,14089289,14089292,7921887,3,17,12,True,True,0.037744,-0.100515
7729,6168363,50,16,0.294145,224,6225203,-1,512.0,6933655,6933705,765292,50,107,11,True,True,0.9349688888888887,-0.294145
7730,6170285,6,15,0.534654,224,6225203,-1,615.0,8408348,8408354,2238063,6,72,12,True,True,0.21293350000000003,-0.534654
7731,6170812,28303,8,0.39085,224,6225203,-1,200.0,9680986,9709289,3510174,28303,59,12,True,True,268.9322783333333,-0.3852347164321204
7732,6170820,852,1,0.077585,224,6225203,-1,46.0,6307703,6308555,136883,852,122,11,True,True,0.7344145333333332,-0.077585
7733,6171254,11,32,0.763589,224,6225203,-1,1216.0,7032655,7032666,861401,11,108,8,True,True,0.3723358222222222,-0.763589
7734,6171266,6290,1,0.677383,224,6225203,-1,30.0,7810643,7816933,1639377,6290,86,11,True,True,10.615646583333334,-0.6613691585434586
7735,6171277,10237,3,0.153496,224,6225203,-1,63.0,13181089,13191326,7009812,10237,26,11,True,True,25.1853378,-0.12424888356528033
7736,6171329,8,10,0.358087,224,6225203,-1,360.0,9119548,9119556,2948219,8,68,12,True,True,0.084224,-0.358087
7737,6171796,29,4,0.216672,224,6225203,-1,128.0,14314325,14314354,8142529,29,11,8,True,True,0.034583466666666667,-0.216672
7738,6171947,8514,128,0.034445,224,6225203,-1,1408.0,15242325,15250839,9070378,8514,4,8,True,True,205.25611626666665,-0.031080727326770155
7739,6180587,10886,2,0.675044,224,6225203,-1,16.0,7335643,7346529,1155056,10886,100,11,True,True,5.785128977777778,-0.6677996086783133
7740,6180626,47,1,0.216166,224,6225203,-1,50.0,11902789,11902836,5722163,47,43,12,True,True,0.14136555555555558,-0.216166
7741,6180674,58,1,0.696742,224,6225203,-1,44.0,6403401,6403459,222727,58,129,10,True,True,0.07017999999999999,-0.696742
7742,6180804,34,2,0.836501,224,6225203,-1,48.0,7034455,7034489,853651,34,115,7,True,True,0.046852,-0.836501
7743,6180922,3,1,0.811512,224,6225203,-1,11.0,9508186,9508189,3327264,3,65,11,True,True,0.0014169833333333335,-0.811512
7744,6181531,14512,1,0.641012,224,6225203,-1,50.0,12207989,12222501,6026458,14512,39,12,True,True,14.913199166666667,-0.6181405590145743
7745,6181893,34,4,0.71641,224,6225203,-1,136.0,8897148,8897182,2715255,34,76,9,True,True,0.18075986666666669,-0.71641
7746,6181980,11445,16,0.89701,224,6225203,-1,160.0,6528301,6539746,346321,11445,130,10,True,True,49.185135555555554,-0.8746440384777622
7747,6182070,10698,256,0.390618,224,6225203,-1,11520.0,11557189,11567887,5375119,10698,47,12,True,True,5816.638112,-0.3786619547787697
7748,6182223,59,2,0.308324,224,6225203,-1,40.0,14309825,14309884,8127602,59,14,7,True,True,0.022413444444444444,-0.308324
7749,6182229,14021,8,0.052415,224,6225203,-1,368.0,10057589,10071610,3875360,14021,62,7,True,True,176.9655736888889,-0.05116385496174211
7750,6182245,6,7,0.004666,224,6225203,-1,126.0,15610025,15610031,9427780,6,0,12,True,True,0.012261900000000001,-0.004666
7751,6182363,11,15,0.77241,224,6225203,-1,165.0,6252703,6252714,70340,11,143,10,True,True,0.03986445833333334,-0.77241
7752,6182386,12,2,0.767114,224,6225203,-1,18.0,9303148,9303160,3120762,12,75,12,True,True,0.0058626,-0.767114
7753,6182528,13,32,0.928821,224,6225203,-1,640.0,6329901,6329914,147373,13,141,1,True,True,0.2031928888888889,-0.928821
7754,6182662,527,8,0.374645,224,6225203,-1,208.0,10055789,10056316,3873127,527,64,12,True,True,3.0436709333333334,-0.374645
7755,6182694,1989,2,0.23854,224,6225203,-1,62.0,6426401,6428390,243707,1989,140,10,True,True,3.56217745,-0.23854
7756,6182782,38,2,0.091386,224,6225203,-1,56.0,9216748,9216786,3033966,38,77,9,True,True,0.06654137777777779,-0.091386
7757,6182850,21,4,0.421683,224,6225203,-1,132.0,12651689,12651710,6468839,21,35,12,True,True,0.0379764,-0.421683
7758,6182870,18,2,0.989291,224,6225203,-1,28.0,6230603,6230621,47733,18,150,8,True,True,0.013727000000000001,-0.989291
7759,6182876,16473,21,0.337117,224,6225203,-1,336.0,14490725,14507198,8307849,16473,12,8,True,True,77.67712493333333,-0.3331724733603359
7760,6183019,13368,6,0.192152,224,6225203,-1,120.0,14487125,14500493,8304106,13368,13,12,True,True,22.778847333333335,-0.1896350322754095
7761,6183053,24,4,0.668949,224,6225203,-1,184.0,7838143,7838167,1655090,24,103,10,True,True,0.192648,-0.668949
7762,6184878,28,1,0.220568,224,6225203,-1,41.0,11241189,11241217,5056311,28,59,12,True,True,0.048745355555555564,-0.220568
7763,6186030,10651,4,0.882286,224,6225203,-1,136.0,9795689,9806340,3609659,10651,72,12,True,True,59.87675286666667,-0.8812498326187448
7764,6186037,134,4,0.796924,224,6225203,-1,168.0,7043350,7043484,857313,134,128,6,True,True,0.6437806666666667,-0.796924
7765,6186291,7,1,0.830451,224,6225203,-1,43.0,7871943,7871950,1685652,7,101,7,True,True,0.015281602777777776,-0.830451
7766,6186296,4,1,0.167883,224,6225203,-1,7.0,12738089,12738093,6551793,4,37,12,True,True,0.000525,-0.167883
7767,6186359,9079,16,0.167047,224,6225203,-1,208.0,14753525,14762604,8567166,9079,9,12,True,True,104.33775039999999,-0.16700073795220388
7768,6186610,2,64,0.41568,224,6225203,-1,2560.0,8132943,8132945,1946333,2,101,12,True,True,0.23819377777777778,-0.41568
7769,6186646,12762,5,0.107684,224,6225203,-1,60.0,12828089,12840851,6641443,12762,38,8,True,True,23.769020833333336,-0.1061946352105451
7770,6186691,94,4,0.327141,224,6225203,-1,188.0,7423843,7423937,1237152,94,121,12,True,True,0.6713396444444444,-0.327141
7771,6186720,10727,1,0.562054,224,6225203,-1,48.0,7048750,7059477,862030,10727,133,8,True,True,15.24317,-0.5524145918667509
7772,6186760,4,16,0.189548,224,6225203,-1,592.0,8798148,8798152,2611388,4,94,12,True,True,0.08575448888888888,-0.189548
7773,6187354,35732,16,0.207119,224,6225203,-1,368.0,14314325,14350057,8126971,35732,16,0,True,True,180.30023635555554,-0.20567203657000954
7774,6187374,16088,32,0.541703,224,6225203,-1,448.0,10230389,10246477,4043015,16088,71,12,True,True,194.08595733333334,-0.5192900131766275
7775,6187428,7,4,0.938923,224,6225203,-1,68.0,6743206,6743213,555778,7,151,8,True,True,0.01646166666666667,-0.938923
7776,6187452,40,4,0.120804,224,6225203,-1,80.0,8231943,8231983,2044491,40,102,8,True,True,0.11348444444444446,-0.120804
7777,6187476,230,32,0.21378,224,6225203,-1,1280.0,14760725,14760955,8573249,230,9,9,True,True,16.16501333333333,-0.21378
7778,6187562,4,1,0.356576,224,6225203,-1,44.0,12914489,12914493,6726927,4,40,12,True,True,0.006435733333333332,-0.356576
7779,6187628,5482,64,0.173622,224,6225203,-1,2112.0,15150525,15156007,8962897,5482,7,12,True,True,613.2992154666667,-0.1649673256349532
7780,6187688,7780,16,0.402139,224,6225203,-1,320.0,6616506,6624286,428818,7780,159,12,True,True,103.18075911111112,-0.34457395250840445
7781,6196956,48,8,0.31624,224,6225203,-1,40.0,13743689,13743737,7546733,48,30,12,True,True,0.053173333333333336,-0.31624
7782,6197065,8715,64,0.389187,224,6225203,-1,2624.0,11154789,11163504,4957724,8715,68,8,True,True,504.9094677333334,-0.3749645117868732
7783,6197309,20587,32,0.458776,224,6225203,-1,256.0,7063150,7083737,865841,20587,140,7,True,True,161.1862350222222,-0.44729177686350585
7784,6197333,132,8,0.066016,224,6225203,-1,304.0,14847125,14847257,8649792,132,10,12,True,True,0.7813813333333333,-0.066016
7785,6197371,40,8,0.815085,224,6225203,-1,248.0,10667789,10667829,4470418,40,75,8,True,True,0.11578844444444446,-0.815085
7786,6197433,8,4,0.649945,224,6225203,-1,72.0,7221543,7221551,1024110,8,138,6,True,True,0.027055999999999997,-0.649945
7787,6198518,5,2,0.36898,224,6225203,-1,20.0,9329786,9329791,3131268,5,92,8,True,True,0.0036372222222222222,-0.36898
7788,6198545,6037,1,0.067331,224,6225203,-1,45.0,12294389,12300426,6095844,6037,53,12,True,True,8.217925875,-0.06635727213143013
7789,6198567,13942,3,0.218561,224,6225203,-1,111.0,7061350,7075292,862783,13942,146,2,True,True,40.81391991666667,-0.21184086924270706
7790,6199325,12,4,0.301534,224,6225203,-1,132.0,12916289,12916301,6716964,12,43,7,True,True,0.057921600000000004,-0.301534
7791,6199601,9528,16,0.598869,224,6225203,-1,752.0,7052350,7061878,852749,9528,150,1,True,True,204.03262746666667,-0.5732779579987534
7792,6199623,16060,128,0.983102,224,6225203,-1,3328.0,8224743,8240803,2025120,16060,113,7,True,True,1984.5565560888888,-0.8648527121885435
7793,6200106,14,3,0.101814,224,6225203,-1,78.0,13916489,13916503,7716383,14,30,12,True,True,0.06079406666666665,-0.101814
7794,6200395,17,19,0.536182,224,6225203,-1,855.0,7067943,7067960,867548,17,147,2,True,True,0.379807625,-0.536182
7795,6201790,98,3,0.990531,224,6225203,-1,138.0,6329803,6329901,128013,98,182,10,True,True,0.33028613333333334,-0.990531
7796,6201992,13,32,0.850465,224,6225203,-1,1088.0,7671043,7671056,1469051,13,131,12,True,True,0.6517633777777777,-0.850465
7797,6202188,15248,8,0.171459,224,6225203,-1,224.0,9304086,9319334,3101898,15248,97,1,True,True,125.57206168888888,-0.16700333820656948
7798,6202259,119,4,0.959035,224,6225203,-1,68.0,6754006,6754125,551747,119,170,2,True,True,0.3005054111111111,-0.959035
7799,6202348,13269,32,0.599867,224,6225203,-1,1120.0,6629106,6642375,426758,13269,175,9,True,True,692.7222586666668,-0.5930438853480141
7800,6202504,4977,8,0.981416,224,6225203,-1,344.0,6404301,6409278,201797,4977,183,6,True,True,56.1310132,-0.9695278547105273
7801,6202738,9543,16,0.696315,224,6225203,-1,224.0,10884789,10894332,4682051,9543,76,12,True,True,38.743883733333334,-0.6237830465334212
7802,6202784,3,4,0.677901,224,6225203,-1,112.0,9463986,9463989,3261202,3,93,10,True,True,0.0183904,-0.677901
7803,6202795,12009,1,0.972367,224,6225203,-1,35.0,6259903,6271912,57108,12009,191,6,True,True,11.880437722222224,-0.9506634037381333
7804,6202868,670,1,0.693721,224,6225203,-1,24.0,6259003,6259673,56135,670,192,1,True,True,0.44756,-0.693721
7805,6203049,269,8,0.332047,224,6225203,-1,216.0,6530106,6530375,327057,269,180,1,True,True,1.4908518,-0.332047
7806,6203171,1197,3,0.635353,224,6225203,-1,126.0,7032655,7033852,829484,1197,165,0,True,True,4.19829795,-0.635353
7807,6204006,19249,128,0.883967,224,6225203,-1,4864.0,6739606,6758855,535600,19249,176,11,True,True,3310.818980977778,-0.8712223018443119
7808,6204286,8237,4,0.317967,224,6225203,-1,68.0,7291443,7299680,1087157,8237,144,11,True,True,16.66120567777778,-0.3083473938239686
7809,6204343,16776,1,0.851554,224,6225203,-1,30.0,7766443,7783219,1562100,16776,132,0,True,True,20.244869583333333,-0.8329786652572297
7810,6206461,119,16,0.48213,224,6225203,-1,784.0,11331189,11331308,5124728,119,69,7,True,True,1.6878801333333333,-0.48213
7811,6207230,21,4,0.335105,224,6225203,-1,64.0,10577789,10577810,4370559,21,82,12,True,True,0.03313706666666667,-0.335105
7812,6207482,681,8,0.608533,224,6225203,-1,96.0,8538948,8539629,2331466,681,115,11,True,True,2.9031488000000003,-0.5485685206316148
7813,6207629,10100,64,0.585037,224,6225203,-1,1792.0,10978389,10988489,4770760,10100,76,8,True,True,543.5366023111111,-0.5750613341277003
7814,6207858,109,32,0.382371,224,6225203,-1,1376.0,11384389,11384498,5176531,109,67,2,True,True,3.9383298666666664,-0.382371
7815,6207901,27,32,0.640592,224,6225203,-1,1312.0,6472401,6472428,264500,27,193,11,True,True,0.8005824,-0.640592
7816,6208349,196,1,0.232425,224,6225203,-1,13.0,8983548,8983744,2775199,196,111,12,True,True,0.05768388888888888,-0.232425
7817,6210331,11382,10,0.587469,224,6225203,-1,470.0,12824489,12835871,6614158,11382,47,12,True,True,158.61904405555555,-0.5800012158843523
7818,6210539,12,2,0.988381,224,6225203,-1,94.0,7816043,7816055,1605504,12,137,7,True,True,0.06228440000000001,-0.988381
7819,6210662,20824,32,0.232606,224,6225203,-1,1376.0,9680986,9701810,3470324,20824,95,0,True,True,1394.294233422222,-0.23103648002449545
7820,6210840,189,3,0.616349,224,6225203,-1,114.0,6504401,6504590,293561,189,196,10,True,True,0.81581535,-0.616349
7821,6210850,9410,4,0.896779,224,6225203,-1,88.0,7562543,7571953,1351693,9410,146,12,True,True,18.02966342222222,-0.8619912011186378
7822,6211134,23,4,0.308849,224,6225203,-1,84.0,14977725,14977748,8766591,23,9,12,True,True,0.02736463333333334,-0.30884899999999993
7823,6211443,21,5,0.737913,224,6225203,-1,95.0,8222943,8222964,2011500,21,127,6,True,True,0.04803516666666667,-0.737913
7824,6212544,5,2,0.757246,224,6225203,-1,96.0,6530101,6530106,317557,5,197,7,True,True,0.012316,-0.7572460000000002
7825,6214784,7,16,0.619766,224,6225203,-1,560.0,7958343,7958350,1743559,7,134,12,True,True,0.20005066666666668,-0.619766
7826,6214847,161,4,0.059923,224,6225203,-1,84.0,13136889,13137050,6922042,161,42,12,True,True,0.46939549999999997,-0.059923
7827,6219088,11,1,0.374524,224,6225203,-1,41.0,8321948,8321959,2102860,11,124,8,True,True,0.013347094444444445,-0.374524
7828,6223783,10,4,0.296615,224,6225203,-1,136.0,7678243,7678253,1454460,10,149,9,True,True,0.07100711111111112,-0.296615
7829,6224187,10232,4,0.151671,224,6225203,-1,152.0,12964089,12974321,6739902,10232,44,11,True,True,91.25902793333333,-0.1507335271278221
7830,6225090,18531,100,0.204385,224,6225203,-1,3900.0,11643589,11662120,5418499,18531,68,12,True,True,2766.9984225000003,-0.20289737987076614
7831,6225413,11946,113,0.037907,226,6227003,-1,2599.0,15238725,15250671,9013312,11946,6,7,True,True,555.8192377833334,-0.031179962553077194
7832,6226281,9339,64,0.923409,226,6227003,-1,2432.0,6263503,6272842,37222,9339,218,3,True,True,652.7727552,-0.9100839142080959
7833,6226847,91,1,0.598075,226,6227003,-1,42.0,6939055,6939146,712208,91,188,7,True,True,0.10458478333333335,-0.5980749999999999
7834,6232781,8,8,0.945876,245,6252703,-1,192.0,6621906,6621914,389125,8,202,2,True,True,0.0804096,-0.945876
7835,6234484,38,64,0.739256,245,6252703,-1,2368.0,9304048,9304086,3069564,38,111,6,True,True,2.442315733333333,-0.739256
7836,6234645,5418,32,0.32869,245,6252703,-1,416.0,10316789,10322207,4082144,5418,92,12,True,True,40.04347475555556,-0.30894386987421996
7837,6234774,319,4,0.278126,245,6252703,-1,108.0,10403189,10403508,4168415,319,92,12,True,True,1.5133998,-0.278126
7838,6235408,28813,1,0.643602,245,6252703,-1,19.0,8494748,8523561,2259340,28813,129,12,True,True,26.127148688888887,-0.6279935537249798
7839,6237416,7,8,0.760494,245,6252703,-1,168.0,7037155,7037162,799739,7,188,7,True,True,0.033761,-0.760494
7840,6237461,1018,1,0.520873,245,6252703,-1,17.0,6942655,6943673,705194,1018,193,2,True,True,0.4604357444444445,-0.520873
7841,6237706,12201,1,0.977568,245,6252703,-1,29.0,7471643,7483844,1233937,12201,163,1,True,True,14.547541955555555,-0.9627146846818941
7842,6237799,10444,14,0.648046,245,6252703,-1,378.0,8220243,8230687,1982444,10444,139,6,True,True,105.66579765,-0.5805334551262399
7843,6237848,14170,2,0.288455,245,6252703,-1,92.0,10974789,10988959,4736941,14170,84,8,True,True,38.06315054444445,-0.2852038304749855
7844,6239963,212,2,0.023693,245,6252703,-1,66.0,10489589,10489801,4249626,212,93,12,True,True,0.5239226666666668,-0.023693
7845,6240057,14,1,0.846935,245,6252703,-1,45.0,6482301,6482315,242244,14,220,7,True,True,0.013517,-0.846935
7846,6240278,19618,2,0.33127,245,6252703,-1,44.0,12121589,12141207,5881311,19618,62,12,True,True,30.808782888888885,-0.3236641100402651
7847,6241516,23,1,0.242249,245,6252703,-1,5.0,7029055,7029078,787539,23,198,12,True,True,0.004013819444444445,-0.242249
7848,6242557,54,4,0.539312,245,6252703,-1,72.0,6480501,6480555,237944,54,223,9,True,True,0.08341919999999999,-0.539312
7849,6242604,9233,64,0.906632,245,6252703,-1,832.0,6381301,6390534,138697,9233,230,9,True,True,179.2664524444444,-0.832014483112849
7850,6242942,14832,119,0.665006,245,6252703,-1,4879.0,8886348,8901180,2643406,14832,127,12,True,True,2298.8789257,-0.6032618883846781
7851,6244121,9,64,0.248338,245,6252703,-1,2944.0,9029548,9029557,2785427,9,123,11,True,True,0.5812192,-0.248338
7852,6244172,10,8,0.68735,245,6252703,-1,104.0,10143989,10143999,3899817,10,98,12,True,True,0.034279555555555556,-0.68735
7853,6244213,24,1,0.719502,245,6252703,-1,12.0,11375389,11375413,5131176,24,77,11,True,True,0.007546400000000001,-0.719502
7854,6244275,3,8,0.608063,245,6252703,-1,48.0,8228343,8228346,1984068,3,142,1,True,True,0.0038112000000000003,-0.6080629999999999
4420,3599033,10,8,0.121962,1,3599033,-1,256.0,3685433,3685443,86400,10,0,12,True,True,0.08590933333333334,-0.121962
4421,3601659,10,1,0.768146,188,3685433,-1,19.0,5625405,5625415,2023746,10,0,10,True,True,0.0026304444444444444,-0.768146
4422,3601907,6031,4,0.248962,188,3685433,-1,172.0,5691425,5697456,2089518,6031,0,11,True,True,25.068372677777774,-0.2485452180350996
4423,3601977,9968,128,0.771225,188,3685433,-1,768.0,4828396,4838364,1226419,9968,2,11,True,True,141.6148224,-0.7710123564327825
4424,3602335,9031,2,0.442961,188,3685433,-1,24.0,6643777,6652808,3041442,9031,0,7,True,True,5.638833000000001,-0.4309851285335827
4425,3602647,10350,1,0.737619,188,3685433,-1,18.0,3929080,3939430,326433,10350,4,6,True,True,5.4331655,-0.7309025158602558
4426,3602663,886,8,0.03351,188,3685433,-1,184.0,11538340,11539226,7935677,886,0,0,True,True,6.9149346666666665,-0.03351
4427,3604547,6,6,0.460835,188,3685433,-1,132.0,7382371,7382377,3777824,6,1,11,True,True,0.016522000000000002,-0.460835
4428,3604641,1145,32,0.770996,188,3685433,-1,512.0,3994388,3995533,389747,1145,6,1,True,True,15.180359111111109,-0.770996
4429,3604922,15,1,0.521139,188,3685433,-1,22.0,5829225,5829240,2224303,15,3,11,True,True,0.012237499999999998,-0.521139
4430,3604995,7,4,0.982116,188,3685433,-1,104.0,4514976,4514983,909981,7,7,12,True,True,0.02308164444444444,-0.982116
4431,3605014,40369,50,0.472826,188,3685433,-1,1400.0,7567771,7608140,3962757,40369,1,8,True,True,2263.6831038888886,-0.4686758666879623
4432,3605223,9932,1,0.681442,188,3685433,-1,42.0,4020370,4030302,415147,9932,9,1,True,True,13.029042366666669,-0.6462048675184013
4433,3605492,4812,256,0.312109,188,3685433,-1,8704.0,9591771,9596583,5986279,4812,1,12,True,True,711.3427413333334,-0.2852456440481303
4434,3605570,579,4,0.323063,188,3685433,-1,200.0,9461171,9461750,5855601,579,2,11,True,True,2.9036850000000003,-0.323063
4435,3605841,241,2,0.629164,188,3685433,-1,32.0,6330477,6330718,2724636,241,6,12,True,True,0.2744186666666667,-0.629164
4436,3605933,11431,2,0.042186,188,3685433,-1,66.0,6594177,6605608,2988244,11431,6,12,True,True,29.6380337,-0.04203890569863247
4437,3606018,184,16,0.937421,188,3685433,-1,672.0,4623490,4623674,1017472,184,12,1,True,True,2.619963733333334,-0.937421
4438,3606157,43,1,0.520926,188,3685433,-1,44.0,6759316,6759359,3153159,43,5,6,True,True,0.05227701111111111,-0.520926
4439,3607787,11,8,0.253313,188,3685433,-1,120.0,4287706,4287717,679919,11,15,8,True,True,0.019084999999999998,-0.253313
4440,3607835,3669,32,0.63852,188,3685433,-1,1472.0,7165333,7169002,3557498,3669,5,2,True,True,108.24304977777777,-0.6303938031381159
4441,3607893,10395,32,0.198724,188,3685433,-1,864.0,9895171,9905566,6287278,10395,1,12,True,True,355.1435424,-0.19061968911152774
4442,3607918,131,4,0.88752,188,3685433,-1,148.0,4949709,4949840,1341791,131,14,11,True,True,0.4338603555555555,-0.88752
4443,3608069,9617,128,0.863658,188,3685433,-1,3200.0,3985007,3994624,376938,9617,21,6,True,True,805.8520177777777,-0.8557467577561075
4444,3608142,45,4,0.217788,188,3685433,-1,76.0,9416971,9417016,5808829,45,4,11,True,True,0.12597,-0.217788
4445,3609215,18897,5,0.112928,188,3685433,-1,55.0,11044271,11063168,7435056,18897,1,12,True,True,35.94264452777778,-0.11257598874966737
4446,3609235,6,16,0.632909,188,3685433,-1,752.0,4334970,4334976,725735,6,20,10,True,True,0.059934400000000006,-0.632909
4447,3609295,102,1,0.324513,188,3685433,-1,41.0,10136071,10136173,6526776,102,2,7,True,True,0.18062755000000003,-0.324513
4448,3609324,52,1,0.16736,188,3685433,-1,27.0,7874771,7874823,4265447,52,7,8,True,True,0.056277,-0.16736
4449,3612264,97,32,0.2761,188,3685433,-1,192.0,5647225,5647322,2034961,97,17,7,True,True,0.5251450666666667,-0.2761
4450,3612998,3,8,0.11965,188,3685433,-1,360.0,7564171,7564174,3951173,3,9,0,True,True,0.046179000000000005,-0.11965000000000003
4451,3613280,117,16,0.789144,188,3685433,-1,512.0,4334976,4335093,721696,117,24,1,True,True,0.7957248000000001,-0.789144
4452,3613362,13488,8,0.00893,188,3685433,-1,368.0,11676140,11689628,8062778,13488,0,12,True,True,190.27165226666668,-0.008792365174042445
4453,3614472,25974,8,0.041993,188,3685433,-1,256.0,12529252,12555226,8914780,25974,0,12,True,True,305.10402844444445,-0.04159584766020191
4454,3614510,5239,4,0.783475,188,3685433,-1,124.0,6641977,6647216,3027467,5239,16,11,True,True,17.9582039,-0.7535377811558633
4455,3614555,18,32,0.475271,188,3685433,-1,1504.0,4776996,4777014,1162441,18,25,6,True,True,0.6601808,-0.475271
4456,3614578,139,1,0.596212,188,3685433,-1,42.0,3781047,3781186,166469,139,35,1,True,True,0.1550962,-0.596212
4457,3614804,416,16,0.371399,188,3685433,-1,160.0,10612271,10612687,6997467,416,4,12,True,True,4.015231999999999,-0.371399
4458,3615033,9,8,0.08948,188,3685433,-1,40.0,7071733,7071742,3456700,9,15,12,True,True,0.012004,-0.08948
4459,3615173,17,14,0.157698,188,3685433,-1,700.0,9027171,9027188,5411998,17,10,12,True,True,0.6163869444444444,-0.157698
4460,3615213,396,1,0.091402,188,3685433,-1,26.0,12053052,12053448,8437839,396,1,12,True,True,0.8539101999999998,-0.091402
4461,3615711,16582,256,0.618645,188,3685433,-1,6912.0,4030302,4046884,414591,16582,35,8,True,True,3105.4963583999997,-0.5974009710389412
4462,3615813,15389,16,0.930849,188,3685433,-1,336.0,5219909,5235298,1604096,15389,27,12,True,True,98.18243213333334,-0.819154081241118
4463,3615840,28,1,0.996973,188,3685433,-1,35.0,4302106,4302134,686266,28,35,2,True,True,0.020046444444444447,-0.996973
4464,3615880,7607,32,0.625132,188,3685433,-1,1600.0,5940677,5948284,2324797,7607,23,1,True,True,312.1957555555556,-0.6175451075133456
4465,3615923,14759,32,0.059775,188,3685433,-1,832.0,12356452,12371211,8740529,14759,1,12,True,True,524.6234655999999,-0.05677289304559864
4466,3615992,10,32,0.644575,188,3685433,-1,640.0,6597777,6597787,2981785,10,22,8,True,True,0.23900444444444446,-0.644575
4467,3627860,12820,256,0.701328,188,3685433,-1,4864.0,5632605,5645425,2004745,12820,29,9,True,True,1148.2974435555557,-0.6045081131977652
4468,3628129,6,4,0.791466,188,3685433,-1,140.0,4052284,4052290,424155,6,41,8,True,True,0.024938666666666668,-0.791466
4469,3628218,19,32,0.125827,188,3685433,-1,1600.0,12270052,12270071,8641834,19,2,12,True,True,0.9043155555555557,-0.125827
4470,3628580,26,4,0.232675,188,3685433,-1,172.0,9722371,9722397,6093791,26,10,11,True,True,0.1095143111111111,-0.23267500000000005
4471,3628688,27,16,0.981676,188,3685433,-1,512.0,3973280,3973307,344592,27,48,11,True,True,0.37067520000000004,-0.9816759999999999
4472,3628874,34,4,0.788562,188,3685433,-1,24.0,5918325,5918359,2289451,34,28,7,True,True,0.029711466666666672,-0.788562
4473,3628952,22,8,0.756698,188,3685433,-1,400.0,4193884,4193906,564932,22,44,10,True,True,0.17832222222222227,-0.756698
4474,3628991,27,1,0.805525,188,3685433,-1,30.0,3973307,3973334,344316,27,50,1,True,True,0.02171925,-0.8055249999999999
4475,3641283,24,10,0.438719,188,3685433,-1,310.0,8637371,8637395,4996088,24,15,12,True,True,0.25938733333333336,-0.438719
4476,3641363,6696,4,0.192965,188,3685433,-1,136.0,9199971,9206667,5558608,6696,14,12,True,True,33.9320034,-0.19044006646990994
4477,3643034,67,1,0.68925,188,3685433,-1,50.0,4306916,4306983,663882,67,44,2,True,True,0.06807944444444444,-0.68925
4478,3643821,17,8,0.358167,188,3685433,-1,304.0,5332009,5332026,1688188,17,36,10,True,True,0.1365644,-0.358167
4479,3659990,2,4,0.134732,188,3685433,-1,120.0,5469105,5469107,1809115,2,36,10,True,True,0.007015333333333334,-0.134732
4480,3660044,204,25,0.898663,188,3685433,-1,425.0,4837409,4837613,1177365,204,40,2,True,True,1.5875733333333333,-0.898663
4481,3660260,7004,128,0.485302,188,3685433,-1,2176.0,5447005,5454009,1786745,7004,37,1,True,True,344.61465528888897,-0.47628307663558606
4482,3660679,5,16,0.4375,188,3685433,-1,368.0,10353071,10353076,6692392,5,8,12,True,True,0.09235266666666668,-0.4375
4483,3660746,5,1,0.294715,188,3685433,-1,13.0,5087509,5087514,1426763,5,41,8,True,True,0.0014791111111111112,-0.294715
4484,3660784,140,34,0.697038,188,3685433,-1,1360.0,5916525,5916665,2255741,140,32,6,True,True,6.932675555555557,-0.697038
4485,3660860,9450,32,0.189776,188,3685433,-1,1088.0,4838309,4847759,1177449,9450,44,6,True,True,168.6605329777778,-0.17327891796524533
4486,3661028,773,1,0.186627,188,3685433,-1,37.0,8723771,8724544,5062743,773,17,12,True,True,1.8125089277777777,-0.18662699999999996
4487,3661037,3,2,0.347665,188,3685433,-1,30.0,4312867,4312870,651830,3,53,8,True,True,0.0018825,-0.347665
4488,3661057,9,16,0.732402,188,3685433,-1,192.0,6756616,6756625,3095559,9,26,12,True,True,0.04488,-0.732402
4489,3661097,2714,1,0.275324,188,3685433,-1,42.0,9372771,9375485,5711674,2714,15,12,True,True,4.444192666666666,-0.23723889507017518
4490,3661187,11,16,0.83135,188,3685433,-1,96.0,3989507,3989518,328320,11,64,6,True,True,0.027344533333333337,-0.83135
4491,3661202,4,6,0.914474,188,3685433,-1,210.0,4238106,4238110,576904,4,59,11,True,True,0.011841666666666667,-0.914474
4492,3661241,8,1,0.55452,188,3685433,-1,27.0,7654171,7654179,3992930,8,21,12,True,True,0.0075306,-0.55452
4493,3661274,20842,1,0.068877,188,3685433,-1,13.0,11538340,11559182,7877066,20842,6,7,True,True,12.733058505555555,-0.06878836017307888
4494,3661337,35594,16,0.155025,188,3685433,-1,656.0,11485271,11520865,7823934,35594,7,12,True,True,864.1933496888889,-0.15074062425612286
4495,3661440,101,8,0.295673,188,3685433,-1,368.0,11545540,11545641,7884100,101,5,2,True,True,1.6392120444444447,-0.295673
4496,3661501,63,1,0.263349,188,3685433,-1,42.0,8049571,8049634,4388070,63,23,12,True,True,0.12135806666666668,-0.26168962215420594
4497,3662111,8148,64,0.367113,188,3685433,-1,832.0,4905509,4913657,1243398,8148,52,10,True,True,204.33347537777775,-0.3660408589087858
4498,3662159,5579,4,0.00072,188,3685433,-1,136.0,10090071,10095650,6427912,5579,13,12,True,True,26.312567133333335,-0.0006530098323256334
4499,3662220,11570,1,0.638026,188,3685433,-1,10.0,10266671,10278241,6604451,11570,12,11,True,True,4.0382948333333335,-0.620426901232943
4500,3663788,609,1,0.379044,188,3685433,-1,5.0,6854733,6855342,3190945,609,33,12,True,True,0.11486416666666667,-0.379044
4501,3663875,76,8,0.185534,188,3685433,-1,240.0,11771740,11771816,8107865,76,4,2,True,True,0.8485653333333333,-0.185534
4502,3663967,14665,10,0.01872,188,3685433,-1,460.0,6670216,6684881,3006249,14665,37,10,True,True,173.1970226666667,-0.01854244570268706
4503,3664153,27,2,0.856829,188,3685433,-1,40.0,5695025,5695052,2030872,27,47,1,True,True,0.026292,-0.856829
4504,3664169,5448,2,0.776017,188,3685433,-1,56.0,3777443,3782891,113274,5448,83,11,True,True,7.949251022222222,-0.7718193398564615
4505,3664201,8450,4,0.238787,188,3685433,-1,48.0,3883980,3892430,219779,8450,82,6,True,True,8.846026666666667,-0.2309487932020251
4506,3664343,84,16,0.721004,188,3685433,-1,144.0,4046884,4046968,382541,84,74,6,True,True,0.3590832,-0.7210040000000001
4507,3664361,91,1,0.658289,188,3685433,-1,18.0,3733243,3733334,68882,91,86,8,True,True,0.03940754999999999,-0.658289
4508,3664393,22,2,0.538957,188,3685433,-1,80.0,8139571,8139593,4475178,22,26,8,True,True,0.076824,-0.538957
4509,3664433,6,13,0.387491,188,3685433,-1,65.0,8550971,8550977,4886538,6,26,12,True,True,0.01264575,-0.387491
4510,3664610,111,4,0.52407,188,3685433,-1,188.0,6764733,6764844,3100123,111,37,1,True,True,0.5322499333333334,-0.52407
4511,3664644,4,32,0.497549,188,3685433,-1,1600.0,5133509,5133513,1468865,4,59,7,True,True,0.18780444444444447,-0.497549
4512,3664668,188,32,0.551468,188,3685433,-1,160.0,7470571,7470759,3805903,188,33,12,True,True,2.023715555555556,-0.5514680000000001
4513,3664712,4,8,0.613039,188,3685433,-1,64.0,5599705,5599709,1934993,4,56,12,True,True,0.004246755555555555,-0.613039
4514,3664784,6124,1,0.3226,188,3685433,-1,32.0,11944552,11950676,8279768,6124,4,12,True,True,7.882230755555556,-0.31294889589480196
4515,3664816,16150,121,0.640904,188,3685433,-1,1815.0,5937077,5953227,2272261,16150,49,0,True,True,772.3809234166666,-0.6349887710034978
4516,3665011,232,32,0.110464,188,3685433,-1,992.0,6985333,6985565,3320322,232,38,11,True,True,8.648300088888888,-0.110464
4517,3665100,33,4,0.523201,188,3685433,-1,104.0,5513305,5513338,1848205,33,60,11,True,True,0.08189133333333333,-0.523201
4518,3665246,165,101,0.06668,188,3685433,-1,4242.0,3994646,3994811,329400,165,87,1,True,True,18.1242985,-0.06667999999999999
4519,3665281,7,64,0.835193,188,3685433,-1,2880.0,4342176,4342183,676895,7,75,9,True,True,0.282184,-0.835193
4520,3665449,6317,8,0.129774,188,3685433,-1,104.0,9286371,9292688,5620922,6317,23,12,True,True,28.662049288888888,-0.1278828710105519
4521,3665460,328,4,0.873493,188,3685433,-1,88.0,3881277,3881605,215817,328,97,1,True,True,0.5608435555555557,-0.873493
4522,3665924,9014,74,0.202079,188,3685433,-1,2220.0,11768140,11777154,8102216,9014,6,8,True,True,951.3964166666667,-0.19901665596562096
4523,3665959,15066,4,0.48537,188,3685433,-1,128.0,7161733,7176799,3495774,15066,39,0,True,True,40.52926542222222,-0.47757138566717877
4524,3665973,7608,3,0.098754,188,3685433,-1,15.0,12097252,12104860,8431279,7608,3,11,True,True,3.8772385,-0.09442220633723242
4525,3666177,10056,113,0.571012,188,3685433,-1,1921.0,4883409,4893465,1217232,10056,73,11,True,True,447.7969941916666,-0.5624990289477901
4526,3666436,7,1,0.8363,188,3685433,-1,10.0,3984107,3984114,317671,7,97,7,True,True,0.0018604444444444447,-0.8363
4527,3667058,8,8,0.657921,188,3685433,-1,48.0,5356993,5357001,1689935,8,67,2,True,True,0.006203733333333333,-0.657921
4528,3667074,37,8,0.525821,188,3685433,-1,136.0,5306309,5306346,1639235,37,69,12,True,True,0.09331564444444446,-0.525821
4529,3668186,12,8,0.701314,188,3685433,-1,72.0,5446993,5447005,1778807,12,67,1,True,True,0.0190752,-0.701314
4530,3668196,39839,1,0.255939,188,3685433,-1,44.0,11858152,11897991,8189956,39839,6,1,True,True,87.95080518888889,-0.2495632512967693
4531,3668426,38,4,0.366354,188,3685433,-1,24.0,7251733,7251771,3583307,38,40,12,True,True,0.017507866666666667,-0.366354
4532,3668615,13,64,0.605954,188,3685433,-1,640.0,4658596,4658609,989981,13,83,10,True,True,0.11218133333333333,-0.605954
4533,3668830,23991,4,0.070874,188,3685433,-1,92.0,7474171,7498162,3805341,23991,38,8,True,True,133.94991083333332,-0.07033702128474255
4534,3668847,12081,256,0.930211,188,3685433,-1,12288.0,4636496,4648577,967649,12081,85,8,True,True,3373.9128832000006,-0.8850329983147406
4535,3668865,5,1,0.208738,188,3685433,-1,33.0,8233171,8233176,4564306,5,32,8,True,True,0.0076468333333333345,-0.208738
4536,3669374,4541,184,0.491406,188,3685433,-1,4048.0,4782396,4786937,1113022,4541,84,7,True,True,548.4076463555556,-0.48720095082179304
4537,3669407,7819,4,0.889767,188,3685433,-1,96.0,3685443,3693262,16036,7819,116,1,True,True,23.752043466666663,-0.8626605354892709
4538,3669434,2,4,0.079957,188,3685433,-1,112.0,11305271,11305273,7635837,2,14,12,True,True,0.007350933333333333,-0.079957
4539,3669546,5723,2,0.80102,188,3685433,-1,38.0,3976907,3982630,307361,5723,109,8,True,True,5.615798227777777,-0.7849014325480222
4540,3669588,33704,64,0.0607,188,3685433,-1,1024.0,12531052,12564756,8861464,33704,0,7,True,True,1469.798968888889,-0.058991137930741865
4541,3669597,10,1,0.55802,188,3685433,-1,26.0,3829747,3829757,160150,10,116,6,True,True,0.006398166666666667,-0.55802
4542,3670045,612,43,0.938244,188,3685433,-1,430.0,4284106,4284718,614061,612,99,7,True,True,5.307791,-0.938244
4543,3670118,3,16,0.415953,188,3685433,-1,96.0,5332909,5332912,1662791,3,75,6,True,True,0.007610400000000001,-0.415953
4544,3670126,12,8,0.369069,188,3685433,-1,120.0,11858140,11858152,8188014,12,8,12,True,True,0.0815,-0.369069
4545,3670158,26577,128,0.708434,188,3685433,-1,4352.0,8291771,8318348,4621613,26577,35,7,True,True,3700.9623665777776,-0.6967279736302292
4546,3670351,9,2,0.823643,188,3685433,-1,70.0,4171784,4171793,501433,9,105,8,True,True,0.013679750000000003,-0.823643
4547,3670440,3747,1,0.265816,188,3685433,-1,30.0,11764540,11768287,8094100,3747,11,11,True,True,4.5347721666666665,-0.26553699160391614
4548,3672786,28250,128,0.040653,188,3685433,-1,4224.0,7698371,7726621,4025585,28250,41,11,True,True,2690.3309664000003,-0.03957476236129232
4549,3672822,13457,128,0.070388,188,3685433,-1,3072.0,12183652,12197109,8510830,13457,4,12,True,True,1841.2726016000001,-0.07031036941534073
4550,3673201,21313,16,0.303905,188,3685433,-1,144.0,10525871,10547184,6852670,21313,21,12,True,True,109.7239444,-0.27901665871078574
4551,3673565,89,1,0.944603,188,3685433,-1,12.0,4839209,4839298,1165644,89,90,6,True,True,0.0205056,-0.944603
4552,3673625,16711,4,0.960587,188,3685433,-1,68.0,4312870,4329581,639245,16711,103,1,True,True,16.969859,-0.9583468855441335
4553,3673741,75,2,0.097119,188,3685433,-1,16.0,9808771,9808846,6135030,75,27,12,True,True,0.029439999999999997,-0.097119
4554,3673762,201,1,0.725172,188,3685433,-1,41.0,4768896,4769097,1095134,201,97,7,True,True,0.18473575,-0.725172
4555,3673920,5,1,0.531661,188,3685433,-1,25.0,3729643,3729648,55723,5,133,11,True,True,0.0032253472222222223,-0.531661
4556,3674946,25,1,0.18946,188,3685433,-1,24.0,7251771,7251796,3576825,25,51,1,True,True,0.011518333333333334,-0.18946
4557,3674980,12598,32,0.526192,188,3685433,-1,1440.0,6330477,6343075,2655497,12598,66,0,True,True,535.42972,-0.5075605746455456
4558,3675045,21116,45,0.248763,188,3685433,-1,1215.0,4309267,4330383,634222,21116,109,2,True,True,408.457711125,-0.24833420136781523
4559,3675284,288,3,0.625325,188,3685433,-1,105.0,8240371,8240659,4565087,288,40,9,True,True,1.2518222500000002,-0.582510126623901
4560,3675406,1649,5,0.178898,188,3685433,-1,220.0,11308871,11310520,7633465,1649,18,8,True,True,12.481647444444445,-0.178898
4561,3675425,101,1,0.749194,188,3685433,-1,6.0,4167284,4167385,491859,101,119,8,True,True,0.007766900000000001,-0.749194
4562,3675572,12,2,0.415185,188,3685433,-1,28.0,4193906,4193918,518334,12,117,1,True,True,0.006808666666666668,-0.415185
4563,3675590,8667,16,0.105514,188,3685433,-1,400.0,9505371,9514038,5829781,8667,31,11,True,True,63.485513333333344,-0.10541980348589115
4564,3675622,29,12,0.638624,188,3685433,-1,216.0,6768333,6768362,3092711,29,61,8,True,True,0.157209,-0.638624
4565,3675637,7754,128,0.357963,188,3685433,-1,1920.0,11395271,11403025,7719634,7754,18,12,True,True,540.8915786666666,-0.35554349443799926
4566,3675654,189,32,0.458721,188,3685433,-1,320.0,8854371,8854560,5178717,189,39,12,True,True,2.0830319999999998,-0.458721
4567,3675688,10761,1,0.665242,188,3685433,-1,46.0,4298506,4309267,622818,10761,118,2,True,True,9.958652316666665,-0.6472877584320448
4568,3675741,8744,4,0.882824,188,3685433,-1,196.0,4074384,4083128,398643,8744,126,10,True,True,45.844752799999995,-0.8768852527477462
4569,3675872,9308,1,0.166809,188,3685433,-1,44.0,7338171,7347479,3662299,9308,56,12,True,True,10.883726944444444,-0.16672812114751615
4570,3675903,11829,72,0.180397,188,3685433,-1,2232.0,6027077,6038906,2351174,11829,75,12,True,True,447.97517200000004,-0.17847498552138072
4571,3676012,238,1,0.401557,188,3685433,-1,35.0,3883080,3883318,207068,238,143,1,True,True,0.1618565277777778,-0.401557
4572,3676024,33,8,0.337513,188,3685433,-1,360.0,10871471,10871504,7195447,33,22,12,True,True,0.382536,-0.337513
4573,3676082,23,5,0.158176,188,3685433,-1,70.0,6244077,6244100,2567995,23,76,12,True,True,0.03451213888888889,-0.158176
4574,3676130,45,1,0.998434,188,3685433,-1,50.0,4303316,4303361,627186,45,121,2,True,True,0.04602500000000001,-0.998434
4575,3676133,2356,2,0.443012,188,3685433,-1,18.0,7384171,7386527,3708038,2356,56,7,True,True,0.87172,-0.443012
4576,3676184,230,8,0.352324,188,3685433,-1,128.0,4294906,4295136,618722,230,125,9,True,True,0.5127466666666667,-0.352324
4577,3677867,53,45,0.315155,188,3685433,-1,1710.0,10439471,10439524,6761604,53,25,12,True,True,7.386596750000001,-0.315155
4578,3677893,32,1,0.991463,188,3685433,-1,33.0,3994356,3994388,316463,32,141,2,True,True,0.027344533333333334,-0.991463
4579,3677973,1043,1,0.324654,188,3685433,-1,43.0,7161733,7162776,3483760,1043,64,8,True,True,0.9389636472222221,-0.324654
4580,3677995,13208,38,0.37172,188,3685433,-1,608.0,8143171,8156379,4465176,13208,48,2,True,True,319.0965504888889,-0.3703831518203056
4581,3678079,1889,4,0.764184,188,3685433,-1,168.0,4784196,4786085,1106117,1889,111,7,True,True,9.584237133333334,-0.761189891074856
4582,3678090,14913,128,0.430588,188,3685433,-1,1792.0,5781425,5796338,2103335,14913,87,12,True,True,958.4203328,-0.40998644699497
4583,3678108,13165,16,0.725868,188,3685433,-1,128.0,4680696,4693861,1002588,13165,116,10,True,True,30.312360533333333,-0.7158441929378013
4584,3678125,7,4,0.608413,188,3685433,-1,108.0,7560571,7560578,3882446,7,56,12,True,True,0.03328709999999999,-0.608413
4585,3678176,6,37,0.563145,188,3685433,-1,1295.0,9981571,9981577,6303395,6,30,12,True,True,0.4583436666666667,-0.563145
4586,3678377,8869,256,0.213928,188,3685433,-1,9472.0,11529471,11538340,7851094,8869,17,11,True,True,3766.5865023999995,-0.2021501134048901
4587,3678440,12027,210,0.765708,188,3685433,-1,5250.0,5131709,5143736,1453269,12027,107,11,True,True,1858.1023416666667,-0.7648257530027234
4588,3679211,14,64,0.926147,188,3685433,-1,2176.0,4623476,4623490,944265,14,124,12,True,True,0.6454983111111112,-0.926147
4589,3679280,44,128,0.254089,188,3685433,-1,5632.0,11966652,11966696,8287372,44,7,10,True,True,9.56057031111111,-0.254089
4590,3679312,4,1,0.961652,188,3685433,-1,31.0,3781043,3781047,101731,4,165,8,True,True,0.003294266666666667,-0.961652
4591,3679372,7906,32,0.4475,188,3685433,-1,992.0,11218871,11226777,7539499,7906,23,7,True,True,283.5221945777778,-0.44254268550384224
4592,3680172,1984,32,0.397091,188,3685433,-1,1024.0,5355009,5356993,1674837,1984,104,10,True,True,46.65318115555556,-0.3847974991066145
4593,3680281,13,14,0.726313,188,3685433,-1,574.0,6647216,6647229,2966935,13,79,1,True,True,0.19720407777777776,-0.726313
4594,3680922,11742,86,0.982956,188,3685433,-1,602.0,5443393,5455135,1762471,11742,104,12,True,True,160.6532116,-0.9744066070460208
4595,3681024,1300,8,0.595763,188,3685433,-1,168.0,4833809,4835109,1152785,1300,120,1,True,True,4.077303533333334,-0.5922233165641178
4596,3681070,19,1,0.517609,188,3685433,-1,28.0,4831996,4832015,1150926,19,121,8,True,True,0.009991255555555556,-0.517609
4597,3681095,23,32,0.993412,188,3685433,-1,288.0,3982307,3982330,301212,23,162,7,True,True,0.17605120000000002,-0.993412
4598,3681213,5,32,0.301842,188,3685433,-1,1408.0,7564171,7564176,3882958,5,60,8,True,True,0.30101866666666666,-0.301842
4599,3681391,13,8,0.300334,188,3685433,-1,264.0,4776096,4776109,1094705,13,127,1,True,True,0.08369313333333335,-0.300334
4600,3681904,3459,4,0.221887,188,3685433,-1,156.0,10003671,10007130,6321767,3459,33,10,True,True,23.4101517,-0.1586540419820481
4601,3682096,13849,4,0.85572,188,3685433,-1,152.0,3980507,3994356,298411,13849,166,8,True,True,55.30173017777778,-0.8552616325987112
4602,3682167,19827,32,0.021701,188,3685433,-1,352.0,11217071,11236898,7534904,19827,24,12,True,True,249.37494071111112,-0.021338831347818037
4603,3682283,6,1,0.82194,188,3685433,-1,19.0,5309909,5309915,1627626,6,112,8,True,True,0.00216125,-0.82194
4604,3682525,22,32,0.689719,188,3685433,-1,1248.0,3994624,3994646,312099,22,162,1,True,True,0.7109578666666667,-0.689719
4605,3682574,13,1,0.275957,188,3685433,-1,35.0,8464571,8464584,4781997,13,51,12,True,True,0.016457097222222224,-0.275957
4606,3682589,3,4,0.553663,188,3685433,-1,56.0,3993107,3993110,310518,3,166,3,True,True,0.004350266666666667,-0.553663
4607,3683826,2914,1,0.556323,188,3685433,-1,29.0,7158133,7161047,3474307,2914,75,12,True,True,1.570902288888889,-0.4939609622266141
4608,3685104,2,1,0.925922,188,3685433,-1,14.0,4428576,4428578,743472,2,140,12,True,True,0.0006822666666666666,-0.925922
4609,3688341,561,1,0.154715,232,3729643,-1,38.0,8378171,8378732,4689830,561,52,12,True,True,0.8686492833333332,-0.154715
4610,3688365,19295,64,0.037736,232,3729643,-1,2112.0,12442852,12462147,8754487,19295,2,12,True,True,1852.8351834666669,-0.03695386589945209
4611,3688398,12603,8,0.355656,232,3729643,-1,128.0,6941133,6953736,3252735,12603,80,12,True,True,67.22982400000001,-0.3546485528155796
4612,3688772,56,1,0.138408,232,3729643,-1,42.0,9113571,9113627,5424799,56,47,12,True,True,0.12905946666666668,-0.138408
4613,3688871,53,8,0.367083,232,3729643,-1,160.0,3928180,3928233,239309,53,182,11,True,True,0.25310444444444447,-0.367083
4614,3688977,11,8,0.582156,232,3729643,-1,112.0,5915625,5915636,2226648,11,101,12,True,True,0.044858488888888895,-0.582156
4615,3689104,7367,16,0.232994,232,3729643,-1,768.0,7784771,7792138,4095667,7367,62,12,True,True,185.00458453333334,-0.2308174660269888
4616,3689453,19,1,0.811074,232,3729643,-1,11.0,4016746,4016765,327293,19,170,10,True,True,0.007724872222222222,-0.811074
4617,3690701,14513,16,0.091905,232,3729643,-1,592.0,11541940,11556453,7851239,14513,17,2,True,True,415.0909972,-0.0912250231975641
4618,3690792,149,32,0.399798,232,3729643,-1,1568.0,9678171,9678320,5987379,149,41,12,True,True,8.088859022222223,-0.399798
4619,3690846,16952,256,0.917882,232,3729643,-1,12800.0,5920125,5937077,2229279,16952,102,7,True,True,6933.578204444445,-0.9040707303352927
4620,3690876,21615,64,0.734266,232,3729643,-1,896.0,4163684,4185299,472808,21615,168,11,True,True,436.15495964444443,-0.6965987539959487
4621,3690903,30,8,0.723581,232,3729643,-1,160.0,5039709,5039739,1348806,30,129,12,True,True,0.16581333333333334,-0.723581
4622,3691207,140,16,0.792904,232,3729643,-1,768.0,3828847,3828987,137640,140,195,8,True,True,2.6458880000000002,-0.792904
4623,3691710,20607,32,0.172902,232,3729643,-1,1312.0,8245771,8266378,4554061,20607,58,7,True,True,1056.3854234666667,-0.169788159201122
4624,3691896,6844,35,0.825705,232,3729643,-1,1540.0,4048684,4055528,356788,6844,173,7,True,True,309.4029228888889,-0.8164769356326687
4625,3692532,17,8,0.689595,232,3729643,-1,256.0,6764716,6764733,3072184,17,89,7,True,True,0.11100017777777776,-0.689595
4626,3692654,1207,32,0.576232,232,3729643,-1,608.0,8940771,8941978,5248117,1207,51,12,True,True,44.26170924444444,-0.576232
4627,3692800,10,1,0.907656,232,3729643,-1,50.0,3882177,3882187,189377,10,197,6,True,True,0.009715277777777778,-0.907656
4628,3692903,3,12,0.595231,232,3729643,-1,456.0,3883077,3883080,190174,3,197,6,True,True,0.026581000000000004,-0.595231
4629,3693006,11,21,0.300393,232,3729643,-1,861.0,10134271,10134282,6441265,11,35,11,True,True,0.40906827500000004,-0.300393
4630,3699045,8653,32,0.730789,232,3729643,-1,928.0,3836947,3845600,137902,8653,201,9,True,True,175.25676204444443,-0.6872516624656534
4631,3699066,22116,32,0.576284,232,3729643,-1,288.0,5603305,5625421,1904239,22116,117,8,True,True,92.3567832,-0.572000004281948
4632,3699271,21,1,0.078477,232,3729643,-1,16.0,8767971,8767992,5068700,21,54,11,True,True,0.02210226666666667,-0.078477
4633,3699282,111,18,0.055923,232,3729643,-1,612.0,11720340,11720451,8021058,111,15,11,True,True,2.3638449,-0.055923
4634,3699352,13,4,0.770902,232,3729643,-1,48.0,4833796,4833809,1134444,13,144,7,True,True,0.011719066666666667,-0.770902
4635,3699478,11,4,0.34793,232,3729643,-1,172.0,5083909,5083920,1384431,11,136,11,True,True,0.0517462,-0.34793
4636,3699527,13020,12,0.817142,232,3729643,-1,600.0,4623476,4636496,923949,13020,157,0,True,True,141.73397333333332,-0.7991337929932514
4637,3700163,6,11,0.416522,232,3729643,-1,187.0,8243971,8243977,4543808,6,63,8,True,True,0.04606433333333334,-0.416522
4638,3701086,44,32,0.867831,232,3729643,-1,1088.0,6421377,6421421,2720291,44,103,12,True,True,1.077917866666667,-0.867831
4639,3701224,130,1,0.869787,232,3729643,-1,36.0,3881147,3881277,179923,130,209,11,True,True,0.09093499999999999,-0.869787
4640,3701346,187,32,0.226718,232,3729643,-1,928.0,5645425,5645612,1944079,187,119,1,True,True,4.8932331555555555,-0.226718
4641,3712058,24,36,0.652779,232,3729643,-1,216.0,4168184,4168208,456126,24,181,6,True,True,0.0664416,-0.652779
4642,3712151,13959,64,0.602302,232,3729643,-1,704.0,4767096,4781055,1054945,13959,156,12,True,True,237.57110666666665,-0.5645281849534896
4643,3714914,7407,9,0.011434,232,3729643,-1,288.0,11130671,11138078,7415757,7407,28,12,True,True,67.88250479999999,-0.011406211541907756
4644,3715223,18,16,0.777419,232,3729643,-1,592.0,4537076,4537094,821853,18,164,10,True,True,0.27075119999999997,-0.777419
4645,3715324,18,16,0.382487,232,3729643,-1,800.0,6762916,6762934,3047592,18,96,2,True,True,0.36944,-0.382487
4646,3715542,5,8,0.304783,232,3729643,-1,136.0,5355909,5355914,1640367,5,132,6,True,True,0.016114111111111114,-0.304783
4647,3720730,18,16,0.041182,232,3729643,-1,304.0,8289971,8289989,4569241,18,63,11,True,True,0.22000480000000003,-0.041182
4648,3720939,56,4,0.53993,232,3729643,-1,104.0,6113477,6113533,2392538,56,110,12,True,True,0.1273191111111111,-0.53993
4649,3721655,12,1,0.14958,232,3729643,-1,44.0,11589740,11589752,7868085,12,17,11,True,True,0.019833733333333332,-0.14958
4650,3723113,108,2,0.502402,232,3729643,-1,54.0,6507777,6507885,2784664,108,107,12,True,True,0.1910952,-0.502402
4651,3723509,38,1,0.220797,232,3729643,-1,43.0,3825247,3825285,101738,38,224,11,True,True,0.0402781,-0.220797
4652,3723658,819,1,0.05052,232,3729643,-1,22.0,6334977,6335796,2611319,819,109,2,True,True,0.50995945,-0.05052
4653,3723949,12732,20,0.731579,232,3729643,-1,920.0,4772496,4785228,1048547,12732,163,2,True,True,311.2001506666667,-0.6942596639218376
4654,3724018,394,4,0.392883,232,3729643,-1,32.0,6157677,6158071,2433659,394,113,11,True,True,0.20179804444444444,-0.392883
4655,3733006,4,16,0.445616,232,3733243,-1,112.0,4953309,4953313,1220303,4,150,8,True,True,0.009268622222222222,-0.445616
4656,3733414,122,4,0.595132,251,3777443,-1,96.0,5785025,5785147,2051611,122,123,8,True,True,0.4377685333333334,-0.595132
4657,3736777,71,3,0.504729,251,3777443,-1,114.0,4118584,4118655,381807,71,198,11,True,True,0.24772136666666666,-0.504729
4658,3736867,291,2,0.222086,251,3777443,-1,94.0,7918971,7919262,4182104,291,72,11,True,True,1.0227356666666665,-0.222086
4659,3737473,40,1,0.289783,251,3777443,-1,29.0,6331377,6331417,2593904,40,111,6,True,True,0.04127666666666666,-0.289783
4660,3737586,14,4,0.394322,251,3777443,-1,200.0,3988607,3988621,251021,14,214,1,True,True,0.07458111111111111,-0.394322
4661,3737606,16503,3,0.132189,251,3777443,-1,123.0,6758416,6774919,3020810,16503,101,7,True,True,53.268237299999996,-0.13101690207435318
4662,3737796,274,12,0.082545,251,3777443,-1,552.0,10957871,10958145,7220075,274,31,12,True,True,5.1651192,-0.082545
4663,3740770,18193,1,0.571441,251,3777443,-1,22.0,8135971,8154164,4395201,18193,72,12,True,True,15.9924853,-0.5352324323354326
4664,3740870,2,4,0.049311,251,3777443,-1,60.0,11398871,11398873,7658001,2,24,8,True,True,0.004501666666666667,-0.049311
4665,3740946,4650,1,0.399191,251,3777443,-1,42.0,7871171,7875821,4130225,4650,77,12,True,True,8.066411966666667,-0.39027015692253086
4666,3741105,22,1,0.085079,251,3777443,-1,42.0,10222471,10222493,6481366,22,39,12,True,True,0.030178866666666672,-0.085079
4667,3741132,20,4,0.501823,251,3777443,-1,116.0,6648116,6648136,2906984,20,109,6,True,True,0.06131244444444445,-0.501823
4668,3741765,21010,1,0.773825,251,3777443,-1,12.0,4282306,4303316,540541,21010,200,11,True,True,4.2949323999999995,-0.7372449558244333
4669,3741794,1379,32,0.130375,251,3777443,-1,448.0,10698671,10700050,6956877,1379,34,12,True,True,42.27136853333333,-0.12316666699113686
4670,3741818,8052,16,0.134871,251,3777443,-1,144.0,10785071,10793123,7043253,8052,34,12,True,True,37.3249224,-0.12172615977748848
4671,3742130,11773,256,0.559296,251,3777443,-1,2560.0,4119484,4131257,377354,11773,210,6,True,True,803.5625884444444,-0.546069160894336
4672,3742226,27737,2,0.487861,251,3777443,-1,30.0,7963171,7990908,4220945,27737,78,11,True,True,37.221922666666664,-0.4640043116515303
4673,3744910,24,1,0.652248,251,3777443,-1,47.0,4020346,4020370,275436,24,219,8,True,True,0.03822666666666667,-0.652248
4674,3745166,37,4,0.196099,251,3777443,-1,152.0,8229571,8229608,4484405,37,74,12,True,True,0.29559904444444446,-0.18990362752941797
4675,3745225,5,16,0.615997,251,3777443,-1,800.0,4780596,4780601,1035371,5,177,3,True,True,0.10554444444444444,-0.615997
8402,6658550,8,1,0.126368,1,6658550,-1,25.0,6744950,6744958,86400,8,0,12,True,True,0.0021755555555555556,-0.126368
8403,6659967,7085,8,0.378801,172,6744950,-1,304.0,12328187,12335272,5668220,7085,0,12,True,True,54.92298502222222,-0.37795442534764334
8404,6661077,2266,32,0.735422,172,6744950,-1,320.0,8719241,8721507,2058164,2266,1,2,True,True,7.517077333333334,-0.735422
8405,6662693,92,1,0.052865,172,6744950,-1,19.0,13021187,13021279,6358494,92,0,12,True,True,0.02942450833333333,-0.05277762374650813
8406,6663607,6,2,0.725419,172,6744950,-1,20.0,6789150,6789156,125543,6,3,0,True,True,0.002715333333333333,-0.725419
8407,6663928,2959,64,0.9745,172,6744950,-1,384.0,8807441,8810400,2143513,2959,2,12,True,True,11.707435733333334,-0.9719496300202436
8408,6664109,6,4,0.707502,172,6744950,-1,148.0,10197543,10197549,3533434,6,2,12,True,True,0.009393066666666667,-0.707502
8409,6667408,18,2,0.249112,172,6744950,-1,78.0,12043287,12043305,5375879,18,2,10,True,True,0.0447525,-0.249112
8410,6667915,35,1,0.608703,172,6744950,-1,9.0,7212841,7212876,544926,35,6,11,True,True,0.010320625,-0.608703
8411,6669820,3,1,0.706787,172,6744950,-1,41.0,7887843,7887846,1218023,3,6,2,True,True,0.0008661250000000002,-0.706787
8412,6670131,6799,2,0.183105,172,6744950,-1,18.0,15839701,15846500,9169570,6799,0,12,True,True,4.258593599999999,-0.18251841452387935
8413,6670278,21978,2,0.986246,172,6744950,-1,50.0,6863456,6885434,193178,21978,9,7,True,True,24.637645555555554,-0.963227798905371
8414,6670422,210,2,0.798469,172,6744950,-1,40.0,9921943,9922153,3251521,210,5,6,True,True,0.10941000000000001,-0.798469
8415,6670615,22390,152,0.502229,172,6744950,-1,5472.0,15751501,15773891,9080886,22390,1,12,True,True,8565.1950448,-0.4902959246467648
8416,6670823,31,18,0.275823,172,6744950,-1,270.0,14516287,14516318,7845464,31,2,0,True,True,0.23996325000000002,-0.275823
8417,6671262,315,2,0.427765,172,6744950,-1,58.0,10774887,10775202,4103625,315,6,12,True,True,0.4519795,-0.427765
8418,6671303,2,60,0.941677,172,6744950,-1,1200.0,7050041,7050043,378738,2,13,10,True,True,0.05540666666666667,-0.941677
8419,6671362,5,8,0.881388,172,6744950,-1,280.0,7393241,7393246,721879,5,12,10,True,True,0.031317222222222225,-0.881388
8420,6671435,8,2,0.814023,172,6744950,-1,26.0,7914466,7914474,1243031,8,11,1,True,True,0.003233822222222222,-0.814023
8421,6672239,38,16,0.305187,172,6744950,-1,208.0,12761987,12762025,6089748,38,4,12,True,True,0.3140060444444444,-0.30317096263475934
8422,6672376,65655,1,0.857921,172,6744950,-1,14.0,7873263,7938918,1200887,65655,14,12,True,True,12.842340700000003,-0.8473255516134933
8423,6672527,16,32,0.947455,172,6744950,-1,384.0,6811250,6811266,138723,16,19,10,True,True,0.07043413333333334,-0.947455
8424,6672602,19,2,0.406515,172,6744950,-1,78.0,9399541,9399560,2726939,19,10,12,True,True,0.01809275,-0.406515
8425,6672621,10,1,0.312737,172,6744950,-1,42.0,13680087,13680097,7007466,10,3,12,True,True,0.015793166666666667,-0.312737
8426,6672835,18979,2,0.090141,172,6744950,-1,92.0,15391301,15410280,8718466,18979,2,12,True,True,85.44229903333334,-0.08760775485763433
8427,6673123,6401,32,0.079475,172,6744950,-1,1088.0,11453187,11459588,4780064,6401,9,12,True,True,270.2015208888889,-0.07666993011404008
8428,6673156,13820,1,0.729953,172,6744950,-1,27.0,7601263,7615083,928107,13820,19,8,True,True,7.189316174999999,-0.6931594300265509
8429,6673287,12,1,0.944867,172,6744950,-1,6.0,7141141,7141153,467854,12,22,7,True,True,0.0011374,-0.944867
8430,6677934,4116,8,0.165113,172,6744950,-1,160.0,15394901,15399017,8716967,4116,2,1,True,True,30.13458933333333,-0.15469107528976578
8431,6677950,48,8,0.057412,172,6744950,-1,296.0,13904287,13904335,7226337,48,5,8,True,True,0.5094752,-0.057412
8432,6684601,37,2,0.743409,172,6744950,-1,34.0,7910843,7910880,1226242,37,19,6,True,True,0.013628333333333334,-0.743409
8433,6684784,14,16,0.55416,172,6744950,-1,384.0,12241787,12241801,5557003,14,10,8,True,True,0.12505173333333333,-0.55416
8434,6685046,98,8,0.492851,172,6744950,-1,104.0,8714643,8714741,2029597,98,19,12,True,True,0.14359395555555554,-0.492851
8435,6685053,82,8,0.874353,172,6744950,-1,112.0,7396841,7396923,711788,82,25,8,True,True,0.2572030222222222,-0.8743529999999998
8436,6685090,5649,32,0.962166,172,6744950,-1,256.0,11146187,11151836,4461097,5649,13,10,True,True,15.30687928888889,-0.9563412186979531
8437,6685291,41,1,0.423984,172,6744950,-1,34.0,9657339,9657380,2972048,41,17,8,True,True,0.018412416666666667,-0.4239839999999999
8438,6685422,9165,8,0.508682,172,6744950,-1,264.0,8715641,8724806,2030219,9165,21,6,True,True,24.76738513333333,-0.5078878750641028
8439,6685437,42,16,0.730797,172,6744950,-1,128.0,6868011,6868053,182574,42,33,2,True,True,0.12986026666666667,-0.730797
8440,6685575,14349,256,0.479656,172,6744950,-1,8704.0,8113518,8127867,1427943,14349,23,12,True,True,1487.6547498666669,-0.44351441071176995
8441,6685967,370,4,0.515011,172,6744950,-1,80.0,10597444,10597814,3911477,370,15,12,True,True,0.7876066666666668,-0.515011
8442,6687864,3,1,0.997954,172,6744950,-1,42.0,6923011,6923014,235147,3,35,9,True,True,0.0017944500000000004,-0.997954
8443,6688959,12,4,0.888081,172,6744950,-1,44.0,8626443,8626455,1937484,12,24,6,True,True,0.005171466666666666,-0.888081
8444,6688970,7565,16,0.697882,172,6744950,-1,752.0,9544339,9551904,2855369,7565,19,10,True,True,133.9534007111111,-0.6566820511620084
8445,6688989,65,2,0.405471,172,6744950,-1,98.0,13900687,13900752,7211698,65,6,11,True,True,0.21233333333333332,-0.405471
8446,6689034,2,4,0.616287,172,6744950,-1,20.0,8025318,8025320,1336284,2,28,12,True,True,0.00038833333333333336,-0.616287
8447,6689145,10104,4,0.910886,172,6744950,-1,96.0,9177141,9187245,2487996,10104,22,12,True,True,14.573432,-0.8834497132622403
8448,6690630,13444,15,0.745917,172,6744950,-1,225.0,10600287,10613731,3909657,13444,16,6,True,True,79.0235675,-0.7280663595444946
8449,6690784,12,2,0.71416,172,6744950,-1,22.0,6815201,6815213,124417,12,44,1,True,True,0.0041418666666666664,-0.71416
8450,6690805,12,4,0.702592,172,6744950,-1,136.0,6951962,6951974,261157,12,41,7,True,True,0.07039813333333335,-0.7025919999999999
8451,6690999,162,4,0.749668,172,6744950,-1,36.0,6957362,6957524,266363,162,41,1,True,True,0.248103,-0.749668
8452,6691121,122,1,0.244226,172,6744950,-1,19.0,15128487,15128609,8437366,122,4,11,True,True,0.08570161111111112,-0.244226
8453,6691182,1384,6,0.738983,172,6744950,-1,228.0,9285641,9287025,2594459,1384,24,12,True,True,7.819553866666666,-0.7389830000000001
8454,6691260,20,2,0.950868,172,6744950,-1,62.0,6864411,6864431,173151,20,47,1,True,True,0.02744533333333334,-0.950868
8455,6691976,2,1,0.823363,172,6744950,-1,21.0,6928062,6928064,236086,2,45,2,True,True,0.0006440000000000001,-0.823363
8456,6692023,180,4,0.880332,172,6744950,-1,92.0,7876863,7877043,1184840,180,36,1,True,True,0.178388,-0.880332
8457,6692104,26055,32,0.528111,172,6744950,-1,256.0,9653739,9679794,2961635,26055,22,10,True,True,78.8742848,-0.5079823930465261
8458,6692240,2,32,0.609194,172,6744950,-1,1120.0,9925543,9925545,3233303,2,20,8,True,True,0.02855377777777778,-0.609194
8459,6693041,7498,8,0.607374,172,6744950,-1,208.0,10329043,10336541,3636002,7498,19,10,True,True,38.33748128888889,-0.5707127957439214
8460,6693060,9,9,0.964647,172,6744950,-1,261.0,7880643,7880652,1187583,9,39,2,True,True,0.032279175,-0.964647
8461,6693068,7871,1,0.674522,172,6744950,-1,35.0,6953762,6961633,260694,7871,49,7,True,True,11.498867625,-0.6609421210145915
8462,6693225,45,2,0.881931,172,6744950,-1,62.0,8287218,8287263,1593993,45,34,6,True,True,0.027520250000000003,-0.881931
8463,6693234,13127,128,0.523516,172,6744950,-1,4096.0,13025687,13038814,6332453,13127,9,8,True,True,974.4515072,-0.5226938381371685
8464,6693334,20781,32,0.225069,172,6744950,-1,192.0,15970301,15991082,9276967,20781,0,12,True,True,118.02913919999999,-0.22221197515477972
8465,6693490,146,1,0.075122,172,6744950,-1,10.0,15444501,15444647,8751011,146,3,6,True,True,0.058562222222222224,-0.075122
8466,6693495,5968,2,0.839409,172,6744950,-1,24.0,6983741,6989709,290246,5968,52,1,True,True,2.2199552,-0.7939865225958633
8467,6693954,8839,2,0.513684,172,6744950,-1,52.0,9313141,9321980,2619187,8839,30,7,True,True,8.60027061111111,-0.5064535109136182
8468,6694487,18,2,0.952484,172,6744950,-1,30.0,9921043,9921061,3226556,18,26,12,True,True,0.008353499999999998,-0.952484
8469,6694554,650,1,0.422722,172,6744950,-1,27.0,13593687,13594337,6899133,650,11,8,True,True,0.6453525,-0.422722
8470,6694558,7636,16,0.379095,172,6744950,-1,480.0,10688487,10696123,3993929,7636,21,7,True,True,97.824928,-0.37858502344219347
8471,6694656,49,1,0.373284,172,6744950,-1,41.0,14602687,14602736,7908031,49,7,12,True,True,0.039097372222222225,-0.373284
8472,6694767,7,1,0.113234,172,6744950,-1,50.0,12589187,12589194,5894420,7,16,12,True,True,0.005806111111111112,-0.113234
8473,6694773,146,3,0.914045,172,6744950,-1,18.0,9004341,9004487,2309568,146,38,10,True,True,0.05396159999999999,-0.914045
8474,6694882,45,16,0.249765,172,6744950,-1,496.0,8027118,8027163,1332236,45,46,7,True,True,0.21669000000000005,-0.249765
8475,6694978,6,8,0.53912,172,6744950,-1,352.0,14251687,14251693,7556709,6,9,7,True,True,0.035346666666666665,-0.53912
8476,6695010,8038,256,0.766414,172,6744950,-1,8192.0,7938918,7946956,1243908,8038,49,7,True,True,759.4076387555556,-0.7585681927200337
8477,6695053,16759,64,0.117865,172,6744950,-1,1088.0,16584301,16601060,9889248,16759,0,11,True,True,275.34427626666667,-0.10924240682602895
8478,6695148,93,4,0.299178,172,6744950,-1,112.0,14077087,14077180,7381939,93,11,0,True,True,0.27961173333333333,-0.299178
8479,6695180,58,128,0.293545,172,6744950,-1,3840.0,8721041,8721099,2025861,58,43,7,True,True,2.308864,-0.293545
8480,6695199,6,1,0.213066,172,6744950,-1,50.0,8286318,8286324,1591119,6,49,12,True,True,0.0028958333333333336,-0.213066
8481,6695238,25,4,0.738026,172,6744950,-1,164.0,9311341,9311366,2616103,25,39,10,True,True,0.07089583333333334,-0.738026
8482,6695298,20,64,0.568842,172,6744950,-1,448.0,8714741,8714761,2019443,20,47,1,True,True,0.12623644444444446,-0.568842
8483,6695334,12654,92,0.217463,172,6744950,-1,2024.0,15578701,15591355,8883367,12654,4,1,True,True,680.0945399111112,-0.21719290359355242
8484,6695375,8,32,0.30482,172,6744950,-1,800.0,12151787,12151795,5456412,8,23,12,True,True,0.23656888888888888,-0.30482
8485,6695418,8,2,0.933111,172,6744950,-1,58.0,8484143,8484151,1788725,8,52,1,True,True,0.019676177777777776,-0.933111
8486,6695567,7916,256,0.642974,172,6744950,-1,3072.0,9496539,9504455,2800972,7916,39,7,True,True,714.0173056,-0.5770456417803137
8487,6695643,41,8,0.825727,172,6744950,-1,352.0,6950162,6950203,254519,41,76,10,True,True,0.5738323555555556,-0.825727
8488,6696117,662,4,0.035429,172,6744950,-1,184.0,14689087,14689749,7992970,662,9,12,True,True,2.587743288888889,-0.035429
8489,6696123,68,1,0.463057,172,6744950,-1,7.0,9518639,9518707,2822516,68,40,0,True,True,0.016624299999999998,-0.463057
8490,6696212,17714,8,0.617749,172,6744950,-1,256.0,13501887,13519601,6805675,17714,18,12,True,True,132.4518840888889,-0.5791422006027735
8491,6696220,9492,4,0.488266,172,6744950,-1,80.0,8628243,8637735,1932023,9492,55,7,True,True,8.478676,-0.4287728986686426
8492,6696273,189,4,0.355744,172,6744950,-1,24.0,11625987,11626176,4929714,189,27,12,True,True,0.11268180000000001,-0.355744
8493,6696284,286,16,0.61553,172,6744950,-1,320.0,10198443,10198729,3502159,286,35,6,True,True,0.9680782222222222,-0.61553
8494,6696298,22865,1,0.328552,172,6744950,-1,47.0,15304901,15327766,8608603,22865,8,12,True,True,32.296365030555556,-0.325359448621505
8495,6696472,11783,4,0.353893,172,6744950,-1,172.0,8199918,8211701,1503446,11783,63,12,True,True,23.741021444444446,-0.34071218159508027
8496,6696604,20,4,0.005154,172,6744950,-1,80.0,16402301,16402321,9705697,20,1,12,True,True,0.05893333333333333,-0.005154
8497,6696658,25,8,0.890196,172,6744950,-1,312.0,8331418,8331443,1634760,25,62,11,True,True,0.19502166666666668,-0.890196
8498,6698389,10136,2,0.186158,172,6744950,-1,60.0,9660939,9671075,2962550,10136,42,8,True,True,6.590756666666667,-0.18073050984952996
8499,6698447,22,4,0.354532,172,6744950,-1,36.0,11280387,11280409,4581940,22,31,11,True,True,0.011629200000000001,-0.354532
8500,6698564,17,1,0.101338,172,6744950,-1,22.0,7630563,7630580,931999,17,78,10,True,True,0.009137027777777777,-0.101338
8501,6698630,1956,1,0.492046,172,6744950,-1,30.0,13198487,13200443,6499857,1956,21,12,True,True,1.4021259999999998,-0.492046
8502,6699954,9735,1,0.084744,172,6744950,-1,24.0,14819687,14829422,8119733,9735,11,11,True,True,17.407753733333333,-0.08255878734488917
8503,6705235,25,1,0.514319,172,6744950,-1,42.0,9631639,9631664,2926404,25,48,6,True,True,0.01647625,-0.514319
8504,6705489,19,22,0.153711,172,6744950,-1,924.0,15530901,15530920,8825412,19,6,12,True,True,0.6050968000000001,-0.153711
8505,6705689,2302,8,0.123843,172,6744950,-1,232.0,14512687,14514989,7806998,2302,16,7,True,True,15.364724577777778,-0.12384300000000002
8506,6705986,4,1,0.487412,172,6744950,-1,49.0,12848387,12848391,6142401,4,27,12,True,True,0.0089082,-0.487412
8507,6706134,41,16,0.15563,172,6744950,-1,112.0,13112087,13112128,6405953,41,25,12,True,True,0.10728697777777778,-0.15563
8508,6706223,14224,2,0.656633,172,6744950,-1,20.0,12329987,12344211,5623764,14224,31,7,True,True,7.260272555555556,-0.6452427598678084
8509,6706301,13442,8,0.226095,172,6744950,-1,288.0,15443601,15457043,8737300,13442,8,11,True,True,150.05943279999997,-0.21253232063870908
8510,6706308,37,1,0.395359,172,6744950,-1,46.0,12675587,12675624,5969279,37,31,12,True,True,0.04009027777777778,-0.38798026457773593
8511,6706394,30,8,0.299285,172,6744950,-1,56.0,13770087,13770117,7063693,30,22,12,True,True,0.045626,-0.299285
8512,6706686,147,32,0.428341,172,6744950,-1,1280.0,7909943,7910090,1203257,147,85,10,True,True,2.0384,-0.428341
8513,6706712,3,4,0.182182,172,6744950,-1,196.0,10103943,10103946,3397231,3,50,12,True,True,0.011449666666666665,-0.182182
8514,6706728,8,32,0.811544,172,6744950,-1,1152.0,8620143,8620151,1913415,8,75,11,True,True,0.08629759999999999,-0.811544
8515,6706789,20,1,0.108695,172,6744950,-1,28.0,15218487,15218507,8511698,20,12,0,True,True,0.02595288888888889,-0.108695
8516,6707123,32855,8,0.438572,172,6744950,-1,208.0,11890587,11923442,5183464,32855,40,7,True,True,205.79007857777773,-0.4383847946559348
8517,6707147,17258,8,0.839357,172,6744950,-1,160.0,7139341,7156599,432194,17258,100,11,True,True,67.02573777777778,-0.8331878438664161
8518,6708435,4880,1,0.161834,172,6744950,-1,26.0,10373243,10378123,3664808,4880,49,11,True,True,4.187206688888889,-0.14992091488503073
8519,6708487,62,4,0.353738,172,6744950,-1,188.0,14516287,14516349,7807800,62,18,2,True,True,0.3341710444444444,-0.353738
8520,6708512,324,4,0.43396,172,6744950,-1,200.0,10511044,10511368,3802532,324,50,11,True,True,2.2554,-0.43396
8521,6708732,57,1,0.359237,172,6744950,-1,42.0,15084287,15084344,8375555,57,14,7,True,True,0.10358705000000003,-0.359237
8522,6708906,16,1,0.870514,172,6744950,-1,21.0,7396923,7396939,688017,16,100,1,True,True,0.009409866666666667,-0.870514
8523,6708965,55,8,0.198465,172,6744950,-1,320.0,14775487,14775542,8066522,55,16,12,True,True,0.5694088888888889,-0.198465
8524,6709526,98,16,0.189567,172,6744950,-1,576.0,15132087,15132185,8422561,98,13,8,True,True,2.1696416,-0.189567
8525,6709543,8202,2,0.040256,172,6744950,-1,88.0,13590087,13598289,6880544,8202,30,7,True,True,27.3017558,-0.04019685298148976
8526,6709545,284,16,0.394546,172,6744950,-1,448.0,7400523,7400807,690978,284,103,8,True,True,4.167554844444444,-0.394546
8527,6710014,9997,1,0.743924,172,6744950,-1,6.0,8489543,8499540,1779529,9997,85,1,True,True,2.3307079666666666,-0.7435950671070113
8528,6710249,2100,8,0.900998,172,6744950,-1,96.0,6813101,6815201,102852,2100,123,1,True,True,2.4737656,-0.7046925138066571
8529,6710726,20,2,0.160313,172,6744950,-1,78.0,12021187,12021207,5310461,20,45,12,True,True,0.04413066666666667,-0.160313
8530,6710888,13426,42,0.198992,172,6744950,-1,924.0,15218501,15231927,8507613,13426,12,1,True,True,546.6441082666666,-0.19647278060899429
8531,6710908,15363,1,0.479295,172,6744950,-1,42.0,10306943,10322306,3596035,15363,59,10,True,True,25.025981633333334,-0.47562175870390044
8532,6711020,7021,21,0.665243,172,6744950,-1,105.0,9929143,9936164,3218123,7021,63,8,True,True,9.254079625000001,-0.546139174757144
8533,6711492,20210,4,0.2658,172,6744950,-1,68.0,16315901,16336111,9604409,20210,2,12,True,True,33.066497700000006,-0.2644675683469185
8534,6711790,2644,1,0.421095,172,6744950,-1,43.0,10466844,10469488,3755054,2644,58,12,True,True,3.2253320555555556,-0.36911688295992723
8535,6711902,21375,256,0.550124,172,6744950,-1,4352.0,11798787,11820162,5086885,21375,49,12,True,True,1971.0021589333332,-0.5431339968265982
8536,6712080,73,4,0.79982,172,6744950,-1,124.0,8439918,8439991,1727838,73,94,12,True,True,0.26233198888888887,-0.79982
8537,6712146,42,71,0.714321,172,6744950,-1,710.0,7716963,7717005,1004817,42,110,12,True,True,0.5327839999999999,-0.714321
8538,6712201,95,1,0.324888,172,6744950,-1,5.0,13022087,13022182,6309886,95,37,6,True,True,0.00800902777777778,-0.324888
8539,6712467,6,16,0.764393,172,6744950,-1,688.0,9973343,9973349,3260876,6,67,11,True,True,0.05353786666666666,-0.764393
8540,6712772,33,1,0.881767,172,6744950,-1,38.0,6979462,6979495,266690,33,124,10,True,True,0.026173766666666664,-0.881767
8541,6712792,8619,16,0.501859,172,6744950,-1,560.0,8353518,8362137,1640726,8619,97,10,True,True,57.17683533333333,-0.48644262294877194
8542,6713969,3251,1,0.923561,172,6744950,-1,34.0,6924811,6928062,210842,3251,131,7,True,True,1.6358762833333336,-0.8914224716878086
8543,6714465,81,5,0.843063,172,6744950,-1,110.0,7608463,7608544,893998,81,115,9,True,True,0.14770799999999998,-0.843063
8544,6714576,16,2,0.388849,172,6744950,-1,30.0,10599387,10599403,3884811,16,58,1,True,True,0.013813333333333334,-0.388849
8545,6715167,3,1,0.109733,172,6744950,-1,6.0,16540101,16540104,9824934,3,1,11,True,True,0.0004338000000000001,-0.109733
8546,6715187,24,26,0.10788,172,6744950,-1,624.0,13284887,13284911,6569700,24,35,12,True,True,0.5583136000000001,-0.10788
8547,6715308,98,8,0.021152,172,6744950,-1,304.0,15399401,15399499,8684093,98,11,7,True,True,1.4816554666666666,-0.021152
8548,6715781,6502,8,0.155542,172,6744950,-1,48.0,14077087,14083589,7361306,6502,29,12,True,True,7.918180933333333,-0.15147472678752955
8549,6715792,68,1,0.500001,172,6744950,-1,12.0,9747339,9747407,3031547,68,77,12,True,True,0.021460800000000002,-0.500001
8550,6716171,15494,8,0.767385,172,6744950,-1,120.0,7444963,7460457,728792,15494,123,1,True,True,65.535617,-0.7662548446673554
8551,6716218,21849,2,0.236505,172,6744950,-1,58.0,13588287,13610136,6872069,21849,36,12,True,True,44.20530996666667,-0.2302020394499656
8552,6716224,39,8,0.67831,172,6744950,-1,352.0,10951287,10951326,4235063,39,60,8,True,True,0.41626346666666664,-0.6783099999999999
8553,6716336,323,16,0.342141,172,6744950,-1,96.0,10861287,10861610,4144951,323,61,12,True,True,0.6064647999999999,-0.342141
8554,6716745,436,9,0.976439,172,6744950,-1,126.0,7027941,7028377,311196,436,135,11,True,True,1.2485732,-0.976439
8555,6716958,10598,32,0.737432,172,6744950,-1,960.0,9485941,9496539,2768983,10598,88,12,True,True,304.2818373333333,-0.7360677493524508
8556,6717398,25270,1,0.434329,172,6744950,-1,9.0,11712387,11737657,4994989,25270,56,12,True,True,5.191817100000001,-0.4199221460995654
8557,6717678,379,4,0.289467,172,6744950,-1,72.0,14338087,14338466,7620409,379,27,12,True,True,0.48663599999999996,-0.289467
8558,6717855,52,3,0.485929,172,6744950,-1,132.0,12238187,12238239,5520332,52,52,12,True,True,0.18748253333333334,-0.485929
8559,6717865,4,16,0.7609,172,6744950,-1,592.0,6925711,6925715,207846,4,147,6,True,True,0.03372426666666667,-0.7609
8560,6718881,47,64,0.247747,172,6744950,-1,384.0,6789150,6789197,70269,47,157,11,True,True,0.40838613333333335,-0.247747
8561,6719183,5048,32,0.152496,172,6744950,-1,896.0,15883901,15888949,9164718,5048,5,11,True,True,135.52331768888888,-0.14792734654290537
8562,6719217,1317,9,0.51124,172,6744950,-1,171.0,6816101,6817418,96884,1317,154,6,True,True,3.5332475999999997,-0.5112399999999999
8563,6719376,16026,16,0.249467,172,6744950,-1,192.0,15575101,15591127,8855725,16026,9,11,True,True,81.64135146666666,-0.24700746439266688
8564,6719543,6,16,0.766728,172,6744950,-1,624.0,7877043,7877049,1157500,6,126,1,True,True,0.040331200000000005,-0.766728
8565,6719575,240,8,0.864167,172,6744950,-1,344.0,7444723,7444963,725148,240,134,11,True,True,2.463895222222222,-0.8044689544035036
8566,6719590,9,4,0.994257,172,6744950,-1,136.0,7095141,7095150,375551,9,142,11,True,True,0.012325000000000001,-0.994257
8567,6719804,143,8,0.247354,172,6744950,-1,56.0,10599244,10599387,3879440,143,71,7,True,True,0.2304524444444444,-0.247354
8568,6719831,1,3,0.820609,172,6744950,-1,78.0,7718763,7718764,998932,1,130,7,True,True,0.0010497500000000001,-0.820609
8569,6719897,12,4,0.198412,172,6744950,-1,160.0,13990687,13990699,7270790,12,33,12,True,True,0.05205866666666667,-0.198412
8570,6719987,93,8,0.706461,172,6744950,-1,264.0,9289241,9289334,2569254,93,99,8,True,True,0.6285312000000001,-0.706461
8571,6720322,860,8,0.809952,172,6744950,-1,336.0,8621943,8622803,1901621,860,111,7,True,True,2.9088948000000006,-0.8059574759894257
8572,6720698,28,32,0.701145,172,6744950,-1,1344.0,10380444,10380472,3659746,28,76,0,True,True,1.2598357333333334,-0.701145
8573,6720775,10084,1,0.502334,172,6744950,-1,14.0,8625543,8635627,1904768,10084,112,8,True,True,1.4357571666666669,-0.4835079067473083
8574,6724918,7775,1,0.181188,172,6744950,-1,31.0,14424487,14432262,7699569,7775,29,12,True,True,8.46200645,-0.1679699050825542
8575,6750100,26,3,0.992552,206,6789150,-1,78.0,7258841,7258867,508741,26,147,7,True,True,0.02640343333333333,-0.992552
8576,6753849,169,4,0.591196,206,6789150,-1,40.0,12934787,12934956,6180938,169,49,12,True,True,0.17738211111111113,-0.5902203338698927
8577,6756623,10137,16,0.634477,206,6789150,-1,240.0,8485943,8496080,1729320,10137,118,7,True,True,93.82024200000001,-0.6177713136326255
8578,6756733,11913,1,0.229384,206,6789150,-1,30.0,13415487,13427400,6658754,11913,43,12,True,True,8.3255135,-0.2232649532506243
8579,6757768,2,4,0.132296,206,6789150,-1,164.0,12502787,12502789,5745019,2,55,12,True,True,0.007826444444444445,-0.132296
8580,6759208,10,8,0.038366,206,6789150,-1,328.0,9630739,9630749,2871531,10,97,12,True,True,0.051468666666666676,-0.038366
8581,6759419,51,8,0.990399,206,6789150,-1,88.0,6813050,6813101,53631,51,175,7,True,True,0.05144993333333333,-0.990399
8582,6759463,20,32,0.929098,206,6789150,-1,1184.0,7144741,7144761,385278,20,154,8,True,True,0.9709457777777779,-0.929098
8583,6759475,9246,1,0.426303,206,6789150,-1,31.0,14909687,14918933,8150212,9246,22,12,True,True,11.469109955555552,-0.40982248814977484
8584,6759776,2755,1,0.616467,206,6789150,-1,37.0,6861656,6864411,101880,2755,174,1,True,True,2.2561613333333335,-0.616467
8585,6760116,14,16,0.090935,206,6789150,-1,144.0,15218487,15218501,8458371,14,19,12,True,True,0.0934304,-0.090935
8586,6760143,10204,8,0.050955,206,6789150,-1,240.0,16143101,16153305,9382958,10204,4,12,True,True,97.20637399999998,-0.05031173692129009
8587,6760202,8,30,0.407297,206,6789150,-1,690.0,13683687,13683695,6923485,8,41,8,True,True,0.21808599999999995,-0.407297
8588,6760727,12352,4,0.306446,206,6789150,-1,152.0,11888787,11901139,5128060,12352,68,8,True,True,55.48804122222222,-0.3052904803760507
8589,6760798,17,4,0.63331,206,6789150,-1,156.0,7742663,7742680,981865,17,146,10,True,True,0.0427856,-0.63331
8590,6760809,91,32,0.231428,206,6789150,-1,1472.0,14996087,14996178,8235278,91,24,12,True,True,6.628391466666666,-0.231428
8591,6760837,5,8,0.336178,206,6789150,-1,272.0,7347241,7347246,586404,5,159,11,True,True,0.025892888888888896,-0.336178
8592,6760951,309,32,0.479195,206,6789150,-1,288.0,13329087,13329396,6568136,309,49,11,True,True,2.4423359999999996,-0.479195
8593,6761259,15,1,0.509864,206,6789150,-1,21.0,9834643,9834658,3073384,15,99,1,True,True,0.0057636250000000005,-0.509864
8594,6761321,23,2,0.643873,206,6789150,-1,22.0,9833739,9833762,3072418,23,100,12,True,True,0.009258394444444444,-0.643873
8595,6761626,29,4,0.30429,206,6789150,-1,96.0,10284843,10284872,3523217,29,91,12,True,True,0.07236853333333333,-0.30429
8596,6761885,5,2,0.269246,206,6789150,-1,82.0,14249887,14249892,7488002,5,36,12,True,True,0.006861805555555557,-0.269246
8597,6762086,24,1,0.280556,206,6789150,-1,10.0,11124087,11124111,4362001,24,78,12,True,True,0.006514,-0.280556
8598,6762107,17051,8,0.351025,206,6789150,-1,384.0,11037687,11054738,4275580,17051,79,12,True,True,182.18208,-0.350011976718948
8599,6762250,951,16,0.418074,206,6789150,-1,432.0,10017543,10018494,3255293,951,98,11,True,True,4.3571016,-0.418074
8600,6762557,16076,1,0.319841,206,6789150,-1,15.0,14510887,14526963,7748330,16076,33,12,True,True,7.529830374999999,-0.30999067184557894
8601,6762605,22,4,0.047556,206,6789150,-1,24.0,15665101,15665123,8902496,22,9,12,True,True,0.04626600000000001,-0.047556
8602,6762689,13406,8,0.040889,206,6789150,-1,56.0,14823287,14836693,8060598,13406,27,8,True,True,54.15398364444445,-0.04000106203546235
8603,6762751,645,1,0.052131,206,6789150,-1,24.0,8982241,8982886,2219490,645,126,11,True,True,0.137213,-0.052131
8604,6762947,4452,4,0.744755,206,6789150,-1,148.0,7884243,7888695,1121296,4452,155,2,True,True,8.8987146,-0.7198172991223205
8605,6763239,643,2,0.211978,206,6789150,-1,60.0,14163487,14164130,7400248,643,40,12,True,True,0.8380433333333334,-0.211978
8606,6763259,6866,64,0.472058,206,6789150,-1,384.0,11149787,11156653,4386528,6866,81,8,True,True,32.306752,-0.3308799134127603
8607,6763736,251,8,0.908482,206,6789150,-1,120.0,7720563,7720814,956827,251,163,7,True,True,0.40536500000000003,-0.908482
8608,6764066,118,32,0.100762,206,6789150,-1,768.0,16405901,16406019,9641835,118,2,8,True,True,2.4637141333333337,-0.100762
8609,6764140,11607,7,0.18484,206,6789150,-1,63.0,16229501,16241108,9465361,11607,5,12,True,True,26.249950650000002,-0.1823382560751287
8610,6792760,455,1,0.948328,252,6811250,-1,35.0,6861201,6861656,68441,455,200,11,True,True,0.4287765416666667,-0.9252195033750145
8611,6792892,89,2,0.363581,252,6811250,-1,66.0,7371141,7371230,578249,89,177,7,True,True,0.3543164166666667,-0.363581
8612,6792903,2,8,0.304357,252,6811250,-1,224.0,11885187,11885189,5092284,2,78,12,True,True,0.01148871111111111,-0.304357
8613,6792922,9391,8,0.096887,252,6811250,-1,296.0,15397601,15406992,8604679,9391,18,6,True,True,144.63570346666666,-0.09570949891194858
8614,6792964,41,4,0.013662,252,6811250,-1,136.0,12416387,12416428,5623423,41,70,12,True,True,0.12882335555555557,-0.012972811201857878
8615,6792988,13,8,0.551768,252,6811250,-1,184.0,7918066,7918079,1125078,13,158,2,True,True,0.03632517777777777,-0.551768
8616,6793046,25,1,0.861974,252,6811250,-1,7.0,8484118,8484143,1691072,25,148,11,True,True,0.007420972222222222,-0.861974
8617,6793120,1,64,0.331212,252,6811250,-1,3200.0,10380443,10380444,3587323,1,101,9,True,True,0.10712888888888888,-0.33121199999999995
8618,6793359,12183,4,0.741292,252,6811250,-1,48.0,7168641,7180824,375282,12183,187,10,True,True,5.0144564,-0.7331014842123034
8619,6793507,94,2,0.361385,252,6811250,-1,96.0,15396701,15396795,8603194,94,19,7,True,True,0.38457280000000005,-0.361385
8620,6793644,375,2,0.778808,252,6811250,-1,86.0,7489163,7489538,695519,375,178,11,True,True,0.5485187499999999,-0.778808
8621,6793657,5,1,0.528862,252,6811250,-1,45.0,11539587,11539592,4745930,5,85,12,True,True,0.006245625,-0.528862
8622,6793690,13373,16,0.371592,252,6811250,-1,448.0,13856487,13869860,7062797,13373,50,12,True,True,238.95044320000002,-0.365895076676921
8623,6794425,36,1,0.650248,252,6811250,-1,48.0,7369341,7369377,574916,36,188,10,True,True,0.104232,-0.650248
8624,6794611,16,8,0.210033,252,6811250,-1,296.0,12065387,12065403,5270776,16,78,10,True,True,0.14777635555555554,-0.210033
8625,6794650,8,1,0.384049,252,6811250,-1,34.0,9518639,9518647,2723989,8,129,10,True,True,0.0094996,-0.3840490000000001
8626,6794882,6903,16,0.887194,252,6811250,-1,464.0,7146541,7153444,351659,6903,195,7,True,True,80.79213111111112,-0.8460591340122653
8627,6794897,9,4,0.130485,252,6811250,-1,168.0,10111143,10111152,3316246,9,112,9,True,True,0.033075,-0.130485
8628,6795119,4,1,0.742587,252,6811250,-1,33.0,9834639,9834643,3039520,4,121,6,True,True,0.0024152333333333333,-0.742587
8629,6795199,30161,62,0.120354,252,6811250,-1,1984.0,10686687,10716848,3891488,30161,98,12,True,True,1534.8066161777776,-0.11755678862935054
8630,6795317,113,1,0.586561,252,6811250,-1,41.0,8851641,8851754,2056324,113,143,11,True,True,0.04186430277777778,-0.586561
8631,6795662,23,4,0.912177,252,6811250,-1,148.0,7914443,7914466,1118781,23,171,2,True,True,0.05292274444444445,-0.912177
8632,6795678,11543,4,0.654355,252,6811250,-1,116.0,7575563,7587106,779885,11543,187,12,True,True,41.29194515555556,-0.6354060941927473
8633,6795730,72,16,0.190434,252,6811250,-1,192.0,11236187,11236259,4440457,72,90,12,True,True,0.1810176,-0.190434
8634,6795780,240,4,0.70466,252,6811250,-1,116.0,9199241,9199481,2403461,240,141,10,True,True,0.3302906666666667,-0.70466
8635,6796706,8,32,0.925501,252,6811250,-1,1536.0,7050941,7050949,254235,8,208,6,True,True,0.2836821333333333,-0.925501
8636,6797232,9963,1,0.07488,252,6811250,-1,30.0,15753301,15763264,8956069,9963,10,7,True,True,19.50908583333333,-0.07347127235031581
8637,6797280,18,2,0.546579,252,6811250,-1,84.0,9522239,9522257,2724959,18,133,8,True,True,0.045628800000000004,-0.546579
8638,6797293,62,8,0.342898,252,6811250,-1,168.0,9090741,9090803,2293448,62,145,12,True,True,0.20791493333333336,-0.342898
8639,6797647,13965,128,0.725351,252,6811250,-1,5248.0,10380444,10394409,3582797,13965,108,1,True,True,2774.6328192,-0.7216724517153654
8640,6797758,1656,1,0.989645,252,6811250,-1,41.0,7597663,7599319,799905,1656,193,10,True,True,1.8028274000000002,-0.989645
8641,6797788,16,1,0.201999,252,6811250,-1,20.0,11934787,11934803,5136999,16,82,11,True,True,0.007160888888888889,-0.201999
8642,6797820,77,16,0.720769,252,6811250,-1,320.0,8938041,8938118,2140221,77,150,12,True,True,0.2060177777777778,-0.720769
8643,6797940,56,1,0.043811,252,6811250,-1,19.0,16409501,16409557,9611561,56,2,8,True,True,0.025278866666666663,-0.043811
8644,6801335,5109,64,0.191707,252,6811250,-1,1088.0,16495901,16501010,9694566,5109,2,12,True,True,102.59267893333336,-0.1908086183430831
8645,6801695,17432,1,0.550496,252,6811250,-1,39.0,7257041,7274473,455346,17432,210,11,True,True,12.289106050000001,-0.5187691924354055
8646,6801769,11,1,0.252526,252,6811250,-1,48.0,15082487,15082498,8280718,11,32,12,True,True,0.024854133333333337,-0.25252600000000003
8647,6801804,22853,35,0.877075,252,6811250,-1,1365.0,7303041,7325894,501237,22853,210,11,True,True,646.8334979166667,-0.8287482832178148
8648,6801841,23,32,0.853438,252,6811250,-1,480.0,6915811,6915834,113970,23,233,11,True,True,0.14572800000000002,-0.853438
8649,6802457,5,2,0.906815,252,6811250,-1,80.0,6871611,6871616,69154,5,234,8,True,True,0.010920000000000001,-0.906815
8650,6802703,23827,1,0.975126,252,6811250,-1,6.0,7786863,7810690,984160,23827,191,11,True,True,6.402249116666667,-0.9429061390902193
8651,6802844,5402,1,0.894913,252,6811250,-1,41.0,6817001,6822403,14157,5402,241,6,True,True,2.459346163888889,-0.7220476558769424
8652,6808475,12039,1,0.448482,252,6811250,-1,12.0,11366787,11378826,4558312,12039,94,12,True,True,4.3884518,-0.4462363242077167
8653,6808515,225,16,0.717326,252,6811250,-1,224.0,8715641,8715866,1907126,225,159,0,True,True,0.57666,-0.717326
8654,6809122,42,1,0.910849,252,6811250,-1,47.0,8575943,8575985,1766821,42,168,12,True,True,0.048061416666666676,-0.910849
8655,6809142,3938,1,0.067708,252,6811250,-1,14.0,16056701,16060639,9247559,3938,9,12,True,True,2.6407351833333332,-0.06696758904511357
8656,6809863,679,1,0.419004,252,6811250,-1,18.0,6983062,6983741,173199,679,229,8,True,True,0.2071629,-0.4190040000000001
8657,6810153,9066,32,0.931332,252,6811250,-1,320.0,10947687,10956753,4137534,9066,103,12,True,True,86.78887200000001,-0.9299109538766046
6872,5320285,20178,32,0.782156,1,5320285,-1,352.0,5406685,5426863,86400,20178,0,12,True,True,290.46165768888886,-0.7762699374972106
6873,5320299,5629,1,0.947383,130,5406685,-1,18.0,6144895,6150524,824596,5629,0,8,True,True,3.9925679,-0.9179615954057061
6874,5320322,43,1,0.82361,130,5406685,-1,9.0,6374695,6374738,1054373,43,0,11,True,True,0.01117785,-0.82361
6875,5320330,6210,64,0.041969,130,5406685,-1,1216.0,14174578,14180788,8854248,6210,0,12,True,True,306.82932124444443,-0.041171478037159225
6876,5320417,54,8,0.105411,130,5406685,-1,184.0,7421573,7421627,2101156,54,1,0,True,True,0.32082239999999995,-0.105411
6877,5320442,4531,11,0.629926,130,5406685,-1,242.0,7424273,7428804,2103831,4531,1,7,True,True,49.82108987777777,-0.6082736814452994
6878,5320811,78,1,0.870869,130,5406685,-1,34.0,6904796,6904874,1583985,78,3,6,True,True,0.0953428,-0.8037071119180306
6879,5326366,3,16,0.910986,130,5406685,-1,736.0,6329595,6329598,1003229,3,5,11,True,True,0.06045626666666666,-0.910986
6880,5326406,82,2,0.157033,130,5406685,-1,82.0,7152784,7152866,1826378,82,3,10,True,True,0.20166396666666667,-0.157033
6881,5326414,738,1,0.292123,130,5406685,-1,6.0,8204565,8205303,2878151,738,1,11,True,True,0.18073619999999999,-0.292123
6882,5326463,8,4,0.441518,130,5406685,-1,104.0,9035565,9035573,3709102,8,1,12,True,True,0.017918044444444444,-0.441518
6883,5326490,27824,32,0.505897,130,5406685,-1,1536.0,8338765,8366589,3012275,27824,2,12,True,True,1934.8440362666668,-0.5011494676915325
6884,5326642,8,1,0.732552,130,5406685,-1,24.0,5630251,5630259,303609,8,11,1,True,True,0.0063194666666666665,-0.732552
6885,5326650,12078,75,0.099294,130,5406685,-1,3300.0,13569778,13581856,8243128,12078,1,12,True,True,2206.198353333333,-0.09844284771301527
6886,5326702,2168,1,0.647093,130,5406685,-1,32.0,6697008,6699176,1370306,2168,9,1,True,True,2.2838193777777778,-0.647093
6887,5326733,123,16,0.334608,130,5406685,-1,608.0,11033965,11034088,5707232,123,2,12,True,True,0.5330521777777778,-0.3288463155692148
6888,5326785,41,64,0.137772,130,5406685,-1,3072.0,12223597,12223638,6896812,41,2,2,True,True,6.6828031999999995,-0.137772
6889,5326885,9,21,0.848595,130,5406685,-1,483.0,6437873,6437882,1110988,9,12,1,True,True,0.093617475,-0.848595
6890,5327312,15,32,0.439108,130,5406685,-1,160.0,10081565,10081580,4754253,15,4,7,True,True,0.08609333333333333,-0.439108
6891,5329574,6132,123,0.41575,130,5406685,-1,2460.0,11423765,11429897,6094191,6132,3,0,True,True,565.5700446666667,-0.41385847779606394
6892,5329625,78,4,0.769033,130,5406685,-1,200.0,6437795,6437873,1108170,78,15,2,True,True,0.3359633333333334,-0.769033
6893,5329685,3044,1,0.245316,130,5406685,-1,10.0,7332129,7335173,2002444,3044,11,6,True,True,1.3423795,-0.2272739108081472
6894,5329717,4,1,0.809145,130,5406685,-1,44.0,7691665,7691669,2361948,4,9,11,True,True,0.004227911111111111,-0.809145
6895,5329743,52,16,0.34132,130,5406685,-1,208.0,7531573,7531625,2201830,52,10,6,True,True,0.46454719999999994,-0.34132
6896,5329758,22,16,0.505023,130,5406685,-1,464.0,6439673,6439695,1109915,22,17,7,True,True,0.21984062222222225,-0.505023
6897,5329929,64,8,0.085234,130,5406685,-1,104.0,14520178,14520242,9190249,64,0,12,True,True,0.09213013333333332,-0.085234
6898,5329953,19403,32,0.372436,130,5406685,-1,864.0,7807365,7826768,2477412,19403,10,10,True,True,526.340112,-0.32089693358652377
6899,5329987,18,1,0.754845,130,5406685,-1,21.0,5908241,5908259,578254,18,25,10,True,True,0.014272650000000001,-0.754845
6900,5330013,41,1,0.360643,130,5406685,-1,50.0,6427895,6427936,1097882,41,22,3,True,True,0.059136805555555554,-0.36064300000000005
6901,5330215,11785,4,0.664995,130,5406685,-1,180.0,10298565,10310350,4968350,11785,6,12,True,True,60.62843249999999,-0.633939525075099
6902,5330225,41,4,0.151611,130,5406685,-1,116.0,11423765,11423806,6093540,41,5,12,True,True,0.18126965555555558,-0.151611
6903,5330796,12039,128,0.753507,130,5406685,-1,4864.0,6433295,6445334,1102499,12039,24,8,True,True,1523.5617450666666,-0.7056549707328107
6904,5331322,6,3,0.421722,130,5406685,-1,81.0,7129784,7129790,1798462,6,19,1,True,True,0.01857465,-0.421722
6905,5331339,5,2,0.228182,130,5406685,-1,94.0,13828978,13828983,8497639,5,2,12,True,True,0.01809761111111111,-0.228182
6906,5331402,7,1,0.801769,130,5406685,-1,34.0,6562773,6562780,1231371,7,23,11,True,True,0.0063777388888888896,-0.801769
6907,5331500,12101,32,0.413409,130,5406685,-1,1568.0,9599965,9612066,4268465,12101,10,12,True,True,758.5118681777777,-0.4024635203476966
6908,5331724,2922,1,0.409309,130,5406685,-1,37.0,7421573,7424495,2089849,2922,19,12,True,True,4.023536016666666,-0.3509392410502319
6909,5332028,13055,64,0.458753,130,5406685,-1,2944.0,7647465,7660520,2315437,13055,16,8,True,True,862.3621226666667,-0.45838542885581246
6910,5332161,81,32,0.85239,130,5406685,-1,512.0,5885241,5885322,553080,81,36,7,True,True,0.983808,-0.85239
6911,5332646,86,1,0.794607,130,5406685,-1,30.0,6434195,6434281,1101549,86,30,6,True,True,0.06300933333333333,-0.7946069999999997
6912,5332815,13,62,0.361774,130,5406685,-1,1364.0,13220578,13220591,7887763,13,4,12,True,True,0.29543482222222217,-0.361774
6913,5332881,34,4,0.029763,130,5406685,-1,184.0,11951365,11951399,6618484,34,6,7,True,True,0.19216346666666667,-0.029763
6914,5333114,8162,1,0.145584,130,5406685,-1,11.0,12669097,12677259,7335983,8162,5,12,True,True,0.8875898777777778,-0.1370977516475629
6915,5333205,8,1,0.009949,130,5406685,-1,38.0,6043228,6043236,710023,8,39,10,True,True,0.013642000000000001,-0.009949
6916,5333254,19,1,0.806247,130,5406685,-1,25.0,6241195,6241214,907941,19,38,7,True,True,0.01149763888888889,-0.806247
6917,5335249,15,1,0.943643,130,5406685,-1,8.0,5924157,5924172,588908,15,41,3,True,True,0.004667,-0.943643
6918,5335270,6733,64,0.084778,130,5406685,-1,2688.0,11513765,11520498,6178495,6733,8,12,True,True,689.2973920000001,-0.08445498625586313
6919,5335279,3,32,0.314805,130,5406685,-1,1120.0,6878108,6878111,1542829,3,29,12,True,True,0.13597733333333334,-0.314805
6920,5340417,383,2,0.981945,130,5406685,-1,92.0,6719108,6719491,1378691,383,30,10,True,True,1.2118247666666668,-0.981945
6921,5340511,14931,4,0.164325,130,5406685,-1,124.0,13742578,13757509,8402067,14931,3,12,True,True,122.95547911111112,-0.15844997055536067
6922,5340780,110,6,0.061468,130,5406685,-1,270.0,13656178,13656288,8315398,110,4,12,True,True,1.8259725000000002,-0.061468
6923,5340881,12,1,0.759192,130,5406685,-1,5.0,6932296,6932308,1591415,12,30,8,True,True,0.0018745,-0.759192
6924,5340988,39962,32,0.660176,130,5406685,-1,160.0,7287029,7326991,1946041,39962,28,12,True,True,201.11713955555553,-0.6529139046620395
6925,5344910,8897,8,0.641466,130,5406685,-1,128.0,6330495,6339392,985585,8897,44,6,True,True,31.971146311111113,-0.6397113528822476
6926,5344928,82,2,0.902511,130,5406685,-1,72.0,6429695,6429777,1084767,82,42,0,True,True,0.1559968,-0.902511
6927,5345018,18384,32,0.05781,130,5406685,-1,992.0,14606578,14624962,9261560,18384,0,12,True,True,244.0575109333333,-0.05685581192635489
6928,5345307,137,1,0.631608,130,5406685,-1,29.0,9772765,9772902,4427458,137,17,12,True,True,0.23246464444444445,-0.631608
6929,5346560,21193,5,0.71337,130,5406685,-1,160.0,6468973,6490166,1122413,21193,39,0,True,True,90.70689644444444,-0.6740269869041072
6930,5346791,429,4,0.660362,130,5406685,-1,172.0,5916057,5916486,569266,429,54,2,True,True,2.5565492333333335,-0.660362
6931,5347388,67,4,0.519778,130,5406685,-1,76.0,8068565,8068632,2721177,67,22,11,True,True,0.21998854444444443,-0.519778
6932,5347761,27299,2,0.295724,130,5406685,-1,74.0,11423765,11451064,6076004,27299,12,0,True,True,64.91650719444443,-0.2862436785759624
6933,5347929,6468,64,0.402003,130,5406685,-1,1408.0,8382965,8389433,3035036,6468,21,11,True,True,339.26818737777774,-0.39544794214216517
6934,5348178,7111,2,0.680871,130,5406685,-1,28.0,6420695,6427806,1072517,7111,50,7,True,True,5.017534666666666,-0.6249152040153437
6935,5348221,13489,128,0.55361,130,5406685,-1,640.0,10471365,10484854,5123144,13489,16,12,True,True,272.7757973333333,-0.47739652316615183
6936,5348239,5,8,0.304323,130,5406685,-1,128.0,9859165,9859170,4510926,5,19,12,True,True,0.02611555555555556,-0.304323
6937,5351461,8142,14,0.742698,130,5406685,-1,448.0,5626651,5634793,275190,8142,64,1,True,True,121.85649528888888,-0.7252303007706447
6938,5351872,9,16,0.909231,130,5406685,-1,688.0,5515185,5515194,163313,9,65,10,True,True,0.211044,-0.909231
6939,5352215,331,1,0.007902,130,5406685,-1,50.0,7530673,7531004,2178458,331,31,8,True,True,0.628716111111111,-0.007902
6940,5352494,6,38,0.279781,130,5406685,-1,1824.0,12315397,12315403,6962903,6,9,12,True,True,0.1739184,-0.279781
6941,5354007,20,4,0.527792,130,5406685,-1,28.0,9903365,9903385,4549358,20,20,0,True,True,0.020528666666666667,-0.527792
6942,5354320,591,1,0.920451,130,5406685,-1,15.0,5927757,5928348,573437,591,62,8,True,True,0.34130249999999995,-0.920451
6943,5365988,59,1,0.700295,130,5406685,-1,30.0,5626592,5626651,260604,59,69,10,True,True,0.05836575,-0.700295
6944,5366909,14,8,0.446189,130,5406685,-1,88.0,9121965,9121979,3755056,14,24,12,True,True,0.02345933333333333,-0.446189
6945,5368060,28288,32,0.205134,130,5406685,-1,736.0,12225397,12253685,6857337,28288,10,7,True,True,771.1281616888889,-0.18907807993503267
6946,5368628,29,4,0.544425,130,5406685,-1,48.0,7557308,7557337,2188680,29,34,1,True,True,0.05795746666666666,-0.544425
6947,5368861,25820,32,0.788342,130,5406685,-1,1376.0,7178529,7204349,1809668,25820,42,1,True,True,1337.2225694222223,-0.7854106228284903
6948,5369672,15,16,0.652037,130,5406685,-1,800.0,10079765,10079780,4710093,15,21,12,True,True,0.40753333333333336,-0.6520370000000001
6949,5370616,1305,1,0.697471,130,5406685,-1,44.0,5913641,5914946,543025,1305,70,8,True,True,2.330833388888889,-0.6848354235478622
6950,5370641,67,16,0.887675,130,5406685,-1,624.0,5493085,5493152,122444,67,77,12,True,True,1.6506030666666667,-0.887675
6951,5370673,44,32,0.781563,130,5406685,-1,1120.0,8073965,8074009,2703292,44,31,7,True,True,2.230056888888889,-0.781563
6952,5371268,13678,10,0.404506,130,5406685,-1,480.0,8208165,8221843,2836897,13678,30,8,True,True,293.653652,-0.40004025758399125
6953,5372935,449,1,0.197296,130,5406685,-1,13.0,12401797,12402246,7028862,449,9,12,True,True,0.17336290833333332,-0.17505083451456033
6954,5373410,98,64,0.301531,130,5406685,-1,2752.0,8555765,8555863,3182355,98,29,12,True,True,13.52300693333333,-0.301531
6955,5378120,396,13,0.03697,130,5406685,-1,91.0,6903896,6904292,1525776,396,52,2,True,True,1.4038024,-0.03697
6956,5388412,6,1,0.334493,130,5406685,-1,34.0,9123765,9123771,3735353,6,27,7,True,True,0.003307066666666667,-0.334493
6957,5388565,8152,2,0.725099,130,5406685,-1,88.0,6141295,6149447,752730,8152,72,7,True,True,28.605817533333333,-0.7022469796644188
6958,5389569,16113,2,0.740052,130,5406685,-1,92.0,6047736,6063849,658167,16113,73,2,True,True,46.501467466666675,-0.6932093817335186
6959,5389584,10674,128,0.126006,130,5406685,-1,1152.0,6044136,6054810,654552,10674,74,6,True,True,388.36070399999994,-0.10806837044329963
6960,5389601,1979,4,0.991924,130,5406685,-1,148.0,6021128,6023107,631527,1979,76,6,True,True,8.454235655555555,-0.8700402616460767
6961,5389650,26581,155,0.283928,130,5406685,-1,2790.0,13063397,13089978,7673747,26581,8,11,True,True,3629.46461625,-0.2648950441134985
6962,5391038,45,1,0.09282,130,5406685,-1,8.0,7178484,7178529,1787446,45,50,8,True,True,0.010635,-0.09282
6963,5391101,5394,8,0.551786,130,5406685,-1,184.0,5787841,5793235,396740,5394,85,12,True,True,33.487523644444444,-0.5368109092057124
6964,5391112,6,4,0.521336,130,5406685,-1,188.0,5699641,5699647,308529,6,86,6,True,True,0.04770813333333334,-0.5213360000000001
6965,5391518,27437,32,0.757046,130,5406685,-1,1344.0,6791708,6819145,1400190,27437,57,7,True,True,1225.7586880000001,-0.7391514082672022
6966,5391702,8,12,0.160027,130,5406685,-1,552.0,8862765,8862773,3471063,8,31,12,True,True,0.0858912,-0.160027
6967,5391780,16,1,0.027891,130,5406685,-1,13.0,14001778,14001794,8609998,16,3,12,True,True,0.0104936,-0.027891
6968,5391840,32318,256,0.796599,130,5406685,-1,2304.0,6566373,6598691,1174533,32318,62,8,True,True,1860.2503039999997,-0.7713120257477857
6969,5391868,7,1,0.592504,130,5406685,-1,17.0,5559385,5559392,167517,7,94,10,True,True,0.003946502777777778,-0.592504
6970,5391915,8,16,0.24134,130,5406685,-1,768.0,12219997,12220005,6828082,8,15,2,True,True,0.3769173333333333,-0.24134
6971,5391923,81,1,0.774158,130,5406685,-1,37.0,5698741,5698822,306818,81,92,2,True,True,0.13552483333333334,-0.7559212325833512
6972,5392042,21,8,0.726509,130,5406685,-1,96.0,6427895,6427916,1035853,21,72,0,True,True,0.058156000000000006,-0.7265090000000001
6973,5394059,27,8,0.986955,130,5406685,-1,64.0,6652773,6652800,1258714,27,63,12,True,True,0.048907200000000005,-0.986955
6974,5394249,11103,32,0.110442,130,5406685,-1,352.0,11949565,11960668,6555316,11103,17,11,True,True,145.5387159111111,-0.10548615047047097
6975,5394560,7298,14,0.059946,130,5406685,-1,574.0,9296565,9303863,3902005,7298,31,12,True,True,109.15817313333332,-0.05977913569208203
6976,5394817,14571,2,0.372979,130,5406685,-1,66.0,7785265,7799836,2390448,14571,44,12,True,True,49.419313716666665,-0.3671344852566134
6977,5394829,50,2,0.62699,130,5406685,-1,12.0,6742108,6742158,1347279,50,64,6,True,True,0.028045,-0.62699
6978,5394850,119,1,0.354473,130,5406685,-1,15.0,6422495,6422614,1027645,119,79,7,True,True,0.04646454166666666,-0.354473
6979,5394947,10210,61,0.047733,130,5406685,-1,2501.0,12489097,12499307,7094150,10210,11,12,True,True,455.0108412861111,-0.04634566151000194
6980,5395042,13069,128,0.650962,130,5406685,-1,2688.0,5537285,5550354,142243,13069,105,10,True,True,1335.3661664,-0.6460466342407425
6981,5395051,13,1,0.12475,130,5406685,-1,39.0,11953165,11953178,6558114,13,17,7,True,True,0.02260375,-0.12475
6982,5404216,108,8,0.297961,130,5406685,-1,312.0,8252365,8252473,2848149,108,41,11,True,True,1.3104,-0.297961
6983,5404231,12590,4,0.736859,130,5406685,-1,148.0,5633851,5646441,229620,12590,103,2,True,True,63.98611403333333,-0.7228378582355619
6984,5404251,19571,32,0.453147,130,5406685,-1,1408.0,5917857,5937428,513606,19571,96,7,True,True,1025.3273731555555,-0.43996094469184494
6985,5404355,423,1,0.982951,130,5406685,-1,37.0,6117395,6117818,713040,423,90,11,True,True,0.808504575,-0.982951
6986,5404531,3,32,0.805388,130,5406685,-1,416.0,6446873,6446876,1042342,3,74,9,True,True,0.03842453333333334,-0.805388
6987,5404663,8273,256,0.989,130,5406685,-1,4864.0,5604492,5612765,199829,8273,110,11,True,True,1655.7428771555553,-0.9734222114311165
6988,5404726,360,1,0.565597,130,5406685,-1,17.0,6429695,6430055,1024969,360,81,7,True,True,0.16170400000000001,-0.565597
6989,5404883,1167,32,0.894339,130,5406685,-1,1408.0,5930228,5931395,525345,1167,97,2,True,True,54.967463466666665,-0.894339
6990,5405062,5649,1,0.627744,130,5406685,-1,47.0,12039997,12045646,6634935,5649,17,1,True,True,8.340799774999999,-0.5863091785376512
6991,5405093,38,1,0.533289,130,5406685,-1,27.0,10730565,10730603,5325472,38,26,12,True,True,0.02511705,-0.533289
6992,5405279,2611,6,0.595549,130,5406685,-1,264.0,6900208,6902819,1494929,2611,67,10,True,True,27.578232,-0.5710154576127616
6993,5405300,6178,1,0.350337,130,5406685,-1,50.0,7084996,7091174,1679696,6178,64,10,True,True,5.968209444444446,-0.3473259547964068
6994,5405341,13,32,0.284535,130,5406685,-1,1472.0,10861165,10861178,5455824,13,26,12,True,True,0.47898471111111107,-0.284535
6995,5405392,6561,1,0.784789,130,5406685,-1,24.0,7174884,7181445,1769492,6561,63,10,True,True,4.2469402,-0.77315617632358
6996,5405421,11,5,0.714854,130,5406685,-1,45.0,6231295,6231306,825874,11,96,12,True,True,0.016286875000000003,-0.714854
6997,5405739,13037,8,0.672434,130,5406685,-1,160.0,7335173,7348210,1929434,13037,59,1,True,True,84.92317866666666,-0.6399786030288918
6998,5405856,10708,4,0.714351,130,5406685,-1,128.0,7643865,7654573,2238009,10708,53,1,True,True,30.379694577777773,-0.7059265588764343
6999,5406099,4,4,0.519667,130,5406685,-1,88.0,7523473,7523477,2117374,4,57,11,True,True,0.0133672,-0.519667
7000,5406479,9453,64,0.247633,130,5406685,-1,448.0,11423765,11433218,6017286,9453,24,0,True,True,151.8049655111111,-0.24385206374096094
7001,5406487,7846,2,0.327847,130,5406685,-1,86.0,8689965,8697811,3283478,7846,42,8,True,True,21.690640738888888,-0.3250547797508563
7002,5406499,17137,16,0.582369,130,5406685,-1,176.0,11164565,11181702,5758066,17137,26,11,True,True,67.5957348,-0.5814205289774242
7003,5407008,60,32,0.822843,196,5493085,-1,832.0,6418895,6418955,1011887,60,98,11,True,True,0.9775999999999999,-0.822843
7004,5408337,30,1,0.361268,196,5493085,-1,8.0,6652800,6652830,1244463,30,82,1,True,True,0.006763333333333334,-0.361268
7005,5408442,13751,4,0.097988,196,5493085,-1,116.0,13019197,13032948,7610755,13751,10,6,True,True,61.94630840000001,-0.09115054172558479
7006,5408570,39,2,0.71164,196,5493085,-1,26.0,5560292,5560331,151722,39,129,6,True,True,0.03362818333333333,-0.71164
7007,5408757,11264,1,0.828438,196,5493085,-1,26.0,6741208,6752472,1332451,11264,81,10,True,True,12.833047066666667,-0.8041924642296064
7008,5408765,62,16,0.081947,196,5493085,-1,752.0,12928297,12928359,7519532,62,11,12,True,True,1.366212711111111,-0.081947
7009,5408895,18,14,0.062194,196,5493085,-1,532.0,10212165,10212183,4803270,18,34,11,True,True,0.3133214,-0.062193999999999985
7010,5409161,8,71,0.888509,196,5493085,-1,2201.0,9903365,9903373,4494204,8,38,11,True,True,0.6454799333333333,-0.888509
7011,5420634,14037,16,0.476253,196,5493085,-1,704.0,11732565,11746602,6311931,14037,23,11,True,True,372.3135738666667,-0.47453067068630483
7012,5422871,157,16,0.446164,196,5493085,-1,400.0,7643708,7643865,2220837,157,62,12,True,True,1.3969511111111113,-0.446164
7013,5422941,8321,16,0.369294,196,5493085,-1,112.0,7851565,7859886,2428624,8321,57,11,True,True,30.068140355555556,-0.3260797941447482
7014,5477459,2,8,0.526256,196,5493085,-1,168.0,6285395,6285397,807936,2,111,11,True,True,0.006772266666666668,-0.526256
7015,5477492,47,4,0.588239,196,5493085,-1,164.0,9686365,9686412,4208873,47,42,12,True,True,0.32105961111111114,-0.588239
7016,5477898,6728,1,0.518945,196,5493085,-1,7.0,11120365,11127093,5642467,6728,30,12,True,True,0.609900938888889,-0.2946844026972416
7017,5477922,13,32,0.394782,196,5493085,-1,1536.0,12931897,12931910,7453975,13,11,8,True,True,0.6164565333333334,-0.394782
7018,5478470,419,8,0.263694,196,5493085,-1,296.0,12039578,12039997,6561108,419,21,12,True,True,4.449361,-0.263694
7019,5478503,40,16,0.498827,196,5493085,-1,96.0,6073195,6073235,594692,40,121,8,True,True,0.14707066666666666,-0.4986778076149217
7020,5478704,24,15,0.423422,196,5493085,-1,735.0,10557765,10557789,5079061,24,36,12,True,True,0.647878,-0.423422
7021,5478751,62,2,0.44008,196,5493085,-1,54.0,7422473,7422535,1943722,62,74,6,True,True,0.10810319999999998,-0.44007999999999997
7022,5479037,2589,2,0.931036,196,5493085,-1,36.0,5919657,5922246,440620,2589,131,7,True,True,3.4737354,-0.8922203045956907
7023,5479188,71,1,0.489541,196,5493085,-1,20.0,6928696,6928767,1449508,71,87,10,True,True,0.043041777777777776,-0.489541
7024,5479215,588,8,0.973272,196,5493085,-1,296.0,7129196,7129784,1649981,588,85,10,True,True,6.652017866666666,-0.973272
7025,5479876,5033,32,0.823812,196,5493085,-1,416.0,5832041,5837074,352165,5033,139,11,True,True,72.31102435555555,-0.8227909672728068
7026,5479895,11349,1,0.144346,196,5493085,-1,29.0,10774765,10786114,5294870,11349,35,11,True,True,2.9923894888888887,-0.12649860079764316
7027,5480199,37,3,0.127124,196,5493085,-1,24.0,13134178,13134215,7653979,37,9,11,True,True,0.039631933333333334,-0.127124
7028,5480208,151,1,0.711151,196,5493085,-1,40.0,8686365,8686516,3206157,151,56,11,True,True,0.16682144444444447,-0.7111509999999999
7029,5480252,1035,2,0.129385,196,5493085,-1,30.0,14260978,14262013,8780726,1035,2,12,True,True,0.6075449999999999,-0.129385
7030,5480313,14,32,0.704525,196,5493085,-1,608.0,5646441,5646455,166128,14,147,2,True,True,0.30891466666666667,-0.704525
7031,5480362,4,1,0.863272,196,5493085,-1,35.0,7698865,7698869,2218503,4,69,9,True,True,0.003240611111111111,-0.863272
7032,5480469,3,4,0.118058,196,5493085,-1,200.0,12402697,12402700,6922228,3,17,6,True,True,0.015951666666666666,-0.118058
7033,5480759,566,16,0.212643,196,5493085,-1,608.0,12575497,12576063,7094738,566,16,12,True,True,5.1275072,-0.212643
7034,5485254,131,2,0.473356,196,5493085,-1,20.0,11427365,11427496,5942111,131,31,2,True,True,0.09700549999999998,-0.473356
7035,5485298,15703,245,0.746496,196,5493085,-1,1470.0,7937965,7953668,2452667,15703,69,12,True,True,1008.5989684166666,-0.7220324098895049
7036,5485316,3332,8,0.94407,196,5493085,-1,128.0,6139495,6142827,654179,3332,133,10,True,True,17.653894755555555,-0.9353099564377975
7037,5486882,13,5,0.369332,196,5493085,-1,180.0,9989765,9989778,4502883,13,48,12,True,True,0.0839345,-0.369332
7038,5486925,10610,19,0.951822,196,5493085,-1,323.0,8024365,8034975,2537440,10610,70,12,True,True,157.48722295833335,-0.9423508740409731
7039,5487043,7,26,0.6016,196,5493085,-1,1014.0,5932028,5932035,444985,7,142,7,True,True,0.23744781666666667,-0.6016
7040,5487080,10179,3,0.40862,196,5493085,-1,108.0,6423395,6433574,936315,10179,124,6,True,True,29.798658900000003,-0.40773110891593195
7041,5487115,84,1,0.120866,196,5493085,-1,18.0,12126397,12126481,6639282,84,24,12,True,True,0.0897876,-0.120866
7042,5487163,45,6,0.571765,196,5493085,-1,204.0,7421573,7421618,1934410,45,87,0,True,True,0.296412,-0.571765
7043,5487270,308,31,0.040282,196,5493085,-1,1395.0,9513565,9513873,4026295,308,56,12,True,True,11.8049085,-0.040282
7044,5487342,177,4,0.153305,196,5493085,-1,28.0,6472573,6472750,985231,177,116,2,True,True,0.135051,-0.153305
7045,5487359,26976,32,0.371467,196,5493085,-1,1344.0,12582697,12609673,7095338,26976,16,0,True,True,660.4996272000001,-0.3513452607635679
7046,5487843,2,1,0.99102,196,5493085,-1,13.0,6474373,6474375,986530,2,117,7,True,True,0.0005897666666666667,-0.99102
7047,5490421,5,1,0.30326,196,5493085,-1,17.0,11600165,11600170,6109744,5,32,12,True,True,0.0017741388888888891,-0.30326
7048,5490572,21,2,0.485926,196,5493085,-1,28.0,7468473,7468494,1977901,21,88,11,True,True,0.025656400000000003,-0.485926
7049,5490962,111,4,0.791204,196,5493085,-1,92.0,7107096,7107207,1616134,111,103,10,True,True,0.5049266666666666,-0.791204
7050,5491084,157,4,0.14214,196,5493085,-1,120.0,11818965,11819122,6327881,157,31,12,True,True,0.8586853333333335,-0.14214
7051,5491425,61,1,0.589624,196,5493085,-1,11.0,6424295,6424356,932870,61,134,6,True,True,0.017466502777777778,-0.589624
7052,5491435,11921,1,0.048651,196,5493085,-1,44.0,5695141,5707062,203706,11921,168,6,True,True,22.8554414,-0.046908097116139066
7053,5491457,33,16,0.894253,196,5493085,-1,624.0,5933828,5933861,442371,33,154,7,True,True,0.7675096000000001,-0.894253
7054,5491562,13,16,0.889057,196,5493085,-1,624.0,6903808,6903821,1412246,13,110,8,True,True,0.3160074666666667,-0.889057
7055,5491583,3979,4,0.215581,196,5493085,-1,132.0,12582697,12586676,7091114,3979,17,9,True,True,8.8979528,-0.20861596571790603
7056,5491672,6016,16,0.819125,196,5493085,-1,336.0,5910041,5916057,418369,6016,165,0,True,True,79.34420480000001,-0.8057808230476903
7057,5491709,6190,14,0.488794,196,5493085,-1,350.0,9210165,9216355,3718456,6190,62,12,True,True,67.02756180555555,-0.48592693625208916
7058,5491949,14,16,0.122328,196,5493085,-1,192.0,7130684,7130698,1638735,14,104,6,True,True,0.10273386666666666,-0.122328
7059,5491967,22,5,0.348649,196,5493085,-1,110.0,5700541,5700563,208574,22,172,6,True,True,0.10235255555555556,-0.348649
7060,5491982,9,32,0.870427,196,5493085,-1,832.0,5642851,5642860,150869,9,177,9,True,True,0.24483679999999997,-0.8704269999999998
7061,5492093,656,13,0.417575,196,5493085,-1,468.0,7535173,7535829,2043080,656,88,2,True,True,13.8724976,-0.417575
7062,5492111,86,6,0.573059,196,5493085,-1,150.0,8642165,8642251,3150054,86,69,12,True,True,0.6354683333333333,-0.573059
7063,5492209,66,4,0.565764,196,5493085,-1,124.0,7475673,7475739,1983464,66,93,9,True,True,0.3891037333333333,-0.565764
7064,5492297,16,2,0.900287,196,5493085,-1,82.0,6239395,6239411,747098,16,151,6,True,True,0.03175768888888889,-0.900287
7065,5492396,13696,10,0.781349,196,5493085,-1,260.0,6043236,6056932,550840,13696,160,1,True,True,115.00406377777779,-0.7114888797163404
7066,5492736,12909,32,0.475228,196,5493085,-1,416.0,7200629,7213538,1707893,12909,103,10,True,True,167.50587822222224,-0.4730787110447758
7067,5492746,6972,4,0.720033,196,5493085,-1,96.0,5876241,5883213,383495,6972,176,11,True,True,17.721545600000002,-0.6978000982843262
7068,5492762,7019,8,0.60571,196,5493085,-1,336.0,5701441,5708460,208679,7019,179,6,True,True,99.60239706666667,-0.6024602768236518
7069,5492799,67,8,0.761951,196,5493085,-1,400.0,7062896,7062963,1570097,67,113,12,True,True,0.9074033333333333,-0.761951
7070,5493423,5372,16,0.504764,234,5515185,-1,96.0,6468973,6474345,975550,5372,133,10,True,True,13.489202933333335,-0.4295479385729178
7071,5493530,88,13,0.460936,234,5515185,-1,78.0,11250965,11251053,5757435,88,41,12,True,True,0.18786386666666668,-0.460936
7072,5493769,13421,1,0.449929,234,5515185,-1,17.0,8160365,8173786,2666596,13421,77,12,True,True,8.646809308333335,-0.4254272588032689
7073,5493787,13,8,0.449075,234,5515185,-1,80.0,8469365,8469378,2975578,13,72,12,True,True,0.044670888888888885,-0.449075
7074,5493820,8,4,0.866346,234,5515185,-1,192.0,6697000,6697008,1203180,8,129,11,True,True,0.05056426666666667,-0.866346
7075,5498257,36,16,0.325216,234,5515185,-1,768.0,7331229,7331265,1832972,36,105,11,True,True,1.0409472,-0.325216
7076,5498524,6193,16,0.799812,234,5515185,-1,272.0,6976496,6982689,1477972,6193,118,11,True,True,49.09822737777778,-0.7858289901097764
7077,5498578,7933,4,0.664502,234,5515185,-1,92.0,6906596,6914529,1408018,7933,121,7,True,True,24.713921411111112,-0.652540798129731
7078,5503043,45,2,0.409628,234,5515185,-1,98.0,11686565,11686610,6183522,45,34,12,True,True,0.16206750000000003,-0.409628
7079,5503055,41,4,0.232822,234,5515185,-1,104.0,8072165,8072206,2569110,41,81,8,True,True,0.19295784444444442,-0.232822
7080,5503068,48,18,0.395397,234,5515185,-1,90.0,12841897,12841945,7338829,48,15,12,True,True,0.081,-0.395397
7081,5503216,94,4,0.540994,234,5515185,-1,116.0,12755497,12755591,7252281,94,16,12,True,True,0.1493848,-0.540994
7082,5503428,11,1,0.958079,234,5515185,-1,50.0,6020228,6020239,516800,11,177,12,True,True,0.015467222222222224,-0.9580790000000002
7083,5503584,37,1,0.890043,234,5515185,-1,6.0,6518573,6518610,1014989,37,141,11,True,True,0.0069658666666666666,-0.8900430000000003
7084,5503596,4,1,0.735913,234,5515185,-1,5.0,8949165,8949169,3445569,4,70,12,True,True,0.0003949444444444445,-0.735913
7085,5503600,11,32,0.645917,234,5515185,-1,1280.0,5910041,5910052,406441,11,190,7,True,True,0.5316373333333334,-0.645917
7086,5503641,4,4,0.865954,234,5515185,-1,72.0,5648241,5648245,144600,4,201,7,True,True,0.010452,-0.865954
7087,5503690,23431,64,0.707209,234,5515185,-1,704.0,7527073,7550504,2023383,23431,100,8,True,True,662.1062291555555,-0.6999474767576477
7088,5503736,280,16,0.571995,234,5515185,-1,528.0,7479273,7479553,1975537,280,102,8,True,True,6.445413333333333,-0.571995
7089,5503803,35,16,0.796159,234,5515185,-1,256.0,5635651,5635686,131848,35,206,7,True,True,0.31566577777777777,-0.7961589999999997
7090,5504030,35,2,0.707399,234,5515185,-1,44.0,7557273,7557308,2053243,35,97,10,True,True,0.0641196111111111,-0.707399
7091,5504142,9,2,0.561044,234,5515185,-1,42.0,5886141,5886150,381999,9,195,6,True,True,0.00857115,-0.561044
7092,5504872,4,4,0.123782,234,5515185,-1,120.0,9340765,9340769,3835893,4,65,11,True,True,0.013470666666666667,-0.123782
7093,5505288,30625,128,0.559353,234,5515185,-1,6272.0,11953178,11983803,6447890,30625,31,1,True,True,5597.659438933333,-0.5363698213767872
7094,5505382,7,2,0.192427,234,5515185,-1,32.0,11905365,11905372,6399983,7,35,12,True,True,0.010231822222222221,-0.192427
7095,5505403,262,33,0.618704,234,5515185,-1,1023.0,10947565,10947827,5442162,262,50,12,True,True,2.9921385999999996,-0.6160827497257508
7096,5505919,8727,128,0.576856,234,5515185,-1,4992.0,12228997,12237724,6723078,8727,25,8,True,True,1410.3777237333334,-0.5012176608725661
7097,5506043,1264,1,0.052874,234,5515185,-1,16.0,14433778,14435042,8927735,1264,2,12,True,True,0.20420622222222223,-0.052874
7098,5506093,121,1,0.570244,234,5515185,-1,5.0,6789908,6790029,1283815,121,142,11,True,True,0.020637222222222223,-0.570244
7099,5507487,30,8,0.189396,234,5515185,-1,352.0,9427165,9427195,3919678,30,70,12,True,True,0.4239839999999999,-0.189396
7100,5508181,351,2,0.475836,234,5515185,-1,78.0,11337365,11337716,5829184,351,48,12,True,True,1.2102597,-0.475836
7101,5508235,556,16,0.896864,234,5515185,-1,608.0,5694241,5694797,186006,556,214,7,True,True,16.0741824,-0.896864
7102,5508271,117,32,0.120283,234,5515185,-1,896.0,14347378,14347495,8839107,117,3,12,True,True,1.8648448000000002,-0.120283
7103,5512274,9671,7,0.936182,234,5515185,-1,168.0,5920557,5930228,408283,9671,198,6,True,True,61.57783893333334,-0.9267026062569556
7104,5512317,6,1,0.179743,234,5515185,-1,13.0,9993365,9993371,4481048,6,64,8,True,True,0.0026988,-0.179743
7105,5512777,20,7,0.018974,234,5515185,-1,168.0,10384965,10384985,4872188,20,60,12,True,True,0.07534800000000001,-0.018974
7106,5513422,88,138,0.786757,234,5515185,-1,3864.0,6903808,6903896,1390386,88,143,0,True,True,13.246135466666667,-0.786757
7107,5513454,3,10,0.245287,234,5515185,-1,490.0,13483378,13483381,7969924,3,11,8,True,True,0.07005366666666667,-0.245287
7108,5513708,7,2,0.705618,234,5515185,-1,10.0,5559392,5559399,45684,7,231,1,True,True,0.002321472222222222,-0.705618
7109,5517238,53,1,0.887656,252,5537285,-1,30.0,6238495,6238548,721257,53,185,9,True,True,0.04076141666666667,-0.887656
7110,5519081,16744,4,0.444229,252,5537285,-1,76.0,12212797,12229541,6693716,16744,32,12,True,True,72.99446156666666,-0.4233378254134579
7111,5519111,53,15,0.806921,252,5537285,-1,645.0,6745708,6745761,1226597,53,151,8,True,True,1.5067988333333335,-0.806921
7112,5519157,42120,185,0.606855,252,5537285,-1,5920.0,11688365,11730485,6169208,42120,43,7,True,True,8731.630246666666,-0.5862451429784875
7113,5519879,144,4,0.401798,252,5537285,-1,108.0,10644165,10644309,5124286,144,61,12,True,True,0.4890672,-0.4017980000000001
7114,5522376,10914,32,0.044984,252,5537285,-1,1152.0,13018297,13029211,7495921,10914,16,12,True,True,465.97624319999994,-0.04314835452772299
7115,5524692,16121,8,0.861974,252,5537285,-1,248.0,5692441,5708562,167749,16121,227,11,True,True,176.15279213333332,-0.8559886861383975
7116,5525123,5,6,0.023263,252,5537285,-1,252.0,8776365,8776370,3251242,5,88,12,True,True,0.034174,-0.023263
7117,5525158,6,13,0.437017,252,5537285,-1,624.0,5883441,5883447,358283,6,219,9,True,True,0.08881600000000002,-0.4370170000000001
7118,5525495,6,60,0.414936,252,5537285,-1,1980.0,13306978,13306984,7781483,6,12,12,True,True,0.643269,-0.414936
7119,5526245,9346,256,0.859648,252,5537285,-1,9984.0,6063849,6073195,537604,9346,199,8,True,True,3490.637058133333,-0.8596122466568881
7120,5526393,11543,64,0.317382,252,5537285,-1,2432.0,10861165,10872708,5334772,11543,60,0,True,True,600.4481603555556,-0.27348992736014976
7121,5526548,25,1,0.257178,252,5537285,-1,41.0,12216397,12216422,6689849,25,34,1,True,True,0.07268673611111111,-0.257178
7122,5526694,11103,1,0.114645,252,5537285,-1,21.0,10167965,10179068,4641271,11103,71,12,True,True,8.576216716666668,-0.1118142437105805
7123,5526755,39,32,0.099334,252,5537285,-1,1120.0,14088178,14088217,8561423,39,6,12,True,True,2.006610666666667,-0.099334
7124,5526871,12087,32,0.168156,252,5537285,-1,1216.0,13479778,13491865,7952907,12087,13,12,True,True,658.2830659555556,-0.1662016818206051
7125,5526964,9,32,0.144034,252,5537285,-1,1472.0,13393378,13393387,7866414,9,14,12,True,True,0.4066032,-0.144034
7126,5529375,6075,128,0.255555,252,5537285,-1,4480.0,13089978,13096053,7560603,6075,18,8,True,True,939.5275680000002,-0.25469315341762677
7127,5529431,6,1,0.089629,252,5537285,-1,31.0,13915378,13915384,8385947,6,8,12,True,True,0.006977583333333335,-0.089629
1150,994133,154,1,0.052609,1,994133,-1,17.0,1080533,1080687,86400,154,0,12,True,True,0.07187137222222222,-0.05260900000000002
1151,994202,6763,2,0.15741,10,1080533,-1,26.0,8257116,8263879,7262914,6763,0,12,True,True,8.005731355555554,-0.15652241552270446
1152,994284,10744,16,0.617838,10,1080533,-1,224.0,5598416,5609160,4604132,10744,1,12,True,True,67.09045404444444,-0.6076946609666335
1153,994848,30,1,0.673969,10,1080533,-1,27.0,1166933,1166963,172085,30,2,12,True,True,0.029450249999999997,-0.673969
1154,994925,4132,128,0.272103,10,1080533,-1,1536.0,8519916,8524048,7524991,4132,0,8,True,True,219.80047359999998,-0.26827963625903417
1155,995038,72,1,0.661939,10,1080533,-1,28.0,3580592,3580664,2585554,72,3,11,True,True,0.07904400000000002,-0.661939
1156,995070,14346,1,0.485662,10,1080533,-1,33.0,1538432,1552778,543362,14346,4,10,True,True,15.320416833333333,-0.4594681055902079
1157,995191,16,40,0.442044,10,1080533,-1,520.0,5995416,5995432,5000225,16,2,12,True,True,0.24352177777777778,-0.442044
1158,995919,234,8,0.273167,10,1080533,-1,280.0,6081816,6082050,5085897,234,2,12,True,True,3.073798,-0.273167
1159,995960,21928,16,0.754943,10,1080533,-1,304.0,1600795,1622723,604835,21928,6,8,True,True,254.83884097777778,-0.7516707646834913
1160,995966,8966,256,0.113818,10,1080533,-1,7936.0,10192537,10201503,9196571,8966,0,12,True,True,1501.600275911111,-0.10841890412365605
1161,1093171,1,5,0.429914,104,1166933,-1,250.0,3775791,3775792,2682620,1,6,8,True,True,0.00854375,-0.429914
1162,1093221,15556,64,0.283246,104,1166933,-1,1280.0,9532737,9548293,8439516,15556,1,1,True,True,293.8585991111111,-0.2509503802972679
1163,1093281,10,1,0.678486,104,1166933,-1,25.0,1480732,1480742,387451,10,11,11,True,True,0.006465277777777777,-0.678486
1164,1093299,23,1,0.486633,104,1166933,-1,10.0,4237672,4237695,3144373,23,7,0,True,True,0.009534138888888889,-0.486633
1165,1093712,4738,32,0.667133,104,1166933,-1,800.0,4346172,4350910,3252460,4738,7,10,True,True,165.8259422222222,-0.659690650553796
1166,1093772,12,8,0.045417,104,1166933,-1,128.0,9441816,9441828,8348044,12,2,8,True,True,0.045585066666666674,-0.045417
1167,1093777,14,8,0.395263,104,1166933,-1,336.0,9528216,9528230,8434439,14,2,12,True,True,0.14545813333333332,-0.395263
1168,1093910,16958,1,0.599325,104,1166933,-1,42.0,1211133,1228091,117223,16958,16,11,True,True,28.652576633333336,-0.579403405254838
1169,1093937,63,1,0.007687,104,1166933,-1,21.0,10365337,10365400,9271400,63,0,12,True,True,0.064602825,-0.007687
1170,1093970,6681,4,0.301419,104,1166933,-1,136.0,6519216,6525897,5425246,6681,7,12,True,True,29.030838800000005,-0.29925667886850715
1171,1094413,13584,4,0.211234,104,1166933,-1,136.0,9351816,9365400,8257403,13584,5,8,True,True,101.53144373333333,-0.17944284139225666
1172,1094762,81,1,0.137235,104,1166933,-1,33.0,9217616,9217697,8122854,81,6,12,True,True,0.20690505,-0.137235
1173,1094806,4127,4,0.25552,104,1166933,-1,20.0,3027287,3031414,1932481,4127,17,9,True,True,2.063810833333333,-0.1789824407497163
1174,1094913,15538,1,0.328122,104,1166933,-1,6.0,7997916,8013454,6903003,15538,9,12,True,True,3.9605352666666667,-0.31588766265370444
1175,1095007,5,6,0.00773,104,1166933,-1,246.0,4680816,4680821,3585809,5,14,11,True,True,0.033660999999999996,-0.00773
1176,1095043,7568,1,0.747014,104,1166933,-1,33.0,1410913,1418481,315870,7568,23,10,True,True,5.701224466666666,-0.5613916746213813
1177,1095366,20494,2,0.175695,104,1166933,-1,22.0,5508416,5528910,4413050,20494,14,11,True,True,16.467808255555553,-0.17349249132167402
1178,1095385,18,16,0.380207,104,1166933,-1,96.0,1540232,1540250,444847,18,22,7,True,True,0.070344,-0.380207
1179,1095413,34,4,0.703671,104,1166933,-1,156.0,1597195,1597229,501782,34,22,7,True,True,0.19016313333333335,-0.703671
1180,1095456,22,2,0.500262,104,1166933,-1,90.0,5800516,5800538,4705060,22,13,8,True,True,0.06649500000000001,-0.500262
1181,1095651,10565,1,0.833354,104,1166933,-1,14.0,2652109,2662674,1556458,10565,22,1,True,True,4.8709462666666665,-0.806938499780357
1182,1095814,3,16,0.8062,104,1166933,-1,320.0,1387913,1387916,292099,3,29,8,True,True,0.023904,-0.8062
1183,1095861,25,1,0.072075,104,1166933,-1,47.0,9261816,9261841,8165955,25,6,11,True,True,0.050045208333333334,-0.07207499999999999
1184,1095977,15240,7,0.861764,104,1166933,-1,161.0,1809395,1824635,713418,15240,24,10,True,True,85.18762680555557,-0.8609315052481347
1185,1095989,22,1,0.042302,104,1166933,-1,26.0,9131216,9131238,8035227,22,8,12,True,True,0.029254622222222224,-0.042302
1186,1096064,35,2,0.018742,104,1166933,-1,50.0,1277833,1277868,181769,35,33,1,True,True,0.06785625,-0.018742
1187,1097312,6379,2,0.921162,104,1166933,-1,14.0,1291853,1298232,194541,6379,33,7,True,True,2.6210221722222222,-0.9176318837842787
1188,1098703,9,1,0.86211,104,1166933,-1,31.0,2035095,2035104,936392,9,25,0,True,True,0.010258675,-0.86211
1189,1102692,3,8,0.575759,104,1166933,-1,328.0,3020087,3020090,1917395,3,24,10,True,True,0.02764493333333334,-0.575759
1190,1102770,8,2,0.5734,104,1166933,-1,50.0,4463816,4463824,3361046,8,19,7,True,True,0.01889888888888889,-0.5734
1191,1126168,9182,1,0.709499,104,1166933,-1,29.0,1512732,1521914,386564,9182,33,7,True,True,8.391155155555555,-0.6999319256824892
1192,1126543,12,1,0.417694,104,1166933,-1,46.0,5464216,5464228,4337673,12,18,12,True,True,0.0138966,-0.4176940000000001
1193,1126627,8,2,0.115173,104,1166933,-1,24.0,8654116,8654124,7527489,8,9,12,True,True,0.014451733333333334,-0.115173
1194,1127158,4722,32,0.020857,104,1166933,-1,512.0,10582337,10587059,9455179,4722,0,12,True,True,60.21795555555556,-0.019469320054571356
1195,1135592,103,36,0.324768,104,1166933,-1,1296.0,6256416,6256519,5120824,103,15,6,True,True,5.6191032,-0.324768
1196,1135907,12,1,0.801322,104,1166933,-1,21.0,1542032,1542044,406125,12,35,7,True,True,0.0085029,-0.801322
1197,1137382,3744,8,0.618125,104,1166933,-1,232.0,4349772,4353516,3212390,3744,24,8,True,True,40.3433616,-0.5683736956363106
1198,1139349,9081,1,0.832026,104,1166933,-1,41.0,1647695,1656776,508346,9081,34,7,True,True,13.770020947222223,-0.8107808822140753
1199,1146845,26,1,0.91977,104,1166933,-1,35.0,1566095,1566121,419250,26,37,1,True,True,0.049450916666666664,-0.91977
1200,1146985,279,1,0.08813,104,1166933,-1,13.0,1832795,1833074,685810,279,33,7,True,True,0.16202614999999998,-0.08813
1201,1147010,5,23,0.844484,104,1166933,-1,460.0,3113687,3113692,1966677,5,29,12,True,True,0.09099055555555555,-0.844484
1202,1147066,593,16,0.243316,104,1166933,-1,800.0,4353372,4353965,3206306,593,24,3,True,True,24.07448222222222,-0.243316
1203,1147188,25840,32,0.588871,104,1166933,-1,1376.0,1273333,1299173,126145,25840,50,8,True,True,1157.8497703111111,-0.5758230602609897
1204,1147611,3,10,0.523963,104,1166933,-1,190.0,3336092,3336095,2188481,3,30,7,True,True,0.016506250000000004,-0.523963
1205,1148007,12000,2,0.395767,104,1166933,-1,26.0,6169116,6181116,5021109,12000,16,6,True,True,14.479404333333335,-0.3927370231371652
1206,1149858,6,8,0.310275,104,1166933,-1,344.0,4006291,4006297,2856433,6,29,6,True,True,0.04512133333333334,-0.310275
1207,1149895,19,1,0.339513,104,1166933,-1,26.0,4702916,4702935,3553021,19,23,10,True,True,0.025209094444444448,-0.339513
1208,1149959,40703,8,0.333069,104,1166933,-1,264.0,3113692,3154395,1963733,40703,34,1,True,True,418.51061706666667,-0.3287050711718842
1209,1150623,31,1,0.168133,104,1166933,-1,22.0,9846937,9846968,8696314,31,3,0,True,True,0.027855911111111107,-0.168133
1210,1150917,11999,8,0.510483,104,1166933,-1,296.0,1591795,1603794,440878,11999,46,10,True,True,117.36406577777778,-0.5036041640077774
1211,1151265,945,1,0.114027,104,1166933,-1,48.0,5291416,5292361,4140151,945,24,12,True,True,1.1113054666666666,-0.1106995033218894
1212,1151881,41,4,0.509952,104,1166933,-1,140.0,5377816,5377857,4225935,41,24,12,True,True,0.13229105555555556,-0.509952
1213,1152096,5885,64,0.905923,104,1166933,-1,1664.0,1284168,1290053,132072,5885,58,6,True,True,289.7798268444444,-0.8269314428481395
1214,1152326,16,4,0.349375,104,1166933,-1,40.0,2652093,2652109,1499767,16,42,6,True,True,0.021621333333333336,-0.34937500000000005
1215,1152376,78,1,0.727379,104,1166933,-1,10.0,1644995,1645073,492619,78,47,10,True,True,0.030283500000000005,-0.727379
1216,1152625,2691,32,0.818949,104,1166933,-1,992.0,1279668,1282359,127043,2691,61,7,True,True,99.08494453333333,-0.7986522053041104
1217,1154344,11288,256,0.815037,104,1166933,-1,6656.0,1425239,1436527,270895,11288,57,3,True,True,2323.1315697777777,-0.6879303916650159
1218,1154580,39231,21,0.236269,104,1166933,-1,756.0,4324072,4363303,3169492,39231,32,12,True,True,1421.6346732,-0.23386917060496795
1219,1154754,47,4,0.146444,104,1166933,-1,76.0,8958416,8958463,7803662,47,11,12,True,True,0.05089107777777778,-0.146444
1220,1154807,20,1,0.197272,104,1166933,-1,6.0,8564116,8564136,7409309,20,13,11,True,True,0.007067333333333334,-0.197272
1221,1155116,73,1,0.602399,104,1166933,-1,21.0,4725016,4725089,3569900,73,28,10,True,True,0.06817165833333334,-0.602399
1222,1156885,275,32,0.760215,104,1166933,-1,544.0,1214733,1215008,57848,275,69,1,True,True,7.0636133333333335,-0.760215
1223,1156930,21,16,0.655509,104,1166933,-1,272.0,2258346,2258367,1101416,21,47,11,True,True,0.1552870666666667,-0.655509
1224,1157013,250,16,0.177146,104,1166933,-1,736.0,3782991,3783241,2625978,250,38,9,True,True,7.9866222222222225,-0.177146
1225,1157242,3957,128,0.772848,104,1166933,-1,5760.0,1787295,1791252,630053,3957,52,7,True,True,824.64672,-0.7671110562410969
1226,1157590,4,1,0.494117,104,1166933,-1,29.0,3766791,3766795,2609201,4,40,12,True,True,0.003574411111111111,-0.494117
1227,1157662,571,4,0.754446,104,1166933,-1,72.0,1542932,1543503,385270,571,60,6,True,True,1.3871874,-0.754446
1228,1157674,47,22,0.759877,104,1166933,-1,396.0,3288292,3288339,2130618,47,43,12,True,True,0.5814699000000001,-0.759877
1229,1157686,12145,27,0.448905,104,1166933,-1,972.0,6864816,6876961,5707130,12145,17,12,True,True,536.5248570000001,-0.4465487600061235
1230,1158062,1278,1,0.924154,104,1166933,-1,49.0,1262533,1263811,104471,1278,76,8,True,True,1.742239236111111,-0.7817646025812344
1231,1158132,9455,1,0.564492,104,1166933,-1,29.0,2825187,2834642,1667055,9455,49,12,True,True,7.068235008333334,-0.5026660809160779
1232,1159630,20,4,0.635298,104,1166933,-1,116.0,3449992,3450012,2290362,20,43,12,True,True,0.03822844444444445,-0.6352980000000001
1233,1160181,12751,8,0.624522,104,1166933,-1,104.0,3610491,3623242,2450310,12751,42,1,True,True,39.06129326666667,-0.5396816635080764
1234,1160206,1405,23,0.864247,104,1166933,-1,1035.0,2325546,2326951,1165340,1405,54,6,True,True,50.58902037499999,-0.7288757870859005
1235,1162444,17559,29,0.627217,104,1166933,-1,1276.0,1645895,1663454,483451,17559,61,6,True,True,784.6374698555557,-0.6210062244587271
1236,1162633,10395,1,0.150957,104,1166933,-1,20.0,10409537,10419932,9246904,10395,1,11,True,True,7.786975055555557,-0.14805492882666782
1237,1162667,27183,1,0.068286,104,1166933,-1,37.0,9044816,9071999,7882149,27183,12,12,True,True,50.39053309999999,-0.0682834788860805
1238,1162881,1,1,0.442208,104,1166933,-1,20.0,6868416,6868417,5705535,1,19,8,True,True,0.0009316111111111111,-0.442208
1239,1162899,378,16,0.30282,104,1166933,-1,240.0,7824216,7824594,6661317,378,19,12,True,True,2.7150479999999995,-0.30282
1240,1162909,8618,32,0.274674,104,1166933,-1,1408.0,7392216,7400834,6229307,8618,20,12,True,True,140.6546865777778,-0.26522836924090953
1241,1162924,907,61,0.056172,104,1166933,-1,1220.0,10278937,10279844,9116013,907,3,12,True,True,34.760724611111115,-0.056172
1242,1162981,3,2,0.507337,104,1166933,-1,40.0,6778416,6778419,5615435,3,24,12,True,True,0.0018543333333333335,-0.5073369999999999
1243,1163064,15836,49,0.310408,104,1166933,-1,735.0,4855616,4871452,3692552,15836,36,11,True,True,646.6084181666666,-0.3100986397898878
1244,1163448,240,4,0.451914,104,1166933,-1,188.0,7478616,7478856,6315168,240,21,12,True,True,0.7145253333333333,-0.451914
1245,1164035,54,2,0.05689,104,1166933,-1,16.0,10019737,10019791,8855702,54,5,12,True,True,0.0407664,-0.05689
1246,1164071,1339,2,0.831697,104,1166933,-1,98.0,1293653,1294992,129582,1339,86,7,True,True,3.9158831833333343,-0.831697
1247,1165297,130,1,0.076731,104,1166933,-1,29.0,3584192,3584322,2418895,130,53,2,True,True,0.13878836111111112,-0.076731
1248,1165977,107,16,0.86425,104,1166933,-1,480.0,1990895,1991002,824918,107,68,12,True,True,1.8094413333333335,-0.86425
1249,1166085,343,1,0.855293,104,1166933,-1,21.0,1904495,1904838,738410,343,69,7,True,True,0.2875597666666667,-0.855293
1250,1166325,41,16,0.615008,104,1166933,-1,176.0,3768591,3768632,2602266,41,51,7,True,True,0.22235302222222225,-0.615008
1251,1166467,320,4,0.507068,104,1166933,-1,112.0,9438216,9438536,8271749,320,10,12,True,True,1.1668906666666667,-0.507068
1252,1166489,16048,16,0.462712,104,1166933,-1,640.0,3831691,3847739,2665202,16048,50,6,True,True,431.94236266666667,-0.4555680307203492
1253,1166504,6611,8,0.554316,104,1166933,-1,192.0,1412713,1419324,246209,6611,90,7,True,True,31.164377066666667,-0.4511667190547291
1254,1166548,6845,8,0.791818,104,1166933,-1,168.0,1287768,1294613,121220,6845,95,1,True,True,32.8118014,-0.7698674869418631
1255,1166563,8,5,0.895877,104,1166933,-1,100.0,1318013,1318021,151450,8,93,8,True,True,0.03489111111111111,-0.895877
1256,1166965,13672,32,0.449734,206,1211133,-1,1152.0,2035095,2048767,868130,13672,71,11,True,True,675.4847711999998,-0.4273938415745632
1257,1166983,17,1,0.809816,206,1211133,-1,8.0,1595395,1595412,428412,17,82,2,True,True,0.004875977777777777,-0.809816
1258,1167043,5,2,0.651837,206,1211133,-1,34.0,1436527,1436532,269484,5,91,7,True,True,0.005870194444444445,-0.651837
1259,1167058,13082,32,0.321527,206,1211133,-1,1536.0,4375616,4388698,3208558,13082,44,10,True,True,940.5555285333332,-0.3184805263663339
1260,1167100,21,32,0.475629,206,1211133,-1,448.0,5796916,5796937,4629816,21,34,12,True,True,0.3351338666666667,-0.475629
1261,1167121,2163,1,0.150861,206,1211133,-1,32.0,9348216,9350379,8181095,2163,12,12,True,True,5.401321333333334,-0.14548479515366308
1262,1167209,4961,4,0.061874,206,1211133,-1,108.0,9756937,9761898,8589728,4961,7,12,True,True,20.1686904,-0.06008659347797825
1263,1167268,1093,1,0.103502,206,1211133,-1,39.0,6168216,6169309,5000948,1093,33,12,True,True,2.0005087916666664,-0.103502
1264,1167302,11886,27,0.899127,206,1211133,-1,756.0,1510932,1522818,343630,11886,95,6,True,True,281.56679460000004,-0.8337961548761714
1265,1167605,8344,4,0.343438,206,1211133,-1,36.0,4237672,4246016,3070067,8344,54,12,True,True,12.750012,-0.3409928455721908
1266,1167610,121,4,0.714316,206,1211133,-1,148.0,4636616,4636737,3469006,121,47,12,True,True,0.6461305888888889,-0.714316
1267,1169111,2,8,0.504549,206,1211133,-1,288.0,4986216,4986218,3817105,2,43,11,True,True,0.0296944,-0.504549
1268,1169121,13195,173,0.172559,206,1211133,-1,7612.0,6432816,6446011,5263695,13195,31,12,True,True,3665.347959044444,-0.1686863876869413
1269,1169177,61,8,0.247744,206,1211133,-1,352.0,9531816,9531877,8362639,61,9,8,True,True,0.4043893333333334,-0.247744
1270,1169243,16,32,0.437758,206,1211133,-1,640.0,8343516,8343532,7174273,16,23,12,True,True,0.37822577777777777,-0.437758
1271,1169296,5,16,0.439422,206,1211133,-1,752.0,1812995,1813000,643699,5,86,7,True,True,0.12961555555555554,-0.439422
1272,1169303,8961,16,0.522748,206,1211133,-1,128.0,3290092,3299053,2120789,8961,71,7,True,True,41.48693333333334,-0.5095322320771708
1273,1169527,7861,44,0.158746,206,1211133,-1,2112.0,6872016,6879877,5702489,7861,29,8,True,True,733.9418181333334,-0.15452697211594693
1274,1169538,9,2,0.372852,206,1211133,-1,42.0,8429916,8429925,7260378,9,23,12,True,True,0.0090174,-0.372852
1275,1169590,7460,1,0.282894,206,1211133,-1,24.0,5205016,5212476,4035426,7460,48,7,True,True,2.831307466666667,-0.27211114959927557
1276,1170047,76,4,0.408769,206,1211133,-1,24.0,5512016,5512092,4341969,76,44,8,True,True,0.06521813333333333,-0.408769
1277,1170344,75,1,0.338367,206,1211133,-1,27.0,4107072,4107147,2936728,75,64,12,True,True,0.05720625,-0.338367
1278,1173850,14008,30,0.597886,206,1211133,-1,180.0,1340113,1354121,166263,14008,115,10,True,True,58.443715,-0.5269646626929178
1279,1174083,8200,16,0.789227,206,1211133,-1,720.0,1516332,1524532,342249,8200,107,2,True,True,199.327824,-0.7591201629470954
1280,1174102,3921,77,0.647305,206,1211133,-1,2772.0,1823795,1827716,649693,3921,92,9,True,True,363.97093040000004,-0.6355008511101597
1281,1174179,15452,16,0.065912,206,1211133,-1,720.0,6692016,6707468,5517837,15452,34,12,True,True,300.80487999999997,-0.06288748548858512
1282,1174239,1532,1,0.094506,206,1211133,-1,25.0,5072616,5074148,3898377,1532,51,12,True,True,1.2512397222222225,-0.094506
1283,1174274,58,32,0.678379,206,1211133,-1,224.0,4375616,4375674,3201342,58,59,0,True,True,0.6401808,-0.678379
1284,1174317,200,2,0.284147,206,1211133,-1,30.0,2324646,2324846,1150329,200,89,11,True,True,0.24749999999999997,-0.284147
1285,1174618,578,1,0.723734,206,1211133,-1,38.0,2738787,2739365,1564169,578,86,2,True,True,0.7169415666666666,-0.723734
1286,1174663,23,35,0.656564,206,1211133,-1,1155.0,6342816,6342839,5168153,23,37,12,True,True,1.1415570833333333,-0.656564
1287,1174775,16600,4,0.906343,206,1211133,-1,176.0,2498346,2514946,1323571,16600,90,12,True,True,119.61951271111108,-0.8835563601002602
1288,1174799,9673,32,0.87328,206,1211133,-1,1248.0,1273333,1283006,98534,9673,132,0,True,True,452.6772744,-0.8724627125301271
1289,1174889,6527,4,0.333362,206,1211133,-1,128.0,6605616,6612143,5430727,6527,35,12,True,True,26.08923591111111,-0.3236824379789252
1290,1176555,56,1,0.58274,206,1211133,-1,48.0,3606292,3606348,2429737,56,77,10,True,True,0.10568319999999999,-0.58274
1291,1176646,63,32,0.141428,206,1211133,-1,1024.0,3339692,3339755,2163046,63,81,8,True,True,1.8930688000000002,-0.141428
1292,1176692,460,40,0.349821,206,1211133,-1,1440.0,4151272,4151732,2974580,460,69,11,True,True,32.60664,-0.349821
1293,1176978,311,1,0.967697,206,1211133,-1,24.0,1876995,1877306,700017,311,102,10,True,True,0.3239998,-0.967697
1294,1177613,2086,2,0.69848,206,1211133,-1,48.0,3918091,3920177,2740478,2086,72,12,True,True,3.5818010666666664,-0.69848
1295,1177628,9,16,0.391958,206,1211133,-1,112.0,7304016,7304025,6126388,9,30,12,True,True,0.010942400000000001,-0.391958
1296,1177643,65,1,0.595041,206,1211133,-1,39.0,1691895,1691960,514252,65,110,11,True,True,0.06302995833333333,-0.595041
1297,1178313,4026,32,0.938002,206,1211133,-1,992.0,1301813,1305839,123500,4026,134,9,True,True,118.10674017777778,-0.8869414241130783
1298,1178624,16454,256,0.309582,206,1211133,-1,6400.0,5909016,5925470,4730392,16454,45,10,True,True,4919.69152,-0.30880198478695603
1299,1178638,12363,256,0.376679,206,1211133,-1,6144.0,1553732,1566095,375094,12363,120,9,True,True,2748.5382826666664,-0.3157300410445615
1300,1178662,147,1,0.791662,206,1211133,-1,20.0,2651046,2651193,1472384,147,97,10,True,True,0.09932300000000001,-0.791662
1301,1178718,6469,32,0.813185,206,1211133,-1,1088.0,1785495,1791964,606777,6469,112,12,True,True,254.90214044444448,-0.7452602278653098
1302,1183323,278,32,0.670116,206,1211133,-1,480.0,2738509,2738787,1555186,278,95,0,True,True,4.355704,-0.670116
1303,1183672,116,1,0.828959,206,1211133,-1,37.0,1622895,1623011,439223,116,118,10,True,True,0.1490397,-0.828959
1304,1183685,13339,8,0.738775,206,1211133,-1,384.0,3830791,3844130,2647106,13339,76,8,True,True,219.0211456,-0.7348624537678359
1305,1183718,6208,8,0.685414,206,1211133,-1,136.0,3341492,3347700,2157774,6208,86,7,True,True,29.883326844444447,-0.6808101720304819
1306,1183767,10726,2,0.526393,206,1211133,-1,62.0,1414513,1425239,230746,10726,137,7,True,True,22.591388294444442,-0.5149929379880926
1307,1183900,76,4,0.646025,206,1211133,-1,172.0,2997987,2998063,1814087,76,95,12,True,True,0.33395328888888887,-0.646025
1308,1183938,4,8,0.423406,206,1211133,-1,304.0,7131216,7131220,5947278,4,31,12,True,True,0.014193422222222222,-0.423406
1309,1184946,18041,8,0.361828,206,1211133,-1,256.0,1854895,1872936,669949,18041,112,10,True,True,192.78163342222223,-0.3502901013900326
1310,1185012,163,2,0.362598,206,1211133,-1,78.0,8785616,8785779,7600604,163,20,12,True,True,0.3152718833333333,-0.362598
1311,1185031,22,12,0.180263,206,1211133,-1,480.0,8872016,8872038,7686985,22,20,12,True,True,0.08917333333333333,-0.18026299999999998
1312,1185212,4,1,0.214193,206,1211133,-1,25.0,8567716,8567720,7382504,4,23,8,True,True,0.00658638888888889,-0.21419300000000005
1313,1185291,84,32,0.947668,206,1211133,-1,1408.0,1277868,1277952,92577,84,155,1,True,True,4.5859968,-0.947668
1314,1185684,15,4,0.486271,206,1211133,-1,180.0,4942016,4942031,3756332,15,61,12,True,True,0.14152499999999998,-0.486271
1315,1191642,84,1,0.226543,206,1211133,-1,32.0,7737816,7737900,6546174,84,31,12,True,True,0.11738346666666669,-0.226543
1316,1191737,2892,1,0.137565,206,1211133,-1,18.0,9626337,9629229,8434600,2892,8,12,True,True,0.5891191499999999,-0.08736674166566946
1317,1191778,247,3,0.077165,206,1211133,-1,84.0,5710516,5710763,4518738,247,54,8,True,True,0.7007637000000001,-0.077165
1318,1191811,5636,8,0.844428,206,1211133,-1,280.0,1388813,1394449,197002,5636,150,6,True,True,41.57162644444445,-0.8398525059674259
1319,1192077,4,1,0.101141,206,1211133,-1,45.0,2212395,2212399,1020318,4,114,6,True,True,0.004268999999999999,-0.101141
1320,1192104,16915,256,0.770875,206,1211133,-1,5632.0,1699095,1716010,506991,16915,127,9,True,True,2749.6051342222217,-0.7561826265904577
1321,1192299,3,8,0.83512,206,1211133,-1,248.0,1305413,1305416,113114,3,156,1,True,True,0.021208133333333337,-0.83512
1322,1192348,269,64,0.883682,206,1211133,-1,2176.0,1510032,1510301,317684,269,146,9,True,True,16.98473173333333,-0.883682
1323,1194337,3071,8,0.037747,206,1211133,-1,368.0,6958416,6961487,5764079,3071,37,12,True,True,22.43672488888889,-0.032936681764790095
1324,1194394,48,8,0.336764,206,1211133,-1,80.0,1902695,1902743,708301,48,120,10,True,True,0.14308266666666666,-0.336764
1325,1194454,28023,1,0.766308,206,1211133,-1,40.0,1567895,1595918,373441,28023,139,7,True,True,44.565437888888894,-0.733227471142375
1326,1194499,48,16,0.131049,206,1211133,-1,576.0,8698316,8698364,7503817,48,23,11,True,True,0.515328,-0.131049
1327,1194846,25,32,0.37672,206,1211133,-1,512.0,7910616,7910641,6715770,25,32,12,True,True,0.29720888888888886,-0.37672
1328,1194889,6967,256,0.162247,206,1211133,-1,12544.0,7911516,7918483,6716627,6967,32,6,True,True,2145.5461440000004,-0.1618959007508056
1329,1195374,67,16,0.831345,206,1211133,-1,704.0,1410913,1410980,215539,67,158,0,True,True,1.1885025777777776,-0.831345
1330,1195475,6491,128,0.771098,206,1211133,-1,1664.0,1880595,1887086,685120,6491,124,8,True,True,453.3152,-0.7669585369407722
1331,1195492,4762,4,0.809044,206,1211133,-1,164.0,1274233,1278995,78741,4762,174,6,True,True,30.061010944444448,-0.8067633765539531
1332,1195820,14,8,0.165539,206,1211133,-1,144.0,1569695,1569709,373875,14,143,7,True,True,0.08286879999999999,-0.165539
1333,1195870,669,19,0.437673,206,1211133,-1,171.0,4353516,4354185,3157646,669,77,1,True,True,5.805431475,-0.437673
1334,1196468,8784,128,0.410859,206,1211133,-1,2048.0,8516316,8525100,7319848,8784,28,12,True,True,625.6441344,-0.34189264349699927
1335,1197052,6,8,0.676363,206,1211133,-1,240.0,2038695,2038701,841643,6,121,8,True,True,0.061264,-0.676363
1336,1197189,7288,36,0.23753,206,1211133,-1,1440.0,4550216,4557504,3353027,7288,75,12,True,True,350.039264,-0.22577556921989003
1337,1197554,19,2,0.444199,206,1211133,-1,12.0,5706916,5706935,4509362,19,60,12,True,True,0.0073739,-0.44419899999999995
1338,1197715,7726,184,0.284928,206,1211133,-1,4600.0,9539937,9547663,8342222,7726,9,8,True,True,474.4886455555556,-0.233174359281112
1339,1197805,30512,128,0.748537,206,1211133,-1,4864.0,4811416,4841928,3613611,30512,73,12,True,True,6198.321880177778,-0.7381464845552383
1340,1197926,48,8,0.448928,206,1211133,-1,304.0,7565016,7565064,6367090,48,38,12,True,True,0.2282432,-0.44892799999999994
1341,1198812,23,1,0.534011,206,1211133,-1,14.0,4462016,4462039,3263204,23,81,12,True,True,0.015213605555555558,-0.534011
1342,1198938,16,1,0.309468,206,1211133,-1,30.0,6255516,6255532,5056578,16,54,12,True,True,0.020205333333333332,-0.309468
1343,1198971,14212,2,0.808624,206,1211133,-1,24.0,1384313,1398525,185342,14212,174,11,True,True,9.649882866666667,-0.7235427164194355
1344,1199693,30,8,0.469016,206,1211133,-1,136.0,3614091,3614121,2414398,30,102,1,True,True,0.10755333333333335,-0.469016
1345,1199930,7380,1,0.835113,206,1211133,-1,28.0,1290053,1297433,90123,7380,182,1,True,True,5.987639933333334,-0.8241172186451159
1346,1202155,74,8,0.367841,206,1211133,-1,240.0,3918991,3919065,2716836,74,95,6,True,True,0.6353146666666666,-0.367841
1347,1202424,36,2,0.94713,206,1211133,-1,26.0,1258933,1258969,56509,36,193,11,True,True,0.0275704,-0.9471300000000002
1348,1202559,26,8,0.98444,206,1211133,-1,136.0,1309013,1309039,106454,26,179,8,True,True,0.10309404444444444,-0.98444
1349,1202714,24,7,0.46168,206,1211133,-1,294.0,3115492,3115516,1912778,24,114,7,True,True,0.2904328,-0.46168
1350,1203627,197,1,0.281772,206,1211133,-1,37.0,8170716,8170913,6967089,197,33,12,True,True,0.3463084888888888,-0.281772
1351,1203673,4662,4,0.381872,206,1211133,-1,124.0,7305816,7310478,6102143,4662,42,7,True,True,7.752773466666667,-0.3554695844596439
1352,1203713,62,32,0.52746,206,1211133,-1,1600.0,2738509,2738571,1534796,62,125,12,True,True,3.2380533333333337,-0.5274600000000002
1353,1203772,135,2,0.966268,206,1211133,-1,100.0,1436532,1436667,232760,135,172,1,True,True,0.4661625,-0.966268
1354,1203872,57,32,0.816891,206,1211133,-1,832.0,1269733,1269790,65861,57,198,9,True,True,1.6586544,-0.816891
1355,1203924,23275,43,0.801259,206,1211133,-1,1118.0,1830995,1854270,627071,23275,144,9,True,True,1043.7574243055556,-0.7750206185586556
1356,1205505,6,32,0.138399,206,1211133,-1,1536.0,6346416,6346422,5140911,6,54,8,True,True,0.3305728,-0.138399
1357,1205783,9475,256,0.250003,206,1211133,-1,5888.0,4020672,4030147,2814889,9475,97,2,True,True,1219.1698197333333,-0.24382414607886563
1358,1206862,128,32,0.641179,206,1211133,-1,288.0,1314413,1314541,107551,128,187,8,True,True,1.3761535999999996,-0.641179
1359,1223498,27,4,0.874117,251,1258933,-1,60.0,1502832,1502859,279334,27,174,10,True,True,0.054643500000000005,-0.874117
1360,1223641,226,1,0.554541,251,1258933,-1,13.0,3772191,3772417,2548550,226,105,7,True,True,0.09853725555555555,-0.554541
1361,1224041,21,1,0.10259,251,1258933,-1,49.0,9532716,9532737,8308675,21,11,6,True,True,0.0193795,-0.10259
1362,1225226,28,16,0.845892,251,1258933,-1,640.0,2280446,2280474,1055220,28,136,10,True,True,0.6969386666666667,-0.845892
1363,1225273,21,4,0.851166,251,1258933,-1,96.0,2214146,2214167,988873,21,138,2,True,True,0.0531944,-0.851166
1364,1227915,12,32,0.285063,251,1258933,-1,1120.0,2325546,2325558,1097631,12,134,0,True,True,0.5544,-0.285063
1365,1228250,7654,8,0.763117,251,1258933,-1,176.0,3658291,3665945,2430041,7654,109,11,True,True,35.29906404444444,-0.7037626781741415
1366,1229002,48,16,0.272791,251,1258933,-1,224.0,2125095,2125143,896093,48,142,12,True,True,0.5139456000000001,-0.272791
1367,1229105,220,16,0.905306,251,1258933,-1,368.0,2651193,2651413,1422088,220,133,1,True,True,2.7350986666666666,-0.905306
1368,1229713,20658,119,0.147349,251,1258933,-1,5712.0,9670537,9691195,8440824,20658,8,11,True,True,5755.2966268,-0.14731827762075744
1369,1230193,7676,1,0.437473,251,1258933,-1,38.0,3580592,3588268,2350399,7676,115,0,True,True,10.481867644444444,-0.4169749226344966
1370,1230556,6,16,0.946413,251,1258933,-1,736.0,1294613,1294619,64057,6,202,1,True,True,0.1317808,-0.946413
1371,1230732,17,8,0.222038,251,1258933,-1,224.0,8699216,8699233,7468484,17,26,6,True,True,0.07097688888888888,-0.222038
1372,1230788,599,1,0.451128,251,1258933,-1,27.0,3609892,3610491,2379104,599,114,8,True,True,0.691081275,-0.451128
1373,1230842,9605,4,0.349585,251,1258933,-1,136.0,5116816,5126421,3885974,9605,77,11,True,True,35.528409933333336,-0.338816235610241
1374,1235051,23287,128,0.02667,251,1258933,-1,1664.0,9843337,9866624,8608286,23287,7,12,True,True,1781.538932622222,-0.026076914991541304
1375,1235300,14,8,0.053257,251,1258933,-1,304.0,7217616,7217630,5982316,14,48,12,True,True,0.10653004444444443,-0.053257
1376,1235392,17,2,0.502007,251,1258933,-1,12.0,5203216,5203233,3967824,17,79,12,True,True,0.003443633333333334,-0.5020070000000001
1377,1235511,454,1,0.235778,251,1258933,-1,43.0,7651416,7651870,6415905,454,43,12,True,True,0.7080520944444444,-0.235778
1378,1236012,295,4,0.994525,251,1258933,-1,104.0,1283268,1283563,47256,295,215,3,True,True,1.0651073333333334,-0.9945249999999998
1379,1236187,17,4,0.374913,251,1258933,-1,160.0,8084316,8084333,6848129,17,38,12,True,True,0.10637466666666666,-0.374913
1380,1236211,51,4,0.028188,251,1258933,-1,104.0,9846937,9846988,8610726,51,7,1,True,True,0.2166389333333333,-0.028188
1381,1236861,297,4,0.930826,251,1258933,-1,148.0,1546532,1546829,309671,297,185,2,True,True,1.2315006,-0.930826
1382,1236977,126,1,0.839176,251,1258933,-1,22.0,1816595,1816721,579618,126,167,8,True,True,0.09822890000000001,-0.839176
1383,1237020,12617,1,0.649961,251,1258933,-1,23.0,1811195,1823812,574175,12617,169,7,True,True,10.13319906111111,-0.6498024072797894
1384,1237041,19866,16,0.791381,251,1258933,-1,736.0,3827191,3847057,2590150,19866,113,11,True,True,634.6570524444444,-0.7871469250270282
1385,1237455,182,16,0.1376,251,1258933,-1,608.0,3680391,3680573,2442936,182,119,10,True,True,5.197758222222222,-0.1376
1386,1237793,10471,1,0.286879,251,1258933,-1,14.0,5620516,5630987,4382723,10471,75,10,True,True,3.773916688888889,-0.26957270543610284
1387,1237852,53,16,0.829762,251,1258933,-1,336.0,2584746,2584799,1346894,53,149,12,True,True,0.5582313333333333,-0.829762
1388,1237979,28,8,0.696072,251,1258933,-1,280.0,3363592,3363620,2125613,28,130,10,True,True,0.20468933333333333,-0.696072
1389,1238030,25,4,0.138793,251,1258933,-1,156.0,3334292,3334317,2096262,25,134,11,True,True,0.1129375,-0.138793
1390,1240035,15281,128,0.705536,251,1258933,-1,2816.0,4005391,4020672,2765356,15281,110,12,True,True,967.7305244444444,-0.7048892015808567
1391,1240185,56,1,0.448601,251,1258933,-1,23.0,3536392,3536448,2296207,56,130,12,True,True,0.03804966666666666,-0.448601
1392,1240201,34,2,0.005251,251,1258933,-1,56.0,3770391,3770425,2530190,34,119,7,True,True,0.06385804444444444,-0.005251
1393,1240206,7860,256,0.079226,251,1258933,-1,12032.0,10495937,10503797,9255731,7860,1,12,True,True,2410.011571911111,-0.07377049773534869
1394,1240227,36,64,0.255924,251,1258933,-1,2240.0,3201892,3201928,1961665,36,141,12,True,True,2.6313280000000003,-0.255924
1395,1240251,222,10,0.834963,251,1258933,-1,320.0,1310813,1311035,70562,222,222,7,True,True,2.348858666666667,-0.834963
1396,1242062,7846,3,0.548804,251,1258933,-1,78.0,2911587,2919433,1669525,7846,148,12,True,True,15.708864383333333,-0.5142517556527757
1397,1242109,31,1,0.727235,251,1258933,-1,36.0,4005391,4005422,2763282,31,111,0,True,True,0.024397000000000002,-0.727235
1398,1242152,2651,8,0.527772,251,1258933,-1,136.0,2211495,2214146,969343,2651,167,12,True,True,8.603716622222223,-0.477318668536532
1399,1242232,9941,12,0.111187,251,1258933,-1,60.0,9933337,9943278,8691105,9941,7,12,True,True,28.789960666666666,-0.09787889592280297
1400,1242481,46,41,0.288102,251,1258933,-1,1558.0,9536337,9536383,8293856,46,15,8,True,True,1.1652022333333336,-0.2881020000000001
1401,1242829,8,1,0.301151,251,1258933,-1,32.0,7044816,7044824,5801987,8,56,12,True,True,0.0071900444444444435,-0.301151
1402,1242973,34,8,0.047749,251,1258933,-1,184.0,10106137,10106171,8863164,34,6,12,True,True,0.44530555555555557,-0.047749
1403,1243056,18345,1,0.419826,251,1258933,-1,33.0,5886916,5905261,4643860,18345,76,12,True,True,27.52519275,-0.40963128080641714
1404,1243104,34,30,0.793899,251,1258933,-1,1050.0,2628946,2628980,1385842,34,163,11,True,True,0.9360341666666667,-0.793899
1405,1243221,20017,4,0.457114,251,1258933,-1,136.0,2411946,2431963,1168725,20017,166,12,True,True,96.8455607111111,-0.4491467388463985
9512,7420904,105,2,0.730865,1,7420904,-1,10.0,7507304,7507409,86400,105,0,12,True,True,0.022633333333333335,-0.730865
9513,7421140,3189,4,0.225831,135,7507304,-1,140.0,15807034,15810223,8385894,3189,0,2,True,True,17.942970111111112,-0.2244378615735908
9514,7447663,476,16,0.263812,135,7507304,-1,800.0,9799054,9799530,2351391,476,1,11,True,True,16.307631111111114,-0.2636389096285951
9515,7451106,21769,32,0.296234,135,7507304,-1,224.0,8083935,8105704,632829,21769,2,11,True,True,139.2919447111111,-0.2931326830972486
9516,7451300,22056,128,0.082794,135,7507304,-1,3968.0,14173283,14195339,6721983,22056,1,12,True,True,3359.8468056888887,-0.08132965888401959
9517,7451557,281,1,0.558515,135,7507304,-1,20.0,12974783,12975064,5523226,281,2,12,True,True,0.3433507777777778,-0.5585150000000001
9518,7451869,38,64,0.872872,135,7507304,-1,1920.0,7867530,7867568,415661,38,5,10,True,True,1.7984639999999998,-0.872872
9519,7453317,7620,1,0.659481,135,7507304,-1,42.0,8310735,8318355,857418,7620,4,6,True,True,4.74756275,-0.5702438773280185
9520,7453877,29,2,0.735268,135,7507304,-1,90.0,9400054,9400083,1946177,29,4,10,True,True,0.042165999999999995,-0.735268
9521,7453926,1089,32,0.205891,135,7507304,-1,1600.0,11877304,11878393,4423378,1089,3,6,True,True,126.07232,-0.205891
9522,7454242,9589,42,0.078017,135,7507304,-1,756.0,16680504,16690093,9226262,9589,0,1,True,True,226.3851366,-0.07359105515905644
9523,7455218,114,4,0.971765,135,7507304,-1,96.0,7642404,7642518,187186,114,10,6,True,True,0.2560288,-0.971765
9524,7457507,7217,1,0.060267,135,7507304,-1,18.0,15563486,15570703,8105979,7217,2,12,True,True,6.10559635,-0.05658725222071679
9525,7457873,11752,130,0.013128,135,7507304,-1,4030.0,16685904,16697656,9228031,11752,0,8,True,True,1394.3020866666668,-0.012230016073802467
9526,7458016,11,8,0.216135,135,7507304,-1,232.0,12362704,12362715,4904688,11,6,11,True,True,0.06933642222222224,-0.216135
9527,7458182,96,4,0.818511,135,7507304,-1,56.0,8566974,8567070,1108792,96,10,11,True,True,0.15273813333333336,-0.818511
9528,7458304,10277,71,0.187917,135,7507304,-1,1420.0,14259683,14269960,6801379,10277,4,12,True,True,489.86103677777777,-0.1871405910827956
9529,7458385,27,5,0.104535,135,7507304,-1,200.0,8319735,8319762,861350,27,12,7,True,True,0.05277,-0.104535
9530,7458487,184,4,0.208661,135,7507304,-1,60.0,12715583,12715767,5257096,184,7,12,True,True,0.9314386666666667,-0.208661
9531,7458666,13,32,0.590523,135,7507304,-1,1216.0,11531182,11531195,4072516,13,10,11,True,True,0.9107164444444443,-0.590523
9532,7458715,1395,2,0.527645,135,7507304,-1,30.0,10917854,10919249,3459139,1395,11,12,True,True,1.5879685,-0.5141675843393363
9533,7458727,46,1,0.858459,135,7507304,-1,27.0,7818830,7818876,360103,46,19,3,True,True,0.031902150000000004,-0.8584590000000002
9534,7458977,37320,8,0.760488,135,7507304,-1,400.0,9195954,9233274,1736977,37320,14,7,True,True,437.96480666666673,-0.7502339896500243
9535,7459029,14846,1,0.311825,135,7507304,-1,23.0,15803434,15818280,8344405,14846,3,7,True,True,14.770015672222222,-0.3110569337831138
9536,7459262,6908,16,0.454022,135,7507304,-1,224.0,8475827,8482735,1016565,6908,17,1,True,True,107.38896248888888,-0.3983503853113824
9537,7459573,3195,4,0.153999,135,7507304,-1,32.0,16549640,16552835,9090067,3195,2,11,True,True,7.6331355555555565,-0.15388585176785516
9538,7459790,12,8,0.504511,135,7507304,-1,96.0,11876404,11876416,4416614,12,12,6,True,True,0.08335360000000001,-0.504511
9539,7460179,8139,16,0.914125,135,7507304,-1,256.0,8129935,8138074,669756,8139,22,11,True,True,52.924054044444446,-0.9078454807191736
9540,7460299,234,8,0.218785,135,7507304,-1,104.0,11486982,11487216,4026683,234,14,8,True,True,0.8596016,-0.218785
9541,7460340,6157,1,0.363644,135,7507304,-1,30.0,15085486,15091643,7625146,6157,6,7,True,True,6.313939083333333,-0.36105501310501337
9542,7462757,1,1,0.975065,135,7507304,-1,22.0,7551504,7551505,88747,1,29,11,True,True,0.0006743,-0.975065
9543,7462847,46,3,0.867859,135,7507304,-1,96.0,7758349,7758395,295502,46,28,9,True,True,0.11940373333333335,-0.867859
9544,7462894,755,4,0.513464,135,7507304,-1,48.0,8029835,8030590,566941,755,26,2,True,True,0.9652926666666667,-0.5134639999999999
9545,7462915,17458,16,0.780021,135,7507304,-1,320.0,8037935,8055393,575020,17458,26,9,True,True,199.77982755555556,-0.7620817160414747
9546,7463964,11,2,0.187953,135,7507304,-1,24.0,12629183,12629194,5165219,11,11,7,True,True,0.007241666666666668,-0.18795299999999998
9547,7464892,13,4,0.277838,135,7507304,-1,116.0,16682304,16682317,9217412,13,1,7,True,True,0.05837216666666666,-0.277838
9548,7465082,6755,128,0.164196,135,7507304,-1,2560.0,8522774,8529529,1057692,6755,23,7,True,True,598.8558791111111,-0.15774194744073536
9549,7465329,22,2,0.307147,135,7507304,-1,90.0,9668454,9668476,2203125,22,20,12,True,True,0.027412000000000002,-0.307147
9550,7465376,7661,16,0.869831,135,7507304,-1,544.0,9490054,9497715,2024678,7661,21,12,True,True,94.47980142222224,-0.8581124722863865
9551,7465404,2698,32,0.648383,135,7507304,-1,512.0,11587082,11589780,4121678,2698,16,7,True,True,60.586808888888896,-0.5734735798664649
9552,7465458,15,6,0.14729,135,7507304,-1,300.0,7706949,7706964,241491,15,37,1,True,True,0.12725,-0.14729
9553,7465541,9,4,0.876196,135,7507304,-1,176.0,8796692,8796701,1331151,9,25,8,True,True,0.0393096,-0.876196
9554,7465580,45,4,0.745026,135,7507304,-1,180.0,8475782,8475827,1010202,45,29,11,True,True,0.385605,-0.745026
9555,7465625,700,1,0.240562,135,7507304,-1,11.0,11676180,11676880,4210555,700,16,12,True,True,0.29285666666666665,-0.240562
9556,7465675,13,1,0.894098,135,7507304,-1,43.0,8217835,8217848,752160,13,33,10,True,True,0.013639599999999998,-0.894098
9557,7465724,4622,8,0.18703,135,7507304,-1,392.0,8239935,8244557,774211,4622,33,10,True,True,39.57896273333334,-0.17926009086000172
9558,7465781,102,4,0.028586,135,7507304,-1,104.0,11263454,11263556,3797673,102,20,12,True,True,0.3101661333333333,-0.028586
9559,7465790,1354,8,0.661886,135,7507304,-1,184.0,11679953,11681307,4214163,1354,16,1,True,True,9.54675311111111,-0.661886
9560,7465971,63,32,0.452641,135,7507304,-1,1472.0,14997223,14997286,7531252,63,8,10,True,True,3.2171664000000004,-0.4526410000000001
9561,7466592,21,2,0.265579,135,7507304,-1,14.0,12540983,12541004,5074391,21,14,7,True,True,0.008739150000000001,-0.265579
9562,7468178,56,2,0.926928,135,7507304,-1,100.0,7641504,7641560,173326,56,48,8,True,True,0.1310088888888889,-0.926928
9563,7468182,484,16,0.084067,135,7507304,-1,80.0,16246240,16246724,8778058,484,4,12,True,True,1.3092737777777779,-0.084067
9564,7468203,10,8,0.431474,135,7507304,-1,272.0,14997286,14997296,7529083,10,9,1,True,True,0.09436133333333334,-0.43147399999999997
9565,7468269,26,16,0.15062,135,7507304,-1,512.0,14390283,14390309,6922014,26,11,0,True,True,0.6437831111111111,-0.15062
9566,7468381,1733,4,0.50219,135,7507304,-1,128.0,8497927,8499660,1029546,1733,36,10,True,True,8.5543744,-0.4856426646263339
9567,7468392,9270,256,0.507927,135,7507304,-1,11520.0,11867134,11876404,4398742,9270,21,7,True,True,7290.8931840000005,-0.47815215957878954
9568,7469489,16453,1,0.053157,135,7507304,-1,34.0,8502427,8518880,1032938,16453,37,2,True,True,21.837390422222224,-0.05188278004848187
9569,7469646,52,2,0.272589,135,7507304,-1,20.0,15171886,15171938,7702240,52,8,12,True,True,0.03138777777777778,-0.272589
9570,7469780,170,1,0.097813,135,7507304,-1,29.0,13323983,13324153,5854203,170,15,12,True,True,0.25077266666666664,-0.097813
9571,7469818,11436,128,0.648622,135,7507304,-1,6144.0,9914054,9925490,2444236,11436,31,10,True,True,2339.3724416,-0.6060356778634964
9572,7470263,126,2,0.732002,135,7507304,-1,16.0,8142535,8142661,672272,126,48,9,True,True,0.057338400000000005,-0.732002
9573,7470324,19,8,0.422588,135,7507304,-1,136.0,8020835,8020854,550511,19,53,6,True,True,0.06711222222222224,-0.422588
9574,7470968,77,2,0.294006,135,7507304,-1,64.0,7808930,7809007,337962,77,56,6,True,True,0.1118792888888889,-0.294006
9575,7471047,5,8,0.402692,135,7507304,-1,56.0,10441654,10441659,2970607,5,31,12,True,True,0.0036773333333333337,-0.4026920000000001
9576,7471089,262,1,0.594049,135,7507304,-1,35.0,8427982,8428244,956893,262,45,9,True,True,0.29917125000000006,-0.594049
9577,7471439,140,32,0.529563,135,7507304,-1,384.0,14649483,14649623,7178044,140,12,12,True,True,3.16512,-0.529563
9578,7471767,213,1,0.493616,135,7507304,-1,9.0,8135335,8135548,663568,213,52,3,True,True,0.048026175,-0.493616
9579,7471808,102,11,0.433565,135,7507304,-1,209.0,10831454,10831556,3359646,102,32,12,True,True,0.5854159666666666,-0.433565
9580,7471834,10,4,0.681161,135,7507304,-1,124.0,7637904,7637914,166070,10,66,12,True,True,0.02611577777777778,-0.681161
9581,7471849,155,1,0.646345,135,7507304,-1,5.0,10528054,10528209,3056205,155,33,12,True,True,0.02150194444444444,-0.646345
9582,7471908,27,1,0.958972,135,7507304,-1,16.0,8929103,8929130,1457195,27,41,11,True,True,0.0098628,-0.958972
9583,7471940,6347,32,0.21958,135,7507304,-1,832.0,8314335,8320682,842395,6347,51,8,True,True,61.217660977777776,-0.19046889100385442
9584,7472063,7103,16,0.053138,135,7507304,-1,480.0,8951203,8958306,1479140,7103,41,10,True,True,104.78341333333333,-0.05240486722003266
9585,7472164,321,1,0.035688,135,7507304,-1,37.0,12318504,12318825,4846340,321,22,8,True,True,0.4952709,-0.035688
9586,7472257,9092,64,0.266178,135,7507304,-1,2112.0,15757434,15766526,8285177,9092,7,7,True,True,671.9354165333333,-0.2513590902969193
9587,7472310,34,4,0.065847,135,7507304,-1,76.0,15610566,15610600,8138256,34,8,0,True,True,0.10227615555555557,-0.065847
9588,7472367,260,2,0.101032,135,7507304,-1,52.0,16419040,16419300,8946673,260,4,12,True,True,0.5763275555555555,-0.101032
9589,7472391,7,1,0.226465,135,7507304,-1,6.0,15610600,15610607,8138209,7,9,1,True,True,0.0016623833333333333,-0.226465
9590,7472466,44,16,0.620221,135,7507304,-1,496.0,8030735,8030779,558269,44,66,6,True,True,0.5813064888888889,-0.620221
9591,7472913,203,5,0.715823,135,7507304,-1,180.0,10182454,10182657,2709541,203,40,11,True,True,0.7206499999999999,-0.7158229999999998
9592,7473068,4428,32,0.391908,135,7507304,-1,960.0,9843254,9847682,2370186,4428,42,11,True,True,144.25906666666666,-0.3918275878178434
9593,7473076,9633,85,0.101304,135,7507304,-1,2890.0,14736023,14745656,7262947,9633,16,12,True,True,1939.7602291111114,-0.09134360513538582
9594,7473095,5,32,0.733924,135,7507304,-1,1056.0,9377954,9377959,1904859,5,48,11,True,True,0.139524,-0.733924
9595,7473646,211,1,0.879528,135,7507304,-1,5.0,9333754,9333965,1860108,211,49,11,True,True,0.021949861111111114,-0.879528
9596,7474035,16855,220,0.268267,135,7507304,-1,3080.0,16505440,16522295,9031405,16855,4,12,True,True,2783.8030733333335,-0.2575039152058406
9597,7474304,116,32,0.205705,135,7507304,-1,480.0,12450904,12451020,4976600,116,27,7,True,True,2.3728959999999995,-0.205705
9598,7475199,4,8,0.785728,135,7507304,-1,80.0,7911735,7911739,436536,4,76,1,True,True,0.008216000000000001,-0.785728
9599,7475208,21,1,0.347633,135,7507304,-1,24.0,12226504,12226525,4751296,21,30,1,True,True,0.026045600000000002,-0.347633
9600,7475834,57,16,0.287993,135,7507304,-1,336.0,11004254,11004311,3528420,57,40,12,True,True,0.7049000000000001,-0.287993
9601,7477326,23,1,0.596313,135,7507304,-1,35.0,8265635,8265658,788309,23,68,8,True,True,0.01376326388888889,-0.596313
9602,7477372,2,32,0.733882,135,7507304,-1,416.0,7968535,7968537,491163,2,79,1,True,True,0.020790755555555554,-0.733882
9603,7478388,75,4,0.094243,135,7507304,-1,144.0,14563083,14563158,7084695,75,19,12,True,True,0.45119999999999993,-0.094243
9604,7478403,4037,1,0.50324,135,7507304,-1,50.0,13801983,13806020,6323580,4037,23,12,True,True,3.8536972222222228,-0.44220236118527845
9605,7478737,15613,25,0.700471,135,7507304,-1,925.0,10004054,10019667,2525317,15613,48,12,True,True,264.9093059722223,-0.6724090814021025
9606,7478932,12150,4,0.476758,135,7507304,-1,84.0,10051854,10064004,2572922,12150,48,10,True,True,17.300941,-0.4748670341012451
9607,7479608,11987,1,0.305324,135,7507304,-1,42.0,9289554,9301541,1809946,11987,58,9,True,True,12.010935533333335,-0.2976501218466061
9608,7479731,23,16,0.906668,135,7507304,-1,576.0,8131735,8131758,652004,23,78,6,True,True,0.34463200000000005,-0.906668
9609,7480361,86,8,0.238619,135,7507304,-1,312.0,14953023,14953109,7472662,86,17,12,True,True,0.7366129333333333,-0.23861899999999997
9610,7480435,12668,237,0.315112,135,7507304,-1,11376.0,15610566,15623234,8130131,12668,12,8,True,True,5661.8338728,-0.3144155763194078
9611,7480498,8452,1,0.069455,135,7507304,-1,36.0,16159840,16168292,8679342,8452,7,12,True,True,18.105724399999996,-0.05412037218661517
9612,7481026,93,3,0.187344,135,7507304,-1,123.0,16073440,16073533,8592414,93,8,1,True,True,0.5042057,-0.187344
9613,7481280,23947,247,0.899869,135,7507304,-1,5681.0,8498827,8522774,1017547,23947,70,6,True,True,5301.439513066666,-0.8906555363441074
9614,7481294,9,8,0.141834,135,7507304,-1,80.0,15302486,15302495,7821192,9,16,11,True,True,0.025284,-0.141834
9615,7481416,4845,4,0.012735,135,7507304,-1,136.0,15801634,15806479,8320218,4845,11,11,True,True,24.501564311111114,-0.01244189014175716
9616,7481427,46,20,0.474601,135,7507304,-1,160.0,12627383,12627429,5145956,46,34,12,True,True,0.19021511111111114,-0.474601
9617,7481465,14246,16,0.334054,135,7507304,-1,752.0,16332640,16346886,8851175,14246,6,12,True,True,452.15406657777777,-0.3252212037969924
9618,7481557,48,7,0.177515,135,7507304,-1,77.0,15814234,15814282,8332677,48,10,2,True,True,0.1719461333333333,-0.177515
9619,7481724,5912,64,0.263832,135,7507304,-1,1600.0,14086883,14092795,6605159,5912,31,12,True,True,289.6918311111111,-0.2631218044047339
9620,7482405,12589,32,0.076977,135,7507304,-1,704.0,15623234,15635823,8140829,12589,15,2,True,True,356.74157493333325,-0.07599816518593633
9621,7482495,5781,4,0.679203,135,7507304,-1,124.0,7642518,7648299,160023,5781,104,1,True,True,16.451260833333333,-0.658641107931223
9622,7483729,367,1,0.85309,135,7507304,-1,44.0,8151535,8151902,667806,367,88,7,True,True,0.4572575333333333,-0.85309
9623,7483771,6,1,0.594005,135,7507304,-1,30.0,9194154,9194160,1710383,6,71,12,True,True,0.005000500000000001,-0.594005
9624,7483829,733,1,0.969542,135,7507304,-1,39.0,8085735,8086468,601906,733,94,6,True,True,0.8112355333333332,-0.969542
9625,7484125,6337,128,0.583159,135,7507304,-1,4608.0,10614454,10620791,3130329,6337,56,12,True,True,710.8695936,-0.577210457108829
9626,7485298,6441,64,0.488307,135,7507304,-1,576.0,12222904,12229345,4737606,6441,44,12,True,True,186.4367648,-0.46069231693571416
9627,7485400,6086,16,0.24751,135,7507304,-1,160.0,14000483,14006569,6515083,6086,33,12,True,True,40.95293511111111,-0.2472173928539211
9628,7485441,42,4,0.109386,135,7507304,-1,108.0,15388886,15388928,7903445,42,20,12,True,True,0.1390788,-0.109386
9629,7485503,324,2,0.818926,135,7507304,-1,36.0,7823330,7823654,337827,324,107,6,True,True,0.30987359999999997,-0.818926
9630,7485531,3,19,0.567267,135,7507304,-1,893.0,8791292,8791295,1305761,3,79,9,True,True,0.07088187500000001,-0.567267
9631,7485881,968,16,0.990413,135,7507304,-1,128.0,8262035,8263003,776154,968,92,10,True,True,2.261936355555556,-0.990413
9632,7485930,30,16,0.835359,135,7507304,-1,656.0,8309835,8309865,823905,30,91,11,True,True,0.38075333333333333,-0.835359
9633,7486024,1347,4,0.525269,135,7507304,-1,144.0,13147583,13148930,5661559,1347,37,12,True,True,10.064784,-0.525269
9634,7486423,322,1,0.167305,135,7507304,-1,10.0,15755634,15755956,8269211,322,15,12,True,True,0.11168927777777778,-0.16730500000000004
9635,7486522,39,8,0.146583,135,7507304,-1,48.0,8697692,8697731,1211170,39,82,12,True,True,0.0248872,-0.14658300000000002
9636,7486545,96,32,0.09391,135,7507304,-1,928.0,13914083,13914179,6427538,96,36,8,True,True,2.3006976000000003,-0.09391
9637,7486552,12,1,0.304602,135,7507304,-1,16.0,13368183,13368195,5881631,12,38,11,True,True,0.004996266666666667,-0.304602
9638,7486563,517,8,0.736186,135,7507304,-1,280.0,12537383,12537900,5050820,517,46,1,True,True,3.8325210000000003,-0.736186
9639,7486797,12091,64,0.452616,135,7507304,-1,896.0,11177054,11189145,3690257,12091,61,12,True,True,324.9297208888889,-0.4390657790321188
9640,7486842,462,1,0.734815,135,7507304,-1,23.0,9282354,9282816,1795512,462,80,12,True,True,0.19457386666666668,-0.734815
9641,7486887,589,32,0.989793,135,7507304,-1,320.0,7808030,7808619,321143,589,121,6,True,True,4.364530666666667,-0.9784464339446235
9642,7486917,28843,4,0.25734,135,7507304,-1,140.0,13061183,13090026,5574266,28843,41,12,True,True,208.15063422222227,-0.2543061160350098
9643,7505496,7,2,0.486493,135,7507304,-1,44.0,7937435,7937442,431939,7,117,1,True,True,0.007143888888888888,-0.486493
9644,7505618,77,1,0.364289,135,7507304,-1,29.0,11264354,11264431,3758736,77,61,6,True,True,0.06609204722222223,-0.35784866354453143
9645,7505678,5,4,0.013561,135,7507304,-1,148.0,15900634,15900639,8394956,5,10,12,True,True,0.041881944444444444,-0.013561
9646,7505987,3,1,0.352626,135,7507304,-1,42.0,10007654,10007657,2501667,3,73,1,True,True,0.00232925,-0.352626
9647,7506481,10809,1,0.710157,135,7507304,-1,19.0,8195735,8206544,689254,10809,108,11,True,True,2.1864010916666663,-0.693405811577577
9648,7507707,1443,16,0.891372,178,7551504,-1,768.0,8149735,8151178,642028,1443,110,9,True,True,35.45703893333334,-0.7857067977637086
9649,7508060,599,16,0.774526,178,7551504,-1,592.0,8431582,8432181,923522,599,99,8,True,True,10.675670844444443,-0.774526
9650,7508335,25,32,0.856956,178,7551504,-1,1120.0,8084835,8084860,576500,25,117,6,True,True,0.8205555555555556,-0.856956
9651,7508355,439,16,0.902167,178,7551504,-1,624.0,8026235,8026674,517880,439,122,2,True,True,7.280610133333334,-0.902167
9652,7508810,41,1,0.595744,178,7551504,-1,9.0,9582054,9582095,2073244,41,79,11,True,True,0.004736525,-0.5957439999999999
9653,7509792,1361,1,0.112761,178,7551504,-1,31.0,12270704,12272065,4760912,1361,52,11,True,True,2.2899165249999998,-0.11276099999999997
9654,7510285,49,1,0.685784,178,7551504,-1,9.0,7845430,7845479,335145,49,130,10,True,True,0.0100646,-0.6857840000000001
9655,7511158,181,4,0.728216,178,7551504,-1,52.0,10658654,10658835,3147496,181,69,11,True,True,0.2933406666666667,-0.728216
9656,7511337,264,4,0.020727,178,7551504,-1,60.0,16680240,16680504,9168903,264,3,11,True,True,0.61314,-0.020727
9657,7511356,16631,256,0.978637,178,7551504,-1,5888.0,7686718,7703349,175362,16631,139,11,True,True,2638.761778488889,-0.9746687928848325
9658,7511475,10,1,0.856266,178,7551504,-1,49.0,8038835,8038845,527360,10,123,6,True,True,0.013924166666666668,-0.856266
9659,7514110,15957,32,0.659367,178,7551504,-1,480.0,9846854,9862811,2332744,15957,79,1,True,True,285.827184,-0.6488405742598219
9660,7514206,8830,6,0.141633,178,7551504,-1,138.0,15669234,15678064,8155028,8830,18,0,True,True,69.05746856666669,-0.12834913815054252
9661,7515103,4,7,0.497832,178,7551504,-1,119.0,12136504,12136508,4621401,4,57,12,True,True,0.022406377777777778,-0.497832
9662,7515573,71,1,0.244368,178,7551504,-1,41.0,7762895,7762966,247322,71,141,6,True,True,0.07332485555555555,-0.244368
9663,7516063,225,8,0.741012,178,7551504,-1,184.0,7810730,7810955,294667,225,139,7,True,True,0.939895,-0.741012
9664,7516430,12454,64,0.973291,178,7551504,-1,1024.0,7964935,7977389,448505,12454,133,10,True,True,354.91375786666663,-0.9604711868622616
9665,7516582,11,1,0.35942,178,7551504,-1,48.0,8884892,8884903,1368310,11,96,12,True,True,0.007465333333333334,-0.35941999999999996
9666,7523724,10082,16,0.744365,178,7551504,-1,512.0,8019935,8030017,496211,10082,133,9,True,True,135.27083804444445,-0.7381594269785084
9667,7524970,12360,8,0.193842,178,7551504,-1,336.0,13910483,13922843,6385513,12360,40,12,True,True,108.14476213333334,-0.19152587186128492
9668,7525197,20221,4,0.954814,178,7551504,-1,104.0,8611292,8631513,1086095,20221,101,1,True,True,30.092751577777772,-0.9381934371610442
9669,7525374,37,8,0.638734,178,7551504,-1,344.0,9847754,9847791,2322380,37,82,6,True,True,0.43165597777777776,-0.638734
9670,7526550,15363,1,0.965453,178,7551504,-1,45.0,7811630,7826993,285080,15363,145,6,True,True,17.47698875,-0.9344636042060774
9671,7537641,10,8,0.877144,178,7551504,-1,216.0,8322482,8322492,784841,10,112,7,True,True,0.021108000000000002,-0.877144
9672,7537765,8549,2,0.678802,178,7551504,-1,56.0,7939235,7947784,401470,8549,140,7,True,True,11.293130022222222,-0.6764168980352698
9673,7537949,63,20,0.899221,178,7551504,-1,680.0,7815230,7815293,277281,63,147,2,True,True,0.9976960000000002,-0.899221
9674,7538406,43480,111,0.449269,178,7551504,-1,5439.0,15567086,15610566,8028680,43480,23,8,True,True,10908.993537166667,-0.44780122205112705
9675,7538432,144,8,0.958306,178,7551504,-1,168.0,7761995,7762139,223563,144,154,8,True,True,0.6093696000000001,-0.958306
9676,7541236,118,1,0.526907,178,7551504,-1,48.0,8611174,8611292,1069938,118,104,11,True,True,0.1298256,-0.498148497960975
9677,7541612,16086,8,0.265309,178,7551504,-1,144.0,14975123,14991209,7433511,16086,31,10,True,True,72.0534888,-0.25886496063516495
9678,7541791,407,4,0.679066,178,7551504,-1,24.0,9754854,9755261,2213063,407,88,12,True,True,0.2475102666666667,-0.679066
9679,7541852,19,58,0.887995,178,7551504,-1,1624.0,9107754,9107773,1565902,19,99,12,True,True,0.9260228444444447,-0.8879950000000002
9680,7542109,173,4,0.391026,178,7551504,-1,100.0,11679780,11679953,4137671,173,65,8,True,True,0.6629263888888889,-0.391026
9681,7542142,19,2,0.417294,178,7551504,-1,78.0,10355254,10355273,2813112,19,80,12,True,True,0.05007101666666667,-0.417294
9682,7542176,299,7,0.993944,178,7551504,-1,175.0,7942835,7943134,400659,299,147,8,True,True,1.2235329166666666,-0.993944
9683,7542197,10425,8,0.309323,178,7551504,-1,400.0,10745054,10755479,3202857,10425,76,12,True,True,174.14641666666668,-0.30445838395127606
9684,7542226,15,8,0.0411,178,7551504,-1,376.0,13715583,13715598,6173357,15,44,7,True,True,0.20358833333333332,-0.0411
9685,7542506,5,1,0.520078,178,7551504,-1,30.0,7911730,7911735,369224,5,153,11,True,True,0.00385125,-0.520078
9686,7542518,10317,1,0.343274,178,7551504,-1,42.0,14476683,14487000,6934165,10317,36,12,True,True,35.8778707,-0.3351758287956062
9687,7543012,8973,128,0.612367,178,7551504,-1,3968.0,8012735,8021708,469723,8973,148,11,True,True,919.543383111111,-0.5955370700184007
9688,7543040,8227,32,0.43346,178,7551504,-1,288.0,11963704,11971931,4420664,8227,63,12,True,True,97.8321392,-0.42589149164296425
9689,7543055,5167,1,0.455028,178,7551504,-1,18.0,7933835,7939002,390780,5167,155,10,True,True,2.1415546,-0.4483190033728798
9690,7543071,9,4,0.968153,178,7551504,-1,148.0,8039735,8039744,496664,9,142,6,True,True,0.037850999999999996,-0.968153
9691,7543195,2172,1,0.792341,178,7551504,-1,11.0,11585282,11587454,4042087,2172,71,7,True,True,0.9045776666666667,-0.792341
9692,7554084,9942,4,0.288409,253,7637904,-1,148.0,13540983,13550925,5986899,9942,46,12,True,True,26.579677666666665,-0.2842934568303119
9693,7554231,35,32,0.96947,253,7637904,-1,1504.0,7807095,7807130,252864,35,170,11,True,True,1.233092,-0.96947
9694,7554406,43,32,0.498927,253,7637904,-1,1120.0,11483382,11483425,3928976,43,75,12,True,True,1.6239284444444448,-0.4989270000000001
9695,7554775,2,8,0.685527,253,7637904,-1,232.0,10268854,10268856,2714079,2,88,12,True,True,0.009219422222222223,-0.685527
9696,7554832,53,16,0.466317,253,7637904,-1,656.0,12539183,12539236,4984351,53,56,7,True,True,1.0334788,-0.466317
9697,7554839,40,55,0.150228,253,7637904,-1,2530.0,14866623,14866663,7311784,40,33,11,True,True,3.344378888888889,-0.150228
9698,7554850,1522,14,0.966671,253,7637904,-1,406.0,8784092,8785614,1229242,1522,117,12,True,True,14.365202522222223,-0.966671
9699,7554855,11313,128,0.623795,253,7637904,-1,3968.0,9917654,9928967,2362799,11313,95,1,True,True,1364.2062478222224,-0.5725084582852638
9700,7554941,19250,16,0.66432,253,7637904,-1,416.0,11589780,11609030,4034839,19250,73,2,True,True,367.786328,-0.657311835035932
9701,7555000,46,8,0.303646,253,7637904,-1,288.0,8373882,8373928,818882,46,132,11,True,True,0.1699424,-0.303646
9702,7555030,5551,4,0.28826,253,7637904,-1,112.0,11769953,11775504,4214923,5551,70,8,True,True,17.338794044444445,-0.28805408404387617
9703,7555576,9,3,0.799785,253,7637904,-1,129.0,8884903,8884912,1329327,9,117,1,True,True,0.016415250000000003,-0.799785
9704,7555625,8,12,0.015592,253,7637904,-1,360.0,12888383,12888391,5332758,8,53,12,True,True,0.09648799999999999,-0.015592
9705,7555664,5,1,0.040953,253,7637904,-1,18.0,11534782,11534787,3979118,5,78,8,True,True,0.0045934999999999995,-0.040953
9706,7555997,5,3,0.283017,253,7637904,-1,87.0,14822423,14822428,7266426,5,34,12,True,True,0.015593541666666669,-0.283017
9707,7556017,9121,32,0.593072,253,7637904,-1,1088.0,8317935,8327056,761918,9121,140,8,True,True,109.62212302222224,-0.4405603123916388
9708,7556166,31,8,0.053193,253,7637904,-1,112.0,10138254,10138285,2582088,31,97,12,True,True,0.09553786666666667,-0.053193
9709,7556438,21446,1,0.305822,253,7637904,-1,8.0,12314904,12336350,4758466,21446,64,11,True,True,6.984434666666667,-0.3034121894766535
9710,7556455,96,31,0.430323,253,7637904,-1,1147.0,11539282,11539378,3982827,96,80,8,True,True,5.145594933333333,-0.430323
9711,7556597,36,2,0.660253,253,7637904,-1,98.0,9537854,9537890,1981257,36,112,8,True,True,0.09434459999999999,-0.660253
9712,7556755,6,1,0.000642,253,7637904,-1,14.0,15258286,15258292,7701531,6,27,12,True,True,0.003072766666666667,-0.000642
9713,7556892,9528,32,0.251433,253,7637904,-1,1184.0,15987034,15996562,8430142,9528,11,12,True,True,462.4836213333333,-0.24319850256844594
9714,7556984,9,16,0.350218,253,7637904,-1,304.0,8798492,8798501,1241508,9,128,7,True,True,0.06064040000000001,-0.350218
9715,7558656,58,8,0.283266,253,7637904,-1,184.0,12801983,12802041,5243327,58,57,12,True,True,0.7400735555555555,-0.283266
9716,7558728,21,2,0.859011,253,7637904,-1,66.0,8419882,8419903,861154,21,145,7,True,True,0.03772230000000001,-0.8590110000000002
9717,7558783,39,32,0.665326,253,7637904,-1,320.0,7758395,7758434,199612,39,196,1,True,True,0.3374453333333334,-0.665326
9718,7558912,32,32,0.768885,253,7637904,-1,1280.0,8976903,8976935,1417991,32,125,10,True,True,1.1601920000000001,-0.768885
9719,7559187,7647,29,0.155037,253,7637904,-1,1073.0,15669234,15676881,8110047,7647,20,11,True,True,459.956284225,-0.14983700959728635
9720,7559722,9032,16,0.086003,253,7637904,-1,544.0,15625034,15634066,8065312,9032,21,7,True,True,201.25246453333335,-0.0854147899677146
9721,7559765,2,2,0.270669,253,7637904,-1,22.0,15810634,15810636,8250869,2,14,2,True,True,0.001779311111111111,-0.270669
9722,7559900,26386,165,0.995914,253,7637904,-1,2805.0,7703349,7729735,143449,26386,203,8,True,True,2315.7953385416668,-0.961843172357038
9723,7559976,9378,1,0.196727,253,7637904,-1,7.0,14390283,14399661,6830307,9378,45,12,True,True,3.0857203416666668,-0.1939070303298538
9724,7560136,28,13,0.585225,253,7637904,-1,403.0,11396954,11396982,3836818,28,92,11,True,True,0.2952960111111111,-0.585225
9725,7560771,9,2,0.080718,253,7637904,-1,58.0,15083686,15083695,7522915,9,34,12,True,True,0.0188007,-0.080718
9726,7560886,251,8,0.218858,253,7637904,-1,88.0,9021103,9021354,1460217,251,131,11,True,True,0.4860587111111111,-0.218858
9727,7561424,240,8,0.473178,253,7637904,-1,248.0,9534254,9534494,1972830,240,122,11,True,True,1.727898666666667,-0.473178
9728,7561428,10,2,0.354632,253,7637904,-1,68.0,11766353,11766363,4204925,10,82,12,True,True,0.017349444444444445,-0.35463200000000006
9729,7561500,8311,8,0.811709,253,7637904,-1,88.0,8954803,8963114,1393303,8311,135,1,True,True,22.908770866666664,-0.8101618398972953
9730,7561546,8018,128,0.637045,253,7637904,-1,5888.0,13237583,13245601,5676037,8018,58,12,True,True,1737.1420373333335,-0.6290036344577048
9731,7561575,499,8,0.422563,253,7637904,-1,184.0,11396982,11397481,3835407,499,95,1,True,True,2.4027737111111107,-0.422563
9732,7561780,114,32,0.966907,253,7637904,-1,960.0,7751149,7751263,189369,114,211,11,True,True,2.7049920000000003,-0.966907
9733,7561869,11828,123,0.098139,253,7637904,-1,1968.0,15477086,15488914,7915217,11828,29,12,True,True,1020.534772,-0.0953352945041762
9734,7561916,15,16,0.261261,253,7637904,-1,192.0,13627383,13627398,6065467,15,56,12,True,True,0.07368,-0.261261
9735,7561944,37,1,0.302023,253,7637904,-1,29.0,11090654,11090691,3528710,37,102,12,True,True,0.04266069166666667,-0.302023
9736,7562063,148,64,0.310736,253,7637904,-1,2560.0,9021354,9021502,1459291,148,138,1,True,True,8.337464888888888,-0.310736
9737,7562097,26,32,0.563908,253,7637904,-1,256.0,11352754,11352780,3790657,26,99,11,True,True,0.1311232,-0.563908
9738,7562119,700,13,0.678923,253,7637904,-1,195.0,9891954,9892654,2329835,700,121,11,True,True,6.397679166666666,-0.678923
9739,7562305,3,2,0.32248,253,7637904,-1,40.0,15390686,15390689,7828381,3,30,7,True,True,0.004069,-0.32248
9740,7562431,6273,8,0.578167,253,7637904,-1,240.0,8130835,8137108,568404,6273,183,6,True,True,38.13754466666666,-0.5699051839474225
9741,7562440,4825,16,0.683321,253,7637904,-1,688.0,8418082,8422907,855642,4825,166,11,True,True,91.23001928888888,-0.6804542811207869
9742,7562457,999,4,0.199507,253,7637904,-1,180.0,12449104,12450103,4886647,999,74,12,True,True,7.663328999999999,-0.199507
9743,7562624,42,1,0.135691,253,7637904,-1,50.0,13713783,13713825,6151159,42,57,12,True,True,0.07580416666666667,-0.135691
9744,7562724,6792,128,0.554284,253,7637904,-1,4352.0,8329682,8336474,766958,6792,170,8,True,True,447.6390072888889,-0.47717652884835
9745,7562749,15,1,0.301062,253,7637904,-1,15.0,13824083,13824098,6261334,15,55,10,True,True,0.006515,-0.301062
9746,7562848,7025,2,0.085598,253,7637904,-1,66.0,11308554,11315579,3745706,7025,104,11,True,True,9.0161445,-0.0804037639232543
9747,7562964,28,1,0.566665,253,7637904,-1,48.0,10029754,10029782,2466790,28,122,10,True,True,0.02340053333333333,-0.566665
9748,7562969,86,1,0.628319,253,7637904,-1,15.0,11583482,11583568,4020513,86,96,11,True,True,0.04453008333333333,-0.628319
9749,7562995,13964,16,0.545831,253,7637904,-1,784.0,12050104,12064068,4487109,13964,84,12,True,True,500.23901386666665,-0.5378399662378145
9750,7563194,10781,20,0.375966,253,7637904,-1,280.0,11856353,11867134,4293159,10781,89,12,True,True,230.13277466666668,-0.37158278735377054
9751,7563252,6624,2,0.875921,253,7637904,-1,80.0,8320682,8327306,757430,6624,178,2,True,True,6.258575555555556,-0.6281945640373388
9752,7563313,139,8,0.436893,253,7637904,-1,240.0,13151183,13151322,5587870,139,64,8,True,True,1.7716013333333334,-0.436893
9753,7564405,6,1,0.13861,253,7637904,-1,41.0,16073434,16073440,8509029,6,11,12,True,True,0.010843133333333336,-0.13861
9754,7564740,14547,1,0.441901,253,7637904,-1,19.0,11535682,11550229,3970942,14547,102,6,True,True,11.476713872222222,-0.4228137376865513
9755,7564774,6,16,0.31326,253,7637904,-1,720.0,8326082,8326088,761308,6,180,8,True,True,0.052104000000000004,-0.31326
9756,7564834,20618,32,0.93488,253,7637904,-1,448.0,7807130,7827748,242296,20618,229,1,True,True,229.47444800000002,-0.9136353874761595
9757,7564875,32,4,0.712599,253,7637904,-1,160.0,8793092,8793124,1228217,32,162,7,True,True,0.13546666666666668,-0.712599
9758,7564880,13,8,0.468379,253,7637904,-1,104.0,14303883,14303896,6739003,13,50,11,True,True,0.043677111111111104,-0.468379
9759,7565888,11,2,0.427669,253,7637904,-1,96.0,14303883,14303894,6737995,11,50,0,True,True,0.03411466666666667,-0.427669
9760,7565897,69,2,0.420506,253,7637904,-1,74.0,14649623,14649692,7083726,69,45,1,True,True,0.3006157499999999,-0.420506
9761,7565911,20256,128,0.410259,253,7637904,-1,1280.0,13454583,13474839,5888672,20256,65,12,True,True,717.6000746666667,-0.39118132567911196
9762,7566277,4590,1,0.027673,253,7637904,-1,25.0,16636040,16640630,9069763,4590,4,12,True,True,4.004887500000001,-0.02731227854815979
9763,7566559,28,32,0.558909,253,7637904,-1,448.0,7822430,7822458,255871,28,229,3,True,True,0.3195932444444444,-0.558909
9764,7566576,2,32,0.957492,253,7637904,-1,576.0,8022635,8022637,456059,2,215,7,True,True,0.02992,-0.957492
9765,7566639,79,4,0.420919,253,7637904,-1,52.0,12537304,12537383,4970665,79,82,12,True,True,0.10875929999999999,-0.420919
9766,7566742,64,5,0.755856,253,7637904,-1,45.0,9403654,9403718,1836912,64,150,8,True,True,0.04156,-0.755856
9767,7566922,8560,8,0.615209,253,7637904,-1,256.0,8420782,8429342,853860,8560,184,6,True,True,64.87570915555555,-0.5938856137653332
7477,5838914,19466,16,0.616028,1,5838914,-1,464.0,5925314,5944780,86400,19466,0,12,True,True,235.3832895111111,-0.5478035640568976
7478,5839417,118,8,0.189102,63,5925314,-1,312.0,6878618,6878736,1039201,118,0,10,True,True,0.8635397333333333,-0.189102
7479,5839583,4,2,0.535468,63,5925314,-1,38.0,8334330,8334334,2494747,4,0,12,True,True,0.003684311111111111,-0.535468
7480,5839618,2272,4,0.789588,63,5925314,-1,116.0,6330820,6333092,491202,2272,2,11,True,True,8.929299777777779,-0.7864938625624717
7481,5839644,34,8,0.327681,63,5925314,-1,104.0,8537030,8537064,2697386,34,0,8,True,True,0.11794524444444444,-0.327681
7482,5839700,19967,1,0.053259,63,5925314,-1,18.0,9002080,9022047,3162380,19967,0,8,True,True,14.4502555,-0.05224100583431181
7483,5839896,20,1,0.795612,63,5925314,-1,48.0,7004418,7004438,1164522,20,3,2,True,True,0.023850666666666666,-0.795612
7484,5840012,82,4,0.872851,63,5925314,-1,132.0,6382692,6382774,542680,82,5,6,True,True,0.6528375333333334,-0.872851
7485,5840100,18,1,0.851503,63,5925314,-1,12.0,7120141,7120159,1280041,18,3,10,True,True,0.0074784000000000005,-0.8515030000000002
7486,5840188,107,1,0.968384,63,5925314,-1,30.0,6521392,6521499,681204,107,6,8,True,True,0.13553333333333334,-0.968384
7487,5870614,11551,32,0.885834,63,5925314,-1,672.0,6678118,6689669,807504,11551,6,11,True,True,289.98308640000005,-0.885066253231035
7488,5880600,3,16,0.209238,63,5925314,-1,688.0,10409166,10409169,4528566,3,0,7,True,True,0.056559333333333336,-0.209238
7489,5880962,15,2,0.081408,63,5925314,-1,80.0,10407366,10407381,4526404,15,1,8,True,True,0.031983333333333336,-0.081408
7490,5881100,68,4,0.470667,63,5925314,-1,52.0,7645930,7645998,1764830,68,5,6,True,True,0.11034284444444445,-0.470667
7491,5881385,2,8,0.663502,63,5925314,-1,248.0,7530930,7530932,1649545,2,6,6,True,True,0.019904755555555556,-0.663502
7492,5881622,112,17,0.064873,63,5925314,-1,629.0,10529211,10529323,4647589,112,0,7,True,True,6.418399866666667,-0.064873
7493,5883158,1641,1,0.508614,63,5925314,-1,35.0,9267235,9268876,3384077,1641,3,6,True,True,2.146314041666667,-0.508614
7494,5883784,6,1,0.751308,63,5925314,-1,15.0,6999918,6999924,1116134,6,11,0,True,True,0.0021420000000000002,-0.751308
7495,5885585,1201,64,0.645072,63,5925314,-1,1472.0,6386292,6387493,500707,1201,15,8,True,True,75.95145457777778,-0.5567781720512218
7496,5887426,17,64,0.509159,63,5925314,-1,3136.0,6155114,6155131,267688,17,18,10,True,True,3.749314488888889,-0.509159
7497,5888353,2940,16,0.498588,63,5925314,-1,240.0,8528030,8530970,2639677,2940,6,12,True,True,24.28961333333333,-0.4920627137250058
7498,5888516,102,4,0.464267,63,5925314,-1,200.0,8997580,8997682,3109064,102,5,7,True,True,0.9268966666666667,-0.464267
7499,5889002,20,8,0.321823,63,5925314,-1,104.0,9381135,9381155,3492133,20,3,6,True,True,0.07947911111111111,-0.321823
7500,5889054,7028,1,0.373879,63,5925314,-1,44.0,9090835,9097863,3201781,7028,5,0,True,True,18.5666987,-0.3662565800588988
7501,5890305,1107,1,0.69451,63,5925314,-1,31.0,5928914,5930021,38609,1107,23,8,True,True,0.6626810583333335,-0.649199931154307
7502,5890888,78,1,0.71565,63,5925314,-1,39.0,5929814,5929892,38926,78,23,6,True,True,0.06284265000000001,-0.71565
7503,5890994,2,64,0.494792,63,5925314,-1,832.0,8385730,8385732,2494736,2,10,10,True,True,0.05273955555555555,-0.494792
7504,5891319,21,4,0.268335,63,5925314,-1,104.0,7738830,7738851,1847511,21,12,2,True,True,0.04106526666666667,-0.268335
7505,5894446,38,1,0.400946,63,5925314,-1,26.0,8441630,8441668,2547184,38,10,8,True,True,0.03145133333333333,-0.400946
7506,5895769,6344,1,0.921185,63,5925314,-1,40.0,5974014,5980358,78245,6344,26,11,True,True,9.909785777777778,-0.8994286623381605
7507,5895801,14,16,0.583983,63,5925314,-1,80.0,6173407,6173421,277606,14,25,6,True,True,0.05394355555555556,-0.583983
7508,5896365,6,16,0.036604,63,5925314,-1,656.0,10415466,10415472,4519101,6,1,7,True,True,0.11060160000000002,-0.036604
7509,5897788,87,45,0.219526,63,5925314,-1,2070.0,6358792,6358879,461004,87,25,6,True,True,6.087041999999999,-0.21952599999999997
7510,5897835,22,1,0.203,63,5925314,-1,21.0,8341530,8341552,2443695,22,13,1,True,True,0.010433500000000002,-0.203
7511,5903646,2,16,0.863168,63,5925314,-1,160.0,6831718,6831720,928072,2,22,6,True,True,0.013905777777777779,-0.863168
7512,5903692,5511,16,0.3959,63,5925314,-1,560.0,7622930,7628441,1719238,5511,17,11,True,True,121.49016444444446,-0.3743347714781254
7513,5903830,14,1,0.305999,63,5925314,-1,12.0,9025080,9025094,3121250,14,7,10,True,True,0.006724666666666666,-0.305999
7514,5903854,21512,256,0.888709,63,5925314,-1,7168.0,7121941,7143453,1218087,21512,20,7,True,True,4495.502811022221,-0.8790017557130838
7515,5903891,13741,32,0.57137,63,5925314,-1,1408.0,7526430,7540171,1622539,13741,20,6,True,True,725.7675548444445,-0.5239585993116864
7516,5903910,6463,1,0.935499,63,5925314,-1,34.0,7347143,7353606,1443233,6463,21,7,True,True,9.040006511111113,-0.9045431541201303
7517,5904073,7,16,0.374107,63,5925314,-1,352.0,6880418,6880425,976345,7,26,6,True,True,0.057301688888888876,-0.374107
7518,5904109,192,32,0.550552,63,5925314,-1,480.0,9293835,9294027,3389726,192,5,7,True,True,4.562432,-0.550552
7519,5904173,54,29,0.13433,63,5925314,-1,1276.0,6333092,6333146,428919,54,35,1,True,True,2.343693,-0.13433
7520,5904231,20,8,0.084028,63,5925314,-1,256.0,10103635,10103655,4199404,20,4,6,True,True,0.12394666666666668,-0.084028
7521,5904299,7667,1,0.444505,63,5925314,-1,39.0,9929935,9937602,4025636,7667,5,10,True,True,18.67323629166667,-0.42945642928717853
7522,5904344,7,4,0.351575,63,5925314,-1,116.0,9080080,9080087,3175736,7,10,1,True,True,0.07433634444444444,-0.351575
7523,5904545,13,64,0.583962,63,5925314,-1,2176.0,6286607,6286620,382062,13,40,10,True,True,0.9477265777777778,-0.583962
7524,5905986,11287,128,0.465253,63,5925314,-1,3584.0,8776130,8787417,2870144,11287,14,0,True,True,1390.2316686222223,-0.4442788624113496
7525,5906035,4050,67,0.621126,63,5925314,-1,804.0,8862530,8866580,2956495,4050,14,12,True,True,111.45304833333333,-0.6037565077965447
7526,5906485,4656,2,0.426102,63,5925314,-1,28.0,9518035,9522691,3611550,4656,6,7,True,True,12.251078544444443,-0.42258893175854434
7527,5906664,83,37,0.467551,63,5925314,-1,851.0,10332781,10332864,4426117,83,4,11,True,True,2.0956418694444445,-0.467551
7528,5906719,25,1,0.408953,63,5925314,-1,28.0,6598492,6598517,691773,25,38,1,True,True,0.029796666666666666,-0.408953
7529,5906995,65,8,0.804504,63,5925314,-1,200.0,7690130,7690195,1783135,65,25,11,True,True,0.34807499999999997,-0.804504
7530,5907080,18,4,0.31702,63,5925314,-1,52.0,8864330,8864348,2957250,18,16,7,True,True,0.0318266,-0.31702
7531,5907182,677,2,0.382371,63,5925314,-1,54.0,8776130,8776807,2868948,677,19,12,True,True,1.3492661999999997,-0.3823341059455916
7532,5907513,29749,128,0.179566,63,5925314,-1,1024.0,10554911,10584660,4647398,29749,0,10,True,True,1028.6229987555555,-0.16083491627340044
7533,5908228,324,8,0.23379,63,5925314,-1,272.0,10518457,10518781,4610229,324,2,6,True,True,8.5929696,-0.23379
7534,5922727,807,2,0.645355,63,5925314,-1,88.0,6700218,6701025,777491,807,42,10,True,True,2.7757392666666663,-0.645355
7535,5922836,12,1,0.359093,63,5925314,-1,36.0,6108214,6108226,185378,12,54,12,True,True,0.019974,-0.359093
7536,5922893,56,8,0.082419,63,5925314,-1,64.0,8246130,8246186,2323237,56,28,12,True,True,0.11743573333333332,-0.082419
7537,5923043,9440,30,0.842603,63,5925314,-1,1200.0,7169153,7178593,1246110,9440,36,7,True,True,346.95984333333325,-0.7457253788251735
7538,5923741,6610,32,0.512791,63,5925314,-1,512.0,6633918,6640528,710177,6610,46,10,True,True,131.54934613333333,-0.4196791853418832
7539,5924008,267,32,0.643654,63,5925314,-1,160.0,6830818,6831085,906810,267,44,11,True,True,1.8564213333333335,-0.643654
7540,5924145,828,2,0.785873,63,5925314,-1,36.0,6380892,6381720,456747,828,52,10,True,True,1.7978363999999998,-0.785873
7541,5937302,20,8,0.926606,101,5974014,-1,288.0,6018214,6018234,80912,20,60,11,True,True,0.147392,-0.9266060000000003
7542,5937343,15455,1,0.098409,101,5974014,-1,31.0,10389581,10405036,4452238,15455,6,8,True,True,14.425136569444446,-0.09312626390674975
7543,5937364,22032,1,0.071349,101,5974014,-1,26.0,10200381,10222413,4263017,22032,8,12,True,True,15.429045449999998,-0.06988508126181388
7544,5937459,60,16,0.038281,101,5974014,-1,544.0,9269035,9269095,3331576,60,14,7,True,True,1.2197386666666667,-0.038281
7545,5938122,17491,128,0.200307,101,5974014,-1,4480.0,10403766,10421257,4465644,17491,6,2,True,True,2148.5560568888895,-0.19939959763825718
7546,5939596,10,1,0.196646,101,5974014,-1,45.0,9087225,9087235,3147629,10,18,2,True,True,0.033345,-0.196646
7547,5940046,5,9,0.329241,101,5974014,-1,126.0,8960180,8960185,3020134,5,23,12,True,True,0.021755999999999998,-0.329241
7548,5943944,43,16,0.302716,101,5974014,-1,80.0,7169153,7169196,1225209,43,42,0,True,True,0.08886666666666668,-0.302716
7549,5944054,4569,8,0.815565,101,5974014,-1,64.0,6926418,6930987,982364,4569,48,11,True,True,6.942699200000001,-0.814906567343121
7550,5944985,16221,32,0.683539,101,5974014,-1,704.0,7000818,7017039,1055833,16221,47,6,True,True,293.7348655999999,-0.6764304500546183
7551,5945227,20,1,0.274465,101,5974014,-1,43.0,8390230,8390250,2445003,20,31,6,True,True,0.029211333333333332,-0.274465
7552,5945250,9156,1,0.705643,101,5974014,-1,13.0,6356992,6366148,411742,9156,64,10,True,True,4.202288277777778,-0.6600096338241794
7553,5949338,6946,1,0.997996,101,5974014,-1,48.0,6166814,6173760,217476,6946,69,7,True,True,15.6886288,-0.9964249533546629
7554,5949610,9251,4,0.998405,101,5974014,-1,132.0,6172507,6181758,222897,9251,69,3,True,True,51.198666566666674,-0.9454128580506569
7555,5950566,59,4,0.752383,101,5974014,-1,80.0,7645030,7645089,1694464,59,39,10,True,True,0.14729022222222224,-0.752383
7556,5950742,7103,32,0.739821,101,5974014,-1,704.0,6999918,7007021,1049176,7103,51,9,True,True,124.47141617777777,-0.715444510806208
7557,5950940,1359,8,0.912383,101,5974014,-1,88.0,7525530,7526889,1574590,1359,43,6,True,True,5.9905626000000005,-0.912383
7558,5951016,40,8,0.008534,101,5974014,-1,320.0,7532730,7532770,1581714,40,41,7,True,True,0.42926222222222227,-0.008534000000000002
7559,5951084,22235,2,0.299474,101,5974014,-1,10.0,7260256,7282491,1309172,22235,46,2,True,True,5.216380055555556,-0.29850784487525406
7560,5951247,6,1,0.822309,101,5974014,-1,15.0,7265656,7265662,1314409,6,46,7,True,True,0.0021435,-0.822309
7561,5951296,6,78,0.783128,101,5974014,-1,2964.0,6381792,6381798,430496,6,68,6,True,True,1.0726221999999999,-0.783128
7562,5951655,140,1,0.403811,101,5974014,-1,8.0,8992180,8992320,3040525,140,23,0,True,True,0.05503244444444444,-0.403811
7563,5951854,12,1,0.405758,101,5974014,-1,39.0,8995780,8995792,3043926,12,23,7,True,True,0.024865100000000005,-0.405758
7564,5951926,14,1,0.579954,101,5974014,-1,26.0,6109114,6109128,157188,14,81,6,True,True,0.016829944444444443,-0.579954
7565,5951995,14,28,0.655309,101,5974014,-1,700.0,9032280,9032294,3080285,14,20,9,True,True,0.36812611111111104,-0.655309
7566,5952001,11284,16,0.472004,101,5974014,-1,128.0,9292035,9303319,3340034,11284,15,6,True,True,76.42792746666667,-0.4711695165470566
7567,5952197,8289,16,0.512647,101,5974014,-1,768.0,8111930,8120219,2159733,8289,40,12,True,True,326.04602666666665,-0.5095483398927904
7568,5953161,12067,16,0.761161,101,5974014,-1,576.0,6165014,6177081,211853,12067,83,6,True,True,335.9286848,-0.7147817653609267
7569,5955024,20,4,0.149281,101,5974014,-1,132.0,8963780,8963800,3008756,20,27,8,True,True,0.11448800000000002,-0.149281
7570,5955318,15,1,0.397505,101,5974014,-1,33.0,10288581,10288596,4333263,15,9,12,True,True,0.016005000000000002,-0.397505
7571,5955467,16,16,0.226926,101,5974014,-1,784.0,8998480,8998496,3043013,16,25,6,True,True,0.5699505777777778,-0.226926
7572,5955906,27,1,0.749137,101,5974014,-1,46.0,6834418,6834445,878512,27,67,7,True,True,0.04587809999999999,-0.749137
7573,5956088,10745,1,0.474438,101,5974014,-1,20.0,9076480,9087225,3120392,10745,22,11,True,True,17.056605555555556,-0.464314569223534
7574,5961665,86,1,0.515825,101,5974014,-1,18.0,9087235,9087321,3125570,86,20,1,True,True,0.1147068,-0.515825
7575,5969778,334,8,0.785975,101,5974014,-1,296.0,6334892,6335226,365114,334,83,7,True,True,3.362749111111111,-0.785975
7576,5970831,20,1,0.757621,101,5974014,-1,33.0,7391343,7391363,1420512,20,55,11,True,True,0.03526966666666667,-0.757621
7577,5972158,9422,1,0.72251,101,5974014,-1,5.0,7735230,7744652,1763072,9422,47,6,True,True,0.9332698055555555,-0.6617636078603546
7578,5972911,50,1,0.461401,101,5974014,-1,11.0,9087235,9087285,3114324,50,20,0,True,True,0.04075499999999999,-0.461401
7579,5972972,7561,17,0.791915,101,5974014,-1,527.0,7825230,7832791,1852258,7561,47,12,True,True,139.5700256416667,-0.7656990193564066
7580,5973042,2995,5,0.313075,101,5974014,-1,60.0,10102735,10105730,4129693,2995,12,12,True,True,4.355714166666667,-0.31125482109295755
7581,5973569,43036,2,0.187847,101,5974014,-1,34.0,10642262,10685298,4668693,43036,0,6,True,True,80.58752627777778,-0.1775390087501973
7582,5975531,24,16,0.770131,116,6018214,-1,480.0,7939130,7939154,1963599,24,49,7,True,True,0.6399680000000001,-0.770131
7583,5993285,22793,128,0.697941,116,6018214,-1,1408.0,8337930,8360723,2344645,22793,46,8,True,True,833.6181841777777,-0.681731389170436
7584,5995698,2,8,0.209585,116,6018214,-1,280.0,6242407,6242409,246709,2,95,6,True,True,0.024854666666666667,-0.209585
7585,5995748,7,4,0.449972,116,6018214,-1,180.0,10109481,10109488,4113733,7,12,1,True,True,0.0386715,-0.449972
7586,5995800,686,1,0.558447,116,6018214,-1,14.0,8334330,8335016,2338530,686,48,0,True,True,0.23279028888888892,-0.558447
7587,5995817,602,1,0.3747,116,6018214,-1,30.0,10380581,10381183,4384764,602,9,11,True,True,1.3275103333333333,-0.3747
7588,5995826,170,4,0.577508,116,6018214,-1,28.0,6786618,6786788,790792,170,83,12,True,True,0.10840899999999999,-0.577508
7589,5997313,37,6,0.128346,116,6018214,-1,174.0,10527411,10527448,4530098,37,3,2,True,True,0.58655545,-0.128346
7590,5997397,69,8,0.943354,116,6018214,-1,264.0,6021814,6021883,24417,69,108,8,True,True,0.46977040000000003,-0.943354
7591,5997607,47,16,0.009681,116,6018214,-1,688.0,10336381,10336428,4338774,47,11,6,True,True,0.9306480444444444,-0.009681
7592,6010433,2573,2,0.810401,116,6018214,-1,80.0,7499843,7502416,1489410,2573,67,10,True,True,10.907556000000001,-0.7445060165124338
7593,6010526,2,4,0.834299,116,6018214,-1,144.0,6217607,6217609,207081,2,103,11,True,True,0.0191016,-0.834299
7594,6010551,78,1,0.339822,116,6018214,-1,25.0,10398716,10398794,4388165,78,9,2,True,True,0.05943708333333334,-0.339822
7595,6010570,6486,32,0.419147,116,6018214,-1,192.0,7345343,7351829,1334773,6486,71,11,True,True,50.6187776,-0.40046671792404986
7596,6010615,23,1,0.685763,116,6018214,-1,8.0,8966480,8966503,2955865,23,39,6,True,True,0.009046155555555557,-0.685763
7597,6011833,103,8,0.403369,116,6018214,-1,224.0,9266335,9266438,3254502,103,26,12,True,True,0.8441091555555555,-0.39491101264885514
7598,6084405,10,1,0.778643,182,6108214,-1,47.0,6240607,6240617,156202,10,107,10,True,True,0.024494833333333334,-0.778643
7599,6084716,8396,8,0.537604,182,6108214,-1,168.0,8533430,8541826,2448714,8396,48,8,True,True,46.6147024,-0.5362862288125315
7600,6085683,12,4,0.32608,182,6108214,-1,120.0,8970080,8970092,2884397,12,40,8,True,True,0.073412,-0.32608
7601,6085768,291,64,0.02324,182,6108214,-1,2944.0,10532811,10533102,4447043,291,2,8,True,True,75.86589866666667,-0.02324
7602,6085843,31,32,0.785358,182,6108214,-1,256.0,7524630,7524661,1438787,31,73,7,True,True,0.3975274666666667,-0.785358
7603,6085865,8087,26,0.922144,182,6108214,-1,858.0,6156014,6164101,70149,8087,117,6,True,True,474.2217051,-0.9220185335772569
7604,6093970,4,2,0.153691,182,6108214,-1,22.0,10507657,10507661,4413687,4,6,12,True,True,0.0025106888888888883,-0.153691
7605,6094137,1277,1,0.952638,182,6108214,-1,17.0,7272856,7274133,1178719,1277,79,9,True,True,0.5303026277777778,-0.952638
7606,6094181,836,16,0.330251,182,6108214,-1,432.0,8159730,8160566,2065549,836,61,11,True,True,17.8649856,-0.330251
7607,6094592,4818,1,0.629839,182,6108214,-1,8.0,7094441,7099259,999849,4818,87,2,True,True,1.4784174,-0.6075352717769668
7608,6094727,8,8,0.603003,182,6108214,-1,120.0,8623430,8623438,2528703,8,50,12,True,True,0.04217066666666666,-0.603003
7609,6094907,18787,2,0.607837,182,6108214,-1,84.0,7256656,7275443,1161749,18787,84,6,True,True,36.079660866666664,-0.5711615643962427
7610,6094978,10,4,0.866945,182,6108214,-1,116.0,7169356,7169366,1074378,10,85,2,True,True,0.029966666666666666,-0.866945
7611,6095254,11,44,0.980172,182,6108214,-1,528.0,6611818,6611829,516564,11,105,1,True,True,0.25084106666666667,-0.980172
7612,6095273,34,1,0.204205,182,6108214,-1,8.0,9092635,9092669,2997362,34,29,7,True,True,0.01785226666666667,-0.20420500000000005
7613,6095276,750,8,0.390636,182,6108214,-1,120.0,7577830,7578580,1482554,750,73,6,True,True,3.44529,-0.34622272929191583
7614,6095281,697,1,0.534491,182,6108214,-1,33.0,9179935,9180632,3084654,697,29,0,True,True,1.0755150083333334,-0.5024464951172481
7615,6095288,87,1,0.188339,182,6108214,-1,36.0,8389330,8389417,2294042,87,58,8,True,True,0.1063836,-0.188339
7616,6095300,5354,8,0.108638,182,6108214,-1,208.0,10522057,10527411,4426757,5354,5,2,True,True,103.21948520000001,-0.10418336030599162
7617,6095363,19008,8,0.569515,182,6108214,-1,312.0,7092618,7111626,997255,19008,96,12,True,True,237.91699879999996,-0.569006462713477
7618,6095534,31,4,0.451535,182,6108214,-1,80.0,10105730,10105761,4010196,31,20,2,True,True,0.06046377777777778,-0.451535
7619,6095582,113,2,0.894744,182,6108214,-1,62.0,6110914,6111027,15332,113,134,7,True,True,0.4949739,-0.894744
7620,6095896,137,32,0.093242,182,6108214,-1,320.0,10509457,10509594,4413561,137,7,7,True,True,1.9293253333333336,-0.093242
7621,6095972,9,2,0.104313,182,6108214,-1,96.0,10390481,10390490,4294509,9,14,6,True,True,0.030316799999999998,-0.10431300000000003
7622,6095994,6961,17,0.552907,182,6108214,-1,833.0,7098041,7105002,1002047,6961,98,1,True,True,235.38609954999998,-0.5437215033383055
7623,6096053,39045,8,0.032059,182,6108214,-1,80.0,10413666,10452711,4317613,39045,10,6,True,True,196.46679333333333,-0.030802197466682293
7624,6096103,12315,4,0.689025,182,6108214,-1,132.0,6572792,6585107,476689,12315,118,9,True,True,67.0175055,-0.6226392449235826
7625,6096127,23680,2,0.488613,182,6108214,-1,66.0,7093518,7117198,997391,23680,101,6,True,True,61.209703866666665,-0.4871158274192493
7626,6096190,11,1,0.186692,182,6108214,-1,30.0,10417266,10417277,4321076,11,9,7,True,True,0.009273,-0.186692
7627,6096215,699,18,0.069491,182,6108214,-1,666.0,10412766,10413465,4316551,699,12,2,True,True,12.901757549999997,-0.069491
7628,6096769,50,1,0.962995,182,6108214,-1,9.0,7143453,7143503,1046684,50,99,8,True,True,0.011939999999999997,-0.9629950000000003
7629,6096778,13995,36,0.283818,182,6108214,-1,972.0,10516657,10530652,4419879,13995,7,8,True,True,1283.6862342,-0.28201862863037325
7630,6096933,51,1,0.233039,182,6108214,-1,17.0,10641311,10641362,4544378,51,1,12,True,True,0.07164069166666667,-0.233039
7631,6096961,72,4,0.65957,182,6108214,-1,68.0,8866580,8866652,2769619,72,57,2,True,True,0.1664776,-0.65957
7632,6097020,8852,128,0.069979,182,6108214,-1,5504.0,8992180,9001032,2895160,8852,53,10,True,True,2376.431563377778,-0.0681702400162237
7633,6097126,33,8,0.057453,182,6108214,-1,56.0,10333681,10333714,4236555,33,23,6,True,True,0.05482913333333333,-0.057453
7634,6097130,279,4,0.518532,182,6108214,-1,132.0,7275443,7275722,1178313,279,97,2,True,True,0.8917978666666668,-0.5140198578013847
7635,6097184,6985,8,0.171826,182,6108214,-1,240.0,10393181,10400166,4295997,6985,19,6,True,True,49.46981733333334,-0.1543268660164717
7636,6097211,410,4,0.859707,182,6108214,-1,160.0,7279043,7279453,1181832,410,98,2,True,True,1.649172,-0.8350113348303048
7637,6097271,3,8,0.410861,182,6108214,-1,80.0,7937330,7937333,1840059,3,81,7,True,True,0.012850666666666666,-0.4108610000000001
7638,6097277,278,2,0.157035,182,6108214,-1,34.0,10382381,10382659,4285104,278,22,7,True,True,0.45221813333333344,-0.10221168657213904
7639,6097332,23,4,0.110744,182,6108214,-1,20.0,9562235,9562258,3464903,23,34,11,True,True,0.03407961111111111,-0.110744
7640,6097351,23,32,0.536453,182,6108214,-1,704.0,7094418,7094441,997067,23,115,6,True,True,0.6023424,-0.536453
7641,6098046,203,8,0.478251,182,6108214,-1,200.0,7169153,7169356,1071107,203,109,0,True,True,1.0488333333333335,-0.478251
7642,6098145,19,1,0.068763,182,6108214,-1,26.0,10397681,10397700,4299536,19,19,6,True,True,0.015057394444444445,-0.068763
7643,6098202,1062,2,0.955097,182,6108214,-1,20.0,7477743,7478805,1379541,1062,99,12,True,True,1.309387,-0.9550970000000002
7644,6098431,6,1,0.865699,182,6108214,-1,49.0,6133014,6133020,34583,6,158,10,True,True,0.024566966666666665,-0.8656989999999997
7645,6098546,4961,16,0.129932,182,6108214,-1,480.0,10385981,10390942,4287435,4961,23,8,True,True,82.566024,-0.1048229822152165
7646,6098955,14,1,0.205677,182,6108214,-1,28.0,8393830,8393844,2294875,14,74,8,True,True,0.013599133333333334,-0.205677
7647,6100368,8,26,0.432201,182,6108214,-1,442.0,7935530,7935538,1835162,8,87,7,True,True,0.18933315555555555,-0.432201
7648,6100373,624,1,0.709672,182,6108214,-1,39.0,7167353,7167977,1066980,624,116,7,True,True,0.6216425583333334,-0.7017279341756273
7649,6100434,3,2,0.47478,182,6108214,-1,32.0,6992718,6992721,892284,3,129,11,True,True,0.0023136000000000003,-0.47478
7650,6100512,20254,16,0.603709,182,6108214,-1,736.0,9081880,9102134,2981368,20254,50,6,True,True,978.8561454222221,-0.557850883105349
7651,6100987,28,2,0.939154,182,6108214,-1,14.0,7734330,7734358,1633343,28,92,11,True,True,0.0075732222222222225,-0.939154
7652,6101020,9091,128,0.587492,182,6108214,-1,2816.0,7255756,7264847,1154736,9091,114,12,True,True,589.0630357333333,-0.5188657383270288
7653,6101026,128,16,0.502475,182,6108214,-1,800.0,9516235,9516363,3415209,128,38,12,True,True,9.536568888888889,-0.502475
7654,6101073,7,1,0.684836,182,6108214,-1,29.0,6168907,6168914,67834,7,163,7,True,True,0.009341383333333333,-0.684836
7655,6106453,89,16,0.275441,182,6108214,-1,576.0,9093535,9093624,2987082,89,46,6,True,True,3.2415551999999996,-0.2653658645579516
7656,6106775,9486,8,0.007443,182,6108214,-1,328.0,10200381,10209867,4093606,9486,30,0,True,True,85.1435848,-0.007157997198055571
7657,6106898,10,16,0.142692,182,6108214,-1,672.0,10016335,10016345,3909437,10,36,12,True,True,0.2199306666666667,-0.142692
7658,6107010,66,32,0.06397,182,6108214,-1,1568.0,10517557,10517623,4410547,66,8,6,True,True,10.090654933333333,-0.06397
7659,6107212,15,1,0.399237,182,6108214,-1,21.0,7578730,7578745,1471518,15,102,6,True,True,0.011605124999999999,-0.399237
7660,6107349,5513,1,0.807566,182,6108214,-1,41.0,6218507,6224020,111158,5513,165,6,True,True,16.62685311388889,-0.7983007128849819
7661,6107760,42,4,0.525857,182,6108214,-1,100.0,9735035,9735077,3627275,42,39,12,True,True,0.1478516666666667,-0.525857
7662,6107783,6,4,0.910303,182,6108214,-1,36.0,6517792,6517798,410009,6,154,12,True,True,0.008289000000000001,-0.910303
7663,6108059,58,1,0.879239,182,6108214,-1,48.0,6286620,6286678,178561,58,164,1,True,True,0.09327173333333333,-0.879239
7664,6108112,537,1,0.460205,182,6108214,-1,38.0,9648635,9649172,3540523,537,40,12,True,True,0.7190847666666667,-0.460205
7665,6108162,11,4,0.576133,182,6108214,-1,200.0,8870180,8870191,2762018,11,72,7,True,True,0.061404444444444456,-0.576133
7666,6108299,73,1,0.737291,182,6109114,-1,32.0,6264507,6264580,156208,73,168,10,True,True,0.08406355555555556,-0.737291
7667,6109439,8251,8,0.287912,186,6110914,-1,344.0,10202181,10210432,4092742,8251,31,7,True,True,75.5360035111111,-0.2660813064057275
7668,6110021,745,2,0.880994,186,6110914,-1,70.0,6408392,6409137,298371,745,158,10,True,True,2.6028644444444446,-0.880994
7669,6110292,24,16,0.456307,186,6110914,-1,144.0,9179935,9179959,3069643,24,52,12,True,True,0.1719072,-0.456307
7670,6110560,683,2,0.700317,186,6110914,-1,82.0,7911630,7912313,1801070,683,99,12,True,True,2.199013361111111,-0.700317
7671,6110618,475,1,0.711648,186,6110914,-1,50.0,8868380,8868855,2757762,475,75,7,True,True,0.662888888888889,-0.711648
7672,6111648,10744,4,0.297449,222,6133014,-1,104.0,8873780,8884524,2762132,10744,74,8,True,True,47.69986808888889,-0.29506226750252185
7673,6111677,29494,4,0.613028,222,6133014,-1,180.0,7576930,7606424,1465253,29494,112,11,True,True,211.04076700000002,-0.6038351863330635
7674,6112290,396,7,0.809985,222,6133014,-1,63.0,8115530,8115926,2003240,396,97,8,True,True,1.3434498000000001,-0.809985
7675,6112402,206,1,0.175126,222,6133014,-1,42.0,10335481,10335687,4223079,206,28,7,True,True,0.2534520333333333,-0.17291014813346992
7676,6112602,13650,14,0.249135,222,6133014,-1,126.0,10113981,10127631,4001379,13650,35,8,True,True,49.309928850000006,-0.24454903612886036
7677,6112924,20785,193,0.899965,222,6133014,-1,7334.0,6594892,6615677,481968,20785,163,10,True,True,6351.829497666666,-0.8416510273087981
7678,6116203,5,8,0.733244,222,6133014,-1,160.0,6357892,6357897,241689,5,173,6,True,True,0.02704,-0.733244
7679,6116352,1695,8,0.457828,222,6133014,-1,400.0,8689730,8691425,2573378,1695,84,11,True,True,24.28536111111111,-0.4432160689937725
7680,6116390,8,4,0.910833,222,6133014,-1,96.0,6164114,6164122,47724,8,191,9,True,True,0.048669866666666665,-0.910833
7681,6116853,16547,64,0.183444,222,6133014,-1,2048.0,10513057,10529604,4396204,16547,10,8,True,True,3132.8960284444447,-0.1828508745976874
7682,6117029,5,2,0.568615,222,6133014,-1,90.0,7933730,7933735,1816701,5,106,10,True,True,0.024901250000000003,-0.568615
7683,6118255,11693,41,0.393551,222,6133014,-1,1230.0,8965580,8977273,2847325,11693,75,7,True,True,678.5689078333332,-0.3849725540649596
7684,6118441,9726,24,0.945687,222,6133014,-1,312.0,6602092,6611818,483651,9726,166,2,True,True,111.62813653333335,-0.8554771403997047
7685,6118880,394,1,0.239695,222,6133014,-1,19.0,6948518,6948912,829638,394,155,10,True,True,0.14021693888888892,-0.239695
7686,6118914,18,1,0.87054,222,6133014,-1,21.0,6879518,6879536,760604,18,158,6,True,True,0.0088662,-0.87054
7687,6118928,95,1,0.273776,222,6133014,-1,12.0,7301143,7301238,1182215,95,130,10,True,True,0.02907633333333333,-0.273776
7688,6119064,23817,2,0.628083,222,6133014,-1,10.0,6565592,6589409,446528,23817,173,11,True,True,10.622979416666668,-0.5796016194568867
7689,6119108,9,4,0.29189,222,6133014,-1,152.0,8025530,8025539,1906422,9,104,12,True,True,0.0681378,-0.29189
7690,6123749,14,4,0.916296,222,6133014,-1,92.0,6856518,6856532,732769,14,162,10,True,True,0.04744133333333333,-0.916296
7691,6123915,18,4,0.698044,222,6133014,-1,196.0,7006218,7006236,882303,18,152,7,True,True,0.093884,-0.698044
7692,6124059,81,1,0.722409,222,6133014,-1,45.0,8363630,8363711,2239571,81,96,10,True,True,0.108165375,-0.722409
7693,6124598,92,2,0.217255,222,6133014,-1,36.0,10400166,10400258,4275568,92,20,2,True,True,0.1009516,-0.217255
7694,6124770,8,1,0.493488,222,6133014,-1,36.0,8438030,8438038,2313260,8,93,11,True,True,0.0076511999999999995,-0.493488
7695,6125092,2,5,0.99239,222,6133014,-1,115.0,6926418,6926420,801326,2,162,0,True,True,0.005702722222222223,-0.99239
7696,6125214,4,4,0.552824,222,6133014,-1,140.0,7735230,7735234,1610016,4,115,0,True,True,0.010818888888888888,-0.552824
7697,6125511,10193,16,0.995316,222,6133014,-1,672.0,6156914,6167107,31403,10193,208,6,True,True,454.2751546666666,-0.9804664361432806
7698,6125774,15531,128,0.076534,222,6133014,-1,3328.0,10421257,10436788,4295483,15531,13,2,True,True,3366.856248888889,-0.06987756675703997
7699,6126004,10,16,0.105225,222,6133014,-1,240.0,10525657,10525667,4399653,10,6,2,True,True,0.22038666666666665,-0.105225
7700,6126999,20414,256,0.766539,222,6133014,-1,9728.0,7502416,7522830,1375417,20414,132,6,True,True,10432.96492088889,-0.7640401866141312
7701,6127255,15208,4,0.326013,222,6133014,-1,192.0,9907835,9923043,3780580,15208,46,12,True,True,169.0350442666667,-0.32364298773007627
7702,6127551,151,16,0.450936,222,6133014,-1,96.0,10109330,10109481,3981779,151,41,8,True,True,0.44490640000000004,-0.450936
7703,6128779,3,1,0.252767,222,6133014,-1,26.0,8645530,8645533,2516751,3,92,10,True,True,0.0030515333333333335,-0.252767
7704,6128835,200,32,0.506065,222,6133014,-1,1184.0,9002980,9003180,2874145,200,72,6,True,True,10.660604444444443,-0.506065
7705,6128855,154,2,0.462167,222,6133014,-1,66.0,9086380,9086534,2957525,154,67,6,True,True,0.7577027333333333,-0.4442903538057385
7706,6129010,26,32,0.073195,222,6133014,-1,288.0,9384735,9384761,3255725,26,53,8,True,True,0.3154944,-0.073195
7707,6130829,3,5,0.694486,222,6133014,-1,35.0,7094418,7094421,963589,3,162,0,True,True,0.003906,-0.694486
7708,6132809,32539,37,0.749736,222,6133014,-1,1591.0,7530030,7562569,1397221,32539,135,2,True,True,1689.6580690999997,-0.7297319493708704
7709,6133298,352,1,0.381156,228,6155114,-1,34.0,9085480,9085832,2952182,352,69,2,True,True,0.9280851555555557,-0.381156
7710,6133568,34,106,0.745957,228,6155114,-1,4028.0,6832618,6832652,699050,34,182,6,True,True,5.951325244444444,-0.745957
7711,6133731,53,4,0.855773,228,6155114,-1,32.0,7263856,7263909,1130125,53,151,2,True,True,0.03683617777777778,-0.855773
7712,6133928,6435,4,0.396674,228,6155114,-1,140.0,10392281,10398716,4258353,6435,26,7,True,True,27.09104066666667,-0.3608259796378745
7713,6134348,3,8,0.010737,228,6155114,-1,336.0,9291135,9291138,3156787,3,58,10,True,True,0.046446400000000006,-0.010737
7714,6134461,109,4,0.114683,228,6155114,-1,140.0,10110381,10110490,3975920,109,41,6,True,True,0.46835483333333333,-0.114683
7715,6134542,144,8,0.917137,228,6155114,-1,152.0,6167107,6167251,32565,144,222,1,True,True,1.0072128,-0.917137
7716,6157938,30,8,0.32711,229,6164114,-1,264.0,9080980,9081010,2923042,30,74,6,True,True,0.725054,-0.32711
7717,6158059,72,1,0.748676,229,6164114,-1,50.0,6431392,6431464,273333,72,202,6,True,True,0.10598,-0.748676
7718,6158070,1194,32,0.484759,229,6164114,-1,448.0,8993980,8995174,2835910,1194,84,7,True,True,28.420171733333337,-0.484759
7719,6158142,61,8,0.068237,229,6164114,-1,224.0,9429835,9429896,3271693,61,55,11,True,True,0.5258742222222224,-0.068237
7720,6166540,36,1,0.548429,229,6166814,-1,25.0,9821435,9821471,3654895,36,50,12,True,True,0.0626225,-0.548429
7721,6166801,8740,64,0.242294,229,6166814,-1,384.0,9380235,9388975,3213434,8740,59,12,True,True,136.16894933333333,-0.2393534552812298
7722,6167111,15477,8,0.950018,235,6168907,-1,64.0,7522830,7538307,1355719,15477,148,6,True,True,40.076408,-0.8923944137039018
7723,6167127,12518,64,0.140256,235,6168907,-1,832.0,9385635,9398153,3218508,12518,57,6,True,True,437.2725297777777,-0.13854794330395356
7724,6167151,6896,1,0.820427,235,6168907,-1,22.0,6430492,6437388,263341,6896,209,10,True,True,4.330123844444444,-0.8105955537857901
7725,6167179,4606,42,0.841563,235,6168907,-1,630.0,6241507,6246113,74328,4606,225,6,True,True,132.518057,-0.7621293886560575
7726,6167293,35,32,0.170589,235,6168907,-1,1152.0,10396781,10396816,4229488,35,25,8,True,True,1.1872064,-0.16479113714962698
7727,6167321,2351,32,0.018066,235,6168907,-1,576.0,10641362,10643713,4474041,2351,1,1,True,True,111.46695359999998,-0.017996678265394746
7728,6167402,3,64,0.100515,235,6168907,-1,448.0,9090835,9090838,2923433,3,74,8,True,True,0.0882112,-0.100515
7729,6168363,50,16,0.294145,235,6168907,-1,512.0,8529830,8529880,2361467,50,112,7,True,True,0.8795733333333332,-0.294145
7730,6170285,6,15,0.534654,237,6172507,-1,615.0,7165553,7165559,995268,6,174,10,True,True,0.09262925000000001,-0.534654
7731,6170812,28303,8,0.39085,237,6172507,-1,200.0,8247930,8276233,2077118,28303,125,7,True,True,184.09664333333333,-0.390487574542215
7732,6170820,852,1,0.077585,237,6172507,-1,46.0,6882218,6883070,711398,852,194,7,True,True,0.9114317333333333,-0.077585
7714,6134461,109,4,0.114683,1,6134461,-1,140.0,6138061,6138170,3600,109,0,8,True,True,0.7309540000000001,-0.114683
7715,6134542,144,8,0.917137,1,6138061,-1,152.0,6224461,6224605,89919,144,0,12,True,True,0.7580544000000001,-0.917137
7716,6157938,30,8,0.32711,114,6224461,-1,264.0,9895695,9895725,3737757,30,0,2,True,True,0.41762600000000005,-0.32711
7717,6158059,72,1,0.748676,114,6224461,-1,50.0,8196285,8196357,2038226,72,1,6,True,True,0.14054,-0.748676
7718,6158070,1194,32,0.484759,114,6224461,-1,448.0,9913127,9914321,3755057,1194,0,2,True,True,24.616353066666665,-0.484759
7719,6158142,61,8,0.068237,114,6224461,-1,224.0,10841698,10841759,4683556,61,0,11,True,True,0.4979389333333334,-0.068237
7720,6166540,36,1,0.548429,114,6224461,-1,25.0,7257535,7257571,1090995,36,4,7,True,True,0.032200000000000006,-0.548429
7721,6166801,8740,64,0.242294,114,6224461,-1,384.0,10842606,10851346,4675805,8740,0,1,True,True,104.92096213333333,-0.22670828026213957
7722,6167111,15477,8,0.950018,114,6224461,-1,64.0,6510775,6526252,343664,15477,6,4,True,True,33.84759022222222,-0.9391942002702915
7723,6167127,12518,64,0.140256,114,6224461,-1,832.0,11100857,11113375,4933730,12518,0,2,True,True,935.535683911111,-0.13940224679831656
7724,6167151,6896,1,0.820427,114,6224461,-1,22.0,6503937,6510833,336786,6896,8,6,True,True,3.2493230000000004,-0.74158075448552
7725,6167179,4606,42,0.841563,114,6224461,-1,630.0,8993185,8997791,2826006,4606,5,7,True,True,81.67746475,-0.8365599870827762
7726,6167293,35,32,0.170589,114,6224461,-1,1152.0,11033406,11033441,4866113,35,1,2,True,True,3.479504,-0.170589
7727,6167321,2351,32,0.018066,114,6224461,-1,576.0,9910095,9912446,3742774,2351,5,4,True,True,60.43241119999999,-0.017519247352558345
7728,6167402,3,64,0.100515,114,6224461,-1,448.0,11187257,11187260,5019855,3,0,12,True,True,0.08608693333333334,-0.100515
7729,6168363,50,16,0.294145,114,6224461,-1,512.0,6730775,6730825,562412,50,11,10,True,True,1.800391111111111,-0.294145
7730,6170285,6,15,0.534654,114,6224461,-1,615.0,6698775,6698781,528490,6,12,10,True,True,0.30524500000000004,-0.534654
7731,6170812,28303,8,0.39085,114,6224461,-1,200.0,9910995,9939298,3740183,28303,6,0,True,True,227.51677055555555,-0.3896431125739055
7732,6170820,852,1,0.077585,114,6224461,-1,46.0,10783998,10784850,4613178,852,5,8,True,True,0.9866585999999999,-0.077585
7733,6171254,11,32,0.763589,114,6224461,-1,1216.0,6708675,6708686,537421,11,14,9,True,True,1.1177134222222223,-0.763589
7734,6171266,6290,1,0.677383,114,6224461,-1,30.0,7359235,7365525,1187969,6290,12,2,True,True,4.286352083333333,-0.6773346059999144
7735,6171277,10237,3,0.153496,114,6224461,-1,63.0,11034306,11044543,4863029,10237,2,6,True,True,58.4879456,-0.1532446487909177
7736,6171329,8,10,0.358087,114,6224461,-1,360.0,9674495,9674503,3503166,8,11,10,True,True,0.15752799999999997,-0.358087
7737,6171796,29,4,0.216672,114,6224461,-1,128.0,7533456,7533485,1361660,29,14,11,True,True,0.07527111111111111,-0.216672
7738,6171947,8514,128,0.034445,114,6224461,-1,1408.0,9911498,9920012,3739551,8514,8,2,True,True,537.8733418666666,-0.03416461030535921
7739,6180587,10886,2,0.675044,114,6224461,-1,16.0,6365959,6376845,185372,10886,23,6,True,True,7.3493711555555565,-0.6376908600771978
7740,6180626,47,1,0.216166,114,6224461,-1,50.0,10797498,10797545,4616872,47,6,8,True,True,0.0652451388888889,-0.216166
7741,6180674,58,1,0.696742,114,6224461,-1,44.0,6701475,6701533,520801,58,21,6,True,True,0.20754848888888883,-0.696742
7742,6180804,34,2,0.836501,114,6224461,-1,48.0,6420959,6420993,240155,34,25,9,True,True,0.058520800000000005,-0.836501
7743,6180922,3,1,0.811512,114,6224461,-1,11.0,6652775,6652778,471853,3,23,7,True,True,0.0011666416666666667,-0.811512
7744,6181531,14512,1,0.641012,114,6224461,-1,50.0,6674875,6689387,493344,14512,23,10,True,True,35.74100708333333,-0.5309474798502007
7745,6181893,34,4,0.71641,114,6224461,-1,136.0,8152585,8152619,1970692,34,16,8,True,True,0.1997182666666667,-0.71641
7746,6181980,11445,16,0.89701,114,6224461,-1,160.0,7367952,7379397,1185972,11445,18,2,True,True,51.001924,-0.8780605161208845
7747,6182070,10698,256,0.390618,114,6224461,-1,11520.0,10430098,10440796,4248028,10698,8,12,True,True,8312.200703999999,-0.3905031204391651
7748,6182223,59,2,0.308324,114,6224461,-1,40.0,9864595,9864654,3682372,59,14,2,True,True,0.10874355555555557,-0.308324
7749,6182229,14021,8,0.052415,114,6224461,-1,368.0,10736198,10750219,4553969,14021,8,6,True,True,181.4025507111111,-0.051732053239405676
7750,6182245,6,7,0.004666,114,6224461,-1,126.0,10735298,10735304,4553053,6,9,6,True,True,0.0279846,-0.004666
7751,6182363,11,15,0.77241,114,6224461,-1,165.0,6369559,6369570,187196,11,34,8,True,True,0.07888191666666669,-0.77241
7752,6182386,12,2,0.767114,114,6224461,-1,18.0,9297485,9297497,3115099,12,18,12,True,True,0.0077286,-0.767114
7753,6182528,13,32,0.928821,114,6224461,-1,640.0,6429129,6429142,246601,13,34,2,True,True,0.4137813333333333,-0.928821
7754,6182662,527,8,0.374645,114,6224461,-1,208.0,10734398,10734925,4551736,527,10,6,True,True,4.039654088888889,-0.374645
7755,6182694,1989,2,0.23854,114,6224461,-1,62.0,7844085,7846074,1661391,1989,23,12,True,True,2.7461691,-0.22303911851783834
7756,6182782,38,2,0.091386,114,6224461,-1,56.0,11039706,11039744,4856924,38,2,8,True,True,0.198702,-0.091386
7757,6182850,21,4,0.421683,114,6224461,-1,132.0,9815895,9815916,3633045,21,19,2,True,True,0.1061137,-0.421683
7758,6182870,18,2,0.989291,114,6224461,-1,28.0,6452537,6452555,269667,18,38,9,True,True,0.026192600000000003,-0.989291
7759,6182876,16473,21,0.337117,114,6224461,-1,336.0,7375152,7391625,1192276,16473,27,2,True,True,185.651522,-0.31296993666859607
7760,6183019,13368,6,0.192152,114,6224461,-1,120.0,8119685,8133053,1936666,13368,25,0,True,True,50.09285466666667,-0.186976784512043
7761,6183053,24,4,0.668949,114,6224461,-1,184.0,6940275,6940299,757222,24,32,7,True,True,0.1607424,-0.668949
7762,6184878,28,1,0.220568,114,6224461,-1,41.0,7706285,7706313,1521407,28,27,12,True,True,0.03483223333333334,-0.220568
7763,6186030,10651,4,0.882286,114,6224461,-1,136.0,7349335,7359986,1163305,10651,32,12,True,True,34.60316755555556,-0.8644188690555477
7764,6186037,134,4,0.796924,114,6224461,-1,168.0,6807875,6808009,621838,134,35,11,True,True,1.3525334666666666,-0.796924
7765,6186291,7,1,0.830451,114,6224461,-1,43.0,6596875,6596882,410584,7,42,7,True,True,0.007762455555555554,-0.830451
7766,6186296,4,1,0.167883,114,6224461,-1,7.0,11046449,11046453,4860153,4,2,2,True,True,0.002516111111111111,-0.167883
7767,6186359,9079,16,0.167047,114,6224461,-1,208.0,9983498,9992577,3797139,9079,14,11,True,True,79.22049488888888,-0.16540320722199373
7768,6186610,2,64,0.41568,114,6224461,-1,2560.0,7371552,7371554,1184942,2,32,8,True,True,0.12784355555555557,-0.41568
7769,6186646,12762,5,0.107684,114,6224461,-1,60.0,9438885,9451647,3252239,12762,23,8,True,True,24.461596500000002,-0.09757638997957105
7770,6186691,94,4,0.327141,114,6224461,-1,188.0,10793898,10793992,4607207,94,9,6,True,True,0.4789112,-0.327141
7771,6186720,10727,1,0.562054,114,6224461,-1,48.0,8119685,8130412,1932965,10727,30,7,True,True,16.282938533333333,-0.5431730687344029
7772,6186760,4,16,0.189548,114,6224461,-1,592.0,8141785,8141789,1955025,4,29,10,True,True,0.07040195555555555,-0.189548
7773,6187354,35732,16,0.207119,114,6224461,-1,368.0,11042849,11078581,4855495,35732,3,2,True,True,565.7203106222221,-0.19316895352308525
7774,6187374,16088,32,0.541703,114,6224461,-1,448.0,9920327,9936415,3732953,16088,17,3,True,True,271.23352355555556,-0.5166734305104089
7775,6187428,7,4,0.938923,114,6224461,-1,68.0,6424559,6424566,237131,7,56,7,True,True,0.020285533333333335,-0.938923
7776,6187452,40,4,0.120804,114,6224461,-1,80.0,7711685,7711725,1524233,40,35,7,True,True,0.08871111111111112,-0.12080400000000002
7777,6187476,230,32,0.21378,114,6224461,-1,1280.0,9987098,9987328,3799622,230,16,8,True,True,13.080355555555553,-0.21378
7778,6187562,4,1,0.356576,114,6224461,-1,44.0,8240485,8240489,2052923,4,30,11,True,True,0.006295422222222222,-0.356576
7779,6187628,5482,64,0.173622,114,6224461,-1,2112.0,7713485,7718967,1525857,5482,37,7,True,True,315.36198613333335,-0.17175968706101863
7780,6187688,7780,16,0.402139,114,6224461,-1,320.0,7485656,7493436,1297968,7780,41,10,True,True,63.420384,-0.39871831681233083
7781,6196956,48,8,0.31624,114,6224461,-1,40.0,9930634,9930682,3733678,48,18,8,True,True,0.067152,-0.31624
7782,6197065,8715,64,0.389187,114,6224461,-1,2624.0,9538495,9547210,3341430,8715,28,7,True,True,1118.4782506666668,-0.38526482471267537
7783,6197309,20587,32,0.458776,114,6224461,-1,256.0,9916727,9937314,3719418,20587,20,7,True,True,203.75081173333334,-0.4392477234751691
7784,6197333,132,8,0.066016,114,6224461,-1,304.0,10733498,10733630,4536165,132,15,12,True,True,1.4788282666666663,-0.066016
7785,6197371,40,8,0.815085,114,6224461,-1,248.0,6502137,6502177,304766,40,63,1,True,True,0.15318133333333336,-0.815085
7786,6197433,8,4,0.649945,114,6224461,-1,72.0,6763675,6763683,566242,8,54,10,True,True,0.0301296,-0.649945
7787,6198518,5,2,0.36898,114,6224461,-1,20.0,8417785,8417790,2219267,5,34,0,True,True,0.005230833333333334,-0.36898
7788,6198545,6037,1,0.067331,114,6224461,-1,45.0,9927034,9933071,3728489,6037,20,6,True,True,9.75186175,-0.06552199256411657
7789,6198567,13942,3,0.218561,114,6224461,-1,111.0,10780398,10794340,4581831,13942,12,11,True,True,40.45627545000001,-0.21322153769882715
7790,6199325,12,4,0.301534,114,6224461,-1,132.0,9906495,9906507,3707170,12,28,2,True,True,0.06697680000000002,-0.301534
7791,6199601,9528,16,0.598869,114,6224461,-1,752.0,7489256,7498784,1289655,9528,49,1,True,True,189.64104782222222,-0.5987893246505572
7792,6199623,16060,128,0.983102,114,6224461,-1,3328.0,6365059,6381119,165436,16060,76,12,True,True,2304.7218410666665,-0.9507479454706618
7793,6200106,14,3,0.101814,114,6224461,-1,78.0,10038498,10038512,3838392,14,18,11,True,True,0.046440333333333327,-0.101814
7794,6200395,17,19,0.536182,114,6224461,-1,855.0,7976485,7976502,1776090,17,45,12,True,True,0.633685625,-0.536182
7795,6201790,98,3,0.990531,114,6224461,-1,138.0,6251061,6251159,49271,98,79,10,True,True,0.6181970666666667,-0.990531
7796,6201992,13,32,0.850465,114,6224461,-1,1088.0,6595075,6595088,393083,13,69,6,True,True,0.36192924444444446,-0.850465
7797,6202188,15248,8,0.171459,114,6224461,-1,224.0,10792998,10808246,4590810,15248,11,2,True,True,93.15001546666666,-0.17102673262142418
7798,6202259,119,4,0.959035,114,6224461,-1,68.0,7419352,7419471,1217093,119,54,11,True,True,0.29488596666666667,-0.959035
7799,6202348,13269,32,0.599867,114,6224461,-1,1120.0,8855385,8868654,2653037,13269,39,11,True,True,440.1122226666667,-0.5905530697884692
7800,6202504,4977,8,0.981416,114,6224461,-1,344.0,6505375,6510352,302871,4977,74,1,True,True,38.47433313333333,-0.8869470351202355
7801,6202738,9543,16,0.696315,114,6224461,-1,224.0,6278659,6288202,75921,9543,84,6,True,True,88.22469226666666,-0.6952753504263256
7802,6202784,3,4,0.677901,114,6224461,-1,112.0,7708085,7708088,1505301,3,51,7,True,True,0.009375333333333334,-0.677901
7803,6202795,12009,1,0.972367,114,6224461,-1,35.0,6572075,6584084,369280,12009,74,6,True,True,12.21461179166667,-0.9720002833673104
7804,6202868,670,1,0.693721,114,6224461,-1,24.0,7980085,7980755,1777217,670,47,8,True,True,0.6423513333333333,-0.693721
7805,6203049,269,8,0.332047,114,6224461,-1,216.0,11096049,11096318,4893000,269,2,2,True,True,5.7522959999999985,-0.332047
7806,6203171,1197,3,0.635353,114,6224461,-1,126.0,6228061,6229258,24890,1197,90,8,True,True,5.588793000000001,-0.635353
7807,6204006,19249,128,0.883967,114,6224461,-1,4864.0,7983685,8002934,1779679,19249,48,8,True,True,5896.560765866667,-0.8718849814738964
7808,6204286,8237,4,0.317967,114,6224461,-1,68.0,6641075,6649312,436789,8237,75,11,True,True,19.54737897777778,-0.31395789362395166
7809,6204343,16776,1,0.851554,114,6224461,-1,30.0,6641975,6658751,437632,16776,75,6,True,True,16.862498916666667,-0.8188000028786595
7810,6206461,119,16,0.48213,114,6224461,-1,784.0,8811185,8811304,2604724,119,41,0,True,True,2.898654888888889,-0.48213
7811,6207230,21,4,0.335105,114,6224461,-1,64.0,8244985,8245006,2037755,21,43,6,True,True,0.043792000000000005,-0.335105
7812,6207482,681,8,0.608533,114,6224461,-1,96.0,7353835,7354516,1146353,681,66,2,True,True,1.6040728000000002,-0.6085330000000001
7813,6207629,10100,64,0.585037,114,6224461,-1,1792.0,9812295,9822395,3604666,10100,35,12,True,True,700.4100195555556,-0.5802237865177419
7814,6207858,109,32,0.382371,114,6224461,-1,1376.0,8548385,8548494,2340527,109,43,12,True,True,6.140178311111111,-0.382371
7815,6207901,27,32,0.640592,114,6224461,-1,1312.0,7619885,7619912,1411984,27,60,12,True,True,0.49938,-0.640592
7816,6208349,196,1,0.232425,114,6224461,-1,13.0,9860995,9861191,3652646,196,34,6,True,True,0.10979048888888887,-0.232425
7817,6210331,11382,10,0.587469,114,6224461,-1,470.0,6274159,6285541,63828,11382,99,6,True,True,219.26368586111107,-0.5873020867843832
7818,6210539,12,2,0.988381,114,6224461,-1,94.0,6251159,6251171,40620,12,100,1,True,True,0.05156213333333334,-0.9883809999999998
7819,6210662,20824,32,0.232606,114,6224461,-1,1376.0,9914927,9935751,3704265,20824,27,7,True,True,1125.1311314666666,-0.2309797873812977
7820,6210840,189,3,0.616349,114,6224461,-1,114.0,6228961,6229150,18121,189,103,6,True,True,0.798399,-0.616349
7821,6210850,9410,4,0.896779,114,6224461,-1,88.0,6647375,6656785,436525,9410,83,7,True,True,28.75427377777778,-0.8819975279990362
7822,6211134,23,4,0.308849,114,6224461,-1,84.0,8191785,8191808,1980651,23,50,8,True,True,0.06987936666666668,-0.308849
7823,6211443,21,5,0.737913,114,6224461,-1,95.0,6563075,6563096,351632,21,90,2,True,True,0.07397016666666666,-0.737913
7824,6212544,5,2,0.757246,114,6224461,-1,96.0,6676675,6676680,464131,5,82,7,True,True,0.01689066666666667,-0.757246
7825,6214784,7,16,0.619766,114,6224461,-1,560.0,9037385,9037392,2822601,7,42,11,True,True,0.12763955555555556,-0.619766
7826,6214847,161,4,0.059923,114,6224461,-1,84.0,11099649,11099810,4884802,161,2,2,True,True,1.2418788666666665,-0.059923
7827,6219088,11,1,0.374524,114,6224461,-1,41.0,9391085,9391096,3171997,11,42,12,True,True,0.016690758333333333,-0.374524
7828,6223783,10,4,0.296615,114,6224461,-1,136.0,10931706,10931716,4707923,10,9,6,True,True,0.04086800000000001,-0.296615
7829,6224187,10232,4,0.151671,114,6224461,-1,152.0,9902895,9913127,3678708,10232,35,8,True,True,67.07048724444444,-0.1447462389725549
7830,6225090,18531,100,0.204385,117,6228061,-1,3900.0,11068549,11087080,4843459,18531,4,10,True,True,2183.2760625,-0.19824439758512705
7831,6225413,11946,113,0.037907,117,6228061,-1,2599.0,10932606,10944552,4707193,11946,10,6,True,True,1247.1047664333335,-0.03772822660238403
7832,6226281,9339,64,0.923409,117,6228061,-1,2432.0,7259335,7268674,1033054,9339,81,7,True,True,813.0787648,-0.8861025510503253
7833,6226847,91,1,0.598075,117,6228061,-1,42.0,6741575,6741666,514728,91,86,9,True,True,0.24220863333333334,-0.5980749999999999
7834,6232781,8,8,0.945876,151,6251061,-1,192.0,6433629,6433637,200848,8,106,8,True,True,0.08555093333333333,-0.945876
7835,6234484,38,64,0.739256,151,6251061,-1,2368.0,7757685,7757723,1523201,38,66,10,True,True,3.4046446222222224,-0.739256
7836,6234645,5418,32,0.32869,151,6251061,-1,416.0,9698395,9703813,3463750,5418,43,7,True,True,86.16751057777778,-0.3254771413852066
7837,6234774,319,4,0.278126,151,6251061,-1,108.0,8721185,8721504,2486411,319,53,12,True,True,2.7884109,-0.278126
7838,6235408,28813,1,0.643602,151,6251061,-1,19.0,7262935,7291748,1027527,28813,84,8,True,True,21.111741225000003,-0.6205321487614855
7839,6237416,7,8,0.760494,151,6251061,-1,168.0,6852075,6852082,614659,7,88,11,True,True,0.0348684,-0.760494
7840,6237461,1018,1,0.520873,151,6251061,-1,17.0,6273259,6274277,35798,1018,120,10,True,True,0.6687807555555557,-0.520873
7841,6237706,12201,1,0.977568,151,6251061,-1,29.0,6433637,6445838,195931,12201,111,1,True,True,19.798711880555558,-0.9735978149435717
7842,6237799,10444,14,0.648046,151,6251061,-1,378.0,8188185,8198629,1950386,10444,60,10,True,True,152.93066145,-0.6156192795076583
7843,6237848,14170,2,0.288455,151,6251061,-1,92.0,9536695,9550865,3298847,14170,46,2,True,True,61.919381,-0.2883997585357889
7844,6239963,212,2,0.023693,151,6251061,-1,66.0,7070875,7071087,830912,212,89,11,True,True,0.6874347333333334,-0.023693
7845,6240057,14,1,0.846935,151,6251061,-1,45.0,7169335,7169349,929278,14,89,1,True,True,0.027769000000000002,-0.846935
7846,6240278,19618,2,0.33127,151,6251061,-1,44.0,9890295,9909913,3650017,19618,39,8,True,True,41.70079833333333,-0.3261122798145249
7847,6241516,23,1,0.242249,151,6251061,-1,5.0,10929006,10929029,4687490,23,12,12,True,True,0.0035343333333333338,-0.242249
7848,6242557,54,4,0.539312,151,6251061,-1,72.0,8904985,8905039,2662428,54,54,1,True,True,0.1328508,-0.539312
7849,6242604,9233,64,0.906632,151,6251061,-1,832.0,8117885,8127118,1875281,9233,69,11,True,True,254.6786712888889,-0.8415588430934853
7850,6242942,14832,119,0.665006,151,6251061,-1,4879.0,6507175,6522007,264233,14832,115,7,True,True,2211.2158726777775,-0.6340545792340906
7851,6244121,9,64,0.248338,151,6251061,-1,2944.0,10789398,10789407,4545277,9,18,6,True,True,0.6856576,-0.248338
7852,6244172,10,8,0.68735,151,6251061,-1,104.0,6700575,6700585,456403,10,104,7,True,True,0.08458088888888887,-0.68735
7853,6244213,24,1,0.719502,151,6251061,-1,12.0,7255735,7255759,1011522,24,94,12,True,True,0.010304000000000002,-0.719502
7854,6244275,3,8,0.608063,151,6251061,-1,48.0,7362835,7362838,1118560,3,88,3,True,True,0.0032796,-0.608063
7855,6244781,5455,114,0.381486,151,6251061,-1,3192.0,9725895,9731350,3481114,5455,46,10,True,True,593.9292776666667,-0.3770556965150055
7856,6245020,28567,1,0.321637,151,6251061,-1,6.0,9860095,9888662,3615075,28567,44,11,True,True,8.7443203,-0.3193594401947996
7857,6245128,3,2,0.442361,151,6251061,-1,68.0,9926134,9926137,3681006,3,31,2,True,True,0.007762766666666669,-0.442361
7858,6246233,8,3,0.006043,151,6251061,-1,33.0,10842598,10842606,4596365,8,14,6,True,True,0.0096206,-0.006043
7859,6246872,28,2,0.869867,151,6251061,-1,10.0,7735585,7735613,1488713,28,80,10,True,True,0.0069937777777777784,-0.869867
7860,6247440,6376,4,0.069985,151,6251061,-1,104.0,10255498,10261874,4008058,6376,27,12,True,True,60.96313715555556,-0.06885712225501593
7861,6247495,18,17,0.192465,151,6251061,-1,510.0,8073685,8073703,1826190,18,76,8,True,True,0.5357805000000001,-0.192465
7862,6249536,43,4,0.634367,151,6251061,-1,196.0,6424566,6424609,175030,43,134,1,True,True,0.3591732666666667,-0.634367
7863,6249682,63,16,0.141532,151,6251061,-1,592.0,11029806,11029869,4780124,63,10,8,True,True,3.2045552,-0.141532
7864,6249698,7093,1,0.20422,151,6251061,-1,14.0,10787598,10794691,4537900,7093,21,8,True,True,2.608676,-0.2013610732235815
7865,6249760,22807,32,0.091759,151,6251061,-1,1184.0,8811185,8833992,2561425,22807,65,12,True,True,876.3417275555554,-0.09155189339506606
7866,6249915,15444,16,0.592631,151,6251061,-1,624.0,6571175,6586619,321260,15444,127,6,True,True,275.3550401333334,-0.5901646847349019
7867,6249937,23254,64,0.831221,151,6251061,-1,1472.0,6277759,6301013,27822,23254,145,8,True,True,1403.1753397333334,-0.8275488279810648
7868,6250937,20830,2,0.931813,151,6251061,-1,26.0,6554975,6575805,304038,20830,129,11,True,True,17.99713247222222,-0.890211363381517
7869,6250948,49,2,0.23631,151,6251061,-1,88.0,9910995,9911044,3660047,49,42,6,True,True,0.1984358444444444,-0.23631
7870,6251161,27,1,0.078165,194,6273259,-1,41.0,9934234,9934261,3683073,27,33,8,True,True,0.0389295,-0.078165
7871,6251172,7,26,0.724989,194,6273259,-1,1248.0,7365525,7365532,1114353,7,100,2,True,True,0.19896239999999996,-0.724989
7872,6251927,99,4,0.311463,194,6273259,-1,180.0,10930806,10930905,4678879,99,13,7,True,True,0.5354909999999999,-0.311463
7873,6251990,5,1,0.721674,194,6273259,-1,16.0,6733475,6733480,481485,5,117,7,True,True,0.005499555555555555,-0.721674
7874,6252113,2,4,0.244925,194,6273259,-1,44.0,8158885,8158887,1906772,2,77,8,True,True,0.0033943555555555555,-0.244925
7875,6256781,23843,84,0.176436,194,6273259,-1,3612.0,11019006,11042849,4762225,23843,11,12,True,True,7501.311821733333,-0.17361467710808756
7876,6256847,10440,1,0.248969,194,6273259,-1,28.0,10560698,10571138,4303851,10440,30,12,True,True,12.975010066666666,-0.23869290702520435
7877,6256880,29,1,0.285353,194,6273259,-1,14.0,9301085,9301114,3044205,29,64,8,True,True,0.01448405,-0.285353
7878,6260604,7213,16,0.448271,194,6273259,-1,304.0,7845885,7853098,1585281,7213,90,7,True,True,51.76743546666667,-0.4376612618467283
7879,6260611,2338,4,0.635604,194,6273259,-1,160.0,6503037,6505375,242426,2338,144,6,True,True,5.922485333333334,-0.487114262086557
7880,6260754,18,16,0.271861,194,6273259,-1,320.0,11036106,11036124,4775352,18,8,7,True,True,0.49678400000000006,-0.271861
7881,6260898,10,4,0.781289,194,6273259,-1,44.0,7350235,7350245,1089337,10,111,6,True,True,0.011303111111111111,-0.7812890000000002
7882,6261066,16,1,0.080016,194,6273259,-1,7.0,11092449,11092465,4831383,16,4,7,True,True,0.010920622222222221,-0.080016
7883,6261074,10,1,0.972555,194,6273259,-1,6.0,6852075,6852085,591001,10,121,0,True,True,0.001779,-0.972555
7884,6261097,13,2,0.398244,194,6273259,-1,44.0,8722985,8722998,2461888,13,74,7,True,True,0.04380248888888888,-0.398244
7885,6261328,12317,1,0.167766,194,6273259,-1,20.0,7355635,7367952,1094307,12317,112,7,True,True,5.611865833333334,-0.16744976970960238
7886,6261346,12203,4,0.441376,194,6273259,-1,100.0,9899295,9911498,3637949,12203,52,8,True,True,53.84063222222222,-0.40936811243059457
7887,6261501,36,4,0.505293,194,6273259,-1,172.0,8634785,8634821,2373284,36,77,12,True,True,0.2720352,-0.505293
7888,6261542,10,32,0.734928,194,6273259,-1,1152.0,8857185,8857195,2595643,10,72,7,True,True,0.34796799999999994,-0.7349279999999999
7889,6261575,49,8,0.760324,194,6273259,-1,56.0,7169286,7169335,907711,49,124,7,True,True,0.12094942222222223,-0.760324
7890,6261599,12716,8,0.819604,194,6273259,-1,360.0,6558575,6571291,296976,12716,149,8,True,True,155.81909299999998,-0.7886023879413677
7891,6261631,6,1,0.793559,194,6273259,-1,26.0,7116875,7116881,855244,6,125,11,True,True,0.006075333333333333,-0.793559
7892,6262442,10208,1,0.019811,194,6273259,-1,33.0,11090649,11100857,4828207,10208,5,10,True,True,32.04422778333333,-0.019557214085334874
7893,6262462,277,4,0.381419,194,6273259,-1,124.0,9123785,9124062,2861323,277,70,12,True,True,1.1124935555555555,-0.381419
7894,6262642,15546,8,0.854042,194,6273259,-1,392.0,7026675,7042221,764033,15546,129,12,True,True,285.0063897333333,-0.8009479322672325
7895,6262648,29052,128,0.758858,194,6273259,-1,1408.0,9435285,9464337,3172637,29052,67,11,True,True,1551.2715328,-0.7431035065172974
7896,6262662,82,32,0.921532,194,6273259,-1,1440.0,6413759,6413841,151097,82,169,11,True,True,4.285648,-0.921532
7897,6262673,18,1,0.595183,194,6273259,-1,34.0,8991385,8991403,2728712,18,74,12,True,True,0.0197013,-0.595183
7898,6262684,4772,32,0.152799,194,6273259,-1,896.0,11022606,11027378,4759922,4772,14,8,True,True,383.2689678222222,-0.15181402280226355
7899,6262698,15738,128,0.726648,194,6273259,-1,4608.0,8160685,8176423,1897987,15738,91,7,True,True,2877.0315903999995,-0.7159901617303863
7900,6262737,401,2,0.257292,194,6273259,-1,30.0,10341898,10342299,4079161,401,36,12,True,True,0.7834871666666666,-0.2572920000000001
7901,6263014,52,8,0.463651,194,6273259,-1,104.0,9304685,9304737,3041671,52,71,8,True,True,0.18520897777777776,-0.463651
7902,6263982,24,1,0.453603,194,6273259,-1,30.0,9886695,9886719,3622713,24,58,10,True,True,0.044598000000000006,-0.453603
7903,6264048,132,8,0.375147,194,6273259,-1,80.0,9892095,9892227,3628047,132,57,7,True,True,0.5814746666666667,-0.375147
7904,6264128,24339,1,0.606025,194,6273259,-1,27.0,6441737,6466076,177609,24339,170,9,True,True,33.668552774999995,-0.5994468381710615
7905,6264153,4789,16,0.07194,194,6273259,-1,480.0,10788498,10793287,4524345,4789,27,6,True,True,59.870688,-0.06973270889237149
7906,6264206,6395,4,0.136656,194,6273259,-1,68.0,10343698,10350093,4079492,6395,37,7,True,True,38.08420164444445,-0.12581762319616316
7907,6264222,10100,1,0.469258,194,6273259,-1,15.0,7890085,7900185,1625863,10100,108,11,True,True,4.349428124999999,-0.4357934116351029
7908,6264833,3,16,0.154724,194,6273259,-1,384.0,10124898,10124901,3860065,3,40,12,True,True,0.04156800000000001,-0.154724
7909,6264838,6470,8,0.189626,194,6273259,-1,72.0,8162485,8168955,1897647,6470,98,7,True,True,17.994968999999998,-0.18769938427912577
7910,6265259,27,1,0.012834,194,6273259,-1,18.0,11026206,11026233,4760947,27,14,2,True,True,0.04452704999999999,-0.012834
7911,6265407,245,2,0.5007,194,6273259,-1,60.0,9534285,9534530,3268878,245,74,8,True,True,0.5076399999999999,-0.5007
7912,6265505,6010,176,0.725345,194,6273259,-1,6512.0,9530685,9536695,3265180,6010,75,12,True,True,1370.952909333333,-0.6368704247858166
7913,6265684,16444,36,0.491454,194,6273259,-1,576.0,8070085,8086529,1804401,16444,110,0,True,True,519.3769391999999,-0.4838271049651452
7914,6266486,10,32,0.925691,194,6273259,-1,1312.0,6734375,6734385,467889,10,153,6,True,True,0.9019271111111112,-0.925691
7915,6293965,6405,256,0.940285,245,6365059,-1,2304.0,7161081,7167486,867116,6405,144,11,True,True,742.6741056,-0.9262285552295619
7916,6294014,47,2,0.970493,245,6365059,-1,32.0,6434537,6434584,140523,47,182,6,True,True,0.08376862222222223,-0.970493
7917,6294183,8744,2,0.373145,245,6365059,-1,36.0,9630295,9639039,3336112,8744,72,12,True,True,13.8799806,-0.3728296254502393
7918,6294238,76,1,0.489551,245,6365059,-1,13.0,6496737,6496813,202499,76,181,11,True,True,0.020188133333333334,-0.489551
7919,6294258,12626,1,0.641049,245,6365059,-1,17.0,8155285,8167911,1861027,12626,105,6,True,True,8.212494016666668,-0.6399693310147666
7920,6294397,5647,43,0.588309,245,6365059,-1,645.0,8724785,8730432,2430388,5647,92,7,True,True,265.8031526666667,-0.5728979568048203
7921,6294565,28479,256,0.408788,245,6365059,-1,6144.0,9939298,9967777,3644733,28479,45,2,True,True,7047.889271466666,-0.4068020620406215
7922,6294966,67,8,0.038827,245,6365059,-1,248.0,10169098,10169165,3874132,67,41,11,True,True,1.5379031111111108,-0.038827
7923,6295829,7814,32,0.921603,245,6365059,-1,224.0,9210185,9217999,2914356,7814,85,12,True,True,66.10372284444445,-0.9148748995764265
7924,6298965,26663,64,0.384826,245,6365059,-1,768.0,9696595,9723258,3397630,26663,73,10,True,True,770.4969130666667,-0.38241074079689136
7925,6299872,10537,4,0.565609,245,6365059,-1,40.0,9440685,9451222,3140813,10537,80,7,True,True,13.17834211111111,-0.5114122242670761
7926,6300302,13,1,0.194228,245,6365059,-1,40.0,8461985,8461998,2161683,13,102,11,True,True,0.042416111111111106,-0.194228
7927,6300322,11,4,0.436298,245,6365059,-1,164.0,8195385,8195396,1895063,11,107,2,True,True,0.07042615555555555,-0.436298
7928,6300898,46,1,0.255258,245,6365059,-1,18.0,8154385,8154431,1853487,46,114,7,True,True,0.0305049,-0.255258
7929,6300934,906,1,0.913086,245,6365059,-1,6.0,6428166,6429072,127232,906,198,2,True,True,0.27035039999999994,-0.913086
7930,6302260,33,1,0.722245,245,6365059,-1,50.0,7167486,7167519,865226,33,155,8,True,True,0.07763708333333333,-0.722245
7931,6302530,24,5,0.509608,245,6365059,-1,205.0,8148985,8149009,1846455,24,116,9,True,True,0.16897466666666666,-0.509608
7932,6303072,4,32,0.488622,245,6365059,-1,864.0,9444285,9444289,3141213,4,80,2,True,True,0.09646080000000001,-0.488622
7933,6303104,118,16,0.688489,245,6365059,-1,720.0,6430029,6430147,126925,118,200,6,True,True,4.370012,-0.688489
7934,6303782,4,2,0.696455,245,6365059,-1,100.0,7463552,7463556,1159770,4,140,11,True,True,0.009966666666666667,-0.696455
7935,6303857,21992,1,0.650906,245,6365059,-1,12.0,8166085,8188077,1862228,21992,111,2,True,True,10.6614698,-0.6502257722017957
7936,6304128,4,2,0.926519,245,6365059,-1,66.0,6645575,6645579,341447,4,181,8,True,True,0.009152733333333333,-0.9265189999999998
7937,6304268,3,4,0.735664,245,6365059,-1,56.0,8244085,8244088,1939817,3,106,8,True,True,0.005474000000000001,-0.735664
7938,6304793,55,4,0.242353,245,6365059,-1,172.0,9652395,9652450,3347602,55,75,10,True,True,0.6363163888888889,-0.242353
7939,6305356,7261,1,0.034508,245,6365059,-1,24.0,6650975,6658236,345619,7261,182,8,True,True,5.605620466666667,-0.031703801389174356
7940,6306232,11,4,0.813126,245,6365059,-1,108.0,6594175,6594186,287943,11,189,10,True,True,0.030399600000000002,-0.813126
7941,6306483,18483,16,0.630953,245,6365059,-1,272.0,7463556,7482039,1157073,18483,143,1,True,True,130.29821133333334,-0.630939170475769
7942,6307347,18643,1,0.676426,245,6365059,-1,24.0,9543895,9562538,3236548,18643,77,3,True,True,20.3452594,-0.6684848430325045
7943,6312530,12644,19,0.697471,245,6365059,-1,950.0,9701995,9714639,3389465,12644,72,8,True,True,445.59885375,-0.6783787212799253
7944,6312649,6370,4,0.645334,245,6365059,-1,72.0,6422759,6429129,110110,6370,215,7,True,True,21.149007599999997,-0.6380529045407957
7945,6312732,16236,8,0.261331,245,6365059,-1,192.0,8417785,8434021,2105053,16236,108,12,True,True,184.27867733333338,-0.2602023031752897
7946,6320189,19481,1,0.455471,245,6365059,-1,6.0,7533485,7552966,1213296,19481,143,1,True,True,2.7565297666666666,-0.43556357617658137
7947,6322813,10286,1,0.681066,245,6365059,-1,29.0,6566675,6576961,243862,10286,197,2,True,True,8.837650352777779,-0.6777681521685568
7948,6322961,88,1,0.254288,245,6365059,-1,48.0,9923927,9924015,3600966,88,51,8,True,True,0.17209280000000002,-0.254288
7949,6324202,102,16,0.602149,245,6365059,-1,672.0,7116881,7116983,792679,102,169,1,True,True,2.669408,-0.602149
7950,6324844,9561,1,0.951778,245,6365059,-1,40.0,8901385,8910946,2576541,9561,98,11,True,True,12.670707888888888,-0.9008175093987542
7951,6325444,11804,128,0.841516,245,6365059,-1,3072.0,6498537,6510341,173093,11804,210,7,True,True,715.1377408000001,-0.7590212059859976
7952,6325959,19,4,0.012337,245,6365059,-1,52.0,9994298,9994317,3668339,19,44,9,True,True,0.045873388888888894,-0.012337
7953,6325980,159,1,0.770972,245,6365059,-1,23.0,6731675,6731834,405695,159,183,6,True,True,0.25718868333333333,-0.770972
7954,6326647,10527,1,0.644397,245,6365059,-1,6.0,9812295,9822822,3485648,10527,72,0,True,True,2.4472897000000002,-0.6403606672434962
7955,6326677,9368,16,0.916883,245,6365059,-1,384.0,6559475,6568843,232798,9368,205,6,True,True,125.6816416,-0.9153128307708119
7956,6327300,4292,32,0.397667,245,6365059,-1,1152.0,8070085,8074377,1742785,4292,134,12,True,True,285.43363839999995,-0.39601435795897943
7957,6327484,176,8,0.58616,245,6365059,-1,376.0,7072675,7072851,745191,176,175,7,True,True,3.2512636444444447,-0.58616
7958,6327837,11,1,0.900996,245,6365059,-1,12.0,6938475,6938486,610638,11,179,12,True,True,0.0048048000000000006,-0.900996
7959,6331957,33,10,0.518537,245,6365059,-1,430.0,7708985,7709018,1377028,33,145,6,True,True,0.39594041666666663,-0.518537
7960,6332001,17,128,0.188823,245,6365059,-1,1664.0,8331385,8331402,1999384,17,113,12,True,True,0.9878012444444444,-0.188823
7961,6332054,26653,1,0.422945,245,6365059,-1,36.0,9540295,9566948,3208241,26653,82,7,True,True,44.227316699999996,-0.4172884529013103
7962,6332099,123,2,0.82975,245,6365059,-1,76.0,6445337,6445460,113238,123,223,2,True,True,0.5323166666666667,-0.82975
7963,6332200,1273,16,0.252871,245,6365059,-1,240.0,9703795,9705068,3371595,1273,75,7,True,True,11.334791999999998,-0.252871
7964,6332235,9,16,0.30222,245,6365059,-1,480.0,10647098,10647107,4314863,9,36,12,True,True,0.169824,-0.30222
7965,6332293,18787,128,0.967683,245,6365059,-1,6272.0,6570275,6589062,237982,18787,211,2,True,True,3322.7992373333336,-0.9665499554364132
7966,6332822,138,1,0.658486,245,6365059,-1,23.0,7709885,7710023,1377063,138,149,6,True,True,0.08856341666666666,-0.658486
7967,6333000,21997,128,0.382789,245,6365059,-1,3712.0,10474298,10496295,4141298,21997,38,11,True,True,4202.324493511111,-0.3736542907256693
7968,6333005,11747,64,0.307979,245,6365059,-1,896.0,9211085,9222832,2878080,11747,98,6,True,True,403.0332519111111,-0.3075017118078418
7969,6333011,11207,19,0.411609,245,6365059,-1,760.0,9914927,9926134,3581916,11207,57,0,True,True,359.0850301111111,-0.40807892456142386
1472,1293277,13,1,0.496203,1,1293277,-1,37.0,1379677,1379690,86400,13,0,12,True,True,0.02672756666666666,-0.496203
1473,1294554,6774,64,0.497523,115,1379677,-1,1984.0,5038324,5045098,3743770,6774,0,6,True,True,456.98040746666675,-0.46285075304837114
1474,1294669,12239,3,0.92431,115,1379677,-1,120.0,1537777,1550016,243108,12239,1,11,True,True,16.917002,-0.9214340932569515
1475,1294737,112,2,0.519276,115,1379677,-1,44.0,5037424,5037536,3742687,112,1,11,True,True,0.19528568888888886,-0.519276
1476,1295058,292,16,0.801148,115,1379677,-1,656.0,1833870,1834162,538812,292,2,6,True,True,5.611941511111111,-0.801148
1477,1296674,31905,16,0.727081,115,1379677,-1,480.0,7355290,7387195,6058616,31905,0,12,True,True,364.73069999999996,-0.7244648037699007
1478,1298004,12956,1,0.078927,115,1379677,-1,34.0,11908690,11921646,10610686,12956,0,12,True,True,23.173599866666667,-0.07352039300039884
1479,1299053,5794,178,0.602453,115,1379677,-1,4450.0,6043963,6049757,4744910,5794,2,12,True,True,638.1152284722223,-0.5940796593697164
1480,1299172,10160,8,0.822341,115,1379677,-1,384.0,2260098,2270258,960926,10160,5,1,True,True,45.01684906666667,-0.7983737986248982
1481,1300217,5981,128,0.545474,115,1379677,-1,3200.0,9151390,9157371,7851173,5981,1,12,True,True,416.78594666666663,-0.5449682979279629
1482,1300293,11,1,0.321211,115,1379677,-1,13.0,3102572,3102583,1802279,11,6,10,True,True,0.004482652777777777,-0.321211
1483,1300678,4,9,0.080069,115,1379677,-1,333.0,11995090,11995094,10694412,4,0,12,True,True,0.0428904,-0.080069
1484,1300931,8,4,0.660919,115,1379677,-1,132.0,3635824,3635832,2334893,8,7,6,True,True,0.0096448,-0.660919
1485,1301041,7580,2,0.306496,115,1379677,-1,78.0,8114590,8122170,6813549,7580,3,12,True,True,16.8038715,-0.30566845689816796
1486,1305566,17109,1,0.602622,115,1379677,-1,37.0,5558763,5575872,4253197,17109,6,12,True,True,11.318441216666667,-0.5949308145727807
1487,1305714,670,1,0.426116,115,1379677,-1,31.0,1541377,1542047,235663,670,13,1,True,True,0.24745147222222222,-0.426116
1488,1306220,46393,55,0.689765,115,1379677,-1,1045.0,1707119,1753512,400899,46393,13,10,True,True,2657.7424825416665,-0.6857369212097156
1489,1306545,14816,1,0.351547,115,1379677,-1,15.0,6827163,6841979,5520618,14816,5,12,True,True,4.099353416666667,-0.3293730609423741
1490,1309878,42,2,0.042355,115,1379677,-1,60.0,5299524,5299566,3989646,42,8,12,True,True,0.075775,-0.042355
1491,1310397,16,8,0.870037,115,1379677,-1,384.0,4115624,4115640,2805227,16,11,12,True,True,0.25710933333333336,-0.870037
1492,1312556,496,64,0.352559,115,1379677,-1,2880.0,4593324,4593820,3280768,496,11,12,True,True,24.243199999999998,-0.31078080526479906
1493,1313082,51,43,0.998151,115,1379677,-1,1376.0,1765719,1765770,452637,51,17,1,True,True,4.356565066666667,-0.998151
1494,1313539,32,2,0.274555,115,1379677,-1,70.0,11167890,11167922,9854351,32,2,12,True,True,0.09239377777777778,-0.274555
1495,1313662,8755,32,0.980027,115,1379677,-1,1248.0,2422898,2431653,1109236,8755,16,0,True,True,407.2025845333334,-0.9640953105726764
1496,1314069,13,10,0.947904,115,1379677,-1,50.0,2206840,2206853,892771,13,18,7,True,True,0.009188472222222221,-0.947904
1497,1315723,46,8,0.075041,115,1379677,-1,136.0,2142570,2142616,826847,46,19,8,True,True,0.07536742222222223,-0.075041
1498,1316219,12086,8,0.637513,115,1379677,-1,144.0,2149140,2161226,832921,12086,19,8,True,True,20.861148,-0.6207317647853824
1499,1316353,12827,25,0.363311,115,1379677,-1,675.0,3722224,3735051,2405871,12827,14,12,True,True,92.088255,-0.3548238135255909
1500,1319043,143,2,0.801096,115,1379677,-1,24.0,4232224,4232367,2913181,143,13,0,True,True,0.045903,-0.801096
1501,1320593,9,2,0.679411,115,1379677,-1,70.0,2762203,2762212,1441610,9,18,6,True,True,0.019724250000000002,-0.679411
1502,1320865,90,8,0.952789,115,1379677,-1,360.0,1832070,1832160,511205,90,25,10,True,True,0.65133,-0.952789
1503,1322450,37,1,0.142779,115,1379677,-1,45.0,12234190,12234227,10911740,37,0,12,True,True,0.05334475,-0.142779
1504,1322616,57,1,0.607573,115,1379677,-1,9.0,2207740,2207797,885124,57,22,6,True,True,0.007251825,-0.607573
1505,1323015,12743,2,0.781312,115,1379677,-1,18.0,3852824,3865567,2529809,12743,16,11,True,True,2.9565696999999997,-0.7496389116175396
1506,1323031,8047,37,0.034799,115,1379677,-1,888.0,8978590,8986637,7655559,8047,5,12,True,True,205.64939166666665,-0.03469147774970099
1507,1323428,727,4,0.067233,115,1379677,-1,112.0,6999963,7000690,5676535,727,8,12,True,True,2.4060791999999998,-0.067233
1508,1323517,392,1,0.778515,115,1379677,-1,37.0,2003870,2004262,680353,392,29,9,True,True,0.1783589111111111,-0.778515
1509,1323542,13448,128,0.366328,115,1379677,-1,2176.0,10101790,10115238,8778248,13448,4,12,True,True,705.5083776,-0.36277546510053826
1510,1323995,46337,4,0.382854,115,1379677,-1,112.0,8200990,8247327,6876995,46337,7,12,True,True,128.470468,-0.38205088882324134
1511,1324200,44,28,0.567245,115,1379677,-1,924.0,4370924,4370968,3046724,44,18,7,True,True,0.5845429333333333,-0.567245
1512,1327945,7659,16,0.605095,115,1379677,-1,368.0,6130363,6138022,4802418,7659,12,12,True,True,45.57470955555556,-0.5111961019473943
1513,1327951,5,16,0.679062,115,1379677,-1,528.0,2251940,2251945,923989,5,29,11,True,True,0.034899333333333345,-0.6790620000000002
1514,1328512,20621,179,0.948824,115,1379677,-1,5012.0,4372724,4393345,3044212,20621,19,7,True,True,1183.3742148666665,-0.8866420322677998
1515,1328728,11,2,0.372013,115,1379677,-1,70.0,5911563,5911574,4582835,11,14,12,True,True,0.02231502777777778,-0.372013
1516,1328802,12,1,0.763084,115,1379677,-1,21.0,2252840,2252852,924038,12,31,6,True,True,0.0033313000000000006,-0.763084
1517,1328814,5,1,0.573922,115,1379677,-1,11.0,4116524,4116529,2787710,5,23,6,True,True,0.0023015972222222222,-0.573922
1518,1330137,7732,1,0.52946,115,1379677,-1,15.0,5168924,5176656,3838787,7732,17,12,True,True,1.1635449999999998,-0.51623113668654
1519,1330153,7,16,0.398034,115,1379677,-1,208.0,4817524,4817531,3487371,7,20,12,True,True,0.027720622222222224,-0.398034
1520,1330385,43,2,0.649561,115,1379677,-1,34.0,2766215,2766258,1435830,43,31,7,True,True,0.03491743333333334,-0.649561
1521,1330698,7,8,0.249612,115,1379677,-1,80.0,7007890,7007897,5677192,7,10,9,True,True,0.013306222222222224,-0.249612
1522,1331059,8744,128,0.113449,115,1379677,-1,2432.0,11513490,11522234,10182431,8744,3,12,True,True,652.7133738666666,-0.11323945625566698
1523,1331092,33237,13,0.735675,115,1379677,-1,507.0,1765770,1799007,434678,33237,46,1,True,True,824.3334336250001,-0.7100921958639199
1524,1331191,443,16,0.499044,115,1379677,-1,144.0,1589619,1590062,258428,443,49,1,True,True,0.6418184,-0.499044
1525,1331228,4,2,0.386987,115,1379677,-1,46.0,7180690,7180694,5849462,4,11,12,True,True,0.0026577777777777776,-0.386987
1526,1331306,21,32,0.561673,115,1379677,-1,288.0,6521963,6521984,5190657,21,15,12,True,True,0.1092504,-0.561673
1527,1331604,25,1,0.261777,115,1379677,-1,12.0,6349163,6349188,5017559,25,16,7,True,True,0.003930833333333333,-0.261777
1528,1331611,39,1,0.26029,115,1379677,-1,36.0,9583390,9583429,8251779,39,6,12,True,True,0.0426543,-0.26029
1529,1331759,8757,200,0.446273,115,1379677,-1,4200.0,9928990,9937747,8597231,8757,6,12,True,True,1051.1875033333336,-0.4430056546807344
1530,1331776,17,8,0.996365,115,1379677,-1,112.0,1466077,1466094,134301,17,57,12,True,True,0.05816191111111111,-0.996365
1531,1331818,3,28,0.285577,115,1379677,-1,364.0,6652563,6652566,5320745,3,17,11,True,True,0.014711666666666668,-0.285577
1532,1331990,15,2,0.916479,115,1379677,-1,26.0,2852615,2852630,1520625,15,39,12,True,True,0.012397666666666666,-0.916479
1533,1332252,26,8,0.4912,115,1379677,-1,136.0,3624842,3624868,2292590,26,38,7,True,True,0.032383866666666664,-0.4912
1534,1333108,18,4,0.122637,115,1379677,-1,132.0,10995090,10995108,9661982,18,5,8,True,True,0.0534996,-0.122637
1535,1333163,16498,128,0.852826,115,1379677,-1,640.0,4228624,4245122,2895461,16498,34,10,True,True,133.6431288888889,-0.8089772066367298
1536,1333242,867,1,0.452043,115,1379677,-1,23.0,5082524,5083391,3749282,867,27,11,True,True,0.3272705138888889,-0.44752095901033884
1537,1333786,19,32,0.898679,115,1379677,-1,608.0,2757684,2757703,1423898,19,46,7,True,True,0.44764,-0.898679
1538,1333912,5033,84,0.445111,115,1379677,-1,1932.0,4420524,4425557,3086612,5033,32,11,True,True,390.9825376333333,-0.4243602618334409
1539,1334006,872,8,0.087791,115,1379677,-1,248.0,11599890,11600762,10265884,872,3,12,True,True,6.5555603555555555,-0.087791
1540,1334127,58,12,0.681929,115,1379677,-1,180.0,2711684,2711742,1377557,58,49,11,True,True,0.41757099999999997,-0.681929
1541,1334696,29,3,0.845521,115,1379677,-1,117.0,3435283,3435312,2100587,29,44,8,True,True,0.0200187,-0.845521
1542,1334724,2511,8,0.319588,115,1379677,-1,120.0,10706590,10709101,9371866,2511,7,12,True,True,7.752294,-0.319588
1543,1334768,8,36,0.347425,115,1379677,-1,1728.0,10447390,10447398,9112622,8,8,12,True,True,0.2406912,-0.34742500000000004
1544,1337018,21038,1,0.064939,115,1379677,-1,5.0,11340690,11361728,10003672,21038,5,12,True,True,4.079086361111111,-0.06440362277859742
1545,1337084,10203,16,0.542171,115,1379677,-1,672.0,2946215,2956418,1609131,10203,49,9,True,True,275.24905520000004,-0.5385266041254183
1546,1337224,459,3,0.891332,115,1379677,-1,78.0,1587147,1587606,249923,459,70,11,True,True,0.29749004999999995,-0.7361371065059926
1547,1337255,11,16,0.851362,115,1379677,-1,704.0,1760319,1760330,423064,11,68,11,True,True,0.3515991111111111,-0.851362
1548,1337380,8,1,0.711809,115,1379677,-1,28.0,4235824,4235832,2898444,8,39,2,True,True,0.002959911111111111,-0.711809
1549,1337421,5291,16,0.927324,115,1379677,-1,480.0,3634924,3640215,2297503,5291,47,7,True,True,22.718724,-0.9114429792947966
1550,1337520,59,16,0.6377,115,1379677,-1,80.0,5385924,5385983,4048404,59,29,12,True,True,0.07338288888888889,-0.6377
1551,1337540,58,8,0.793696,115,1379677,-1,344.0,2260040,2260098,922500,58,60,9,True,True,0.2387589333333333,-0.793696
1552,1337563,8260,2,0.508756,115,1379677,-1,62.0,5472363,5480623,4134800,8260,29,1,True,True,15.875394327777776,-0.49795411595670896
1553,1337577,18561,16,0.121362,115,1379677,-1,336.0,7809390,7827951,6471813,18561,17,12,True,True,181.5874732,-0.12116409122644407
1554,1337629,12183,8,0.20098,115,1379677,-1,376.0,2667484,2679667,1329855,12183,60,10,True,True,189.66508362222223,-0.1838720716846801
1555,1337691,25,1,0.138877,115,1379677,-1,30.0,5645163,5645188,4307472,25,29,12,True,True,0.027410416666666663,-0.138877
1556,1337703,119,8,0.790373,115,1379677,-1,360.0,1994870,1994989,657167,119,72,11,True,True,0.392105,-0.790373
1557,1337729,7,16,0.026284,115,1379677,-1,112.0,12103590,12103597,10765861,7,1,10,True,True,0.028437422222222227,-0.026284
1558,1338585,19622,32,0.554021,115,1379677,-1,800.0,4232224,4251846,2893639,19622,46,1,True,True,230.25857333333332,-0.4878512683458081
1559,1338629,64,1,0.368911,115,1379677,-1,28.0,7939990,7940054,6601361,64,18,11,True,True,0.04831928888888888,-0.368911
1560,1338983,182,16,0.803662,115,1379677,-1,288.0,3632942,3633124,2293959,182,55,6,True,True,0.47873279999999996,-0.803662
1561,1339153,4,71,0.551647,115,1379677,-1,3408.0,5652363,5652367,4313210,4,31,8,True,True,0.6155226666666667,-0.551647
1562,1340956,9,8,0.611948,115,1379677,-1,184.0,2424705,2424714,1083749,9,67,1,True,True,0.0675878,-0.611948
1563,1341428,4,8,0.086215,115,1379677,-1,400.0,10620190,10620194,9278762,4,10,12,True,True,0.029062222222222225,-0.086215
1564,1343396,18753,128,0.309291,115,1379677,-1,4608.0,9669790,9688543,8326394,18753,14,12,True,True,1930.9356288,-0.30843558361396883
1565,1343404,59,1,0.999595,115,1379677,-1,38.0,1948870,1948929,605466,59,81,10,True,True,0.02573940555555556,-0.999595
1566,1343558,25529,16,0.71887,115,1379677,-1,288.0,1542947,1568476,199389,25529,90,6,True,True,88.44931600000001,-0.7109245207261741
1567,1343568,19,32,0.525696,115,1379677,-1,1408.0,6347363,6347382,5003795,19,30,11,True,True,0.3505255111111111,-0.525696
1568,1343589,9,4,0.769165,115,1379677,-1,152.0,3617642,3617651,2274053,9,61,7,True,True,0.0077634,-0.769165
1569,1343888,11393,1,0.823339,115,1379677,-1,25.0,4993224,5004617,3649336,11393,44,6,True,True,3.3370204166666673,-0.7381959391235923
1570,1344060,19979,128,0.073751,115,1379677,-1,3840.0,11427090,11447069,10083030,19979,6,12,True,True,3006.164821333333,-0.07362152725857665
1571,1344137,5,32,0.97238,115,1379677,-1,1344.0,2309698,2309703,965561,5,75,6,True,True,0.10656800000000002,-0.97238
1572,1344253,122,32,0.642339,115,1379677,-1,1152.0,3566242,3566364,2221989,122,64,1,True,True,2.276032,-0.642339
1573,1363780,12229,38,0.449974,115,1379677,-1,1672.0,7000690,7012919,5636910,12229,26,1,True,True,505.87071993333336,-0.41450381076531206
1574,1364676,40,1,0.680109,115,1379677,-1,6.0,3080472,3080512,1715796,40,68,1,True,True,0.004751333333333333,-0.680109
1575,1364795,22,16,0.344515,115,1379677,-1,352.0,2645384,2645406,1280589,22,76,12,True,True,0.10407075555555556,-0.34451500000000007
1576,1366877,6679,32,0.87796,115,1379677,-1,1344.0,1923170,1929849,556293,6679,91,6,True,True,131.28495146666666,-0.8286871413150159
1577,1367148,7834,13,0.780263,115,1379677,-1,260.0,1832970,1840804,465822,7834,93,6,True,True,67.22413677777777,-0.7141899668046857
1578,1367189,10,8,0.639794,115,1379677,-1,64.0,1683219,1683229,316030,10,99,12,True,True,0.04484088888888889,-0.639794
1579,1367258,28,1,0.181963,115,1379677,-1,5.0,11689890,11689918,10322632,28,4,12,True,True,0.003939833333333333,-0.181963
1580,1367279,4,19,0.966265,115,1379677,-1,513.0,2764415,2764419,1397136,4,73,2,True,True,0.06424469999999999,-0.9662649999999998
1581,1367491,70,1,0.432618,115,1379677,-1,25.0,3570742,3570812,2203251,70,66,7,True,True,0.03177708333333334,-0.432618
1582,1369153,7330,4,0.910712,115,1379677,-1,24.0,2949815,2957145,1580662,7330,71,2,True,True,7.089569666666666,-0.9054802035270109
1583,1371674,29978,16,0.055413,115,1379677,-1,720.0,11254290,11284268,9882616,29978,9,12,True,True,614.8267639999999,-0.05539745731066762
1584,1371746,7570,32,0.124161,115,1379677,-1,832.0,11820490,11828060,10448744,7570,4,12,True,True,153.53617066666666,-0.12015679363335938
1585,1371766,22985,1,0.153015,115,1379677,-1,36.0,2156340,2179325,784574,22985,92,0,True,True,10.035582999999999,-0.14768940288304058
1586,1374454,11567,32,0.164657,115,1379677,-1,1120.0,10188190,10199757,8813736,11567,16,12,True,True,481.33981777777785,-0.16088082669469997
1587,1376090,11,17,0.322661,115,1379677,-1,85.0,9842590,9842601,8466500,11,19,12,True,True,0.03531183333333334,-0.322661
1588,1381788,16620,8,0.709332,206,1466077,-1,104.0,4206524,4223144,2824736,16620,61,8,True,True,18.953856711111108,-0.6732143954242348
1589,1384832,10899,256,0.346023,206,1466077,-1,8960.0,4861724,4872623,3476892,10899,52,11,True,True,2600.2759253333334,-0.3185233091351923
1590,1385180,25,3,0.940904,206,1466077,-1,111.0,1471477,1471502,86297,25,116,7,True,True,0.06505833333333334,-0.940904
1591,1385597,192,1,0.894926,206,1466077,-1,44.0,2152740,2152932,767143,192,97,1,True,True,0.10189373333333332,-0.8916531952443779
1592,1389857,6,1,0.845934,206,1466077,-1,13.0,3102583,3102589,1712726,6,75,1,True,True,0.0024450833333333334,-0.845934
1593,1389978,10134,32,0.250605,206,1466077,-1,1472.0,4376324,4386458,2986346,10134,56,8,True,True,157.40205582222222,-0.24468324994418764
1594,1390228,10712,64,0.635057,206,1466077,-1,1600.0,3345283,3355995,1955055,10712,76,10,True,True,105.93253333333334,-0.6301033745760172
1595,1405595,74,1,0.550841,206,1466077,-1,9.0,7441690,7441764,6036095,74,28,12,True,True,0.01031745,-0.5508409999999999
1596,1405663,4790,256,0.12517,206,1466077,-1,10496.0,8632990,8637780,7227327,4790,24,12,True,True,1290.4622080000001,-0.1159573914222852
1597,1406002,106,32,0.302825,206,1466077,-1,1184.0,8028190,8028296,6622188,106,27,12,True,True,3.4775066666666663,-0.302825
1598,1406116,50,4,0.533478,206,1466077,-1,152.0,1996670,1996720,590554,50,107,7,True,True,0.06956111111111112,-0.533478
1599,1406373,15161,64,0.502573,206,1466077,-1,3072.0,3632042,3647203,2225669,15161,74,9,True,True,422.34609493333335,-0.48645963637680156
1600,1406442,14079,1,0.168636,206,1466077,-1,44.0,11603490,11617569,10197048,14079,6,8,True,True,16.232668099999998,-0.1659805459940637
1601,1406530,1,8,0.941607,206,1466077,-1,344.0,3036215,3036216,1629685,1,85,12,True,True,0.015639577777777774,-0.941607
1602,1406645,12,16,0.154194,206,1466077,-1,656.0,8892190,8892202,7485545,12,25,12,True,True,0.37475093333333337,-0.154194
1603,1407095,154,32,0.658733,206,1466077,-1,1600.0,2558984,2559138,1151889,154,97,1,True,True,4.36744,-0.658733
1604,1407146,4350,4,0.720633,206,1466077,-1,156.0,3623042,3627392,2215896,4350,78,8,True,True,6.218644466666667,-0.7203502954785862
1605,1408195,10170,128,0.605139,206,1466077,-1,5376.0,2135370,2145540,727175,10170,112,11,True,True,617.1948160000001,-0.6044931154241885
1606,1408412,53,9,0.84253,206,1466077,-1,162.0,2421998,2422051,1013586,53,101,7,True,True,0.365859,-0.84253
1607,1408478,13,16,0.563618,206,1466077,-1,720.0,6913563,6913576,5505085,13,38,12,True,True,0.10373999999999999,-0.563618
1608,1408524,16770,21,0.825236,206,1466077,-1,987.0,1596819,1613589,188295,16770,128,9,True,True,271.9301137,-0.7539574945051276
1609,1408588,818,16,0.028373,206,1466077,-1,144.0,12406990,12407808,10998402,818,0,12,True,True,3.9535576,-0.028373
1610,1408763,78,1,0.045462,206,1466077,-1,14.0,7636590,7636668,6227827,78,33,10,True,True,0.009096966666666666,-0.045462
1611,1408861,22648,16,0.641454,206,1466077,-1,208.0,1714319,1736967,305458,22648,128,8,True,True,316.1767000888889,-0.6373889591230907
1612,1409391,32,2,0.576771,206,1466077,-1,88.0,2308798,2308830,899407,32,106,6,True,True,0.04465706666666666,-0.5767709999999999
1613,1409433,50,1,0.65113,206,1466077,-1,47.0,4280024,4280074,2870591,50,67,11,True,True,0.04640597222222222,-0.65113
1614,1419280,17420,1,0.766959,206,1466077,-1,21.0,1762119,1779539,342839,17420,129,7,True,True,22.549422233333335,-0.7626689331378451
1615,1419841,10,1,0.416587,206,1466077,-1,30.0,3808624,3808634,2388783,10,76,12,True,True,0.008616666666666667,-0.416587
1616,1419867,10276,128,0.638991,206,1466077,-1,6400.0,6435563,6445839,5015696,10276,44,12,True,True,690.4097244444445,-0.5740015356262139
1617,1419942,13212,32,0.498038,206,1466077,-1,192.0,5213124,5226336,3793182,13212,56,11,True,True,51.3778944,-0.4979475632789796
1618,1419965,3682,32,0.627164,206,1466077,-1,1568.0,3615842,3619524,2195877,3682,87,11,True,True,43.00613706666667,-0.47353893192678576
1619,1420003,3,32,0.289672,206,1466077,-1,288.0,10991490,10991493,9571487,3,15,12,True,True,0.022142400000000003,-0.289672
1620,1420167,12298,141,0.95665,206,1466077,-1,1692.0,2145540,2157838,725373,12298,122,6,True,True,253.58897939999997,-0.9530468872443674
1621,1420244,56,2,0.482945,206,1466077,-1,42.0,3633124,3633180,2212880,56,83,1,True,True,0.021481600000000003,-0.482945
1622,1420284,9835,8,0.804688,206,1466077,-1,352.0,2514705,2524540,1094421,9835,109,12,True,True,78.489532,-0.6615439116801646
1623,1420302,31,1,0.684991,206,1466077,-1,50.0,3192583,3192614,1772281,31,94,8,True,True,0.06032944444444445,-0.684991
1624,1420306,8332,256,0.297434,206,1466077,-1,2560.0,9324190,9332522,7903884,8332,25,12,True,True,482.5710791111112,-0.27338120407758165
1625,1420347,34,16,0.072973,206,1466077,-1,272.0,4029224,4029258,2608877,34,79,12,True,True,0.1112585777777778,-0.072973
1626,1424591,1809,1,0.059913,206,1466077,-1,22.0,6654363,6656172,5229772,1809,44,7,True,True,0.6927062999999999,-0.059913
1627,1424612,768,1,0.439605,206,1466077,-1,31.0,2156340,2157108,731728,768,126,2,True,True,0.28095403333333335,-0.4285389049413435
1628,1426672,18,24,0.484251,206,1466077,-1,456.0,10274590,10274608,8847918,18,19,12,True,True,0.3179232,-0.484251
1629,1427179,524,8,0.204023,206,1466077,-1,312.0,10792990,10793514,9365811,524,16,12,True,True,4.6271645333333336,-0.204023
1630,1432315,7,1,0.60666,206,1466077,-1,6.0,2424698,2424705,992383,7,117,7,True,True,0.0017141833333333334,-0.60666
1631,1432369,8,4,0.312582,206,1466077,-1,72.0,7094290,7094298,5661921,8,41,12,True,True,0.0123088,-0.312582
1632,1432443,52,16,0.718363,206,1466077,-1,304.0,2138970,2139022,706527,52,135,1,True,True,0.183768,-0.718363
1633,1432465,5,2,0.7342,206,1466077,-1,62.0,2755884,2755889,1323419,5,112,10,True,True,0.012758222222222223,-0.7342
1634,1432472,7933,197,0.860777,206,1466077,-1,2758.0,1493577,1501510,61105,7933,159,10,True,True,259.39550027222225,-0.8587328045442912
1635,1432563,40,1,0.975374,206,1466077,-1,23.0,1716119,1716159,283556,40,150,7,True,True,0.04014011111111111,-0.975374
1636,1432902,16297,1,0.130766,206,1466077,-1,31.0,7528090,7544387,6095188,16297,38,12,True,True,10.952928697222221,-0.12960862962122804
1637,1433882,10,1,0.37054,206,1466077,-1,17.0,2307898,2307908,874016,10,125,8,True,True,0.002695916666666667,-0.37054
1638,1434306,672,2,0.561651,206,1466077,-1,64.0,1588947,1589619,154641,672,158,7,True,True,0.4327082666666667,-0.561651
1639,1434340,258,2,0.319116,206,1466077,-1,14.0,2422898,2423156,988558,258,122,6,True,True,0.1474197666666667,-0.319116
1640,1434383,83,41,0.466473,206,1466077,-1,287.0,4644724,4644807,3210341,83,71,9,True,True,0.19850833333333331,-0.466473
1641,1434752,30097,16,0.267472,206,1466077,-1,528.0,9064990,9095087,7630238,30097,29,12,True,True,297.35098653333336,-0.2673529870310865
1642,1435236,54,1,0.247919,206,1466077,-1,19.0,12147790,12147844,10712554,54,2,11,True,True,0.0175845,-0.247919
1643,1435263,34,1,0.096812,206,1466077,-1,32.0,10905090,10905124,9469827,34,17,12,True,True,0.026520000000000002,-0.096812
1644,1435411,15,32,0.290212,206,1466077,-1,1056.0,9237790,9237805,7802379,15,30,12,True,True,0.417956,-0.290212
1645,1435621,33,32,0.38415,206,1466077,-1,1056.0,6303163,6303196,4867542,33,58,12,True,True,0.27636400000000005,-0.3841500000000001
1646,1435683,2,2,0.615377,206,1466077,-1,56.0,1542047,1542049,106364,2,168,1,True,True,0.0013343555555555555,-0.615377
1647,1435706,6918,1,0.24827,206,1466077,-1,27.0,7722990,7729908,6287284,6918,41,12,True,True,5.2888535999999995,-0.2470175736243627
1648,1435860,98,2,0.865308,206,1466077,-1,46.0,2420198,2420296,984338,98,131,11,True,True,0.19209088888888887,-0.8653079999999999
1649,1435902,860,5,0.1597,206,1466077,-1,70.0,11822290,11823150,10386388,860,6,7,True,True,1.4513547222222223,-0.1432480227991578
1650,1435919,238,4,0.327436,206,1466077,-1,92.0,3188983,3189221,1753064,238,110,12,True,True,0.4843881777777777,-0.327436
1651,1436041,8762,16,0.577687,206,1466077,-1,464.0,8805790,8814552,7369749,8762,36,12,True,True,71.19248666666667,-0.5394095840780275
1652,1436063,18,4,0.312715,206,1466077,-1,32.0,8460190,8460208,7024127,18,38,12,True,True,0.020598400000000003,-0.312715
1653,1436085,79,1,0.763121,206,1466077,-1,50.0,2558905,2558984,1122820,79,129,11,True,True,0.07001375000000001,-0.763121
1654,1436093,26,28,0.498266,206,1466077,-1,448.0,7182490,7182516,5746397,26,49,7,True,True,0.2490083555555555,-0.498266
1655,1438443,13,1,0.514725,206,1466077,-1,44.0,5648763,5648776,4210320,13,68,8,True,True,0.025843277777777774,-0.514725
1656,1439228,3,2,0.49876,206,1466077,-1,48.0,6740763,6740766,5301535,3,57,12,True,True,0.0024132000000000003,-0.49876
1657,1440078,14813,8,0.30854,206,1466077,-1,192.0,1922270,1937083,482192,14813,162,11,True,True,38.732646933333335,-0.2685631821001573
1658,1440364,46,2,0.023176,206,1466077,-1,18.0,10360990,10361036,8920626,46,23,12,True,True,0.0255093,-0.023176
1659,1440682,10185,1,0.945233,206,1466077,-1,17.0,1878070,1888255,437388,10185,164,11,True,True,2.6359782083333334,-0.8955516948106421
1660,1440832,120,64,0.505444,206,1466077,-1,2816.0,5955763,5955883,4514931,120,68,11,True,True,14.32968533333333,-0.505444
1661,1441739,12,1,0.966687,206,1466077,-1,34.0,1469677,1469689,27938,12,187,8,True,True,0.009565333333333335,-0.966687
1662,1441788,212,1,0.215144,206,1466077,-1,41.0,8546590,8546802,7104802,212,39,12,True,True,0.22611272222222223,-0.215144
1663,1442362,3461,128,0.352895,206,1466077,-1,3200.0,7941790,7945251,6499428,3461,44,7,True,True,360.02411555555557,-0.27253946382047106
1664,1442591,40,1,0.05054,206,1466077,-1,45.0,11734090,11734130,10291499,40,8,11,True,True,0.039869999999999996,-0.05054
1665,1442660,76316,128,0.494894,206,1466077,-1,768.0,9410590,9486906,7967930,76316,32,12,True,True,1198.0300885333331,-0.49047279396093246
1666,1450502,450,32,0.882339,206,1466077,-1,192.0,2946215,2946665,1495713,450,127,0,True,True,3.4480799999999996,-0.882339
1667,1450575,102,2,0.65426,206,1466077,-1,58.0,3619442,3619544,2168867,102,114,7,True,True,0.05892993333333333,-0.65426
1668,1451480,778,32,0.470587,206,1466077,-1,1472.0,6216763,6217541,4765283,778,70,12,True,True,15.44760142222222,-0.41944881881655577
1669,1451527,12814,32,0.536691,206,1466077,-1,896.0,4731124,4743938,3279597,12814,90,12,True,True,185.52111075555558,-0.5135606521490063
1670,1451581,96,4,0.847172,206,1466077,-1,28.0,3479483,3479579,2027902,96,121,11,True,True,0.0803264,-0.847172
1671,1451844,30,16,0.430928,206,1466077,-1,176.0,2761303,2761333,1309459,30,137,8,True,True,0.16530799999999995,-0.430928
1672,1451875,16774,1,0.882456,206,1466077,-1,50.0,3431683,3448457,1979808,16774,123,12,True,True,12.357587500000001,-0.8455255520173093
1673,1452049,27,1,0.727508,206,1466077,-1,23.0,2733784,2733811,1281735,27,141,10,True,True,0.021867824999999997,-0.727508
1674,1452085,57,1,0.763857,206,1466077,-1,33.0,3080415,3080472,1628330,57,130,11,True,True,0.037238575,-0.763857
1675,1452408,18768,1,0.365937,206,1466077,-1,29.0,10818690,10837458,9366282,18768,20,10,True,True,12.2367211,-0.3625087010438403
1676,1452615,52,16,0.400582,206,1466077,-1,272.0,8719390,8719442,7266775,52,41,12,True,True,0.2535312,-0.400582
1677,1454614,8,1,0.570282,206,1466077,-1,47.0,2201440,2201448,746826,8,166,11,True,True,0.007697555555555556,-0.570282
1678,1454636,39,1,0.194655,206,1466077,-1,20.0,5472324,5472363,4017688,39,82,12,True,True,0.024138833333333335,-0.19465500000000005
1679,1456872,6712,86,0.553223,206,1466077,-1,3096.0,2757703,2764415,1300831,6712,143,1,True,True,731.1669690000001,-0.5514332812008913
1680,1596460,10681,32,0.073532,196,1596819,-1,1152.0,12320590,12331271,10724130,10681,1,12,True,True,527.6409472,-0.07266156242561152
1681,1596869,64,32,0.504256,242,1683219,-1,1600.0,5825163,5825227,4228294,64,78,12,True,True,1.0274133333333333,-0.504256
1682,1597436,24,10,0.764404,242,1683219,-1,250.0,3568942,3568966,1971506,24,125,7,True,True,0.10895000000000002,-0.764404
1683,1597484,939,2,0.279721,242,1683219,-1,32.0,10796590,10797529,9199106,939,22,8,True,True,0.8859151999999999,-0.279721
1684,1597521,994,8,0.989091,242,1683219,-1,336.0,1685019,1686013,87498,994,198,7,True,True,23.363108533333335,-0.989091
1685,1597734,3,42,0.680399,242,1683219,-1,1050.0,2331798,2331801,734064,3,163,10,True,True,0.06978125000000002,-0.680399
1686,1597776,122,1,0.118811,242,1683219,-1,23.0,12081490,12081612,10483714,122,5,12,True,True,0.05755238888888889,-0.11767580897406296
1687,1597818,384,8,0.975083,242,1683219,-1,304.0,2205040,2205424,607222,384,174,8,True,True,1.7234773333333333,-0.975083
1688,1597823,17302,18,0.393904,242,1683219,-1,306.0,2375998,2393300,778175,17302,164,11,True,True,131.19552969999998,-0.3533134461300017
1689,1598531,28,1,0.794897,242,1683219,-1,33.0,3323183,3323211,1724652,28,133,11,True,True,0.0072149,-0.794897
1690,1598542,127,51,0.339085,242,1683219,-1,2091.0,9496990,9497117,7898448,127,36,12,True,True,9.173519033333333,-0.339085
1691,1598584,14,3,0.938949,242,1683219,-1,120.0,1710719,1710733,112135,14,203,1,True,True,0.07015866666666666,-0.938949
1692,1598620,11847,3,0.754965,242,1683219,-1,48.0,1926770,1938617,328150,11847,191,8,True,True,6.6159276,-0.7501109940586955
1693,1598714,12681,256,0.199058,242,1683219,-1,3584.0,6608363,6621044,5009649,12681,71,12,True,True,378.8402190222222,-0.17617677088596403
1694,1598776,6557,2,0.509123,242,1683219,-1,36.0,8373790,8380347,6775014,6557,49,12,True,True,6.3877185999999995,-0.5082688193265635
1695,1598819,490,37,0.500078,242,1683219,-1,1628.0,7614490,7614980,6015671,490,58,12,True,True,5.725856888888888,-0.500078
1696,1598835,37,32,0.045303,242,1683219,-1,1568.0,4506924,4506961,2908089,37,104,12,True,True,1.3116450666666668,-0.045303
1697,1603039,14883,16,0.137036,242,1683219,-1,272.0,10533790,10548673,8930751,14883,27,12,True,True,61.62136200000001,-0.13667953381389603
1698,1603587,160,1,0.333041,242,1683219,-1,17.0,4366424,4366584,2762837,160,110,12,True,True,0.03704488888888889,-0.333041
1699,1603891,46,32,0.473744,242,1683219,-1,1504.0,8287390,8287436,6683499,46,51,12,True,True,1.7025029333333335,-0.4737440000000001
1700,1604086,27,64,0.456989,242,1683219,-1,2048.0,3856424,3856451,2252338,27,121,1,True,True,0.7560192,-0.456989
1701,1605702,50,4,0.606261,242,1683219,-1,32.0,5957563,5957613,4351861,50,84,7,True,True,0.06784888888888889,-0.606261
1702,1605723,93,1,0.515506,242,1683219,-1,28.0,2939015,2939108,1333292,93,154,12,True,True,0.06918683333333334,-0.515506
1703,1605946,11059,128,0.327966,242,1683219,-1,3200.0,9756190,9767249,8150244,11059,35,12,True,True,715.9068000000001,-0.3254751383952641
1704,1606006,11257,64,0.613068,242,1683219,-1,1216.0,2004770,2016027,398764,11257,198,6,True,True,152.15611075555555,-0.5819951316716953
1705,1606043,41,1,0.162502,242,1683219,-1,7.0,5738763,5738804,4132720,41,89,12,True,True,0.002822166666666667,-0.162502
1706,1606213,16,2,0.990616,242,1683219,-1,96.0,1950670,1950686,344457,16,203,7,True,True,0.017634133333333333,-0.990616
1707,1606308,359,2,0.739319,242,1683219,-1,96.0,3565883,3566242,1959575,359,141,12,True,True,0.5581253333333334,-0.739319
1708,1606337,1891,8,0.299234,242,1683219,-1,240.0,4368224,4370115,2761887,1891,114,7,True,True,6.371409333333333,-0.299234
1709,1606500,13621,1,0.336373,242,1683219,-1,38.0,7895790,7909411,6289290,13621,58,12,True,True,13.783065183333335,-0.32772838756543593
1710,1606528,59,2,0.828289,242,1683219,-1,50.0,3571642,3571701,1965114,59,140,6,True,True,0.046790277777777785,-0.828289
1711,1606786,19333,64,0.53234,242,1683219,-1,2048.0,7268890,7288223,5662104,19333,66,12,True,True,734.2058894222223,-0.5314118999954744
1712,1606809,112,64,0.70874,242,1683219,-1,768.0,4202924,4203036,2596115,112,124,12,True,True,1.0333866666666667,-0.70874
1713,1608097,518,2,0.299791,242,1683219,-1,34.0,6652563,6653081,5044466,518,77,0,True,True,0.27485184444444444,-0.2687946868483092
1714,1608200,15423,32,0.815749,242,1683219,-1,1248.0,1809970,1825393,201770,15423,219,11,True,True,964.2890573333333,-0.7580044348064829
1715,1608220,15378,1,0.368358,242,1683219,-1,22.0,10015390,10030768,8407170,15378,33,12,True,True,7.71286401111111,-0.34238354880156896
1716,1608688,1992,1,0.673806,242,1683219,-1,21.0,4369124,4371116,2760436,1992,118,6,True,True,0.5923703333333334,-0.6636327017420535
1717,1608889,7265,8,0.979898,242,1683219,-1,272.0,2091170,2098435,482281,7265,208,12,True,True,37.072512,-0.9748002537728984
1718,1611130,6,4,0.583702,242,1683219,-1,172.0,2428305,2428311,817175,6,181,2,True,True,0.03523133333333334,-0.583702
1719,1611158,29,32,0.796755,242,1683219,-1,864.0,3278983,3279012,1667825,29,155,12,True,True,0.32377920000000004,-0.796755
1720,1611488,390,32,0.725324,242,1683219,-1,800.0,3942824,3943214,2331336,390,131,12,True,True,12.311000000000002,-0.725324
1721,1611548,15,8,0.688044,242,1683219,-1,160.0,4637524,4637539,3025976,15,112,11,True,True,0.025686666666666667,-0.688044
1722,1618229,16,1,0.026647,242,1683219,-1,19.0,11081490,11081506,9463261,16,19,12,True,True,0.009499155555555555,-0.026647
1723,1618309,13,2,0.47459,242,1683219,-1,60.0,3567142,3567155,1948833,13,151,6,True,True,0.012631666666666666,-0.47459
1724,1618347,25525,16,0.967071,242,1683219,-1,480.0,2157240,2182765,538893,25525,206,6,True,True,159.59679333333332,-0.8589455254476254
1725,1618857,5,13,0.782904,242,1683219,-1,130.0,4905924,4905929,3287067,5,109,11,True,True,0.016836805555555556,-0.782904
1726,1618870,2,8,0.776162,242,1683219,-1,208.0,2304298,2304300,685428,2,199,11,True,True,0.006673333333333333,-0.776162
1727,1618883,135,32,0.577634,242,1683219,-1,1344.0,4992324,4992459,3373441,135,109,12,True,True,2.081016,-0.577634
4529,3668186,12,8,0.701314,1,3668186,-1,72.0,3669986,3669998,1800,12,0,7,True,True,0.016183200000000002,-0.701314
4530,3668196,39839,1,0.255939,12,3669986,-1,44.0,7147867,7187706,3479671,39839,0,2,True,True,143.1439956222222,-0.25165529317375157
4531,3668426,38,4,0.366354,12,3669986,-1,24.0,5937775,5937813,2269349,38,1,8,True,True,0.04466266666666667,-0.366354
4532,3668615,13,64,0.605954,12,3669986,-1,640.0,5832898,5832911,2164283,13,2,1,True,True,0.3339093333333333,-0.605954
4533,3668830,23991,4,0.070874,12,3669986,-1,92.0,6857098,6881089,3188268,23991,1,11,True,True,78.30297151111111,-0.06970775961803874
4534,3668847,12081,256,0.930211,12,3669986,-1,12288.0,3756386,3768467,87539,12081,4,12,True,True,2092.4247381333334,-0.9269144861801836
4535,3668865,5,1,0.208738,12,3669986,-1,33.0,4977383,4977388,1308518,5,4,12,True,True,0.005392291666666668,-0.208738
4536,3669374,4541,184,0.491406,12,3669986,-1,4048.0,5779698,5784239,2110324,4541,4,2,True,True,802.8995704888889,-0.48972900109668543
4537,3669407,7819,4,0.889767,12,3669986,-1,96.0,4151099,4158918,481692,7819,6,9,True,True,49.26332933333333,-0.7828228866274171
4538,3669434,2,4,0.079957,12,3669986,-1,112.0,7010067,7010069,3340633,2,1,6,True,True,0.0073528,-0.079957
4539,3669546,5723,2,0.80102,12,3669986,-1,38.0,4301865,4307588,632319,5723,7,7,True,True,8.38545335,-0.7997189552089348
4540,3669588,33704,64,0.0607,12,3669986,-1,1024.0,7261746,7295450,3592158,33704,0,6,True,True,1809.1590087111113,-0.05992811775311026
4541,3669597,10,1,0.55802,12,3669986,-1,26.0,5654750,5654760,1985153,10,7,2,True,True,0.008939666666666667,-0.5580200000000001
4542,3670045,612,43,0.938244,166,3756386,-1,430.0,3861748,3862360,191703,612,11,3,True,True,7.1506419999999995,-0.938244
4543,3670118,3,16,0.415953,166,3756386,-1,96.0,6007175,6007178,2337057,3,4,7,True,True,0.012409600000000002,-0.415953
4544,3670126,12,8,0.369069,166,3756386,-1,120.0,5625950,5625962,1955824,12,9,0,True,True,0.086052,-0.369069
4545,3670158,26577,128,0.708434,166,3756386,-1,4352.0,4220970,4247547,550812,26577,12,6,True,True,6034.4714858666675,-0.7026839293522531
4546,3670351,9,2,0.823643,166,3756386,-1,70.0,4137955,4137964,467604,9,14,6,True,True,0.035084000000000004,-0.823643
4547,3670440,3747,1,0.265816,166,3756386,-1,30.0,4096033,4099780,425593,3747,15,6,True,True,4.276281583333333,-0.265581757739891
4548,3672786,28250,128,0.040653,166,3756386,-1,4224.0,5941375,5969625,2268589,28250,5,2,True,True,4898.6344,-0.03989591390588452
4549,3672822,13457,128,0.070388,166,3756386,-1,3072.0,5766241,5779698,2093419,13457,9,2,True,True,1771.5482282666667,-0.06935164010254134
4550,3673201,21313,16,0.303905,166,3756386,-1,144.0,4121733,4143046,448532,21313,17,7,True,True,183.60152839999998,-0.2988268644757782
4551,3673565,89,1,0.944603,166,3756386,-1,12.0,4268320,4268409,594755,89,14,7,True,True,0.03434806666666666,-0.944603
4552,3673625,16711,4,0.960587,166,3756386,-1,68.0,3952848,3969559,279223,16711,20,11,True,True,22.18568,-0.9300139636223427
4553,3673741,75,2,0.097119,166,3756386,-1,16.0,4131655,4131730,457914,75,18,1,True,True,0.07889333333333333,-0.097119
4554,3673762,201,1,0.725172,166,3756386,-1,41.0,5118201,5118402,1444439,201,12,1,True,True,0.28143015,-0.725172
4555,3673920,5,1,0.531661,166,3756386,-1,25.0,5619650,5619655,1945730,5,12,12,True,True,0.006933333333333334,-0.5316609999999999
4556,3674946,25,1,0.18946,166,3756386,-1,24.0,6001775,6001800,2326829,25,5,7,True,True,0.025359999999999997,-0.18946
4557,3674980,12598,32,0.526192,166,3756386,-1,1440.0,5664341,5676939,1989361,12598,11,2,True,True,628.554544,-0.5147068174141358
4558,3675045,21116,45,0.248763,166,3756386,-1,1215.0,7279149,7300265,3604104,21116,0,2,True,True,844.01491725,-0.23814562367126357
4559,3675284,288,3,0.625325,166,3756386,-1,105.0,5715741,5716029,2040457,288,12,0,True,True,1.606668,-0.625325
4560,3675406,1649,5,0.178898,166,3756386,-1,220.0,5184650,5186299,1509244,1649,17,10,True,True,11.529349944444444,-0.178898
4561,3675425,101,1,0.749194,166,3756386,-1,6.0,4496483,4496584,821058,101,20,11,True,True,0.02822445,-0.749194
4562,3675572,12,2,0.415185,166,3756386,-1,28.0,5985575,5985587,2310003,12,7,11,True,True,0.012138933333333334,-0.415185
4563,3675590,8667,16,0.105514,166,3756386,-1,400.0,7007367,7016034,3331777,8667,4,6,True,True,125.38505333333333,-0.10432901175477277
4564,3675622,29,12,0.638624,166,3756386,-1,216.0,4779583,4779612,1103961,29,22,0,True,True,0.2751984,-0.638624
4565,3675637,7754,128,0.357963,166,3756386,-1,1920.0,6595875,6603629,2920238,7754,6,1,True,True,770.4465013333333,-0.3410009060235697
4566,3675654,189,32,0.458721,166,3756386,-1,320.0,4584683,4584872,909029,189,24,12,True,True,4.966919999999999,-0.458721
4567,3675688,10761,1,0.665242,166,3756386,-1,46.0,4497383,4508144,821695,10761,25,0,True,True,23.269544538888887,-0.6579146072847
4568,3675741,8744,4,0.882824,166,3756386,-1,196.0,3855448,3864192,179707,8744,37,2,True,True,46.80394195555555,-0.8704009172502581
4569,3675872,9308,1,0.166809,166,3756386,-1,44.0,3999533,4008841,323661,9308,35,6,True,True,10.9694772,-0.1653526555382845
4570,3675903,11829,72,0.180397,166,3756386,-1,2232.0,7275549,7287378,3599646,11829,1,2,True,True,957.6762234000001,-0.14348862551396893
4571,3676012,238,1,0.401557,166,3756386,-1,35.0,6195275,6195513,2519263,238,8,12,True,True,0.3450008333333333,-0.401557
4572,3676024,33,8,0.337513,166,3756386,-1,360.0,5069383,5069416,1393359,33,24,11,True,True,0.326139,-0.337513
4573,3676082,23,5,0.158176,166,3756386,-1,70.0,6682275,6682298,3006193,23,7,12,True,True,0.08404647222222224,-0.158176
4574,3676130,45,1,0.998434,166,3756386,-1,50.0,3852336,3852381,176206,45,43,1,True,True,0.06278125000000001,-0.9984339999999998
4575,3676133,2356,2,0.443012,166,3756386,-1,18.0,4271109,4273465,594976,2356,32,6,True,True,1.2538656999999997,-0.43653296887453086
4576,3676184,230,8,0.352324,166,3756386,-1,128.0,5651150,5651380,1974966,230,21,8,True,True,1.1899484444444441,-0.352324
4577,3677867,53,45,0.315155,166,3756386,-1,1710.0,5992775,5992828,2314908,53,12,6,True,True,3.3246105,-0.315155
4578,3677893,32,1,0.991463,166,3756386,-1,33.0,3958248,3958280,280355,32,43,2,True,True,0.016863733333333332,-0.991463
4579,3677973,1043,1,0.324654,166,3756386,-1,43.0,3974448,3975491,296475,1043,43,9,True,True,1.3708844333333332,-0.324654
4580,3677995,13208,38,0.37172,166,3756386,-1,608.0,4128033,4141241,450038,13208,40,6,True,True,531.0172912888888,-0.3675402481433535
4581,3678079,1889,4,0.764184,166,3756386,-1,168.0,4316945,4318834,638866,1889,33,6,True,True,13.2864704,-0.764184
4582,3678090,14913,128,0.430588,166,3756386,-1,1792.0,5833948,5848861,2155858,14913,16,2,True,True,1034.9039530666666,-0.426226980912911
4583,3678108,13165,16,0.725868,166,3756386,-1,128.0,3800586,3813751,122478,13165,52,11,True,True,68.28619093333333,-0.7040871224347811
4584,3678125,7,4,0.608413,166,3756386,-1,108.0,5661950,5661957,1983825,7,22,2,True,True,0.0296856,-0.608413
4585,3678176,6,37,0.563145,166,3756386,-1,1295.0,5647550,5647556,1969374,6,25,8,True,True,0.2912023333333333,-0.563145
4586,3678377,8869,256,0.213928,166,3756386,-1,9472.0,6946198,6955067,3267821,8869,6,6,True,True,2148.5045809777776,-0.20450341190189916
4587,3678440,12027,210,0.765708,166,3756386,-1,5250.0,5922148,5934175,2243708,12027,17,7,True,True,2700.7947458333333,-0.735708577444229
4588,3679211,14,64,0.926147,166,3756386,-1,2176.0,3954648,3954662,275437,14,52,7,True,True,0.5484366222222223,-0.926147
4589,3679280,44,128,0.254089,166,3756386,-1,5632.0,5532350,5532394,1853070,44,30,11,True,True,8.69943751111111,-0.254089
4590,3679312,4,1,0.961652,166,3756386,-1,31.0,3965448,3965452,286136,4,52,2,True,True,0.0026615222222222223,-0.961652
4591,3679372,7906,32,0.4475,166,3756386,-1,992.0,5399750,5407656,1720378,7906,31,11,True,True,290.3928995555556,-0.44706135735731645
4592,3680172,1984,32,0.397091,166,3756386,-1,1024.0,5301450,5303434,1621278,1984,32,10,True,True,69.23220195555555,-0.3937168955778614
4593,3680281,13,14,0.726313,166,3756386,-1,574.0,4175870,4175883,495589,13,46,6,True,True,0.32383007222222215,-0.726313
4594,3680922,11742,86,0.982956,166,3756386,-1,602.0,3908648,3920390,227726,11742,59,7,True,True,154.66213435555557,-0.8895627534922387
4595,3681024,1300,8,0.595763,166,3756386,-1,168.0,5117255,5118555,1436231,1300,35,10,True,True,7.45836,-0.595763
4596,3681070,19,1,0.517609,166,3756386,-1,28.0,4270209,4270228,589139,19,45,7,True,True,0.01569991111111111,-0.517609
4597,3681095,23,32,0.993412,166,3756386,-1,288.0,4498283,4498306,817188,23,40,6,True,True,0.3085128,-0.9934119999999997
4598,3681213,5,32,0.301842,166,3756386,-1,1408.0,4890983,4890988,1209770,5,38,10,True,True,0.27590933333333334,-0.301842
4599,3681391,13,8,0.300334,166,3756386,-1,264.0,5118155,5118168,1436764,13,35,6,True,True,0.11720280000000001,-0.300334
4600,3681904,3459,4,0.221887,166,3756386,-1,156.0,5762641,5766100,2080737,3459,22,7,True,True,20.834619866666667,-0.21142143935234742
4601,3682096,13849,4,0.85572,166,3756386,-1,152.0,5305050,5318899,1622954,13849,33,0,True,True,80.55838711111112,-0.8384569851820589
4602,3682167,19827,32,0.021701,166,3756386,-1,352.0,7006467,7026294,3324300,19827,6,11,True,True,257.13367679999993,-0.021613432998978804
4603,3682283,6,1,0.82194,166,3756386,-1,19.0,4021633,4021639,339350,6,61,10,True,True,0.002907633333333333,-0.82194
4604,3682525,22,32,0.689719,166,3756386,-1,1248.0,4131633,4131655,449108,22,58,8,True,True,1.8050794666666667,-0.6897189999999999
4605,3682574,13,1,0.275957,166,3756386,-1,35.0,6107975,6107988,2425401,13,12,7,True,True,0.018159555555555557,-0.275957
4606,3682589,3,4,0.553663,166,3756386,-1,56.0,4050933,4050936,368344,3,63,10,True,True,0.0066724,-0.553663
4607,3683826,2914,1,0.556323,166,3756386,-1,29.0,5775241,5778155,2091415,2914,23,2,True,True,3.767204561111111,-0.5558550458952941
4608,3685104,2,1,0.925922,166,3756386,-1,14.0,3967248,3967250,282144,2,68,6,True,True,0.0006869333333333333,-0.925922
4609,3688341,561,1,0.154715,166,3756386,-1,38.0,6010775,6011336,2322434,561,13,2,True,True,0.9822860666666665,-0.154715
4610,3688365,19295,64,0.037736,166,3756386,-1,2112.0,7163167,7182462,3474802,19295,3,2,True,True,3476.7450256,-0.036505408764805534
4611,3688398,12603,8,0.355656,166,3756386,-1,128.0,5003083,5015686,1314685,12603,45,10,True,True,47.29731484444444,-0.3518036953024683
4612,3688772,56,1,0.138408,166,3756386,-1,42.0,6502275,6502331,2813503,56,12,8,True,True,0.12168986666666666,-0.138408
4613,3688871,53,8,0.367083,166,3756386,-1,160.0,4980983,4981036,1292112,53,47,8,True,True,0.28436266666666665,-0.367083
4614,3688977,11,8,0.582156,166,3756386,-1,112.0,3858148,3858159,169171,11,80,7,True,True,0.034153777777777776,-0.582156
4615,3689104,7367,16,0.232994,166,3756386,-1,768.0,6955067,6962434,3265963,7367,8,8,True,True,107.92411093333334,-0.20484412607223096
4616,3689453,19,1,0.811074,166,3756386,-1,11.0,3982548,3982567,293095,19,73,2,True,True,0.004539363888888888,-0.811074
4617,3690701,14513,16,0.091905,166,3756386,-1,592.0,7282749,7297262,3592048,14513,0,2,True,True,282.69876146666667,-0.09019266965912812
4618,3690792,149,32,0.399798,166,3756386,-1,1568.0,5162401,5162550,1471609,149,44,10,True,True,7.798765955555557,-0.399798
4619,3690846,16952,256,0.917882,166,3756386,-1,12800.0,4158918,4175870,468072,16952,65,6,True,True,11373.511822222223,-0.877862546573351
4620,3690876,21615,64,0.734266,166,3756386,-1,896.0,5351950,5373565,1661074,21615,41,0,True,True,738.201544888889,-0.7305570904365571
4621,3690903,30,8,0.723581,166,3756386,-1,160.0,4303665,4303695,612762,30,60,7,True,True,0.18514666666666668,-0.723581
4622,3691207,140,16,0.792904,166,3756386,-1,768.0,3845686,3845826,154479,140,90,6,True,True,3.3340159999999996,-0.7929040000000003
4623,3691710,20607,32,0.172902,166,3756386,-1,1312.0,5711241,5731848,2019531,20607,32,7,True,True,1221.6355298666667,-0.16996284560988628
4624,3691896,6844,35,0.825705,166,3756386,-1,1540.0,4137055,4143899,445159,6844,71,2,True,True,604.5418011111111,-0.8247487635274818
4625,3692532,17,8,0.689595,166,3756386,-1,256.0,3998633,3998650,306101,17,80,7,True,True,0.10419413333333333,-0.689595
4626,3692654,1207,32,0.576232,166,3756386,-1,608.0,4127133,4128340,434479,1207,75,7,True,True,42.137603822222225,-0.576232
4627,3692800,10,1,0.907656,166,3756386,-1,50.0,3993233,3993243,300433,10,82,6,True,True,0.012213888888888889,-0.907656
4628,3692903,3,12,0.595231,166,3756386,-1,456.0,4295565,4295568,602662,3,63,10,True,True,0.059086200000000005,-0.595231
4629,3693006,11,21,0.300393,166,3756386,-1,861.0,5783298,5783309,2090292,11,27,8,True,True,0.4120937333333333,-0.300393
4630,3699045,8653,32,0.730789,166,3756386,-1,928.0,3856348,3865001,157303,8653,95,6,True,True,218.34322204444445,-0.7280372768086512
4631,3699066,22116,32,0.576284,166,3756386,-1,288.0,3844786,3866902,145720,22116,99,11,True,True,180.60123199999998,-0.5558236921007199
4632,3699271,21,1,0.078477,166,3756386,-1,16.0,7265346,7265367,3566075,21,3,2,True,True,0.028571200000000005,-0.078477
4633,3699282,111,18,0.055923,166,3756386,-1,612.0,6812898,6813009,3113616,111,13,11,True,True,2.1323100000000004,-0.055923
4634,3699352,13,4,0.770902,166,3756386,-1,48.0,5643050,5643063,1943698,13,41,9,True,True,0.028532400000000003,-0.770902
4635,3699478,11,4,0.34793,166,3756386,-1,172.0,6956867,6956878,3257389,11,10,6,True,True,0.035038788888888894,-0.34793
4636,3699527,13020,12,0.817142,166,3756386,-1,600.0,5230650,5243670,1531123,13020,50,11,True,True,231.22375,-0.8017941773025058
4637,3700163,6,11,0.416522,166,3756386,-1,187.0,4152899,4152905,452736,6,76,7,True,True,0.06294108333333333,-0.416522
4638,3701086,44,32,0.867831,166,3756386,-1,1088.0,5349250,5349294,1648164,44,48,11,True,True,1.7607587555555557,-0.867831
4639,3701224,130,1,0.869787,166,3756386,-1,36.0,4220070,4220200,518846,130,75,11,True,True,0.24785799999999994,-0.869787
4640,3701346,187,32,0.226718,166,3756386,-1,928.0,7055167,7055354,3353821,187,7,6,True,True,5.148716711111112,-0.226718
4641,3712058,24,36,0.652779,166,3756386,-1,216.0,5771641,5771665,2059583,24,34,8,True,True,0.22737600000000002,-0.652779
4642,3712151,13959,64,0.602302,166,3756386,-1,704.0,6682298,6696257,2970147,13959,16,1,True,True,445.39212177777773,-0.5720527637867683
4643,3714914,7407,9,0.011434,166,3756386,-1,288.0,7288122,7295529,3573208,7407,0,2,True,True,68.2698504,-0.011389643057199516
4644,3715223,18,16,0.777419,166,3756386,-1,592.0,3988733,3988751,273510,18,97,2,True,True,0.25379039999999997,-0.777419
4645,3715324,18,16,0.382487,166,3756386,-1,800.0,3961848,3961866,246524,18,102,2,True,True,0.27872,-0.382487
4646,3715542,5,8,0.304783,166,3756386,-1,136.0,4268320,4268325,552778,5,77,0,True,True,0.02186955555555556,-0.304783
4647,3720730,18,16,0.041182,166,3756386,-1,304.0,7155967,7155985,3435237,18,7,8,True,True,0.4846064,-0.041182
4648,3720939,56,4,0.53993,166,3756386,-1,104.0,5714841,5714897,1993902,56,41,2,True,True,0.30943235555555554,-0.53993
4649,3721655,12,1,0.14958,166,3756386,-1,44.0,7009167,7009179,3287512,12,11,7,True,True,0.017072,-0.14958
4650,3723113,108,2,0.502402,166,3756386,-1,54.0,5350150,5350258,1627037,108,55,0,True,True,0.2225556,-0.502402
4651,3723509,38,1,0.220797,166,3756386,-1,43.0,4363845,4363883,640336,38,75,11,True,True,0.050989877777777776,-0.220797
4652,3723658,819,1,0.05052,166,3756386,-1,22.0,6014375,6015194,2290717,819,25,2,True,True,0.8919910999999999,-0.05052
4653,3723949,12732,20,0.731579,166,3756386,-1,920.0,4259320,4272052,535371,12732,85,0,True,True,398.3914026666667,-0.7246322267876547
4654,3724018,394,4,0.392883,166,3756386,-1,32.0,4316045,4316439,592027,394,78,2,True,True,0.49898159999999997,-0.3713925466506959
4655,3733006,4,16,0.445616,166,3756386,-1,112.0,5715741,5715745,1982735,4,43,6,True,True,0.02380248888888889,-0.445616
4656,3733414,122,4,0.595132,166,3756386,-1,96.0,5768041,5768163,2034627,122,40,7,True,True,0.4791184000000001,-0.595132
4657,3736777,71,3,0.504729,166,3756386,-1,114.0,5624150,5624221,1887373,71,54,6,True,True,0.4836839499999999,-0.504729
4658,3736867,291,2,0.222086,166,3756386,-1,94.0,6960467,6960758,3223600,291,14,2,True,True,0.5335549666666666,-0.222086
4659,3737473,40,1,0.289783,166,3756386,-1,29.0,7257246,7257286,3519773,40,6,2,True,True,0.1033108888888889,-0.289783
4660,3737586,14,4,0.394322,166,3756386,-1,200.0,5999975,5999989,2262389,14,31,2,True,True,0.12217333333333336,-0.394322
4661,3737606,16503,3,0.132189,166,3756386,-1,123.0,7259046,7275549,3521440,16503,6,6,True,True,160.89864827500003,-0.12884862604193617
4662,3737796,274,12,0.082545,166,3756386,-1,552.0,6588675,6588949,2850879,274,25,12,True,True,9.01396066666667,-0.082545
4663,3740770,18193,1,0.571441,166,3756386,-1,22.0,6016175,6034368,2275405,18193,29,7,True,True,21.743604605555554,-0.5609551278776157
4664,3740870,2,4,0.049311,166,3756386,-1,60.0,7166767,7166769,3425897,2,8,2,True,True,0.00975,-0.049311
4665,3740946,4650,1,0.399191,166,3756386,-1,42.0,5829298,5833948,2088352,4650,43,7,True,True,7.734012999999999,-0.39593496004650136
4666,3741105,22,1,0.085079,166,3756386,-1,42.0,5623250,5623272,1882145,22,63,8,True,True,0.05521670000000001,-0.085079
4667,3741132,20,4,0.501823,166,3756386,-1,116.0,5533250,5533270,1792118,20,65,6,True,True,0.08585933333333333,-0.501823
4668,3741765,21010,1,0.773825,166,3756386,-1,12.0,5091483,5112493,1349718,21010,79,10,True,True,7.965584900000001,-0.7572385797129505
4669,3741794,1379,32,0.130375,166,3756386,-1,448.0,7255867,7257246,3514073,1379,8,7,True,True,55.02124195555556,-0.130375
4670,3741818,8052,16,0.134871,166,3756386,-1,144.0,7268946,7276998,3527128,8052,4,2,True,True,80.7642024,-0.1286383946125182
4671,3742130,11773,256,0.559296,166,3756386,-1,2560.0,4247547,4259320,505417,11773,103,7,True,True,1107.5549084444444,-0.4901888768366804
4672,3742226,27737,2,0.487861,166,3756386,-1,30.0,5643950,5671687,1901724,27737,62,6,True,True,31.6815465,-0.47204687551530045
4673,3744910,24,1,0.652248,166,3756386,-1,47.0,4318745,4318769,573835,24,94,6,True,True,0.047225600000000006,-0.652248
4674,3745166,37,4,0.196099,166,3756386,-1,152.0,4452283,4452320,707117,37,93,11,True,True,0.12019737777777778,-0.196099
4675,3745225,5,16,0.615997,166,3756386,-1,800.0,5140301,5140306,1395076,5,79,10,True,True,0.11502222222222222,-0.615997
4676,3745556,5180,2,0.735668,166,3756386,-1,42.0,4310865,4316045,565309,5180,99,9,True,True,8.489176500000001,-0.7346143016766861
4677,3745892,345,7,0.246246,166,3756386,-1,91.0,6945298,6945643,3199406,345,23,7,True,True,0.8666764166666667,-0.246246
4678,3745926,7556,18,0.071644,166,3756386,-1,774.0,5716641,5724197,1970715,7556,54,6,True,True,264.94734015,-0.06612722959748095
4679,3746126,1346,1,0.776772,166,3756386,-1,38.0,4118133,4119479,372007,1346,124,10,True,True,2.248370805555555,-0.7518264266559428
4680,3746157,12869,5,0.323412,166,3756386,-1,25.0,7159567,7172436,3413410,12869,12,8,True,True,25.133859930555555,-0.30106772288224243
4681,3746241,9785,64,0.924138,166,3756386,-1,2816.0,3978948,3988733,232707,9785,134,8,True,True,609.6264064,-0.9231673825598953
4682,3746249,7103,1,0.089595,166,3756386,-1,10.0,7253167,7260270,3506918,7103,10,12,True,True,6.284567777777778,-0.08925792224125846
4683,3755003,82,3,0.671748,166,3756386,-1,39.0,4314465,4314547,559462,82,103,7,True,True,0.12576135,-0.671748
4684,3755163,75,16,0.423541,166,3756386,-1,688.0,5025183,5025258,1270020,75,89,10,True,True,1.5650566666666665,-0.4235410000000001
4685,3755216,149,15,0.348308,166,3756386,-1,75.0,6768698,6768847,3013482,149,28,12,True,True,0.40850833333333336,-0.348308
4686,3755303,664,1,0.320738,166,3756386,-1,49.0,6017975,6018639,2262672,664,36,7,True,True,1.8414472222222222,-0.320738
4687,3755563,12,7,0.593877,166,3756386,-1,154.0,5629550,5629562,1873987,12,70,8,True,True,0.15387166666666666,-0.593877
4688,3755616,5197,2,0.024207,166,3756386,-1,72.0,7142467,7147664,3386851,5197,16,6,True,True,18.314687999999997,-0.022645299162705974
4689,3755685,162,1,0.304819,166,3756386,-1,12.0,7152367,7152529,3396682,162,15,6,True,True,0.151578,-0.304819
4690,3755779,25,4,0.987652,166,3756386,-1,44.0,4363845,4363870,608066,25,105,0,True,True,0.034326111111111106,-0.987652
4691,3755886,133,1,0.616221,166,3756386,-1,39.0,4779583,4779716,1023697,133,100,12,True,True,0.2278822,-0.616221
4692,3756006,65,1,0.990159,166,3756386,-1,18.0,4028833,4028898,272827,65,138,9,True,True,0.029851249999999992,-0.990159
4693,3756031,311,16,0.44221,166,3756386,-1,800.0,5625950,5626261,1869919,311,74,7,True,True,14.867873333333332,-0.44221
4694,3756055,4751,128,0.145818,166,3756386,-1,1792.0,6592275,6597026,2836220,4751,34,8,True,True,471.57616426666664,-0.1447587397652097
4695,3756222,13626,35,0.044878,166,3756386,-1,315.0,6962267,6975893,3206045,13626,23,7,True,True,103.35045175,-0.044388868164388036
4696,3756261,33,32,0.818172,166,3756386,-1,1408.0,5118168,5118201,1361907,33,93,1,True,True,1.5867455999999998,-0.8181720000000002
4697,3756506,69,2,0.199685,253,3800586,-1,88.0,4868883,4868952,1112377,69,103,6,True,True,0.4649802666666666,-0.199685
4698,3756759,40,8,0.373821,253,3800586,-1,312.0,6498675,6498715,2741916,40,38,12,True,True,0.8303360000000001,-0.37382100000000007
4699,3756843,17162,1,0.757734,253,3800586,-1,14.0,5709441,5726603,1952598,17162,68,6,True,True,11.332218916666665,-0.7520040090712876
4700,3756862,6542,32,0.852764,253,3800586,-1,160.0,3975348,3981890,218486,6542,153,6,True,True,25.739430222222225,-0.7886999626936055
4701,3756895,3,1,0.112372,253,3800586,-1,40.0,6005375,6005378,2248480,3,46,2,True,True,0.005170666666666667,-0.112372
4702,3756915,8,32,0.054538,253,3800586,-1,1472.0,7256767,7256775,3499852,8,9,6,True,True,1.0487836444444445,-0.054538
4703,3757054,179,8,0.948941,253,3800586,-1,360.0,4124433,4124612,367379,179,143,6,True,True,2.574199,-0.948941
4704,3757085,210,1,0.92673,253,3800586,-1,18.0,4273465,4273675,516380,210,125,2,True,True,0.113421,-0.92673
4705,3762278,398,1,0.868752,253,3800586,-1,5.0,4119933,4120331,357655,398,146,7,True,True,0.08675847222222222,-0.868752
4706,3762315,1072,16,0.820134,253,3800586,-1,384.0,5635850,5636922,1873535,1072,78,6,True,True,26.869179733333333,-0.820134
4707,3762596,873,2,0.013733,253,3800586,-1,32.0,7287249,7288122,3524653,873,1,8,True,True,0.886968,-0.013733
4708,3762738,3561,13,0.693795,253,3800586,-1,182.0,4671083,4674644,908345,3561,112,12,True,True,27.33159873888889,-0.6872686275562252
4709,3763357,38,8,0.111278,253,3800586,-1,224.0,6955967,6956005,3192610,38,28,6,True,True,0.15763751111111113,-0.111278
4710,3763829,30,16,0.450062,253,3800586,-1,800.0,5996375,5996405,2232546,30,52,8,True,True,0.8236666666666667,-0.450062
4711,3763901,3,1,0.022748,253,3800586,-1,35.0,7054267,7054270,3290366,3,21,11,True,True,0.0031152916666666673,-0.022748
4712,3764374,127,1,0.20901,253,3800586,-1,45.0,7151467,7151594,3387093,127,18,2,True,True,0.44561124999999996,-0.20901
4713,3764568,25,1,0.538005,253,3800586,-1,45.0,4867983,4868008,1103415,25,114,10,True,True,0.08614999999999999,-0.538005
4714,3765006,404,1,0.203801,253,3800586,-1,8.0,4125333,4125737,360327,404,152,6,True,True,0.1482589777777778,-0.1628159598028232
4715,3765081,180,8,0.523266,253,3800586,-1,368.0,5279350,5279530,1514269,180,98,6,True,True,2.134032,-0.523266
4716,3765135,8,64,0.258658,253,3800586,-1,2432.0,7254067,7254075,3488932,8,12,6,True,True,1.7327729777777778,-0.258658
4717,3765185,10,13,0.483026,253,3800586,-1,364.0,4845883,4845893,1080698,10,117,10,True,True,0.3271753333333333,-0.483026
4718,3766817,15506,16,0.729924,253,3800586,-1,192.0,4408083,4423589,641266,15506,126,11,True,True,87.45261013333334,-0.7214643942828538
4719,3767495,22743,32,0.141347,253,3800586,-1,256.0,5760841,5783584,1993346,22743,71,11,True,True,245.33935502222224,-0.13969584375266375
4720,3767621,8118,85,0.698755,253,3800586,-1,2805.0,5631350,5639468,1863729,8118,86,7,True,True,1477.5993090833335,-0.6709483048859735
4721,3767629,340,11,0.018389,253,3800586,-1,66.0,3847486,3847826,79857,340,187,6,True,True,0.695827,-0.018389
4722,3767677,4,1,0.583005,253,3800586,-1,33.0,4295565,4295569,527888,4,138,0,True,True,0.0057013,-0.583005
4723,3767719,4,16,0.663528,253,3800586,-1,384.0,5095155,5095159,1327436,4,110,1,True,True,0.04712533333333333,-0.663528
4724,3767753,19427,32,0.043482,253,3800586,-1,1312.0,7283649,7303076,3515896,19427,2,6,True,True,823.7918986666666,-0.04316874497045706
4725,3770600,21,4,0.17032,253,3800586,-1,24.0,6943498,6943519,3172898,21,36,12,True,True,0.013993000000000002,-0.17032
4726,3770711,12818,8,0.284014,253,3800586,-1,64.0,4141555,4154373,370844,12818,156,4,True,True,46.32560977777778,-0.28108190648747167
4727,3770842,8241,4,0.789188,253,3800586,-1,140.0,3992333,4000574,221491,8241,175,2,True,True,28.11380288888889,-0.7691545059536105
4728,3771034,6679,3,0.617965,253,3800586,-1,102.0,4317845,4324524,546811,6679,135,6,True,True,28.4843398,-0.6173567192193572
4729,3771114,4923,32,0.053085,253,3800586,-1,800.0,5278450,5283373,1507336,4923,104,8,True,True,123.09144222222224,-0.05245314167222294
4730,3773534,8,2,0.654758,253,3800586,-1,72.0,4095133,4095141,321599,8,171,11,True,True,0.0218192,-0.654758
4731,3773691,23,2,0.008334,253,3800586,-1,20.0,7272546,7272569,3498855,23,6,2,True,True,0.029538388888888892,-0.008334
4732,3775251,3,3,0.388645,253,3800586,-1,42.0,5488150,5488153,1712899,3,98,11,True,True,0.0048874,-0.388645
4733,3775256,74203,8,0.27131,253,3800586,-1,80.0,7144267,7218470,3369011,74203,23,7,True,True,384.6613328888889,-0.2693480334726736
4734,3775461,22,8,0.852083,253,3800586,-1,224.0,5186450,5186472,1410989,22,109,7,True,True,0.15661457777777776,-0.852083
4735,3775465,484,16,0.6601,253,3800586,-1,784.0,4315365,4315849,539900,484,143,6,True,True,14.922107200000001,-0.6601
4736,3775529,23,11,0.864282,253,3800586,-1,330.0,3996833,3996856,221304,23,182,2,True,True,0.18171725000000002,-0.864282
4737,3775548,21509,8,0.019078,253,3800586,-1,64.0,5443950,5465459,1668402,21509,100,11,True,True,46.70463573333333,-0.018984242056781217
4738,3775801,117,16,0.86741,253,3800586,-1,624.0,4123533,4123650,347732,117,173,7,True,True,2.9164668,-0.86741
4739,3775807,8667,128,0.649411,253,3800586,-1,5760.0,4693183,4701850,917376,8667,131,10,True,True,1985.5951360000001,-0.6267956231402224
4740,3775814,295,1,0.231169,253,3800586,-1,6.0,6104375,6104670,2328561,295,51,12,True,True,0.07457600000000002,-0.231169
4741,3775877,598,8,0.380701,253,3800586,-1,280.0,5708541,5709139,1932664,598,83,11,True,True,7.384569111111112,-0.380701
4742,3775944,10,16,0.976612,253,3800586,-1,752.0,3847826,3847836,71882,10,207,1,True,True,0.23318266666666665,-0.976612
4743,3780875,22841,128,0.099604,253,3800586,-1,2688.0,4266520,4289361,485645,22841,159,9,True,True,1824.1882549333332,-0.09853497878866897
4744,3780907,14592,1,0.315456,253,3800586,-1,47.0,6106175,6120767,2325268,14592,51,7,True,True,29.00562595555556,-0.31113938246818723
4745,3780940,7,32,0.866773,253,3800586,-1,480.0,3906848,3906855,125908,7,204,6,True,True,0.09395866666666666,-0.866773
4746,3780982,152,8,0.531561,253,3800586,-1,248.0,5350150,5350302,1569168,152,107,6,True,True,1.4385212444444444,-0.531561
4747,3781726,10507,128,0.186417,253,3800586,-1,768.0,5934175,5944682,2152449,10507,66,8,True,True,388.5733418666667,-0.18553280375883305
4748,3781779,44,1,0.500651,253,3800586,-1,35.0,5827498,5827542,2045719,44,71,11,True,True,0.06442761111111113,-0.500651
4749,3782028,63,7,0.457986,253,3800586,-1,350.0,4363883,4363946,581855,63,145,2,True,True,0.6880825,-0.457986
4750,3782175,100,16,0.92635,253,3800586,-1,656.0,3847836,3847936,65661,100,214,1,True,True,2.0341466666666665,-0.92635
4751,3782239,4,45,0.021488,253,3800586,-1,675.0,7258146,7258150,3475907,4,11,6,True,True,0.23670000000000002,-0.021488
4752,3782343,24,4,0.247392,253,3800586,-1,128.0,4299165,4299189,516822,24,158,8,True,True,0.11317760000000002,-0.247392
4753,3782371,14628,1,0.529415,253,3800586,-1,45.0,5162550,5177178,1380179,14628,119,1,True,True,22.881603000000002,-0.5292701432663084
4754,3782770,17,1,0.33357,253,3800586,-1,42.0,6325875,6325892,2543105,17,50,11,True,True,0.0704123,-0.33357
4755,3782813,3755,4,0.3934,253,3800586,-1,116.0,5305050,5308805,1522237,3755,114,8,True,True,15.400211555555558,-0.38316807663824065
4756,3782901,7,4,0.157005,253,3800586,-1,192.0,6281675,6281682,2498774,7,51,12,True,True,0.0573888,-0.157005
4757,3784680,5380,32,0.34678,253,3800586,-1,992.0,5920348,5925728,2135668,5380,71,12,True,True,202.2931921777778,-0.3288253889696589
4758,3784760,79,2,0.351913,253,3800586,-1,34.0,4312665,4312744,527905,79,160,7,True,True,0.10343338333333334,-0.351913
4759,3786043,6140,12,0.625231,253,3800586,-1,372.0,4497383,4503523,711340,6140,148,6,True,True,107.78987369999999,-0.6250524414616833
4760,3786103,4836,2,0.236205,253,3800586,-1,50.0,3905948,3910784,119845,4836,218,11,True,True,6.637549444444445,-0.18783810544666424
4761,3786136,12503,32,0.978244,253,3800586,-1,320.0,5274850,5287353,1488714,12503,120,11,True,True,125.65273511111113,-0.9708103428994785
4762,3786949,7853,25,0.501251,253,3800586,-1,1200.0,4319645,4327498,532696,7853,156,6,True,True,392.2559933333333,-0.498800735782832
4763,3787888,41,1,0.811893,253,3800586,-1,22.0,5355550,5355591,1567662,41,111,8,True,True,0.03357695,-0.811893
4764,3787929,5991,4,0.625792,253,3800586,-1,64.0,5658350,5664341,1870421,5991,93,2,True,True,15.094845866666667,-0.5957114594310399
4765,3788206,36,16,0.878677,253,3800586,-1,720.0,4133455,4133491,345249,36,189,7,True,True,2.131272,-0.878677
4766,3793189,15235,1,0.890402,253,3800586,-1,22.0,3983448,3998683,190259,15235,211,6,True,True,7.811935083333332,-0.8853213204929806
4767,3793296,24,32,0.814859,253,3800586,-1,1568.0,4300065,4300089,506769,24,169,6,True,True,1.3864256,-0.814859
4768,3793755,43,8,0.029466,253,3800586,-1,232.0,6412275,6412318,2618520,43,50,12,True,True,0.8392032888888888,-0.029466
4769,3794963,722,4,0.554939,253,3800586,-1,144.0,4823783,4824505,1028820,722,145,11,True,True,6.323236,-0.5221000577364499
4770,3795019,219,1,0.280194,253,3800586,-1,15.0,5634950,5635169,1839931,219,101,8,True,True,0.21441925,-0.280194
4771,3795036,1550,1,0.151708,253,3800586,-1,6.0,7260846,7262396,3465810,1550,10,7,True,True,0.7092746,-0.1319791868230099
4772,3795334,47,8,0.897175,253,3800586,-1,88.0,3985248,3985295,189914,47,216,7,True,True,0.09850573333333333,-0.897175
4773,3795560,19937,23,0.656932,253,3800586,-1,943.0,3846586,3866523,51026,19937,239,6,True,True,530.0165212249999,-0.647404437770752
4774,3795585,72,64,0.087795,253,3800586,-1,2880.0,5095083,5095155,1299498,72,137,8,True,True,6.36192,-0.087795
4775,3795959,6636,4,0.382207,253,3800586,-1,144.0,5989175,5995811,2193216,6636,68,8,True,True,34.558572,-0.37302019507306344
4776,3796892,6712,4,0.960606,253,3800586,-1,80.0,3848736,3855448,51844,6712,238,6,True,True,15.619518222222222,-0.9565910516804369
4777,3797073,6565,5,0.612448,253,3800586,-1,150.0,3966348,3972913,169275,6565,225,6,True,True,25.278600416666663,-0.5790911537435118
4778,3797479,5880,31,0.625525,253,3800586,-1,682.0,5351950,5357830,1554471,5880,118,7,True,True,150.37283494444443,-0.617881242993821
4779,3797575,40203,16,0.227428,253,3800586,-1,256.0,5991875,6032078,2194300,40203,68,6,True,True,484.9374378666667,-0.2220902286022649
4780,3798522,3,3,0.240361,253,3800586,-1,93.0,7141567,7141570,3343045,3,27,12,True,True,0.0075857,-0.240361
4781,3798552,43,1,0.152749,253,3800586,-1,42.0,5990975,5991018,2192423,43,70,7,True,True,0.0662501,-0.152749
4782,3799182,12567,128,0.970537,253,3800586,-1,6272.0,4143899,4156466,344717,12567,197,2,True,True,4600.043934577779,-0.93916787069976
4783,3799324,9878,1,0.909735,253,3800586,-1,49.0,4268409,4278287,469085,9878,186,2,True,True,14.446761058333333,-0.8857054830801989
4784,3799843,8419,64,0.329285,253,3800586,-1,1600.0,6108875,6117294,2309032,8419,56,6,True,True,570.1356444444444,-0.3196842006653626
3774,2907987,14250,1,0.700882,1,2907987,-1,40.0,2994387,3008637,86400,14250,0,12,True,True,10.092642999999999,-0.6766960383856557
3775,2908151,9396,2,0.072589,43,2994387,-1,88.0,12017533,12026929,9109382,9396,0,11,True,True,16.711319288888888,-0.07062905060442978
3776,2911601,7,16,0.928048,43,2994387,-1,112.0,3472056,3472063,560455,7,1,1,True,True,0.0287532,-0.928048
3777,2911671,19274,1,0.106136,43,2994387,-1,29.0,6775761,6795035,3864090,19274,1,12,True,True,5.190699286111111,-0.1057300528212469
3778,2911700,18,20,0.786892,43,2994387,-1,940.0,3923792,3923810,1012092,18,2,8,True,True,0.376141,-0.786892
3779,2911760,8450,1,0.301351,43,2994387,-1,28.0,3616173,3624623,704413,8450,3,11,True,True,8.272485355555556,-0.29536833779548144
3780,2914905,17422,33,0.086505,43,2994387,-1,264.0,12366770,12384192,9451865,17422,0,8,True,True,151.3426288,-0.08615803383612618
3781,2915106,14,1,0.765274,43,2994387,-1,11.0,7316261,7316275,4401155,14,2,10,True,True,0.001706833333333333,-0.765274
3782,2915277,18716,128,0.437676,43,2994387,-1,3328.0,5135983,5154699,2220706,18716,4,11,True,True,1498.0370126222222,-0.42206647413483295
3783,2915536,5,8,0.395113,43,2994387,-1,168.0,5246483,5246488,2330947,5,4,11,True,True,0.05066833333333334,-0.395113
3784,2916128,12127,2,0.660723,43,2994387,-1,50.0,5432083,5444210,2515955,12127,4,7,True,True,21.346349722222225,-0.6500405947449113
3785,2916370,2,16,0.473988,43,2994387,-1,80.0,8066628,8066630,5150258,2,2,1,True,True,0.0014462222222222222,-0.473988
3786,2916683,5,1,0.533468,43,2994387,-1,15.0,6080961,6080966,3164278,5,5,12,True,True,0.0008770833333333333,-0.533468
3787,2921047,3,1,0.136381,43,2994387,-1,34.0,10533233,10533236,7612186,3,2,12,True,True,0.0022587333333333338,-0.13638100000000003
3788,2921059,7959,32,0.390993,43,2994387,-1,768.0,9401033,9408992,6479974,7959,3,12,True,True,149.76094933333331,-0.3779831345083001
3789,2921234,330,8,0.797485,43,2994387,-1,144.0,3472956,3473286,551722,330,13,6,True,True,1.7427959999999998,-0.797485
3790,2921365,13007,16,0.545724,43,2994387,-1,208.0,10182233,10195240,7260868,13007,3,12,True,True,63.90012662222221,-0.5133411202553795
3791,2921446,78,16,0.960134,43,2994387,-1,192.0,3461256,3461334,539810,78,16,6,True,True,0.4965376000000001,-0.9601339999999999
3792,2922343,10,16,0.144076,43,2994387,-1,512.0,10970633,10970643,8048290,10,2,12,True,True,0.12955022222222223,-0.144076
3793,2922366,529,2,0.677289,43,2994387,-1,10.0,7686001,7686530,4763635,529,7,12,True,True,0.10528569444444445,-0.677289
3794,2928592,5647,2,0.914169,43,2994387,-1,22.0,3697142,3702789,768550,5647,15,6,True,True,2.0648092055555556,-0.9024502406291575
3795,2944405,473,1,0.795017,43,2994387,-1,35.0,5722383,5722856,2777978,473,11,10,True,True,0.3309620416666667,-0.795017
3796,2961339,17,8,0.729325,43,2994387,-1,200.0,3234387,3234404,273048,17,21,12,True,True,0.12723555555555555,-0.729325
3797,2961560,20,32,0.373131,43,2994387,-1,1216.0,8524433,8524453,5562873,20,6,12,True,True,0.6839999999999999,-0.373131
3798,2961635,16139,4,0.949465,43,2994387,-1,20.0,5069683,5085822,2108048,16139,16,7,True,True,11.474659555555554,-0.934952851867647
3799,2962058,6,2,0.553524,43,2994387,-1,64.0,3080787,3080793,118729,6,24,12,True,True,0.018838400000000005,-0.553524
3800,2962145,51,11,0.55507,43,2994387,-1,77.0,3147087,3147138,184942,51,24,11,True,True,0.17158808333333334,-0.5550699999999998
3801,2962163,751,16,0.123235,43,2994387,-1,416.0,9750233,9750984,6788070,751,5,8,True,True,7.132630844444444,-0.123235
3802,2963700,1749,1,0.00503,43,2994387,-1,11.0,10360433,10362182,7396733,1749,4,12,True,True,0.5045593972222222,-0.004932979589221115
3803,2964106,1,8,0.596655,43,2994387,-1,176.0,3102887,3102888,138781,1,27,10,True,True,0.007166622222222222,-0.596655
3804,2964339,17,3,0.537152,43,2994387,-1,69.0,3480156,3480173,515817,17,22,9,True,True,0.028419183333333334,-0.537152
3805,2964729,13132,56,0.946979,43,2994387,-1,448.0,3330703,3343835,365974,13132,26,10,True,True,119.64501795555557,-0.9176115754077483
3806,2964774,9175,20,0.304691,43,2994387,-1,740.0,5968861,5978036,3004087,9175,14,1,True,True,104.6218331111111,-0.3040816550415203
3807,2964873,338,32,0.748297,43,2994387,-1,544.0,4043883,4044221,1079010,338,20,1,True,True,1.4898739555555556,-0.748297
3808,2965028,10775,16,0.903546,43,2994387,-1,96.0,3862492,3873267,897464,10775,22,10,True,True,40.80777946666666,-0.818456511107929
3809,2966203,5734,7,0.343852,43,2994387,-1,294.0,8792633,8798367,5826430,5734,8,6,True,True,49.50649993333333,-0.34160708212190716
3810,2966671,7,4,0.412654,43,2994387,-1,52.0,3908492,3908499,941821,7,23,7,True,True,0.009932144444444443,-0.412654
3811,2969763,1412,32,0.645932,43,2994387,-1,256.0,3967492,3968904,997729,1412,22,9,True,True,5.8538382222222225,-0.645932
3812,2970284,1812,19,0.512553,43,2994387,-1,190.0,3458556,3460368,488272,1812,32,11,True,True,16.122538666666667,-0.42192276754966895
3813,2970596,7173,2,0.160954,43,2994387,-1,30.0,3971992,3979165,1001396,7173,22,6,True,True,3.409110916666667,-0.14986948823692625
3814,2971170,3,32,0.220788,43,2994387,-1,1088.0,10707833,10707836,7736663,3,3,12,True,True,0.1281482666666667,-0.220788
3815,2971241,3,1,0.834748,43,2994387,-1,37.0,3254187,3254190,282946,3,36,3,True,True,0.0015897666666666668,-0.834748
3816,2971336,7275,2,0.194326,43,2994387,-1,54.0,8414133,8421408,5442797,7275,11,12,True,True,9.40005405,-0.19089703776808226
3817,2972083,34,46,0.181358,43,2994387,-1,1978.0,12190370,12190404,9218287,34,1,1,True,True,1.5245654777777777,-0.181358
3818,3033384,13,4,0.79966,86,3080787,-1,24.0,5994561,5994574,2961177,13,18,10,True,True,0.003685066666666667,-0.79966
3819,3036042,28,16,0.852251,86,3080787,-1,432.0,3239787,3239815,203745,28,40,1,True,True,0.4596143999999999,-0.852251
3820,3036207,8369,2,0.851388,86,3080787,-1,82.0,3686073,3694442,649866,8369,32,8,True,True,8.17998471111111,-0.7259729765535302
3821,3038912,116,8,0.93237,86,3080787,-1,392.0,3307703,3307819,268791,116,40,9,True,True,0.5691578666666668,-0.93237
3822,3038993,36,4,0.994313,86,3080787,-1,192.0,3838592,3838628,799599,36,31,7,True,True,0.0407808,-0.994313
3823,3040549,21,16,0.461265,86,3080787,-1,336.0,4251583,4251604,1211034,21,25,7,True,True,0.2558994666666667,-0.4323273345297917
3824,3041375,20,8,0.549665,86,3080787,-1,368.0,3910292,3910312,868917,20,30,0,True,True,0.20025333333333337,-0.549665
3825,3041510,8394,32,0.290653,86,3080787,-1,576.0,10711433,10719827,7669923,8394,4,8,True,True,288.81178239999997,-0.2784560459945744
3826,3042985,748,1,0.067363,86,3080787,-1,29.0,10621433,10622181,7578448,748,6,7,True,True,0.9295624555555556,-0.067363
3827,3044963,18059,128,0.098202,86,3080787,-1,4096.0,12931170,12949229,9886207,18059,0,12,True,True,3251.8692636444453,-0.09246496631259582
3828,3045113,16,128,0.725589,86,3080787,-1,3968.0,3918392,3918408,873279,16,33,6,True,True,1.3240775111111112,-0.725589
3829,3045224,60,4,0.48719,86,3080787,-1,44.0,7491101,7491161,4445877,60,18,1,True,True,0.09049333333333333,-0.48719
3830,3045578,8846,9,0.330851,86,3080787,-1,99.0,9141833,9150679,6096255,8846,13,12,True,True,12.543114375000002,-0.31728552152754963
3831,3045763,297,1,0.128215,86,3080787,-1,43.0,11057033,11057330,8011270,297,4,12,True,True,0.3463779,-0.128215
3832,3046090,5,1,0.655473,86,3080787,-1,20.0,4249783,4249788,1203693,5,32,7,True,True,0.003869444444444445,-0.655473
3833,3046231,21291,1,0.100045,86,3080787,-1,32.0,12932970,12954261,9886739,21291,0,7,True,True,31.771442933333333,-0.09579339747420004
3834,3046353,13320,1,0.619516,86,3080787,-1,20.0,3147987,3161307,101634,13320,56,6,True,True,11.092663333333334,-0.6137081043517504
3835,3046421,243,16,0.900119,86,3080787,-1,368.0,3694442,3694685,648021,243,44,2,True,True,1.506546,-0.9001189999999999
3836,3046471,28,8,0.317786,86,3080787,-1,264.0,4225883,4225911,1179412,28,34,8,True,True,0.36311146666666666,-0.317786
3837,3046776,105,2,0.450646,86,3080787,-1,12.0,8068428,8068533,5021652,105,19,7,True,True,0.013132000000000001,-0.450646
3838,3051388,6907,40,0.616342,86,3080787,-1,480.0,4828783,4835690,1777395,6907,33,11,True,True,140.650724,-0.6101927464638306
3839,3076161,6213,28,0.305675,86,3080787,-1,280.0,5808783,5814996,2732622,6213,28,12,True,True,13.66586666666667,-0.251384907840281
3840,3076310,9327,256,0.58417,86,3080787,-1,9984.0,7772401,7781728,4696091,9327,21,12,True,True,2298.608721066667,-0.584164622297023
3841,3076349,116,1,0.565552,86,3080787,-1,29.0,3958492,3958608,882143,116,42,6,True,True,0.050160977777777775,-0.565552
3842,3076398,1137,16,0.364493,86,3080787,-1,784.0,10446833,10447970,7370435,1137,11,12,True,True,34.195791155555554,-0.34296557285569185
3843,3076422,11420,11,0.316333,86,3080787,-1,99.0,9836633,9848053,6760211,11420,14,12,True,True,25.335512675,-0.3090217217621017
3844,3078387,151,1,0.428307,86,3080787,-1,20.0,6341961,6342112,3263574,151,28,12,True,True,0.10013816666666667,-0.428307
3845,3078425,648,2,0.004832,86,3080787,-1,76.0,12758370,12759018,9679945,648,2,12,True,True,2.0557809999999996,-0.004813626192317608
3846,3078695,7,16,0.246175,86,3080787,-1,224.0,7404661,7404668,4325966,7,27,11,True,True,0.0463344,-0.246175
3847,3078713,5,32,0.221526,86,3080787,-1,1536.0,5830883,5830888,2752170,5,34,10,True,True,0.05789866666666667,-0.221526
3848,3078777,9,1,0.739816,86,3080787,-1,24.0,3748592,3748601,669815,9,55,11,True,True,0.001305,-0.739816
3849,3078809,68,32,0.436124,86,3080787,-1,640.0,4518183,4518251,1439374,68,42,7,True,True,1.8211911111111112,-0.436124
3850,3078843,30,1,0.84011,86,3080787,-1,6.0,4337983,4338013,1259140,30,43,12,True,True,0.010534433333333334,-0.7603163906930126
3851,3078987,14413,2,0.134306,86,3080787,-1,68.0,12585570,12599983,9506583,14413,3,7,True,True,26.83274711111111,-0.13428054585750682
3852,3079000,49,1,0.732973,86,3080787,-1,13.0,3975592,3975641,896592,49,49,0,True,True,0.010103527777777776,-0.732973
3853,3079028,18,2,0.877886,86,3080787,-1,36.0,3696242,3696260,617214,18,61,7,True,True,0.010917,-0.877886
3854,3079202,45,8,0.462848,86,3080787,-1,384.0,5606683,5606728,2527481,45,38,6,True,True,0.4499040000000001,-0.462848
3855,3079221,11740,130,0.358742,86,3080787,-1,1040.0,12583770,12595510,9504549,11740,4,12,True,True,322.9879177777778,-0.3545173199263823
3856,3079456,9793,128,0.305472,86,3080787,-1,1280.0,11233433,11243226,8153977,9793,8,12,True,True,256.3732586666667,-0.2972083443249695
3857,3079657,6,2,0.551672,86,3080787,-1,96.0,4021592,4021598,941935,6,52,11,True,True,0.005737600000000001,-0.551672
3858,3079762,52,32,0.17577,86,3080787,-1,416.0,4247983,4248035,1168221,52,50,10,True,True,0.8689604444444445,-0.1634107304725169
3859,3079785,16,1,0.606628,86,3080787,-1,39.0,3308603,3308619,228818,16,76,6,True,True,0.0064098666666666665,-0.606628
3860,3079804,24,32,0.841793,86,3080787,-1,1120.0,3412556,3412580,332752,24,75,8,True,True,0.32450133333333336,-0.841793
3861,3079891,14948,1,0.858714,86,3080787,-1,31.0,3236187,3251135,156296,14948,81,7,True,True,12.633705211111112,-0.7306096086809939
3862,3084371,19121,4,0.140002,89,3102887,-1,168.0,11973333,11992454,8888962,19121,8,8,True,True,92.97528940000001,-0.13087353679445293
3863,3084438,7516,16,0.538618,89,3102887,-1,688.0,3246987,3254503,162549,7516,81,8,True,True,81.51485728888889,-0.33811913272643507
3864,3085236,6,1,0.263235,89,3102887,-1,14.0,10797833,10797839,7712597,6,12,12,True,True,0.0026590666666666666,-0.263235
3865,3085260,127,1,0.886336,89,3102887,-1,15.0,5920883,5921010,2835623,127,39,8,True,True,0.015150041666666664,-0.8863360000000002
3866,3115127,186,2,0.076462,145,3147087,-1,38.0,10095833,10096019,6980706,186,20,12,True,True,0.1530222,-0.07646200000000002
3867,3116699,37,1,0.0754,145,3147087,-1,40.0,12190333,12190370,9073634,37,7,12,True,True,0.03355077777777778,-0.0754
3868,3117087,32,1,0.01863,145,3147087,-1,43.0,6169161,6169193,3052074,32,38,7,True,True,0.01426453333333333,-0.01863
3869,3117246,44,1,0.507178,145,3147087,-1,50.0,6602061,6602105,3484815,44,37,12,True,True,0.01730055555555556,-0.507178
3870,3117543,16767,8,0.031194,145,3147087,-1,160.0,12844770,12861537,9727227,16767,2,12,True,True,138.701376,-0.030124208950749604
3871,3117657,16541,16,0.58189,145,3147087,-1,608.0,3750392,3766933,632735,16541,72,7,True,True,62.46074017777777,-0.5796121633581054
3872,3117832,9,4,0.405134,145,3147087,-1,192.0,10009433,10009442,6891601,9,23,12,True,True,0.0477984,-0.405134
3873,3117984,70,2,0.590036,145,3147087,-1,44.0,3971092,3971162,853108,70,65,8,True,True,0.05592766666666667,-0.590036
3874,3119439,12175,8,0.906304,145,3147087,-1,80.0,3660373,3672548,540934,12175,80,11,True,True,10.35315488888889,-0.8743472127451337
3875,3119671,13017,256,0.551594,145,3147087,-1,6912.0,6862161,6875178,3742490,13017,38,12,True,True,882.8643456,-0.5358833842262463
3876,3121027,22596,101,0.543469,145,3147087,-1,4040.0,7781728,7804324,4660701,22596,33,8,True,True,1562.096748888889,-0.5134969562955138
3877,3121239,24557,16,0.998728,145,3147087,-1,336.0,3698042,3722599,576803,24557,78,6,True,True,115.62901839999999,-0.9786836041744903
3878,3121554,144,1,0.472104,145,3147087,-1,19.0,4521783,4521927,1400229,144,57,8,True,True,0.0755668,-0.472104
3879,3124725,9503,1,0.775197,145,3147087,-1,46.0,4981483,4990986,1856758,9503,56,11,True,True,6.151679283333334,-0.6420004904300775
3880,3124877,70,16,0.365819,145,3147087,-1,464.0,9573833,9573903,6448956,70,26,12,True,True,0.8861626666666668,-0.365819
3881,3125037,15,1,0.223307,145,3147087,-1,25.0,7803828,7803843,4678791,15,34,10,True,True,0.004780208333333333,-0.223307
3882,3125139,15384,4,0.772145,145,3147087,-1,140.0,3929192,3944576,804053,15384,74,7,True,True,50.09868266666667,-0.7477767479306329
3883,3125742,295,4,0.733227,145,3147087,-1,104.0,3243387,3243682,117645,295,101,2,True,True,0.959552822222222,-0.6382459216769636
3884,3125821,5,32,0.290999,145,3147087,-1,512.0,9314633,9314638,6188812,5,28,12,True,True,0.10097066666666668,-0.290999
3885,3126121,9,1,0.464701,145,3147087,-1,38.0,3483773,3483782,357652,9,91,8,True,True,0.00677065,-0.464701
3886,3127312,16009,4,0.510412,145,3147087,-1,120.0,3839492,3855501,712180,16009,81,6,True,True,47.298174,-0.5053328561592171
3887,3127546,188,2,0.396785,145,3147087,-1,34.0,5700283,5700471,2572737,188,54,12,True,True,0.15402944444444447,-0.396785
3888,3128217,30,4,0.502167,145,3147087,-1,28.0,3704392,3704422,576175,30,86,7,True,True,0.01339348888888889,-0.49247771361694864
3889,3128359,23189,256,0.662678,145,3147087,-1,6656.0,5091783,5114972,1963424,23189,59,10,True,True,4711.62016,-0.6555640500977159
3890,3128551,4,32,0.847982,145,3147087,-1,576.0,7034961,7034965,3906410,4,42,12,True,True,0.018009599999999997,-0.847982
3891,3128842,15010,1,0.80654,145,3147087,-1,32.0,4427983,4442993,1299141,15010,66,8,True,True,7.711499733333334,-0.576757222216837
3892,3129140,11442,1,0.614036,145,3147087,-1,47.0,5612083,5623525,2482943,11442,56,2,True,True,13.170562205555555,-0.5432063199963871
3893,3129548,51,3,0.165844,145,3147087,-1,27.0,5430283,5430334,2300735,51,59,9,True,True,0.03413429999999999,-0.165844
3894,3130495,1041,8,0.514137,145,3147087,-1,88.0,5917283,5918324,2786788,1041,52,12,True,True,0.9048834666666667,-0.514137
3895,3130726,102,2,0.44622,145,3147087,-1,16.0,3701692,3701794,570966,102,93,1,True,True,0.0265336,-0.44622
3896,3133786,7064,16,0.179145,145,3147087,-1,240.0,12671970,12679034,9538184,7064,4,0,True,True,133.20216133333332,-0.17897397782164323
3897,3138149,8107,8,0.948712,145,3147087,-1,136.0,3682473,3690580,544324,8107,100,10,True,True,12.331265066666667,-0.8611182095406592
3898,3138585,45,4,0.659413,145,3147087,-1,156.0,7513201,7513246,4374616,45,40,10,True,True,0.115206,-0.659413
3899,3141174,50,1,0.967736,145,3147087,-1,38.0,3701642,3701692,560468,50,96,2,True,True,0.030890833333333333,-0.967736
3900,3141629,7049,1,0.73592,145,3147087,-1,43.0,3414356,3421405,272727,7049,111,6,True,True,4.730434180555555,-0.6054557809337118
3901,3141729,9477,2,0.483503,145,3147087,-1,10.0,3930992,3940469,789263,9477,84,7,True,True,2.2268244166666666,-0.4526440757663009
3902,3141837,630,1,0.358796,145,3147087,-1,46.0,8796233,8796863,5654396,630,31,1,True,True,0.8425935,-0.35879600000000006
3903,3141844,9584,128,0.218819,145,3147087,-1,3968.0,9228233,9237817,6086389,9584,30,12,True,True,886.1588465777778,-0.20245136126575583
3904,3141861,17134,3,0.487642,145,3147087,-1,93.0,5605783,5622917,2463922,17134,63,6,True,True,40.29643060833333,-0.4772837528317866
3905,3141872,22292,32,0.062861,145,3147087,-1,1088.0,11969733,11992025,8827861,22292,12,12,True,True,638.8420117333334,-0.056767665014090106
3906,3142446,49,71,0.369435,145,3147087,-1,781.0,11319833,11319882,8177387,49,13,12,True,True,1.0526101055555555,-0.369435
3907,3142634,5,1,0.042808,145,3147087,-1,26.0,12276770,12276775,9134136,5,8,12,True,True,0.004091388888888888,-0.042808
3908,3142888,15142,1,0.206774,145,3147087,-1,46.0,9746633,9761775,6603745,15142,30,12,True,True,16.508042105555553,-0.20448916743799286
3909,3143000,19,21,0.907726,145,3147087,-1,231.0,4782783,4782802,1639783,19,76,12,True,True,0.044316708333333336,-0.907726
3910,3143277,10,1,0.361251,145,3147087,-1,28.0,4609983,4609993,1466706,10,77,7,True,True,0.0034797777777777783,-0.361251
3911,3143287,19,2,0.469674,145,3147087,-1,80.0,3702592,3702611,559305,19,105,6,True,True,0.02471266666666667,-0.469674
3912,3143655,266,16,0.454643,145,3147087,-1,128.0,10185833,10186099,7042178,266,25,8,True,True,0.7576625777777778,-0.454643
3913,3143818,18,119,0.046437,145,3147087,-1,2618.0,9055433,9055451,5911615,18,37,12,True,True,0.9549155,-0.046437
3914,3145238,13,8,0.98059,145,3147087,-1,168.0,3413456,3413469,268218,13,125,6,True,True,0.02008066666666667,-0.98059
3915,3145257,67,1,0.324071,145,3147087,-1,41.0,3460356,3460423,315099,67,123,7,True,True,0.09107831111111112,-0.324071
3916,3145276,11371,64,0.703736,145,3147087,-1,1280.0,3353956,3365327,208680,11371,128,7,True,True,604.7236551111112,-0.6992398055576714
3917,3145286,124,6,0.521373,145,3147087,-1,138.0,4178083,4178207,1032797,124,88,8,True,True,0.16104293333333336,-0.521373
3918,3145601,23651,128,0.829647,145,3147087,-1,1152.0,4200183,4223834,1054582,23651,88,10,True,True,961.3116319999999,-0.7657968430240812
3919,3145641,4022,1,0.834872,145,3147087,-1,19.0,4222283,4226305,1076642,4022,88,10,True,True,3.6348818194444448,-0.8298821475768035
3920,3145833,13,32,0.263316,145,3147087,-1,1248.0,8327733,8327746,5181900,13,42,12,True,True,0.3497173333333333,-0.263316
3921,3145957,16943,4,0.54435,145,3147087,-1,28.0,7890228,7907171,4744271,16943,45,12,True,True,5.9537279666666665,-0.48591366796717117
3922,3145988,5980,1,0.17385,145,3147087,-1,49.0,8610833,8616813,5464845,5980,40,12,True,True,7.2637026972222225,-0.16397939579573798
3923,3154183,25685,64,0.653675,238,3234387,-1,960.0,3357556,3383241,203373,25685,134,2,True,True,937.3757386666665,-0.6221278411903598
3924,3154227,15680,1,0.365297,238,3234387,-1,43.0,8784533,8800213,5630306,15680,40,12,True,True,18.85747238611111,-0.3580230682595139
3925,3154964,3,64,0.653337,238,3234387,-1,384.0,3693273,3693276,538309,3,121,2,True,True,0.0137952,-0.6533370000000001
3926,3154982,17819,1,0.835469,238,3234387,-1,16.0,4088083,4105902,933101,17819,95,11,True,True,1.5319897333333332,-0.7972120697611205
3927,3155084,46368,4,0.516663,238,3234387,-1,128.0,10274033,10320401,7118949,46368,25,7,True,True,132.14408142222223,-0.514543193552094
3928,3155158,50,2,0.376329,238,3234387,-1,22.0,8241333,8241383,5086175,50,46,12,True,True,0.029348611111111103,-0.376329
3929,3155276,17218,16,0.907242,238,3234387,-1,160.0,5180183,5197401,2024907,17218,79,11,True,True,61.28782844444444,-0.8406645444267097
3930,3155303,8295,1,0.516372,238,3234387,-1,45.0,9487433,9495728,6332130,8295,34,12,True,True,7.0829825,-0.49538744139603497
3931,3155323,13,6,0.352898,238,3234387,-1,246.0,12497370,12497383,9342047,13,7,11,True,True,0.12163059999999999,-0.352898
3932,3155807,14557,16,0.867719,238,3234387,-1,240.0,3920192,3934749,764385,14557,111,7,True,True,86.62115133333333,-0.867351657123538
3933,3155869,18,4,0.486862,238,3234387,-1,184.0,3910292,3910310,754423,18,114,7,True,True,0.090114,-0.486862
3934,3155965,191,8,0.48211,238,3234387,-1,104.0,4043692,4043883,887727,191,102,10,True,True,0.16095357777777777,-0.48211
3935,3156106,9,1,0.604211,238,3234387,-1,18.0,5423083,5423092,2266977,9,80,7,True,True,0.00456705,-0.604211
3936,3156253,9884,23,0.501837,238,3234387,-1,667.0,3689673,3699557,533420,9884,132,2,True,True,97.99402808333333,-0.48084684344284145
3937,3156525,23,32,0.138968,238,3234387,-1,640.0,12363170,12363193,9206645,23,9,12,True,True,0.6076906666666667,-0.138968
3938,3156593,11878,64,0.165606,238,3234387,-1,1792.0,11143433,11155311,7986840,11878,18,12,True,True,742.5600448,-0.16288598492726777
3939,3156607,13568,16,0.077088,238,3234387,-1,352.0,5965261,5978829,2808654,13568,71,1,True,True,78.70720879999999,-0.07694508438648545
3940,3156819,25737,128,0.643477,238,3234387,-1,5120.0,4174483,4200220,1017664,25737,104,12,True,True,2399.5746560000002,-0.6077671547538452
3941,3156879,8983,2,0.211517,238,3234387,-1,42.0,5613883,5622866,2457004,8983,78,7,True,True,8.963104383333334,-0.19101250718263413
3942,3156951,13,8,0.186906,238,3234387,-1,176.0,11579033,11579046,8422082,13,16,12,True,True,0.10444084444444443,-0.186906
3943,3158636,83,3,0.362223,238,3234387,-1,51.0,8438033,8438116,5279397,83,49,10,True,True,0.10404949166666665,-0.362223
3944,3171252,8,7,0.717303,238,3234387,-1,140.0,5334883,5334891,2163631,8,87,11,True,True,0.04323511111111111,-0.717303
3945,3172221,502,64,0.11833,238,3234387,-1,3008.0,11147033,11147535,7974812,502,19,1,True,True,54.029211377777784,-0.11833
3946,3172267,19,1,0.230346,238,3234387,-1,15.0,10272233,10272252,7099966,19,31,12,True,True,0.004582958333333333,-0.230346
3947,3172413,40,8,0.811173,238,3234387,-1,40.0,7491061,7491101,4318648,40,64,12,True,True,0.05484444444444445,-0.811173
3948,3172710,24,128,0.720256,238,3234387,-1,5376.0,4850883,4850907,1678173,24,97,10,True,True,4.595046400000001,-0.720256
3949,3172807,24672,16,0.481517,238,3234387,-1,128.0,4937283,4961955,1764476,24672,97,12,True,True,59.17675200000001,-0.459959909945484
3950,3173805,31,1,0.478815,238,3234387,-1,30.0,3917492,3917523,743687,31,128,9,True,True,0.019395666666666665,-0.478815
3951,3174689,1629,2,0.210704,238,3234387,-1,14.0,7976628,7978257,4801939,1629,57,12,True,True,0.36270009999999997,-0.17209007285882047
3952,3174838,26,4,0.161246,238,3234387,-1,156.0,8791733,8791759,5616895,26,48,9,True,True,0.12106033333333334,-0.161246
3953,3175208,2575,4,0.833365,238,3234387,-1,168.0,3927392,3929967,752184,2575,127,2,True,True,11.780867466666667,-0.8299595140242146
3954,3175685,734,1,0.022446,238,3234387,-1,44.0,8698133,8698867,5522448,734,50,12,True,True,0.8100016222222222,-0.022446
3955,3175739,8,9,0.043144,238,3234387,-1,108.0,12936570,12936578,9760831,8,0,8,True,True,0.0365712,-0.043144
3956,3213193,40,32,0.573487,238,3234387,-1,1344.0,3300503,3300543,87310,40,171,11,True,True,0.8001280000000001,-0.5734869999999999
3957,3213292,7,32,0.161129,238,3234387,-1,480.0,3401756,3401763,188464,7,166,11,True,True,0.042643999999999994,-0.161129
3958,3213707,12027,8,0.62954,238,3234387,-1,320.0,3953992,3966019,740285,12027,127,6,True,True,57.85571377777778,-0.6177438323624083
3959,3214079,7848,16,0.039191,238,3234387,-1,288.0,12453170,12461018,9239091,7848,9,12,True,True,72.9080368,-0.038556092926624805
3960,3214664,8,4,0.572269,238,3234387,-1,116.0,4516383,4516391,1301719,8,109,11,True,True,0.035630044444444446,-0.572269
3961,3215048,5,1,0.055912,238,3234387,-1,19.0,6515661,6515666,3300613,5,76,12,True,True,0.0014872777777777777,-0.055912
3962,3215258,6398,32,0.25826,238,3234387,-1,960.0,8068533,8074931,4853275,6398,59,1,True,True,64.71101866666666,-0.24287712824389043
3963,3215295,3413,2,0.180038,238,3234387,-1,96.0,5421283,5424696,2205988,3413,97,12,True,True,9.079711199999998,-0.1769733784901481
3964,3215375,4547,22,0.958238,238,3234387,-1,176.0,3352156,3356703,136781,4547,175,7,True,True,32.10940724444444,-0.9581156358414358
3965,3215389,12527,8,0.599358,238,3234387,-1,240.0,6602961,6615488,3387572,12527,76,6,True,True,24.000656666666664,-0.5856764518264043
3966,3215507,23,8,0.563605,238,3234387,-1,112.0,3480173,3480196,264666,23,164,1,True,True,0.062410755555555565,-0.563605
3967,3216620,813,1,0.01862,238,3234387,-1,47.0,11751833,11752646,8535213,813,18,12,True,True,1.4145499916666666,-0.01862
3968,3216752,5278,1,0.719547,238,3234387,-1,11.0,3840392,3845670,623640,5278,146,6,True,True,0.5578782,-0.5024080738735238
3969,3216902,6,8,0.661745,238,3234387,-1,216.0,3953092,3953098,736190,6,135,10,True,True,0.021722400000000003,-0.661745
3970,3216985,24,32,0.283455,238,3234387,-1,352.0,8611733,8611757,5394748,24,54,6,True,True,0.21319466666666664,-0.283455
3971,3217098,6,1,0.085749,238,3234387,-1,24.0,10884233,10884239,7667135,6,26,12,True,True,0.0024584000000000003,-0.08574900000000002
3972,3218348,9722,16,0.449203,238,3234387,-1,496.0,7121361,7131083,3903013,9722,76,12,True,True,66.01608582222222,-0.44817975621970596
3973,3218367,3,5,0.992776,238,3234387,-1,175.0,3254503,3254506,36136,3,188,2,True,True,0.016689166666666668,-0.992776
3974,3218489,203,4,0.867302,238,3234387,-1,176.0,3256303,3256506,37814,203,188,7,True,True,1.135753422222222,-0.867302
3975,3218788,14762,64,0.170567,238,3234387,-1,1920.0,11665433,11680195,8446645,14762,19,12,True,True,818.6076639999999,-0.1638082057067016
3976,3218960,20,4,0.830364,238,3234387,-1,184.0,3570173,3570193,351213,20,170,12,True,True,0.04229955555555556,-0.830364
3977,3219242,5551,4,0.600839,238,3234387,-1,116.0,3977392,3982943,758150,5551,133,7,True,True,7.303159255555556,-0.48154164716507
3978,3223294,128,6,0.794616,238,3234387,-1,246.0,4472183,4472311,1248889,128,119,11,True,True,2.1053226666666665,-0.794616
3979,3225540,754,2,0.820453,238,3234387,-1,26.0,4696383,4697137,1470843,754,115,12,True,True,0.18536671111111108,-0.820453
3980,3226332,13412,1,0.181884,238,3234387,-1,37.0,3334303,3347715,107971,13412,189,8,True,True,12.415868822222222,-0.17996828003683346
3981,3226397,15893,32,0.659649,238,3234387,-1,1536.0,7599601,7615494,4373204,15893,72,12,True,True,618.60416,-0.6146177094847443
3982,3226436,332,2,0.264521,238,3234387,-1,18.0,11838233,11838565,8611797,332,18,12,True,True,0.24599539999999998,-0.264521
3983,3226743,4441,256,0.724187,238,3234387,-1,6400.0,3347715,3352156,120972,4441,191,7,True,True,1116.5940977777777,-0.7098447571758906
3984,3226844,722,25,0.342671,238,3234387,-1,1100.0,7207761,7208483,3980917,722,79,12,True,True,9.949561111111112,-0.342671
3985,3226926,8998,128,0.45347,238,3234387,-1,2048.0,5290683,5299681,2063757,8998,108,11,True,True,364.1740856888889,-0.36632987783691756
3986,3227019,1061,1,0.590596,238,3234387,-1,10.0,6342861,6343922,3115842,1061,87,6,True,True,0.35764608333333336,-0.586105317253984
3987,3227040,6,1,0.229814,238,3234387,-1,46.0,11406233,11406239,8179193,6,22,12,True,True,0.0082777,-0.229814
3988,3227155,17147,13,0.385462,238,3234387,-1,299.0,8791733,8808880,5564578,17147,55,0,True,True,147.77546351388887,-0.3842357532321477
3989,3227187,12,1,0.10857,238,3234387,-1,31.0,12103933,12103945,8876746,12,15,12,True,True,0.009525266666666669,-0.10857
3990,3227201,2,8,0.202349,238,3234387,-1,232.0,9923033,9923035,6695832,2,44,12,True,True,0.01392902222222222,-0.202349
3991,3227619,4377,16,0.859592,238,3234387,-1,448.0,7294161,7298538,4066542,4377,83,12,True,True,23.58644586666667,-0.854810025216818
3992,3227639,42,4,0.50436,238,3234387,-1,128.0,3975592,3975634,747953,42,147,8,True,True,0.08526933333333335,-0.50436
3993,3227955,27,8,0.419795,238,3234387,-1,184.0,8154933,8154960,4926978,27,68,12,True,True,0.142692,-0.419795
3994,3228020,9,1,0.149561,238,3234387,-1,41.0,11883333,11883342,8655313,9,19,6,True,True,0.010092150000000001,-0.149561
3995,3228272,12686,117,0.096299,238,3234387,-1,4329.0,13022970,13035656,9794698,12686,0,12,True,True,2403.4776349999997,-0.09410841816627463
3996,3228293,20,32,0.475869,238,3234387,-1,1280.0,3408956,3408976,180663,20,199,9,True,True,0.46912000000000004,-0.475869
3997,3228695,243,1,0.614748,238,3234387,-1,5.0,5067883,5068126,1839188,243,123,12,True,True,0.028188,-0.614748
3998,3230542,15,32,0.039037,238,3234387,-1,1280.0,3571973,3571988,341431,15,188,7,True,True,0.1832,-0.039037
3999,3230614,9,8,0.783868,238,3234387,-1,248.0,6167361,6167370,2936747,9,98,12,True,True,0.0231384,-0.783868
4000,3230652,178,18,0.503329,238,3234387,-1,126.0,5965083,5965261,2734431,178,103,11,True,True,0.50823675,-0.4740365107216331
4001,3230740,8,16,0.117516,238,3234387,-1,624.0,7360461,7360469,4129721,8,85,11,True,True,0.12602026666666666,-0.117516
4002,3230930,8191,8,0.482241,238,3234387,-1,56.0,8415933,8424124,5185003,8191,67,7,True,True,10.720371666666667,-0.45894257384054715
4003,3230950,15,4,0.130329,238,3234387,-1,120.0,9660233,9660248,6429283,15,50,12,True,True,0.04553,-0.130329
4004,3230965,13,16,0.603475,238,3234387,-1,496.0,5972461,5972474,2741496,13,104,2,True,True,0.09231386666666666,-0.603475
4005,3232271,10541,85,0.827522,238,3234387,-1,1275.0,3468456,3478997,236185,10541,201,9,True,True,494.5653670833333,-0.7665255841211746
4006,3233206,180,32,0.896969,238,3234387,-1,1376.0,5202283,5202463,1969077,180,125,10,True,True,4.877232,-0.896969
4007,3233353,17432,1,0.77487,238,3234387,-1,24.0,5608483,5625915,2375130,17432,116,7,True,True,10.116817733333335,-0.7181796871418362
4008,3233362,25,32,0.649232,238,3234387,-1,1408.0,5604883,5604908,2371521,25,119,12,True,True,0.8426488888888888,-0.6492320000000001
4009,3233466,312,1,0.522044,238,3234387,-1,29.0,3960292,3960604,726826,312,164,7,True,True,0.12898426666666668,-0.522044
4010,3233513,5867,64,0.370377,238,3234387,-1,2304.0,6255561,6261428,3022048,5867,100,12,True,True,121.88571519999999,-0.3675790811135466
4011,3233675,21233,1,0.043438,238,3234387,-1,48.0,6689361,6710594,3455686,21233,95,12,True,True,8.018746266666666,-0.041658491455901205
4012,3233900,15,16,0.529817,238,3234387,-1,144.0,6429261,6429276,3195361,15,99,12,True,True,0.07432799999999999,-0.529817
4013,3233915,129,11,0.229486,238,3234387,-1,484.0,4424383,4424512,1190468,129,148,12,True,True,2.352379822222222,-0.22271433872463534
4014,3234031,323,1,0.8023,238,3234387,-1,32.0,3957592,3957915,723561,323,170,1,True,True,0.15412124444444444,-0.8023
4015,3234059,24779,2,0.789556,238,3234387,-1,48.0,4784583,4809362,1550524,24779,140,7,True,True,16.284979733333333,-0.7855576600921915
4016,3234226,6230,8,0.381236,238,3234387,-1,344.0,8063028,8069258,4828802,6230,76,12,True,True,20.21428088888889,-0.36299110879224544
4017,3234243,12,4,0.589048,238,3234387,-1,140.0,8969033,8969045,5734790,12,58,12,True,True,0.06097933333333334,-0.589048
4018,3234606,47,1,0.741394,238,3236187,-1,20.0,3250587,3250634,15981,47,234,2,True,True,0.01555177777777778,-0.741394
4019,3237061,2,16,0.761539,248,3239787,-1,368.0,3836792,3836794,599731,2,190,12,True,True,0.004150222222222222,-0.761539
4020,3237080,18897,16,0.696708,248,3239787,-1,688.0,4608183,4627080,1371103,18897,146,12,True,True,144.60433306666667,-0.6800873923275328
4021,3237244,9,32,0.097717,248,3239787,-1,1440.0,12671970,12671979,9434726,9,7,12,True,True,0.869868,-0.097717
4022,3237380,132,16,0.133883,248,3239787,-1,496.0,11492633,11492765,8255253,132,26,12,True,True,2.1882197333333333,-0.133883
4023,3237475,10306,32,0.477141,248,3239787,-1,1568.0,6948561,6958867,3711086,10306,97,12,True,True,238.15524008888892,-0.3715835816343065
4024,3237506,11946,16,0.232513,248,3239787,-1,416.0,10619633,10631579,7382127,11946,39,12,True,True,219.26676488888887,-0.23199772808049324
4025,3237550,36,53,0.859053,248,3239787,-1,265.0,5518483,5518519,2280933,36,129,12,True,True,0.33246899999999996,-0.859053
4026,3237567,54,4,0.283267,248,3239787,-1,116.0,11882433,11882487,8644866,54,22,11,True,True,0.17132039999999998,-0.283267
4027,3237605,3,1,0.876766,248,3239787,-1,16.0,3906692,3906695,669087,3,193,11,True,True,0.0013097333333333336,-0.876766
4028,3237639,57,1,0.408647,248,3239787,-1,40.0,5917283,5917340,2679644,57,119,0,True,True,0.022521333333333338,-0.408647
4029,3237648,9,8,0.189021,248,3239787,-1,80.0,8882633,8882642,5644985,9,63,12,True,True,0.0244,-0.189021
9049,7067964,113,2,0.771941,1,7067964,-1,46.0,7154364,7154477,86400,113,0,12,True,True,0.16994572222222223,-0.771941
9050,7067978,16,16,0.257944,141,7154364,-1,240.0,10537608,10537624,3469630,16,0,8,True,True,0.22834133333333334,-0.257944
9051,7068000,5846,32,0.473261,141,7154364,-1,832.0,9344987,9350833,2276987,5846,1,0,True,True,144.61872533333332,-0.42956401009030426
9052,7072488,40,16,0.256026,141,7154364,-1,288.0,8685129,8685169,1612641,40,2,10,True,True,0.33404799999999996,-0.256026
9053,7072656,13729,98,0.876658,141,7154364,-1,980.0,7442237,7455966,369581,13729,3,6,True,True,551.9715957777778,-0.8324517164063563
9054,7073592,28,4,0.650292,141,7154364,-1,32.0,7668168,7668196,594576,28,3,6,True,True,0.029871644444444442,-0.650292
9055,7073635,11342,32,0.140447,141,7154364,-1,704.0,14068110,14079452,6994475,11342,0,12,True,True,72.73063502222222,-0.14026893986758077
9056,7073725,13964,1,0.123966,141,7154364,-1,47.0,9486387,9500351,2412662,13964,2,12,True,True,21.1331411,-0.1232440451732271
9057,7073777,19272,1,0.568733,141,7154364,-1,43.0,9370687,9389959,2296910,19272,3,10,True,True,17.665205652777775,-0.5473309588596227
9058,7074702,11235,77,0.039593,141,7154364,-1,2926.0,14632510,14643745,7557808,11235,0,12,True,True,350.0705413333334,-0.03774836777149969
9059,7074723,299,11,0.859003,141,7154364,-1,242.0,9214687,9214986,2139964,299,6,7,True,True,2.674231083333333,-0.859003
9060,7074773,12,1,0.400939,141,7154364,-1,36.0,7663668,7663680,588895,12,9,6,True,True,0.013571999999999999,-0.400939
9061,7074936,384,1,0.857001,141,7154364,-1,26.0,8560850,8561234,1485914,384,8,11,True,True,0.21975893333333332,-0.857001
9062,7075408,4299,84,0.91714,141,7154364,-1,672.0,7460462,7464761,385054,4299,11,6,True,True,134.38118400000002,-0.9163207708988066
9063,7075631,4,32,0.128984,141,7154364,-1,1056.0,11494508,11494512,4418877,4,2,11,True,True,0.14260693333333332,-0.128984
9064,7077889,9841,1,0.366732,141,7154364,-1,39.0,7720498,7730339,642609,9841,10,7,True,True,4.2717189666666675,-0.33939481773174407
9065,7078039,10,3,0.844836,141,7154364,-1,66.0,7260564,7260574,182525,10,15,8,True,True,0.020064000000000002,-0.844836
9066,7084626,842,32,0.952045,141,7154364,-1,1088.0,7341237,7342079,256611,842,15,1,True,True,16.253069866666667,-0.952045
9067,7086232,13575,8,0.373683,141,7154364,-1,296.0,13407408,13420983,6321176,13575,2,12,True,True,83.6254982,-0.35183832753675826
9068,7086472,105,1,0.682201,141,7154364,-1,23.0,9652587,9652692,2566115,105,5,6,True,True,0.15860512499999999,-0.682201
9069,7086917,641,1,0.505942,141,7154364,-1,29.0,9295387,9296028,2208470,641,9,7,True,True,0.5017480916666667,-0.505942
9070,7089332,130,2,0.262827,141,7154364,-1,56.0,10272808,10272938,3183476,130,5,8,True,True,0.341796,-0.262827
9071,7093090,2160,2,0.875536,141,7154364,-1,10.0,9211087,9213247,2117997,2160,12,12,True,True,0.5926331388888889,-0.6499707477016436
9072,7106775,4,1,0.682556,141,7154364,-1,12.0,8467950,8467954,1361175,4,15,11,True,True,0.0018646666666666666,-0.682556
9073,7107032,28,1,0.620614,141,7154364,-1,8.0,7640668,7640696,533636,28,19,11,True,True,0.0064076444444444445,-0.620614
9074,7107248,22,9,0.643867,141,7154364,-1,171.0,9293587,9293609,2186339,22,11,11,True,True,0.0701195,-0.643867
9075,7107275,19759,32,0.741043,141,7154364,-1,576.0,9348587,9368346,2241312,19759,9,2,True,True,269.95485119999995,-0.6981486956675168
9076,7109502,7380,8,0.244817,141,7154364,-1,256.0,12575508,12582888,5466006,7380,3,12,True,True,22.690756266666668,-0.24444817744871083
9077,7109724,215,1,0.821235,141,7154364,-1,15.0,7546862,7547077,437138,215,23,12,True,True,0.10301187499999999,-0.821235
9078,7111029,2112,5,0.007943,141,7154364,-1,120.0,14546110,14548222,7435081,2112,1,7,True,True,7.058961999999999,-0.007786853930109414
9079,7112093,69,16,0.85306,141,7154364,-1,336.0,7910023,7910092,797930,69,20,7,True,True,0.6879207999999999,-0.8530600000000003
9080,7112485,34284,1,0.290661,141,7154364,-1,11.0,11625108,11659392,4512623,34284,5,12,True,True,13.892181233333332,-0.2888346705581966
9081,7112504,34188,128,0.158206,141,7154364,-1,3200.0,11233308,11267496,4120804,34188,7,6,True,True,2719.450346666667,-0.1563976834903306
9082,7112573,555,8,0.39928,141,7154364,-1,328.0,7662768,7663323,550195,555,26,10,True,True,5.7190900000000005,-0.39928
9083,7112578,194,2,0.072979,141,7154364,-1,20.0,13015608,13015802,5903030,194,4,0,True,True,0.07297633333333332,-0.072979
9084,7113672,7824,128,0.388223,141,7154364,-1,5760.0,8423750,8431574,1310078,7824,23,11,True,True,1124.550176,-0.35341927696406505
9085,7113827,11316,37,0.462279,141,7154364,-1,1221.0,11230608,11241924,4116781,11316,9,12,True,True,319.7777429,-0.4592155551141236
9086,7114504,1157,32,0.093503,141,7154364,-1,864.0,12579108,12580265,5464604,1157,5,8,True,True,12.101294399999999,-0.093503
9087,7114587,17747,32,0.465878,141,7154364,-1,1088.0,10447608,10465355,3333021,17747,12,11,True,True,1041.8964684444445,-0.4276721815828947
9088,7114913,86,1,0.642484,141,7154364,-1,42.0,9051959,9052045,1937046,86,23,2,True,True,0.2003656666666667,-0.642484
9089,7114996,9,32,0.900127,141,7154364,-1,384.0,7390837,7390846,275841,9,37,11,True,True,0.0876672,-0.900127
9090,7115168,217,4,0.464853,141,7154364,-1,152.0,9249387,9249604,2134219,217,21,7,True,True,1.996723088888889,-0.464853
9091,7117993,60,4,0.085823,141,7154364,-1,72.0,13753008,13753068,6635015,60,3,12,True,True,0.027863999999999996,-0.085823
9092,7118079,105,1,0.731778,141,7154364,-1,30.0,9052987,9053092,1934908,105,25,2,True,True,0.1747375,-0.731778
9093,7118118,1402,1,0.91746,141,7154364,-1,39.0,7956023,7957425,837905,1402,31,11,True,True,2.3500908166666665,-0.91746
9094,7118204,16,16,0.922491,141,7154364,-1,160.0,7807212,7807228,689008,16,33,12,True,True,0.03128177777777778,-0.922491
9095,7118234,9,4,0.768217,141,7154364,-1,92.0,8584750,8584759,1466516,9,28,10,True,True,0.0126178,-0.768217
9096,7118410,13,8,0.199471,141,7154364,-1,72.0,12751908,12751921,5633498,13,6,12,True,True,0.020508799999999997,-0.199471
9097,7118430,11342,32,0.328721,141,7154364,-1,640.0,12841908,12853250,5723478,11342,6,12,True,True,298.22070044444445,-0.3245878561321475
9098,7118548,12493,143,0.317285,141,7154364,-1,715.0,7816212,7828705,697664,12493,36,6,True,True,228.04455483333334,-0.28253885805359774
9099,7118583,6223,2,0.996438,141,7154364,-1,48.0,7256964,7263187,138381,6223,49,9,True,True,9.333336533333334,-0.9515404233124056
9100,7119045,14,4,0.486295,141,7154364,-1,60.0,8175450,8175464,1056405,14,34,0,True,True,0.036089666666666666,-0.486295
9101,7119078,11505,64,0.702291,141,7154364,-1,1344.0,7326864,7338369,207786,11505,49,11,True,True,472.70646080000006,-0.6564362597312453
9102,7119093,205,8,0.476219,141,7154364,-1,384.0,7667268,7667473,548175,205,41,8,True,True,2.511824,-0.476219
9103,7120629,13,3,0.278375,141,7154364,-1,45.0,9399987,9400000,2279358,13,19,7,True,True,0.026258375,-0.278375
9104,7120844,9,8,0.038282,141,7154364,-1,328.0,9372487,9372496,2251643,9,20,7,True,True,0.058662800000000015,-0.038282
9105,7120858,1,16,0.155741,141,7154364,-1,272.0,13276808,13276809,6155950,1,5,11,True,True,0.008646577777777777,-0.155741
9106,7120917,6726,4,0.469968,141,7154364,-1,112.0,9944694,9951420,2823777,6726,18,10,True,True,53.89839653333333,-0.44599036581305523
9107,7122370,25,7,0.640216,141,7154364,-1,224.0,7441337,7441362,318967,25,52,6,True,True,0.27228444444444444,-0.640216
9108,7122396,14,4,0.320187,141,7154364,-1,76.0,8782659,8782673,1660263,14,33,12,True,True,0.03698286666666666,-0.320187
9109,7123755,233,2,0.031323,141,7154364,-1,86.0,13895310,13895543,6771555,233,3,1,True,True,0.6360395166666667,-0.031323
9110,7123774,21286,32,0.601077,141,7154364,-1,224.0,7911823,7933109,788049,21286,42,7,True,True,175.1810672888889,-0.6002935231502137
9111,7123901,75,32,0.380285,141,7154364,-1,1408.0,11797908,11797983,4674007,75,12,12,True,True,5.671013333333333,-0.3802850000000001
9112,7123916,2,32,0.93646,141,7154364,-1,1312.0,8117723,8117725,993807,2,42,7,True,True,0.05040266666666667,-0.93646
9113,7123947,113,16,0.361493,141,7154364,-1,128.0,12143508,12143621,5019561,113,12,12,True,True,1.0498453333333335,-0.361493
9114,7124055,10574,32,0.43011,141,7154364,-1,1408.0,8516650,8527224,1392595,10574,40,8,True,True,503.08427448888887,-0.40949201777380523
9115,7124427,388,39,0.47341,141,7154364,-1,1872.0,9946494,9946882,2822067,388,21,7,True,True,56.950140000000005,-0.45871375283247695
9116,7124495,22,1,0.054078,141,7154364,-1,41.0,7562668,7562690,438173,22,57,1,True,True,0.01591528888888889,-0.05407799999999999
9117,7124616,44,5,0.868021,141,7154364,-1,240.0,7959623,7959667,835007,44,46,8,True,True,0.5929439999999999,-0.868021
9118,7124801,7,32,0.952645,141,7154364,-1,480.0,7241664,7241671,116863,7,68,12,True,True,0.123648,-0.952645
9119,7124812,19,1,0.683671,141,7154364,-1,37.0,7560362,7560381,435550,19,59,9,True,True,0.012404044444444444,-0.683671
9120,7124848,23,1,0.269848,141,7154364,-1,42.0,11319708,11319731,4194860,23,16,12,True,True,0.01604901666666667,-0.269848
9121,7124867,5,66,0.635687,141,7154364,-1,2574.0,7155264,7155269,30397,5,71,6,True,True,0.4207775,-0.635687
9122,7125076,17378,8,0.083591,141,7154364,-1,280.0,14891710,14909088,7766634,17378,0,12,True,True,79.38393866666668,-0.07681757911707893
9123,7125353,8,1,0.069259,141,7154364,-1,8.0,14285110,14285118,7159757,8,3,11,True,True,0.0006620444444444444,-0.069259
9124,7125590,6757,1,0.405068,141,7154364,-1,40.0,9376087,9382844,2250497,6757,29,2,True,True,6.25960011111111,-0.36300159744476956
9125,7125614,3678,1,0.298337,141,7154364,-1,50.0,12665508,12669186,5539894,3678,12,12,True,True,2.9655075,-0.2967821211507824
9126,7125662,32562,128,0.712207,141,7154364,-1,768.0,9491787,9524349,2366125,32562,28,7,True,True,647.1552192000001,-0.6759684081167122
9127,7125680,178,8,0.871289,141,7154364,-1,288.0,7334020,7334198,208340,178,72,1,True,True,1.1495952,-0.871289
9128,7126585,3522,8,0.524778,141,7154364,-1,392.0,9644487,9648009,2517902,3522,28,12,True,True,48.78438693333334,-0.30982531384015594
9129,7126867,11,56,0.669644,141,7154364,-1,2352.0,7808112,7808123,681245,11,58,6,True,True,0.3161414666666667,-0.6696440000000001
9130,7126915,64,2,0.259447,141,7154364,-1,16.0,10710408,10710472,3583493,64,22,12,True,True,0.04746524444444444,-0.259447
9131,7131804,6,36,0.830549,141,7154364,-1,1044.0,7334014,7334020,202210,6,76,2,True,True,0.14047020000000002,-0.8305490000000002
9132,7131838,13,1,0.092441,141,7154364,-1,21.0,7674498,7674511,542660,13,62,8,True,True,0.008164216666666666,-0.092441
9133,7131896,178,6,0.901642,141,7154364,-1,192.0,7592868,7593046,460972,178,68,7,True,True,1.0747402666666666,-0.901642
9134,7132443,7,1,0.342019,141,7154364,-1,14.0,9922587,9922594,2790144,7,28,12,True,True,0.0069008333333333335,-0.342019
9135,7132562,60,1,0.753176,141,7154364,-1,35.0,8692329,8692389,1559767,60,47,9,True,True,0.09554416666666667,-0.753176
9136,7132627,24738,7,0.164533,141,7154364,-1,322.0,13014708,13039446,5882081,24738,10,12,True,True,138.46963316666665,-0.16344999108816177
9137,7132730,6994,4,0.349276,141,7154364,-1,148.0,10624008,10631002,3491278,6994,24,12,True,True,53.58390648888889,-0.2968720640624997
9138,7132808,95,4,0.419101,141,7154364,-1,128.0,9225487,9225582,2092679,95,44,8,True,True,0.86032,-0.419101
9139,7132911,5,4,0.475499,141,7154364,-1,24.0,9651687,9651692,2518776,5,32,9,True,True,0.007881,-0.475499
9140,7132920,5350,1,0.68883,141,7154364,-1,42.0,7328664,7334014,195744,5350,85,7,True,True,7.705259100000001,-0.5725800314740209
9141,7132949,22,18,0.160689,141,7154364,-1,270.0,12755508,12755530,5622559,22,12,8,True,True,0.13158750000000002,-0.160689
9142,7135100,719,1,0.69669,141,7154364,-1,31.0,10153508,10154227,3018408,719,29,1,True,True,0.22518081388888886,-0.69669
9143,7135118,16046,32,0.354692,141,7154364,-1,320.0,11057808,11073854,3922690,16046,24,7,True,True,291.45937777777783,-0.33434567102261736
9144,7135521,26,64,0.692901,141,7154364,-1,2880.0,9398187,9398213,2262666,26,40,10,True,True,3.4062079999999995,-0.692901
9145,7135638,30,13,0.389138,141,7154364,-1,416.0,8124023,8124053,988385,30,63,7,True,True,0.36587200000000003,-0.389138
9146,7135868,11419,94,0.009932,141,7154364,-1,1410.0,9079587,9091006,1943719,11419,52,6,True,True,927.8156260000001,-0.009833157030521136
9147,7135905,14386,8,0.783072,141,7154364,-1,216.0,7440437,7454823,304532,14386,87,8,True,True,129.6440154,-0.7565277830188093
9148,7136048,8,6,0.597129,141,7154364,-1,252.0,10059008,10059016,2922960,8,31,1,True,True,0.031472,-0.597129
9149,7136179,18,32,0.077809,141,7154364,-1,1568.0,14718910,14718928,7582731,18,1,12,True,True,0.2668736,-0.077809
9150,7137518,161,8,0.667962,141,7154364,-1,392.0,7344837,7344998,207319,161,91,2,True,True,2.016077777777778,-0.6679620000000001
9151,7137677,35,1,0.616512,141,7154364,-1,16.0,8313250,8313285,1175573,35,65,9,True,True,0.023075111111111112,-0.616512
9152,7138185,323,1,0.323733,141,7154364,-1,31.0,11232408,11232731,4094223,323,24,7,True,True,0.22609910277777778,-0.323733
9153,7138782,8253,1,0.986368,141,7154364,-1,38.0,7553162,7561415,414380,8253,87,7,True,True,6.875340422222223,-0.9828393343726083
9154,7138878,10,16,0.938969,141,7154364,-1,336.0,8115923,8115933,977045,10,70,12,True,True,0.06454000000000001,-0.938969
9155,7138938,9704,64,0.742836,141,7154364,-1,1088.0,10969608,10979312,3830670,9704,27,12,True,True,618.6385891555556,-0.7394138476014623
9156,7138958,14911,32,0.736719,141,7154364,-1,544.0,8663029,8677940,1524071,14911,62,10,True,True,362.2966816888889,-0.7307889315919583
9157,7139006,14452,32,0.316515,141,7154364,-1,384.0,11450308,11464760,4311302,14452,22,11,True,True,82.87000746666668,-0.31583007425206316
9158,7139240,23347,128,0.150506,141,7154364,-1,4352.0,14978110,15001457,7838870,23347,0,12,True,True,1212.2506275555556,-0.13898454599440327
9159,7139285,12,1,0.458659,141,7154364,-1,8.0,9558087,9558099,2418802,12,43,10,True,True,0.0030024000000000006,-0.458659
9160,7139307,18,16,0.147487,141,7154364,-1,352.0,10269208,10269226,3129901,18,35,10,True,True,0.29421919999999996,-0.147487
9161,7139721,6,32,0.864301,141,7154364,-1,1376.0,7819812,7819818,680091,6,81,2,True,True,0.13413706666666667,-0.864301
9162,7139796,465,4,0.113607,141,7154364,-1,48.0,13321008,13321473,6181212,465,10,11,True,True,0.33219600000000005,-0.113607
9163,7139815,33807,64,0.969976,141,7154364,-1,2688.0,8007423,8041230,867608,33807,78,1,True,True,2601.1303808,-0.9415710434622229
9164,7140040,275,8,0.406387,141,7154364,-1,160.0,7562315,7562590,422275,275,96,6,True,True,0.7763555555555557,-0.406387
9165,7140102,3,4,0.520692,141,7154364,-1,192.0,9343187,9343190,2203085,3,55,7,True,True,0.0182064,-0.520692
9166,7140866,346,4,0.003677,141,7154364,-1,20.0,15064510,15064856,7923644,346,0,12,True,True,0.07406322222222222,-0.003677
9167,7141294,11097,10,0.450559,141,7154364,-1,420.0,9296287,9307384,2154993,11097,57,6,True,True,130.7823125,-0.36632101211078777
9168,7141690,3596,256,0.832511,141,7154364,-1,9216.0,7455966,7459562,314276,3596,104,8,True,True,1464.6490623999996,-0.789872048189091
9169,7141900,30,8,0.125717,141,7154364,-1,224.0,14154510,14154540,7012610,30,7,12,True,True,0.073864,-0.125717
9170,7143944,103,8,0.449329,141,7154364,-1,336.0,10059908,10060011,2915964,103,40,6,True,True,0.5402693333333335,-0.449329
9171,7143981,7296,158,0.969458,141,7154364,-1,6162.0,7459562,7466858,315581,7296,106,7,True,True,2082.8629106999997,-0.9664650190946174
9172,7143987,78,16,0.097446,141,7154364,-1,192.0,7562590,7562668,418603,78,101,1,True,True,0.26424320000000007,-0.097446
9173,7144695,42,4,0.218623,141,7154364,-1,64.0,12928308,12928350,5783613,42,16,12,True,True,0.09240000000000001,-0.218623
9174,7147554,19,1,0.979032,141,7154364,-1,49.0,7436837,7436856,289283,19,113,11,True,True,0.05200410833333334,-0.9790320000000002
9175,7147640,49,1,0.420176,141,7154364,-1,13.0,10534008,10534057,3386368,49,37,12,True,True,0.026230244444444443,-0.420176
9176,7147674,11,35,0.546086,141,7154364,-1,1540.0,11538708,11538719,4391034,11,26,11,True,True,0.2916032777777778,-0.546086
9177,7148673,29,8,0.166101,141,7154364,-1,64.0,8335350,8335379,1186677,29,81,10,True,True,0.08286008888888889,-0.166101
9178,7148736,9465,32,0.377557,141,7154364,-1,416.0,8957459,8966924,1808723,9465,72,12,True,True,197.5837159111111,-0.36593153759727926
9179,7148820,116,32,0.348086,141,7154364,-1,576.0,8306050,8306166,1157230,116,84,12,True,True,2.8016319999999992,-0.348086
9180,7149228,9,1,0.952377,141,7154364,-1,21.0,7561415,7561424,412187,9,109,2,True,True,0.0033348,-0.9523769999999999
9181,7149429,13,6,0.971745,141,7154364,-1,228.0,7720812,7720825,571383,13,98,1,True,True,0.0404092,-0.971745
9182,7149513,14084,1,0.576836,141,7154364,-1,32.0,9827187,9841271,2677674,14084,48,12,True,True,31.91523315555555,-0.5703654550657408
9183,7149817,41,1,0.014371,141,7154364,-1,37.0,13493808,13493849,6343991,41,11,12,True,True,0.055635975000000004,-0.014371
9184,7149890,17,1,0.813779,141,7154364,-1,7.0,7341220,7341237,191330,17,126,2,True,True,0.002111258333333333,-0.813779
9185,7150081,4900,36,0.016191,141,7154364,-1,396.0,14371510,14376410,7221429,4900,6,12,True,True,86.818732,-0.016110762702094827
9186,7150250,9583,32,0.896655,141,7154364,-1,320.0,7392637,7402220,242387,9583,124,7,True,True,92.85768533333334,-0.8948880002730838
9187,7150693,31580,2,0.502085,141,7154364,-1,22.0,9946882,9978462,2796189,31580,47,1,True,True,28.05579296666667,-0.4967909233641078
9188,7150700,672,8,0.867758,141,7154364,-1,328.0,8871059,8871731,1720359,672,77,10,True,True,8.583978666666667,-0.867758
9189,7154274,8,1,0.699317,141,7154364,-1,26.0,7596468,7596476,442194,8,111,7,True,True,0.006651955555555555,-0.699317
9190,7154312,9,1,0.648912,141,7154364,-1,40.0,9340487,9340496,2186175,9,66,11,True,True,0.012889,-0.648912
9191,7154448,15210,8,0.455997,142,7155264,-1,312.0,8640929,8656139,1486481,15210,83,1,True,True,126.02987193333334,-0.4390159916524308
9192,7154533,7486,8,0.410387,142,7155264,-1,64.0,9922594,9930080,2768061,7486,50,1,True,True,33.427132444444446,-0.40799076653615074
9193,7158859,538,1,0.352211,253,7241664,-1,33.0,10247108,10247646,3088249,538,44,12,True,True,0.99525965,-0.352211
9194,7158910,10206,4,0.542467,253,7241664,-1,44.0,8149750,8159956,990840,10206,95,8,True,True,10.661956066666667,-0.46349244273265844
9195,7159012,38,3,0.52317,253,7241664,-1,135.0,8562650,8562688,1403638,38,87,7,True,True,0.112917,-0.52317
9196,7159053,7,8,0.765081,253,7241664,-1,240.0,9212887,9212894,2053834,7,75,7,True,True,0.062090000000000006,-0.765081
9197,7159623,5,4,0.11338,253,7241664,-1,192.0,13895305,13895310,6735682,5,11,0,True,True,0.030472,-0.11338
9198,7159669,206,12,0.175814,253,7241664,-1,156.0,13797208,13797414,6637539,206,12,11,True,True,0.2649434666666666,-0.175814
9199,7159767,103,1,0.428384,253,7241664,-1,43.0,10883208,10883311,3723441,103,39,12,True,True,0.2378742083333333,-0.428384
9200,7159820,5750,32,0.176895,253,7241664,-1,832.0,12402708,12408458,5242888,5750,27,12,True,True,68.59950008888889,-0.16858447850008187
9201,7160054,37473,32,0.594892,253,7241664,-1,1600.0,9489987,9527460,2329933,37473,63,8,True,True,1533.4909200000002,-0.5905567065971239
9202,7160100,414,8,0.542763,253,7241664,-1,392.0,9101687,9102101,1941587,414,82,10,True,True,5.8256884,-0.542763
9203,7160164,15,1,0.381563,253,7241664,-1,21.0,11884308,11884323,4724144,15,29,12,True,True,0.00882875,-0.381563
9204,7160343,14002,5,0.845092,253,7241664,-1,95.0,7547762,7561764,387419,14002,133,6,True,True,30.586857083333335,-0.7726291989259781
9205,7160436,135,1,0.688551,253,7241664,-1,20.0,7670898,7671033,510462,135,120,1,True,True,0.090015,-0.6885509999999999
9206,7160647,6502,3,0.437494,253,7241664,-1,150.0,9836187,9842689,2675540,6502,58,8,True,True,69.62579666666667,-0.40073346368198326
9207,7160727,498,9,0.283248,253,7241664,-1,90.0,13666608,13667106,6505881,498,14,12,True,True,0.49102799999999996,-0.283248
9208,7162746,14808,8,0.620376,253,7241664,-1,120.0,8219650,8234458,1056904,14808,105,10,True,True,46.24367933333333,-0.5731669548057411
9209,7162966,1,5,0.925136,253,7241664,-1,155.0,7594668,7594669,431702,1,130,7,True,True,0.004874319444444444,-0.925136
9210,7162997,11,64,0.856997,253,7241664,-1,1280.0,7864012,7864023,701015,11,116,11,True,True,0.6958257777777779,-0.8569969999999999
9211,7163649,2114,1,0.995363,253,7241664,-1,21.0,7718698,7720812,555049,2114,123,11,True,True,0.6052382,-0.995363
9212,7163720,4028,4,0.80594,253,7241664,-1,132.0,7346637,7350665,182917,4028,151,7,True,True,15.267516,-0.7348310852654514
9213,7164050,224,7,0.103812,253,7241664,-1,168.0,13981710,13981934,6817660,224,10,12,True,True,0.5611349333333333,-0.103812
9214,7164332,124,9,0.649625,253,7241664,-1,144.0,9344987,9345111,2180655,124,76,7,True,True,0.5643984000000001,-0.649625
9215,7164528,34,1,0.61626,253,7241664,-1,20.0,7444037,7444071,279509,34,147,7,True,True,0.033063111111111106,-0.61626
9216,7165397,739,32,0.41128,253,7241664,-1,448.0,11056008,11056747,3890611,739,42,12,True,True,18.580496355555557,-0.41128
9217,7165501,74,64,0.496405,253,7241664,-1,2432.0,13580208,13580282,6414707,74,16,12,True,True,4.111268977777778,-0.496405
9218,7166578,7417,1,0.751727,253,7241664,-1,38.0,9341387,9348804,2174809,7417,80,6,True,True,8.532569505555557,-0.6787192664141861
9219,7170295,121,4,0.927229,253,7241664,-1,96.0,9535987,9536108,2365692,121,68,11,True,True,0.1939872,-0.9272289999999999
9220,7172868,21,5,0.099702,253,7241664,-1,120.0,10157108,10157129,2984240,21,54,2,True,True,0.024206,-0.099702
9221,7173828,18,18,0.444103,253,7241664,-1,630.0,7588368,7588386,414540,18,141,7,True,True,0.32712749999999996,-0.444103
9222,7173913,321,1,0.581234,253,7241664,-1,24.0,8694129,8694450,1520216,321,99,7,True,True,0.2980806,-0.581234
9223,7184070,13,16,0.032636,253,7241664,-1,464.0,11970708,11970721,4786638,13,32,12,True,True,0.07067493333333333,-0.032636
9224,7184899,1013,4,0.289904,253,7241664,-1,148.0,9295387,9296400,2110488,1013,86,0,True,True,4.0466986333333335,-0.289904
9225,7185016,16239,4,0.420641,253,7241664,-1,96.0,9048359,9064598,1863343,16239,98,6,True,True,84.71103813333333,-0.4181803060434662
9226,7186069,16,6,0.222879,253,7241664,-1,276.0,13015608,13015624,5829539,16,22,6,True,True,0.0830576,-0.222879
9227,7186102,2263,4,0.45463,253,7241664,-1,140.0,9830787,9833050,2644685,2263,66,8,True,True,22.571923500000004,-0.411087038129073
9228,7186416,8496,64,0.38108,253,7241664,-1,2112.0,11144208,11152704,3957792,8496,44,12,True,True,670.5850624,-0.37965216264937995
9229,7187747,5,8,0.19556,253,7241664,-1,312.0,11711508,11711513,4523761,5,36,12,True,True,0.06904733333333334,-0.19556
9230,7187993,11,4,0.469574,253,7241664,-1,24.0,9123787,9123798,1935794,11,98,10,True,True,0.014517800000000003,-0.469574
9231,7188234,11,5,0.124441,253,7241664,-1,135.0,10796808,10796819,3608574,11,50,12,True,True,0.04112625,-0.124441
9232,7189561,526,8,0.967616,253,7241664,-1,152.0,7864023,7864549,674462,526,133,1,True,True,3.9511834222222224,-0.967616
9233,7189749,30690,64,0.914029,253,7241664,-1,2240.0,7811712,7842402,621963,30690,137,8,True,True,2202.5332,-0.8575827533568924
9234,7189791,17197,128,0.412935,253,7241664,-1,5120.0,8513050,8530247,1323259,17197,117,6,True,True,2721.461262222222,-0.4021481562138728
9235,7190455,12,1,0.820418,253,7241664,-1,10.0,8959259,8959271,1768804,12,105,7,True,True,0.0072186666666666675,-0.820418
9236,7191158,93,1,0.703835,253,7241664,-1,6.0,8585650,8585743,1394492,93,114,6,True,True,0.0085033,-0.703835
9237,7191735,12789,2,0.741153,253,7241664,-1,100.0,7591068,7603857,399333,12789,156,6,True,True,40.654,-0.7319020116971123
9238,7192149,12,32,0.007605,253,7241664,-1,256.0,12229908,12229920,5037759,12,32,12,True,True,0.14610773333333335,-0.0076050000000000015
9239,7192320,16,32,0.374644,253,7241664,-1,480.0,9740787,9740803,2548467,16,72,12,True,True,0.5134933333333334,-0.374644
9240,7192416,30,1,0.223937,253,7241664,-1,27.0,7670868,7670898,478452,30,150,6,True,True,0.027004499999999997,-0.223937
9241,7192636,115,1,0.283604,253,7241664,-1,29.0,11406108,11406223,4213472,115,42,12,True,True,0.031386055555555556,-0.283604
9242,7192923,2,3,0.879607,253,7241664,-1,54.0,9056587,9056589,1863664,2,105,2,True,True,0.0057792,-0.879607
9243,7192945,38,12,0.264499,253,7241664,-1,504.0,10317008,10317046,3124063,38,58,11,True,True,0.7525672000000001,-0.264499
9244,7193263,44,1,0.838484,253,7241664,-1,47.0,7332264,7332308,139001,44,188,8,True,True,0.07089793333333334,-0.838484
9245,7193967,9,32,0.795138,253,7241664,-1,1024.0,8119523,8119532,925556,9,134,7,True,True,0.1755392,-0.795138
9246,7194119,5,8,0.414717,253,7241664,-1,384.0,9832587,9832592,2638468,5,72,7,True,True,0.15128,-0.414717
9247,7194371,1835,1,0.241554,253,7241664,-1,37.0,12489108,12490943,5294737,1835,31,12,True,True,1.9538672222222218,-0.241554
9248,7194423,7,1,0.900187,253,7241664,-1,12.0,8379550,8379557,1185127,7,129,11,True,True,0.0031100999999999998,-0.900187
9249,7194433,1000,4,0.414557,253,7241664,-1,132.0,10063508,10064508,2869075,1000,65,2,True,True,1.6694333333333333,-0.414557
9250,7195265,56,39,0.01553,253,7241664,-1,507.0,14805310,14805366,7610045,56,3,12,True,True,0.28668033333333337,-0.01553
9251,7195429,2,16,0.153375,253,7241664,-1,208.0,14457910,14457912,7262481,2,7,12,True,True,0.008415911111111112,-0.153375
9252,7196751,143,16,0.374406,253,7241664,-1,784.0,8121323,8121466,924572,143,140,7,True,True,2.1354221777777775,-0.374406
9253,7200934,5663,2,0.816707,253,7241664,-1,10.0,7586568,7592231,385634,5663,172,7,True,True,1.7806746666666666,-0.8133982133568595
9254,7201056,70,1,0.820034,253,7241664,-1,14.0,7242564,7242634,41508,70,202,6,True,True,0.036064,-0.820034
9255,7201163,33,1,0.599946,253,7241664,-1,41.0,9971682,9971715,2770519,33,70,6,True,True,0.049474699999999996,-0.599946
9256,7201177,268,4,0.33509,253,7241664,-1,112.0,13146208,13146476,5945031,268,23,11,True,True,1.4049989333333333,-0.33509
9257,7201192,24047,1,0.959161,253,7241664,-1,36.0,7669968,7694015,468776,24047,164,7,True,True,21.4281844,-0.9082349964085856
9258,7201286,7837,32,0.992829,253,7241664,-1,384.0,8003823,8011660,802537,7837,147,11,True,True,119.50300693333335,-0.9454836850921451
9259,7201325,14831,4,0.241831,253,7241664,-1,128.0,10160708,10175539,2959383,14831,66,2,True,True,41.43252444444444,-0.2293806695331573
9260,7201383,13,8,0.97349,253,7241664,-1,208.0,8197550,8197563,996167,13,140,10,True,True,0.07562186666666666,-0.97349
9261,7201427,10394,8,0.19266,253,7241664,-1,280.0,9970782,9981176,2769355,10394,73,7,True,True,109.45627466666667,-0.18696440068191908
9262,7201607,11188,2,0.644434,253,7241664,-1,64.0,8848959,8860147,1647352,11188,122,10,True,True,32.72101422222222,-0.6375132179295605
9263,7202871,7099,1,0.82855,253,7241664,-1,10.0,8175450,8182549,972579,7099,144,1,True,True,3.2614198055555557,-0.7906616328394139
9264,7203063,5,18,0.801332,253,7241664,-1,432.0,8029523,8029528,826460,5,151,10,True,True,0.057846,-0.801332
9265,7203165,11669,8,0.577854,253,7241664,-1,208.0,8637950,8649619,1434785,11669,129,8,True,True,67.63308066666667,-0.5454604125786672
9266,7204406,19788,1,0.12887,253,7241664,-1,10.0,10149908,10169696,2945502,19788,69,12,True,True,3.575927555555556,-0.12451670952836522
9267,7204441,44,1,0.636273,253,7241664,-1,7.0,8512150,8512194,1307709,44,137,11,True,True,0.007240566666666667,-0.636273
9268,7204550,13130,64,0.977356,253,7241664,-1,2112.0,7337620,7350750,133070,13130,208,2,True,True,657.2046506666667,-0.9613756276966311
9269,7204562,171,1,0.173717,253,7241664,-1,41.0,8634350,8634521,1429788,171,131,6,True,True,0.30536800000000003,-0.173717
9270,7204763,49,4,0.904171,253,7241664,-1,64.0,7815312,7815361,610549,49,166,1,True,True,0.07603057777777777,-0.904171
9271,7204775,8028,1,0.517277,253,7241664,-1,19.0,8171850,8179878,967075,8028,149,10,True,True,7.132649399999999,-0.5139671783481078
9272,7204795,58272,4,0.437402,253,7241664,-1,120.0,14544310,14602582,7339515,58272,7,12,True,True,411.1827660000001,-0.42276692101814156
9273,7204807,11697,256,0.099578,253,7241664,-1,4864.0,13883608,13895305,6678801,11697,16,12,True,True,2294.1862748444446,-0.09417022771830412
9274,7207802,4,4,0.801172,253,7241664,-1,196.0,8633450,8633454,1425648,4,134,8,True,True,0.034147555555555556,-0.801172
9275,7208040,42,4,0.504257,253,7241664,-1,104.0,8826859,8826901,1618819,42,126,11,True,True,0.2081716,-0.504257
9276,7208206,7328,1,0.631441,253,7241664,-1,31.0,9045659,9052987,1837453,7328,122,12,True,True,12.662376938888888,-0.6309107494124505
9277,7208246,81,16,0.784281,253,7241664,-1,176.0,8694459,8694540,1486213,81,129,1,True,True,0.5515884,-0.784281
9278,7209531,110,1,0.843031,253,7241664,-1,12.0,9078687,9078797,1869156,110,118,10,True,True,0.078386,-0.843031
9279,7209617,635,32,0.627318,253,7241664,-1,448.0,9124687,9125322,1915070,635,115,6,True,True,15.644029333333334,-0.6273180000000002
9280,7209643,25,1,0.26023,253,7241664,-1,31.0,10403408,10403433,3193765,25,64,12,True,True,0.02778805555555556,-0.26023
9281,7209667,9,8,0.552906,253,7241664,-1,264.0,8694450,8694459,1484783,9,133,1,True,True,0.0919314,-0.552906
9282,7209674,336,32,0.9487,253,7241664,-1,960.0,7249764,7250100,40090,336,229,9,True,True,10.482304,-0.9487000000000002
9283,7209685,26645,16,0.203763,253,7241664,-1,304.0,10058082,10084727,2848397,26645,76,12,True,True,162.65489684444444,-0.17263473210408126
9284,7209720,15299,64,0.093265,253,7241664,-1,448.0,13102008,13117307,5892288,15299,26,12,True,True,320.82315502222224,-0.09208636500560723
9285,7209776,26,1,0.437421,253,7241664,-1,38.0,10058982,10059008,2849206,26,77,6,True,True,0.015423777777777776,-0.437421
9286,7210165,12871,16,0.628894,253,7241664,-1,272.0,9221887,9234758,2011722,12871,116,9,True,True,239.8314560888889,-0.600285178407506
9287,7210313,11079,64,0.593288,253,7241664,-1,640.0,8629850,8640929,1419537,11079,146,11,True,True,279.4281315555556,-0.5817923156790225
9288,7210375,5745,32,0.027818,253,7241664,-1,832.0,7908223,7913968,697848,5745,178,11,True,True,143.83119111111108,-0.021272505396325
9289,7210382,28,16,0.707576,253,7241664,-1,256.0,9247587,9247615,2037205,28,115,10,True,True,0.5395313777777778,-0.707576
9290,7210418,167,32,0.920594,253,7241664,-1,1056.0,8122223,8122390,911805,167,168,6,True,True,5.170052800000001,-0.920594
9291,7210473,1381,32,0.078773,253,7241664,-1,1536.0,14240910,14242291,7030437,1381,11,12,True,True,77.73723733333335,-0.07799322464184939
9292,7210951,22437,1,0.382405,253,7241664,-1,29.0,13232608,13255045,6021657,22437,26,12,True,True,22.055869283333337,-0.3813118568870584
9293,7211068,2274,1,0.74234,253,7241664,-1,5.0,7584768,7587042,373700,2274,209,10,True,True,0.32697291666666667,-0.7400314538042615
9294,7211177,56,22,0.130548,253,7241664,-1,594.0,9654387,9654443,2443210,56,93,7,True,True,2.1846132000000003,-0.130548
9295,7212319,6,8,0.453706,253,7241664,-1,160.0,9047459,9047465,1835140,6,133,7,True,True,0.053880000000000004,-0.453706
9296,7212722,1338,4,0.631502,253,7241664,-1,84.0,8146150,8147488,933428,1338,171,1,True,True,2.570873666666667,-0.4628598291201091
9297,7212780,4929,4,0.358121,253,7241664,-1,196.0,8696259,8701188,1483479,4929,141,7,True,True,37.65288543333333,-0.35811230070961064
9298,7212857,57,8,0.239722,253,7241664,-1,96.0,12057108,12057165,4844251,57,43,12,True,True,0.1869144,-0.239722
9299,7212939,2,8,0.897909,253,7241664,-1,224.0,7590168,7590170,377229,2,212,7,True,True,0.014843733333333333,-0.897909
9300,7213145,15255,32,0.296923,253,7241664,-1,1280.0,12316308,12331563,5103163,15255,41,12,True,True,220.66921599999998,-0.2762678701635367
9301,7213246,15842,225,0.535417,253,7241664,-1,6975.0,9968982,9984824,2755736,15842,85,10,True,True,4359.213954999999,-0.5157534285585379
9302,7214147,27,1,0.245254,253,7241664,-1,20.0,8146123,8146150,931976,27,176,10,True,True,0.0075885,-0.245254
9303,7214162,3,4,0.780029,253,7241664,-1,100.0,7551362,7551365,337200,3,225,8,True,True,0.006825833333333334,-0.780029
9304,7214384,351,2,0.786048,253,7241664,-1,76.0,7282664,7283015,68280,351,248,10,True,True,0.5684563555555555,-0.7583184351923506
6365,4996152,288,8,0.943162,1,4996152,-1,88.0,5082552,5082840,86400,288,0,12,True,True,1.0459327999999999,-0.943162
6366,4996383,9,1,0.724234,199,5082552,-1,40.0,5367259,5367268,370876,9,0,10,True,True,0.011661000000000001,-0.7242340000000002
6367,4996738,11299,256,0.14056,199,5082552,-1,8192.0,9726233,9737532,4729495,11299,0,7,True,True,6938.920800711112,-0.13949384181841143
6368,4996862,19,8,0.111932,199,5082552,-1,240.0,7180115,7180134,2183253,19,1,6,True,True,0.20031066666666664,-0.111932
6369,4997024,11651,2,0.73448,199,5082552,-1,32.0,5456991,5468642,459967,11651,2,11,True,True,9.334661600000002,-0.7273010022792887
6370,4998240,68,32,0.932935,199,5082552,-1,1120.0,5875957,5876025,877717,68,2,6,True,True,2.0946115555555562,-0.932935
6371,4998380,9,2,0.521958,199,5082552,-1,18.0,6484491,6484500,1486111,9,2,11,True,True,0.0081099,-0.521958
6372,5001282,11,1,0.828982,199,5082552,-1,19.0,7803015,7803026,2801733,11,1,12,True,True,0.008334455555555556,-0.828982
6373,5001393,8013,2,0.949675,199,5082552,-1,36.0,5345159,5353172,343766,8013,7,11,True,True,6.870406699999999,-0.9493693405139003
6374,5003634,1429,2,0.931556,199,5082552,-1,36.0,5297359,5298788,293725,1429,8,8,True,True,2.1856554999999998,-0.931556
6375,5003672,396,11,0.251808,199,5082552,-1,550.0,9093920,9094316,4090248,396,1,6,True,True,19.0938,-0.251808
6376,5003800,518,4,0.884565,199,5082552,-1,40.0,6958615,6959133,1954815,518,4,12,True,True,0.7150661111111112,-0.8812969027093596
6377,5003985,4,16,0.238077,199,5082552,-1,576.0,9404856,9404860,4400871,4,1,12,True,True,0.15466239999999998,-0.238077
6378,5004083,382,8,0.122277,199,5082552,-1,120.0,8978024,8978406,3973941,382,3,6,True,True,1.2599146666666667,-0.07299011708847966
6379,5004332,179,1,0.806687,199,5082552,-1,48.0,7203115,7203294,2198783,179,5,6,True,True,0.33613813333333337,-0.806687
6380,5004346,342,1,0.329286,199,5082552,-1,17.0,8833267,8833609,3828921,342,4,7,True,True,0.1719329,-0.329286
6381,5004375,7617,128,0.584326,199,5082552,-1,1408.0,9051284,9058901,4046909,7617,3,10,True,True,294.93025955555555,-0.5716485944533483
6382,5004770,7207,53,0.389951,199,5082552,-1,2385.0,8418218,8425425,3413448,7207,6,7,True,True,1111.249244375,-0.37866689560601463
6383,5008217,92,1,0.748374,199,5082552,-1,33.0,6756491,6756583,1748274,92,11,9,True,True,0.11770403333333333,-0.748374
6384,5008449,72,16,0.235938,199,5082552,-1,400.0,9494856,9494928,4486407,72,1,12,True,True,1.8281600000000002,-0.235938
6385,5008526,6200,16,0.422869,199,5082552,-1,624.0,8153618,8159818,3145092,6200,8,11,True,True,383.77587386666664,-0.42048361950723323
6386,5008573,5,8,0.144278,199,5082552,-1,152.0,7941319,7941324,2932746,5,9,6,True,True,0.03202133333333333,-0.144278
6387,5009035,112,4,0.175154,199,5082552,-1,48.0,5222525,5222637,213490,112,21,10,True,True,0.23074986666666666,-0.175154
6388,5009187,92,16,0.969923,199,5082552,-1,336.0,5410091,5410183,400904,92,18,2,True,True,1.1256261333333335,-0.969923
6389,5011695,36736,16,0.439475,199,5082552,-1,336.0,8836624,8873360,3824929,36736,6,2,True,True,412.5520448,-0.4381830491124726
6390,5012350,143,32,0.254306,199,5082552,-1,928.0,8996924,8997067,3984574,143,5,2,True,True,8.003157066666667,-0.254306
6391,5012445,12,8,0.589481,199,5082552,-1,296.0,7210315,7210327,2197870,12,13,8,True,True,0.13792613333333334,-0.589481
6392,5013079,28,4,0.490359,199,5082552,-1,104.0,7847215,7847243,2834136,28,12,0,True,True,0.13417848888888886,-0.490359
6393,5013666,39,64,0.374705,199,5082552,-1,2688.0,8828767,8828806,3815101,39,9,7,True,True,3.1950464000000003,-0.374705
6394,5035595,4,1,0.948711,199,5082552,-1,30.0,5692157,5692161,656562,4,22,10,True,True,0.0033266666666666666,-0.948711
6395,5035616,49,1,0.31649,199,5082552,-1,23.0,8989724,8989773,3954108,49,6,2,True,True,0.0998083722222222,-0.31649
6396,5035632,6541,32,0.423781,199,5082552,-1,1120.0,9086479,9093020,4050847,6541,4,2,True,True,650.4609066666667,-0.42356714669292245
6397,5035672,13689,1,0.682738,199,5082552,-1,17.0,7690915,7704604,2655243,13689,17,11,True,True,8.639575855555558,-0.6819028060795435
6398,5035701,48,4,0.963315,199,5082552,-1,196.0,5243259,5243307,207558,48,31,2,True,True,0.3452474666666667,-0.963315
6399,5038555,27,25,0.879434,199,5082552,-1,900.0,7592615,7592642,2554060,27,18,7,True,True,0.8883,-0.879434
6400,5039384,9,8,0.936972,199,5082552,-1,128.0,6778615,6778624,1739231,9,23,1,True,True,0.041296000000000006,-0.936972
6401,5039437,4609,128,0.362998,199,5082552,-1,640.0,9060284,9064893,4020847,4609,5,2,True,True,84.93296888888888,-0.25730872635129226
6402,5039447,15719,8,0.715671,199,5082552,-1,312.0,6093598,6109317,1054151,15719,27,11,True,True,165.9029528,-0.6982622576914165
6403,5039464,2,1,0.821365,199,5082552,-1,11.0,7436315,7436317,2396851,2,20,11,True,True,0.0009769222222222223,-0.821365
6404,5039486,489,1,0.021074,199,5082552,-1,39.0,8416418,8416907,3376932,489,14,12,True,True,1.3155768166666666,-0.020950760294452326
6405,5039769,60,1,0.966805,199,5082552,-1,16.0,6228398,6228458,1188629,60,29,10,True,True,0.03375466666666667,-0.966805
6406,5039891,10,4,0.605815,199,5082552,-1,144.0,7961119,7961129,2921228,10,16,9,True,True,0.060736,-0.605815
6407,5039964,11,2,0.841473,199,5082552,-1,68.0,6016457,6016468,976493,11,32,10,True,True,0.02620077777777778,-0.841473
6408,5040154,8196,8,0.662223,199,5082552,-1,168.0,5994357,6002553,954203,8196,33,6,True,True,90.3122654,-0.6436424098603649
6409,5040184,9272,1,0.940848,199,5082552,-1,33.0,6096298,6105570,1056114,9272,31,7,True,True,10.660270133333334,-0.9181406993340339
6410,5040190,24297,78,0.690682,199,5082552,-1,3120.0,8071619,8095916,3031429,24297,16,0,True,True,5415.531116666666,-0.6808734100644466
6411,5040213,572,8,0.788803,199,5082552,-1,328.0,7639515,7640087,2599302,572,22,0,True,True,14.549099644444444,-0.788803
6412,5040272,2900,64,0.239676,199,5082552,-1,2880.0,9318456,9321356,4278184,2900,3,11,True,True,620.337536,-0.2375499118028739
6413,5040327,32,2,0.552728,199,5082552,-1,80.0,7943119,7943151,2902792,32,19,7,True,True,0.10217244444444445,-0.552728
6414,5040396,7193,1,0.309269,199,5082552,-1,14.0,5875057,5882250,834661,7193,40,11,True,True,3.2834577611111113,-0.3069072775368317
6415,5040423,9,8,0.958484,199,5082552,-1,56.0,5992557,5992566,952134,9,39,12,True,True,0.03534860000000001,-0.958484
6416,5040900,48,4,0.362855,199,5082552,-1,64.0,8646567,8646615,3605667,48,14,1,True,True,0.08449706666666668,-0.362855
6417,5040909,7,64,0.81225,199,5082552,-1,2496.0,5661957,5661964,621048,7,44,11,True,True,0.7400848,-0.81225
6418,5041154,752,8,0.122054,199,5082552,-1,376.0,9052184,9052936,4011030,752,7,6,True,True,7.943760355555556,-0.122054
6419,5041162,10,1,0.866953,199,5082552,-1,30.0,6094498,6094508,1053336,10,38,6,True,True,0.010437499999999999,-0.8669529999999999
6420,5041194,39,32,0.857647,199,5082552,-1,896.0,6104398,6104437,1063204,39,37,6,True,True,1.1238378666666669,-0.857647
6421,5046220,1,16,0.388471,199,5082552,-1,752.0,9093020,9093021,4046800,1,5,2,True,True,0.06697395555555555,-0.388471
6422,5046284,15625,4,0.909789,199,5082552,-1,192.0,5290159,5305784,243875,15625,54,6,True,True,129.1485024,-0.9034509127709012
6423,5046317,3,1,0.392976,199,5082552,-1,49.0,5169108,5169111,122791,3,57,1,True,True,0.006348766666666667,-0.392976
6424,5046332,6729,4,0.977993,199,5082552,-1,44.0,6440291,6447020,1393959,6729,37,2,True,True,23.428784744444442,-0.9648293671029031
6425,5046363,260,1,0.255534,199,5082552,-1,29.0,9023524,9023784,3977161,260,10,8,True,True,0.6949785555555555,-0.255534
6426,5046749,11,9,0.09025,199,5082552,-1,99.0,9090079,9090090,4043330,11,6,8,True,True,0.09698755,-0.09025
6427,5046809,257,1,0.822708,199,5082552,-1,32.0,7384915,7385172,2338106,257,32,12,True,True,0.3651456,-0.822708
6428,5046913,11,32,0.23546,199,5082552,-1,1248.0,7067115,7067126,2020202,11,36,12,True,True,0.391248,-0.23546
6429,5047043,14,4,0.210386,199,5082552,-1,48.0,8735867,8735881,3688824,14,18,6,True,True,0.01805813333333333,-0.210386
6430,5047140,22571,16,0.890247,199,5082552,-1,736.0,5906157,5928728,859017,22571,51,1,True,True,728.9862614222222,-0.8877064774911034
6431,5047202,6,8,0.915891,199,5082552,-1,352.0,6749291,6749297,1702089,6,41,8,True,True,0.0770352,-0.915891
6432,5047254,11,12,0.631353,199,5082552,-1,108.0,7546615,7546626,2499361,11,32,10,True,True,0.058373699999999994,-0.631353
6433,5048161,10364,23,0.879467,199,5082552,-1,276.0,5232895,5243259,184734,10364,65,7,True,True,109.92952656666668,-0.8518875431590344
6434,5048205,473,2,0.766741,199,5082552,-1,72.0,5193225,5193698,145020,473,67,6,True,True,1.2012308,-0.7667410000000002
6435,5048623,20,54,0.406289,199,5082552,-1,270.0,7953919,7953939,2905296,20,25,6,True,True,0.23970000000000005,-0.406289
6436,5048678,9806,32,0.033882,199,5082552,-1,1280.0,8983424,8993230,3934746,9806,14,2,True,True,960.3260373333334,-0.03232739539496367
6437,5049119,1583,2,0.866445,199,5082552,-1,74.0,7952119,7953702,2903000,1583,27,7,True,True,5.188597566666667,-0.8645777977592806
6438,5049130,11094,128,0.823198,199,5082552,-1,768.0,5374459,5385553,325329,11094,63,9,True,True,343.65039146666663,-0.785608747256224
6439,5049135,11,80,0.940495,199,5082552,-1,2960.0,5549891,5549902,500756,11,61,6,True,True,0.7846960000000001,-0.9404950000000002
6440,5049317,7704,256,0.471091,199,5082552,-1,6144.0,7933615,7941319,2884298,7704,30,12,True,True,1892.7421781333333,-0.46580655471228566
6441,5049589,6,8,0.412961,199,5082552,-1,160.0,7524515,7524521,2474926,6,37,12,True,True,0.04894133333333334,-0.412961
6442,5049619,15133,8,0.841163,199,5082552,-1,384.0,7179215,7194348,2129596,15133,43,10,True,True,224.41603626666668,-0.8303598421997305
6443,5049809,7295,16,0.717386,199,5082552,-1,640.0,5880457,5887752,830648,7295,60,2,True,True,194.832768,-0.7108414046629712
6444,5050464,16097,1,0.876761,199,5082552,-1,45.0,6206298,6222395,1155834,16097,52,11,True,True,23.288138125,-0.8594947585958606
6445,5050620,3608,128,0.820241,199,5082552,-1,3712.0,7296715,7300323,2246095,3608,40,12,True,True,434.93088462222227,-0.8200277151712866
6446,5050703,99,4,0.824401,199,5082552,-1,20.0,5576554,5576653,525851,99,67,10,True,True,0.050418500000000005,-0.824401
6447,5050777,49,2,0.698482,199,5082552,-1,84.0,6025449,6025498,974672,49,58,2,True,True,0.15721976666666668,-0.698482
6448,5050915,24920,64,0.506335,199,5082552,-1,1344.0,9023784,9048704,3972869,24920,11,1,True,True,1619.3003008000003,-0.45351845653272693
6449,5051602,7919,2,0.351856,199,5082552,-1,54.0,7646715,7654634,2595113,7919,35,0,True,True,25.7251911,-0.3493299355798661
6450,5051620,4940,16,0.602116,199,5082552,-1,128.0,8967224,8972164,3915604,4940,17,11,True,True,17.55671608888889,-0.5971754511262629
6451,5051644,11891,128,0.813428,199,5082552,-1,4992.0,5550854,5562745,499210,11891,72,1,True,True,1446.5012778666664,-0.7903941489348496
6452,5051662,10,32,0.737786,199,5082552,-1,512.0,7157115,7157125,2105453,10,48,8,True,True,0.2029368888888889,-0.737786
6453,5051696,12002,128,0.453262,199,5082552,-1,4608.0,9542656,9554658,4490960,12002,1,11,True,True,3538.6090495999997,-0.38864307583099483
6454,5051826,9,28,0.027351,199,5082552,-1,728.0,9096956,9096965,4045130,9,5,2,True,True,0.574392,-0.027351
6455,5051887,12955,4,0.052099,199,5082552,-1,176.0,8986124,8999079,3934237,12955,17,6,True,True,172.18055017777777,-0.05161070087656911
6456,5051994,549,1,0.641593,199,5082552,-1,48.0,7953019,7953568,2901025,549,32,6,True,True,1.169736,-0.641593
6457,5052030,7192,8,0.630156,199,5082552,-1,288.0,6018257,6025449,966227,7192,67,7,True,True,72.44514319999999,-0.6019561980681174
6458,5052093,9,1,0.791019,199,5082552,-1,34.0,5547191,5547200,495098,9,80,11,True,True,0.007782600000000001,-0.791019
6459,5053167,300,16,0.136092,199,5082552,-1,672.0,9274256,9274556,4221089,300,5,12,True,True,17.015600000000003,-0.136092
6460,5053192,11523,32,0.400662,199,5082552,-1,320.0,9069284,9080807,4016092,11523,11,7,True,True,341.88943466666666,-0.39099788947088987
6461,5053311,60,4,0.628296,199,5082552,-1,136.0,8536242,8536302,3482931,60,28,1,True,True,0.40217466666666674,-0.628296
6462,5053321,42,1,0.313722,199,5082552,-1,22.0,7646715,7646757,2593394,42,44,9,True,True,0.060645199999999996,-0.313722
6463,5053390,9387,32,0.082232,199,5082552,-1,1600.0,9056684,9066071,4003294,9387,13,2,True,True,455.9606444444444,-0.07255372660626035
6464,5053409,409,1,0.157822,199,5082552,-1,32.0,9019024,9019433,3965615,409,18,10,True,True,1.222092,-0.157822
6465,5053471,669,40,0.516366,199,5082552,-1,880.0,7590815,7591484,2537344,669,49,11,True,True,21.597847333333334,-0.516366
6466,5053478,1370,4,0.969665,199,5082552,-1,68.0,5226125,5227495,172647,1370,97,7,True,True,3.9963165555555555,-0.9288864873196633
6467,5053524,4,1,0.830621,199,5082552,-1,28.0,5200425,5200429,146901,4,99,9,True,True,0.004126577777777777,-0.830621
6468,5053546,607,1,0.763163,199,5082552,-1,22.0,5829957,5830564,776411,607,82,12,True,True,0.3262085444444444,-0.763163
6469,5053558,18448,160,0.84696,199,5082552,-1,4960.0,7694515,7712963,2640957,18448,44,1,True,True,3270.0288688888886,-0.8352198241277436
6470,5053616,14,16,0.685753,199,5082552,-1,272.0,6344098,6344112,1290482,14,68,12,True,True,0.18415911111111113,-0.685753
6471,5053649,94,1,0.792642,199,5082552,-1,32.0,5289259,5289353,235610,94,98,7,True,True,0.12595164444444445,-0.792642
6472,5053681,194,8,0.319399,199,5082552,-1,192.0,8781867,8782061,3728186,194,28,11,True,True,1.0282517333333334,-0.319399
6473,5053696,1791,8,0.478365,199,5082552,-1,216.0,6866815,6868606,1813119,1791,64,7,True,True,12.456763200000001,-0.478365
6474,5054011,14447,128,0.735172,199,5082552,-1,4096.0,6162098,6176545,1108087,14447,73,6,True,True,2281.7663658666665,-0.7139509163443815
6475,5054052,7887,29,0.26068,199,5082552,-1,986.0,7153515,7161402,2099463,7887,62,12,True,True,312.2485999,-0.25494966256151785
6476,5054099,10840,32,0.687467,199,5082552,-1,1120.0,7202215,7213055,2148116,10840,59,10,True,True,460.92864222222227,-0.6781895685122075
6477,5054492,21,8,0.826769,199,5082552,-1,152.0,6027298,6027319,972806,21,80,7,True,True,0.1265539333333333,-0.826769
6478,5055358,13301,128,0.799529,199,5082552,-1,4224.0,7593515,7606816,2538157,13301,50,6,True,True,2200.925056,-0.7633014739675722
6479,5055377,15508,140,0.198664,199,5082552,-1,2800.0,9818033,9833541,4762656,15508,0,2,True,True,1550.8886866666667,-0.19725255588784413
6480,5055439,17,16,0.414496,199,5082552,-1,352.0,5501191,5501208,445752,17,99,11,True,True,0.10718008888888889,-0.414496
6481,5055712,8,16,0.181889,199,5082552,-1,800.0,9029184,9029192,3973472,8,17,2,True,True,0.27598222222222224,-0.181889
6482,5055757,3,8,0.87639,199,5082552,-1,344.0,5578354,5578357,522597,3,96,7,True,True,0.026278733333333335,-0.87639
6483,5055783,1034,4,0.944757,199,5082552,-1,72.0,6049398,6050432,993615,1034,83,10,True,True,4.163090799999999,-0.944757
6484,5056411,109,2,0.884341,199,5082552,-1,12.0,6109798,6109907,1053387,109,79,7,True,True,0.03924726666666667,-0.884341
6485,5056458,266,9,0.224487,199,5082552,-1,225.0,9187856,9188122,4131398,266,7,7,True,True,4.77154125,-0.224487
6486,5056472,345,8,0.948109,199,5082552,-1,176.0,5378059,5378404,321587,345,107,8,True,True,2.4620551999999996,-0.9309009024749885
6487,5056902,18,10,0.923112,199,5082552,-1,420.0,5236495,5236513,179593,18,115,1,True,True,0.27048,-0.923112
6488,5057043,9038,32,0.647107,199,5082552,-1,960.0,5669157,5678195,612114,9038,98,9,True,True,302.13069333333334,-0.6349491475217227
6489,5058075,16,1,0.626627,199,5082552,-1,39.0,8831467,8831483,3773392,16,30,6,True,True,0.018453066666666667,-0.626627
6490,5058146,12,7,0.906845,199,5082552,-1,161.0,6235598,6235610,1177452,12,78,9,True,True,0.059355333333333336,-0.9068449999999999
6491,5058434,553,4,0.974128,199,5082552,-1,32.0,5227495,5228048,169061,553,120,1,True,True,0.7924367111111112,-0.974128
6492,5058632,386,1,0.198266,199,5082552,-1,15.0,9408456,9408842,4349824,386,4,6,True,True,0.4113312499999999,-0.198266
6493,5058801,18,16,0.701261,199,5082552,-1,144.0,6116998,6117016,1058197,18,83,9,True,True,0.0729648,-0.701261
6494,5058827,10593,1,0.168756,199,5082552,-1,7.0,6570891,6581484,1512064,10593,76,12,True,True,3.7067248749999995,-0.1674225343303487
6495,5058866,27,16,0.401035,199,5082552,-1,544.0,8240018,8240045,3181152,27,39,12,True,True,1.3442784,-0.401035
6496,5058919,16733,1,0.428903,199,5082552,-1,7.0,6637191,6653924,1578272,16733,77,10,True,True,5.587149380555555,-0.42137540585769784
6497,5058961,39,1,0.260158,199,5082552,-1,36.0,8083718,8083757,3024757,39,41,2,True,True,0.1134939,-0.260158
6498,5059497,36,30,0.089061,199,5082552,-1,810.0,9722856,9722892,4663359,36,2,8,True,True,2.47779,-0.089061
6499,5059573,159,16,0.36792,199,5082552,-1,800.0,7847215,7847374,2787642,159,52,11,True,True,5.861093333333334,-0.36792
6500,5059943,270,8,0.947244,199,5082552,-1,56.0,5293759,5294029,233816,270,123,8,True,True,0.613284,-0.947244
6501,5059974,12,1,0.117351,199,5082552,-1,36.0,9632856,9632868,4572882,12,3,7,True,True,0.0351408,-0.117351
6502,5060092,437,64,0.718583,199,5082552,-1,640.0,5287459,5287896,227367,437,127,11,True,True,12.209585777777777,-0.718583
6503,5060119,11,3,0.435159,199,5082552,-1,126.0,8330018,8330029,3269899,11,41,12,True,True,0.13250930000000002,-0.435159
6504,5060145,147,4,0.919989,199,5082552,-1,132.0,5191278,5191425,131133,147,137,1,True,True,0.6844222,-0.919989
6505,5060291,12470,16,0.453708,199,5082552,-1,224.0,8105818,8118288,3045527,12470,44,10,True,True,108.39896853333335,-0.359210893462054
6506,5060401,102,1,0.67361,199,5082552,-1,21.0,5993457,5993559,933056,102,104,6,True,True,0.15023155000000002,-0.67361
6507,5060515,81,1,0.118512,199,5082552,-1,19.0,9099656,9099737,4039141,81,11,7,True,True,0.11218027500000001,-0.118512
6508,5064225,9,1,0.713564,199,5082552,-1,19.0,6023657,6023666,959432,9,102,2,True,True,0.0065317249999999995,-0.713564
6509,5064232,10831,16,0.190544,199,5082552,-1,752.0,8979824,8990655,3915592,10831,30,7,True,True,532.5131040888889,-0.1688041224090299
6510,5064330,156,2,0.861937,199,5082552,-1,88.0,5168952,5169108,104622,156,144,12,True,True,0.5928970666666666,-0.861937
6511,5064361,26471,64,0.782122,199,5082552,-1,3008.0,8690767,8717238,3626406,26471,39,11,True,True,2783.3866657777776,-0.7698031514782947
6512,5064423,8,16,0.287962,199,5082552,-1,608.0,7595315,7595323,2530892,8,65,7,True,True,0.1778062222222222,-0.287962
6513,5064462,9,1,0.494168,199,5082552,-1,30.0,7392115,7392124,2327653,9,72,8,True,True,0.00971175,-0.494168
6514,5064563,1019,21,0.130199,199,5082552,-1,336.0,9067484,9068503,4002921,1019,18,0,True,True,16.264128533333334,-0.07870915364535921
6515,5064589,14234,128,0.856338,199,5082552,-1,6400.0,6872215,6886449,1807626,14234,85,8,True,True,3276.9101155555554,-0.8548914120506808
6516,5064614,13897,4,0.600083,199,5082552,-1,112.0,7206715,7220612,2142101,13897,77,2,True,True,57.60743893333334,-0.593599597610018
6517,5064685,14,8,0.995207,199,5082552,-1,168.0,7388515,7388529,2323830,14,74,8,True,True,0.09275373333333334,-0.995207
6518,5064931,36,2,0.282967,199,5082552,-1,84.0,8109418,8109454,3044487,36,48,8,True,True,0.1096536,-0.282967
6519,5064959,9070,16,0.677189,199,5082552,-1,336.0,7438115,7447185,2373156,9070,73,7,True,True,147.904554,-0.660996950357309
6520,5065030,92,1,0.418331,199,5082552,-1,32.0,8782767,8782859,3717737,92,38,6,True,True,0.08127075555555556,-0.418331
6521,5065053,8649,5,0.408524,199,5082552,-1,75.0,8923024,8931673,3857971,8649,34,12,True,True,25.459431666666664,-0.2764196428153267
6522,5065866,10726,1,0.145943,199,5082552,-1,35.0,8974424,8985150,3908558,10726,33,8,True,True,15.672583500000002,-0.14108081263721864
6523,5066942,114,32,0.290193,199,5082552,-1,608.0,8513871,8513985,3446929,114,46,10,True,True,3.7447733333333333,-0.290193
6524,5067190,7978,1,0.261799,199,5082552,-1,35.0,8976224,8984202,3909034,7978,33,7,True,True,12.119290944444446,-0.23528057985975234
6525,5067817,271,1,0.61768,199,5082552,-1,29.0,8535971,8536242,3468154,271,47,10,True,True,0.38733954722222225,-0.61768
6526,5067939,8,2,0.907328,199,5082552,-1,12.0,5699357,5699365,631418,8,129,9,True,True,0.0025472,-0.907328
6527,5068033,7742,128,0.369638,199,5082552,-1,1152.0,8491771,8499513,3423738,7742,49,11,True,True,619.6738336,-0.3690359936826102
6528,5068245,1090,16,0.684267,199,5082552,-1,400.0,8985224,8986314,3916979,1090,30,7,True,True,30.556742222222226,-0.6150440836688097
6529,5068303,4704,1,0.458164,199,5082552,-1,45.0,6865015,6869719,1796712,4704,99,12,True,True,6.897192875,-0.4402191641892854
6530,5068311,8315,32,0.01032,199,5082552,-1,1536.0,6161198,6169513,1092887,8315,112,11,True,True,507.4172714666667,-0.01019208829211436
6531,5068393,5,1,0.133205,199,5082552,-1,26.0,9025584,9025589,3957191,5,24,7,True,True,0.011681944444444444,-0.133205
6532,5068451,6988,8,0.323246,199,5082552,-1,56.0,8970824,8977812,3902373,6988,37,7,True,True,10.83450791111111,-0.3206254580890974
6533,5068510,404,1,0.693024,199,5082552,-1,49.0,5231095,5231499,162585,404,159,8,True,True,0.8170249111111112,-0.693024
6534,5068560,16577,16,0.686852,199,5082552,-1,528.0,6257698,6274275,1189138,16577,110,10,True,True,298.3161646666667,-0.684348996692634
6535,5070297,55,8,0.713336,199,5082552,-1,200.0,5548991,5549046,478694,55,144,7,True,True,0.2651,-0.713336
6536,5070488,21,16,0.708453,199,5082552,-1,464.0,6615091,6615112,1544603,21,106,11,True,True,0.4280864000000001,-0.708453
6537,5070530,24,64,0.736104,199,5082552,-1,384.0,6778591,6778615,1708061,24,103,10,True,True,0.33036800000000005,-0.736104
6538,5070562,127,3,0.256226,199,5082552,-1,33.0,9586856,9586983,4516294,127,4,11,True,True,0.383022475,-0.256226
6539,5070647,163,16,0.095279,199,5082552,-1,608.0,8977124,8977287,3906477,163,36,6,True,True,2.6945276444444444,-0.095279
6540,5070842,18,2,0.058752,199,5082552,-1,32.0,9186056,9186074,4115214,18,12,12,True,True,0.0491616,-0.058752
6541,5071043,9435,128,0.332863,199,5082552,-1,3584.0,8993324,9002759,3922281,9435,31,7,True,True,2371.8382563555556,-0.32141370595130614
6542,5071157,12,2,0.234841,199,5082552,-1,70.0,8991524,8991536,3920367,12,32,7,True,True,0.07439133333333334,-0.234841
6543,5071348,14173,32,0.908227,199,5082552,-1,736.0,5902557,5916730,831209,14173,139,10,True,True,438.04045457777784,-0.8947037760213749
6544,5075723,4,5,0.996739,199,5082552,-1,60.0,6434098,6434102,1358375,4,116,8,True,True,0.01956066666666667,-0.996739
6545,5075965,6144,4,0.939322,199,5082552,-1,100.0,5412791,5418935,336826,6144,157,6,True,True,17.934887500000002,-0.834977792073032
6546,5075987,14922,11,0.96721,199,5082552,-1,506.0,6103498,6118420,1027511,14922,127,9,True,True,223.1741617111111,-0.9542104807068892
6547,5076045,16635,1,0.598232,199,5082552,-1,39.0,6659291,6675926,1583246,16635,111,10,True,True,36.26432333333334,-0.5907674083556193
6548,5076650,191,16,0.748242,199,5082552,-1,720.0,5743557,5743748,666907,191,147,11,True,True,3.8455939999999997,-0.7482419999999999
6549,5077402,8956,1,0.045512,199,5082552,-1,36.0,9814433,9823389,4737031,8956,1,7,True,True,11.095584899999999,-0.045422189161694236
6550,5077548,1352,24,0.253657,199,5082552,-1,600.0,9631056,9632408,4553508,1352,5,11,True,True,65.98661333333332,-0.253657
6551,5077564,570,1,0.619658,199,5082552,-1,23.0,6437698,6438268,1360134,570,119,2,True,True,1.0310650833333332,-0.619658
6552,5077611,21,1,0.302507,199,5082552,-1,15.0,7950319,7950340,2872708,21,73,9,True,True,0.01381275,-0.302507
6553,5078099,8601,32,0.394697,199,5082552,-1,1440.0,8005319,8013920,2927220,8601,69,11,True,True,469.7093239999999,-0.3797481366160354
6554,5080001,6699,16,0.370901,199,5082552,-1,320.0,8077019,8083718,2997018,6699,68,2,True,True,187.74714755555556,-0.35376536576314943
6555,5080498,12679,4,0.968058,199,5082552,-1,168.0,6868615,6881294,1788117,12679,110,7,True,True,76.18448599999999,-0.9557155925995573
6556,5080698,22,8,0.55956,199,5082552,-1,40.0,8243618,8243640,3162920,22,63,8,True,True,0.08353155555555558,-0.55956
6557,5080742,9657,4,0.580487,199,5082552,-1,24.0,8826967,8836624,3746225,9657,51,11,True,True,6.918767266666666,-0.5648379136487208
6558,5080766,5194,9,0.260292,199,5082552,-1,396.0,9019924,9025118,3939158,5194,31,6,True,True,190.38031759999998,-0.2590450789725684
6559,5080810,21,1,0.503747,199,5082552,-1,49.0,8071619,8071640,2990809,21,73,10,True,True,0.09583134166666667,-0.503747
6560,5080885,14224,7,0.930327,199,5082552,-1,189.0,5300959,5315183,220074,14224,177,2,True,True,111.24426915,-0.9019571258939931
6561,5080936,29582,64,0.877897,199,5082552,-1,1536.0,5411891,5441473,330955,29582,172,7,True,True,1143.9901696000002,-0.8524240703981779
6562,5081138,12826,2,0.13192,199,5082552,-1,52.0,9821633,9834459,4740495,12826,0,3,True,True,24.08457971111111,-0.13142355389061677
6563,5081581,2,1,0.317317,199,5082552,-1,18.0,7298515,7298517,2216934,2,103,7,True,True,0.0011694,-0.31731700000000007
6564,5082006,14,128,0.530424,199,5082552,-1,4736.0,8080619,8080633,2998613,14,72,2,True,True,5.825911466666666,-0.530424
6565,5083355,53,1,0.141796,254,5168952,-1,20.0,8425418,8425471,3342063,53,63,9,True,True,0.06317305555555557,-0.141796
6566,5085337,14785,1,0.116842,254,5168952,-1,16.0,9407556,9422341,4322219,14785,11,6,True,True,16.710798844444444,-0.114660806964237
6567,5086109,6977,1,0.044162,254,5168952,-1,39.0,9719256,9726233,4633147,6977,5,12,True,True,21.85799730833333,-0.04354263901843633
6568,5089938,60780,1,0.127871,254,5168952,-1,6.0,9825233,9886013,4735295,60780,0,2,True,True,23.272438933333333,-0.12231291487793068
6569,5090018,12981,16,0.87168,254,5168952,-1,240.0,5830857,5843838,740839,12981,164,6,True,True,80.28556799999998,-0.8491547600257989
6570,5091684,9524,128,0.834804,254,5168952,-1,6272.0,8049519,8059043,2957835,9524,80,11,True,True,4769.948076444444,-0.8088477186333399
6571,5094406,6929,64,0.747823,254,5168952,-1,832.0,7639515,7646444,2545109,6929,97,0,True,True,436.29288906666665,-0.7457489606798486
6572,5095444,3,1,0.926237,254,5168952,-1,8.0,5191275,5191278,95831,3,204,1,True,True,0.0008465333333333335,-0.9262370000000002
6573,5095553,8195,223,0.282926,254,5168952,-1,6690.0,9067484,9075679,3971931,8195,27,9,True,True,4562.798317,-0.24562571789921533
6574,5096599,12262,1,0.876936,254,5168952,-1,36.0,5401059,5413321,304460,12262,185,10,True,True,16.280331599999997,-0.8743150309263518
6575,5096743,32,8,0.612932,254,5168952,-1,240.0,5554454,5554486,457711,32,176,8,True,True,0.1844906666666667,-0.612932
6576,5097070,5,32,0.761564,254,5168952,-1,320.0,5502991,5502996,405921,5,181,7,True,True,0.028657777777777782,-0.761564
6577,5100341,7807,1,0.263758,254,5168952,-1,21.0,9498456,9506263,4398115,7807,11,8,True,True,10.639727058333333,-0.26236368965213713
6578,5100628,80,2,0.31301,254,5168952,-1,60.0,8425471,8425551,3324843,80,68,2,True,True,0.2860666666666667,-0.31301000000000007
6579,5100698,194,1,0.892672,254,5168952,-1,21.0,5191425,5191619,90727,194,209,1,True,True,0.14369903333333334,-0.892672
6580,5100889,10353,16,0.315543,254,5168952,-1,224.0,7716615,7726968,2615726,10353,96,10,True,True,98.13776933333334,-0.29773139958333067
6581,5100985,72,32,0.994565,254,5168952,-1,704.0,6019157,6019229,918172,72,160,6,True,True,1.7257523555555556,-0.9667048673396337
6582,5101113,67,1,0.763675,254,5168952,-1,34.0,5191208,5191275,90095,67,214,10,True,True,0.08035012222222222,-0.763675
6583,5101574,67,1,0.151265,254,5168952,-1,45.0,8622642,8622709,3521068,67,64,12,True,True,0.12011424999999998,-0.151265
6584,5101901,4297,16,0.853034,254,5168952,-1,112.0,5224325,5228622,122424,4297,209,7,True,True,20.77846928888889,-0.8296578693481955
6585,5102944,20125,156,0.657419,254,5168952,-1,4992.0,8736767,8756892,3633823,20125,61,6,True,True,3091.8864149333335,-0.6523444322177306
6586,5128242,32,1,0.79822,254,5168952,-1,31.0,5402859,5402891,274617,32,193,7,True,True,0.03696853333333334,-0.79822
6587,5128271,14108,1,0.053222,254,5168952,-1,30.0,9812633,9826741,4684362,14108,4,12,True,True,14.638508083333331,-0.052936667655521914
6588,5128407,7,4,0.148621,254,5168952,-1,116.0,8644742,8644749,3516335,7,66,10,True,True,0.02233451111111111,-0.148621
6589,5130887,635,3,0.229861,254,5168952,-1,105.0,9079279,9079914,3948392,635,27,1,True,True,6.122617083333333,-0.229861
6590,5130920,8067,4,0.035862,254,5168952,-1,112.0,9075679,9083746,3944759,8067,28,2,True,True,85.71891813333333,-0.03583281107869727
6591,5131077,16965,3,0.260224,254,5168952,-1,15.0,8734967,8751932,3603890,16965,66,11,True,True,7.585297416666665,-0.24968890075276354
6592,5131166,38503,256,0.705963,254,5168952,-1,1280.0,5579254,5617757,448088,38503,185,6,True,True,957.7767004444445,-0.6563726554268318
6593,5131444,11072,64,0.43643,254,5168952,-1,2816.0,9406656,9417728,4275212,11072,16,7,True,True,2338.0539619555557,-0.4363018269448942
6594,5131824,305,8,0.995202,254,5168952,-1,280.0,5876857,5877162,745033,305,177,6,True,True,2.3487372222222227,-0.9952020000000003
6595,5131858,6,2,0.927206,254,5168952,-1,46.0,5240095,5240101,108237,6,214,8,True,True,0.011231666666666668,-0.927206
6596,5132001,31,1,0.040792,254,5168952,-1,12.0,9869433,9869464,4737432,31,0,11,True,True,0.028686366666666668,-0.040792
6597,5132627,12,2,0.35652,254,5168952,-1,70.0,8830567,8830579,3697940,12,62,7,True,True,0.025601333333333337,-0.35652
6598,5132646,11,32,0.709029,254,5168952,-1,672.0,7639515,7639526,2506869,11,113,11,True,True,0.5732290666666668,-0.709029
6599,5132768,63,4,0.4852,254,5168952,-1,64.0,5550791,5550854,418023,63,195,6,True,True,0.09717120000000001,-0.4852
6600,5137437,8,32,0.492989,254,5168952,-1,1312.0,8073419,8073427,2935982,8,91,7,True,True,0.9774983111111112,-0.492989
6601,5137751,372,4,0.845838,254,5168952,-1,60.0,5406491,5406863,268740,372,206,2,True,True,0.8282579999999999,-0.845838
6602,5137821,23,16,0.866879,254,5168952,-1,384.0,5402891,5402914,265070,23,207,1,True,True,0.3291392,-0.866879
6603,5138159,13620,64,0.123654,254,5168952,-1,1280.0,9053084,9066704,3914925,13620,36,6,True,True,525.3329635555556,-0.11477237235914181
6604,5138310,12092,4,0.093578,254,5168952,-1,136.0,9097856,9109948,3959546,12092,24,6,True,True,131.73799422222226,-0.09303127466814463
6605,5138315,44,8,0.868173,254,5168952,-1,168.0,5617757,5617801,479442,44,193,10,True,True,0.1990706666666667,-0.868173
6606,5138352,14077,1,0.180655,254,5168952,-1,8.0,9082879,9096956,3944527,14077,30,3,True,True,10.0353742,-0.1806158521264221
6607,5138365,14606,4,0.168295,254,5168952,-1,92.0,8969024,8983630,3830659,14606,60,7,True,True,47.37332795555555,-0.15185585630058204
6608,5138746,14222,1,0.508738,254,5168952,-1,42.0,8447571,8461793,3308825,14222,82,10,True,True,25.71836796666667,-0.5003488379765825
6609,5138845,10425,128,0.272792,254,5168952,-1,4480.0,5192325,5202750,53480,10425,237,6,True,True,1725.8210666666669,-0.26915502563817983
6610,5138867,11468,128,0.890895,254,5168952,-1,5120.0,5378959,5390427,240092,11468,216,6,True,True,2388.9350115555553,-0.8862673275093487
6611,5138915,3,51,0.585677,254,5168952,-1,561.0,8737667,8737670,3598752,3,71,6,True,True,0.04937267500000001,-0.585677
6612,5138991,9793,86,0.583547,254,5168952,-1,1978.0,6430498,6440291,1291507,9793,160,12,True,True,1609.1706860611112,-0.5757703382213267
6613,5139051,14,8,0.971627,254,5168952,-1,152.0,6025498,6025512,886447,14,177,1,True,True,0.08128368888888887,-0.971627
6614,5139119,21313,8,0.526015,254,5168952,-1,88.0,8830567,8851880,3691448,21313,66,0,True,True,60.30899991111111,-0.5160253654993459
6615,5139199,13858,1,0.570788,254,5168952,-1,48.0,5670057,5683915,530858,13858,198,6,True,True,22.268524400000004,-0.5704856302661121
6616,5139261,25,2,0.416419,254,5168952,-1,30.0,8646542,8646567,3507281,25,78,7,True,True,0.020629166666666664,-0.416419
6617,5139386,84,16,0.076835,254,5168952,-1,144.0,6980715,6980799,1841329,84,145,10,True,True,0.31836,-0.076835
6618,5139411,23,2,0.768253,254,5168952,-1,72.0,6745691,6745714,1606280,23,155,12,True,True,0.0521548,-0.768253
6619,5139460,37,1,0.676909,254,5168952,-1,20.0,6020057,6020094,880597,37,184,6,True,True,0.024117833333333335,-0.6769090000000001
6620,5140670,18710,8,0.887368,254,5168952,-1,328.0,6107998,6126708,967328,18710,174,3,True,True,180.59705875555557,-0.87989590921776
8062,6358221,342,32,0.360206,1,6358221,-1,1216.0,6361821,6362163,3600,342,0,8,True,True,10.9928832,-0.36020599999999997
8063,6358266,92,20,0.045754,18,6361821,-1,980.0,13923255,13923347,7564989,92,0,11,True,True,1.6489262222222223,-0.045754
8064,6358282,6,2,0.807558,18,6361821,-1,42.0,6812953,6812959,454671,6,1,6,True,True,0.0024486,-0.807558
8065,6358418,23,9,0.325525,18,6361821,-1,333.0,10906755,10906778,4548337,23,1,2,True,True,0.12305460000000001,-0.325525
8066,6358437,80,1,0.444306,18,6361821,-1,27.0,11274455,11274535,4916018,80,1,12,True,True,0.122688,-0.4443060000000001
8067,6358476,4851,256,0.606763,18,6361821,-1,11008.0,10875655,10880506,4517179,4851,3,11,True,True,944.3743936000001,-0.6047372775424271
8068,6360282,60,1,0.400165,18,6361821,-1,17.0,13184255,13184315,6823973,60,1,12,True,True,0.022083000000000002,-0.400165
8069,6360357,119,32,0.612592,18,6361821,-1,384.0,7929919,7930038,1569562,119,5,9,True,True,1.6255082666666665,-0.612592
8070,6360389,6848,16,0.081369,18,6361821,-1,480.0,14401455,14408303,8041066,6848,0,12,True,True,88.21604133333332,-0.07906956951150494
8071,6360402,49,8,0.427916,18,6361821,-1,384.0,6448221,6448270,87819,49,8,12,True,True,0.7705152,-0.427916
8072,6360462,15084,128,0.931483,18,6361821,-1,1280.0,6953224,6968308,592762,15084,7,11,True,True,671.991808,-0.8894551393557149
8073,6360498,7,1,0.930845,18,6361821,-1,36.0,6759746,6759753,399248,7,9,10,True,True,0.0029224999999999998,-0.930845
8074,6360556,11,8,0.986871,18,6361821,-1,176.0,7283519,7283530,922963,11,7,0,True,True,0.07507915555555555,-0.986871
8075,6360573,29,16,0.8571,18,6361821,-1,336.0,6534621,6534650,174048,29,11,12,True,True,0.4091938666666667,-0.8571
8076,6360604,29,1,0.905203,18,6361821,-1,27.0,6581521,6581550,220917,29,11,6,True,True,0.017841525,-0.905203
8077,6361175,6398,8,0.734278,18,6361821,-1,80.0,7641419,7647817,1280244,6398,7,11,True,True,35.619568,-0.6984480560179869
8078,6361220,21,4,0.293863,18,6361821,-1,176.0,15965855,15965876,9604635,21,0,12,True,True,0.190652,-0.293863
8079,6361398,70,10,0.195077,18,6361821,-1,170.0,13533455,13533525,7172057,70,3,12,True,True,0.48515638888888896,-0.195077
8080,6361540,15,1,0.143161,18,6361821,-1,27.0,7663519,7663534,1301979,15,9,10,True,True,0.025556625,-0.143161
8081,6366417,26,8,0.520054,102,6448221,-1,224.0,13270655,13270681,6904238,26,4,12,True,True,0.11743448888888888,-0.520054
8082,6366489,53,2,0.571893,102,6448221,-1,14.0,10351655,10351708,3985166,53,9,8,True,True,0.019094133333333332,-0.571893
8083,6366594,21937,8,0.856803,102,6448221,-1,280.0,6618921,6640858,252327,21937,17,6,True,True,184.61807855555557,-0.776981950454435
8084,6368106,42,1,0.504637,102,6448221,-1,16.0,11533655,11533697,5165549,42,6,12,True,True,0.015864800000000002,-0.504637
8085,6368627,17831,40,0.127861,102,6448221,-1,800.0,14833455,14851286,8464828,17831,1,12,True,True,550.8238600000001,-0.12496365860861303
8086,6368649,17,16,0.796821,102,6448221,-1,560.0,6728582,6728599,359933,17,19,6,True,True,0.09046644444444446,-0.796821
8087,6368969,47,8,0.301348,102,6448221,-1,184.0,16401471,16401518,10032502,47,0,12,True,True,0.3974716888888889,-0.301348
8088,6369032,435,8,0.673062,102,6448221,-1,216.0,9560225,9560660,3191193,435,13,8,True,True,0.9082799999999999,-0.673062
8089,6369063,6,16,0.548747,102,6448221,-1,544.0,9740225,9740231,3371162,6,13,12,True,True,0.060973333333333345,-0.548747
8090,6369358,62,16,0.874786,102,6448221,-1,176.0,7125708,7125770,756350,62,19,10,True,True,0.09966293333333333,-0.874786
8091,6369380,5642,2,0.168053,102,6448221,-1,36.0,15099855,15105497,8730475,5642,2,8,True,True,5.600814699999999,-0.16752640053143408
8092,6369945,13,1,0.446287,102,6448221,-1,31.0,12838655,12838668,6468710,13,9,12,True,True,0.009200713888888887,-0.446287
8093,6370044,10,4,0.115679,102,6448221,-1,196.0,16532071,16532081,10162027,10,0,12,True,True,0.05054622222222223,-0.115679
8094,6370359,41,4,0.662642,102,6448221,-1,144.0,10094825,10094866,3724466,41,16,12,True,True,0.08372199999999999,-0.6626419999999998
8095,6370436,80,1,0.240902,102,6448221,-1,12.0,12143855,12143935,5773419,80,11,1,True,True,0.019453333333333336,-0.240902
8096,6370648,4,64,0.211641,102,6448221,-1,2304.0,7175348,7175352,804700,4,24,1,True,True,0.06351359999999999,-0.211641
8097,6370678,7258,32,0.753253,102,6448221,-1,896.0,11015255,11022513,4644577,7258,14,12,True,True,155.4935399111111,-0.7224425071576999
8098,6370994,8385,8,0.659745,102,6448221,-1,104.0,10901355,10909740,4530361,8385,16,8,True,True,14.231195333333332,-0.6527301997971933
8099,6371303,23,8,0.089432,102,6448221,-1,384.0,6727682,6727705,356379,23,32,2,True,True,0.09263786666666667,-0.089432
8100,6371759,2185,2,0.434893,102,6448221,-1,32.0,15272655,15274840,8900896,2185,3,12,True,True,1.7108475555555553,-0.43359898636222943
8101,6376479,24,8,0.715765,102,6448221,-1,400.0,7836319,7836343,1459840,24,24,12,True,True,0.26208000000000004,-0.715765
8102,6376561,701,25,0.160235,102,6448221,-1,825.0,10438055,10438756,4061494,701,19,12,True,True,15.55372958333333,-0.16023499999999996
8103,6376661,203,32,0.928967,102,6448221,-1,800.0,6585121,6585324,208460,203,37,8,True,True,3.7356511111111117,-0.928967
8104,6376712,103,5,0.902649,102,6448221,-1,70.0,7440919,7441022,1064207,103,28,11,True,True,0.33093900000000004,-0.902649
8105,6376806,18812,256,0.766309,102,6448221,-1,12032.0,9032625,9051437,2655819,18812,24,2,True,True,3901.445150577778,-0.6878350470455111
8106,6377084,7,2,0.220376,102,6448221,-1,32.0,13447055,13447062,7069971,7,9,12,True,True,0.005990133333333333,-0.220376
8107,6377095,11908,32,0.257629,102,6448221,-1,384.0,9913025,9924933,3535930,11908,23,12,True,True,87.68459946666667,-0.25631363747854613
8108,6377131,47,4,0.476302,102,6448221,-1,120.0,9916625,9916672,3539494,47,23,1,True,True,0.108852,-0.476302
8109,6378238,10,1,0.897511,102,6448221,-1,32.0,7058508,7058518,680270,10,36,11,True,True,0.005182222222222223,-0.897511
8110,6378720,26,11,0.123098,102,6448221,-1,462.0,16225071,16225097,9846351,26,2,12,True,True,0.49582866666666664,-0.123098
8111,6378935,136,8,0.135756,102,6448221,-1,352.0,16052255,16052391,9673320,136,3,12,True,True,2.0713948444444443,-0.135756
8112,6378951,139,64,0.534543,102,6448221,-1,1152.0,8060519,8060658,1681568,139,30,11,True,True,1.5385632,-0.534543
8113,6379393,5,2,0.725414,102,6448221,-1,68.0,7510819,7510824,1131426,5,35,7,True,True,0.013199555555555556,-0.725414
8114,6379472,188,16,0.090442,102,6448221,-1,656.0,11967455,11967643,5587983,188,16,12,True,True,4.558339911111112,-0.090442
8115,6380095,12873,4,0.691785,102,6448221,-1,20.0,10903155,10916028,4523060,12873,21,7,True,True,4.134633666666667,-0.6687697866726181
8116,6391925,24763,3,0.871941,102,6448221,-1,36.0,8354569,8379332,1962644,24763,32,8,True,True,24.961874099999996,-0.8437432013311198
8117,6393083,6,2,0.93178,102,6448221,-1,62.0,6896424,6896430,503341,6,45,2,True,True,0.0070318333333333335,-0.93178
8118,6402404,10865,16,0.766337,102,6448221,-1,496.0,7327719,7338584,925315,10865,40,11,True,True,226.58861688888888,-0.7597458169363647
8119,6402494,34078,256,0.600679,102,6448221,-1,7680.0,10317577,10351655,3915083,34078,26,1,True,True,5603.754986666668,-0.577702424467252
8120,6402669,20,1,0.643987,102,6448221,-1,39.0,9007048,9007068,2604379,20,33,1,True,True,0.007704666666666668,-0.643987
8121,6404470,327,1,0.37701,102,6448221,-1,18.0,12665855,12666182,6261385,327,15,12,True,True,0.1392366,-0.37701
8122,6405043,16695,8,0.717443,102,6448221,-1,144.0,6843224,6859919,438181,16695,50,10,True,True,14.971093999999999,-0.7173709327293767
8123,6405474,12420,141,0.736002,102,6448221,-1,3666.0,9380225,9392645,2974751,12420,33,11,True,True,1299.8382431666666,-0.6576161067374108
8124,6405788,47,4,0.381651,102,6448221,-1,152.0,6900024,6900071,494236,47,50,2,True,True,0.15258393333333334,-0.381651
8125,6406712,10245,128,0.642102,102,6448221,-1,3968.0,7509019,7519264,1102307,10245,43,10,True,True,1361.141011911111,-0.5378017738305398
8126,6406866,2,4,0.5619,102,6448221,-1,172.0,10139066,10139068,3732200,2,28,11,True,True,0.004177688888888888,-0.5619
8127,6409679,62,16,0.856141,102,6448221,-1,752.0,6737584,6737646,327905,62,57,1,True,True,0.4807452444444444,-0.856141
8128,6411880,3461,4,0.808447,102,6448221,-1,100.0,7131135,7134596,719255,3461,49,1,True,True,2.847642222222223,-0.7363551727031805
8129,6412361,433,2,0.223551,102,6448221,-1,52.0,15186255,15186688,8773894,433,6,12,True,True,0.6452084888888888,-0.223551
8130,6412410,16,2,0.11569,102,6448221,-1,88.0,13619855,13619871,7207445,16,11,12,True,True,0.031179377777777774,-0.11569
8131,6412419,8503,32,0.08768,102,6448221,-1,672.0,14140255,14148758,7727836,8503,10,12,True,True,146.4074042666667,-0.07823891542311913
8132,6412478,35,4,0.089139,102,6448221,-1,168.0,15879455,15879490,9466977,35,5,11,True,True,0.244755,-0.089139
8133,6413657,15493,8,0.740581,102,6448221,-1,240.0,9336025,9351518,2922368,15493,39,12,True,True,32.82749933333333,-0.7359844275021764
8134,6413715,7,1,0.937211,102,6448221,-1,45.0,6729482,6729489,315767,7,64,6,True,True,0.002993375,-0.937211
8135,6413904,35,5,0.744618,102,6448221,-1,155.0,6618021,6618056,204117,35,68,8,True,True,0.26930604166666666,-0.744618
8136,6414290,126,1,0.116106,102,6448221,-1,24.0,10142666,10142792,3728376,126,32,8,True,True,0.040740000000000005,-0.116106
8137,6414603,58,4,0.367737,102,6448221,-1,124.0,12233855,12233913,5819252,58,20,12,True,True,0.0867435111111111,-0.367737
8138,6421226,22,8,0.85333,102,6448221,-1,208.0,7014308,7014330,593082,22,59,7,True,True,0.11879804444444443,-0.85333
8139,6421316,4,8,0.954069,102,6448221,-1,376.0,6817524,6817528,396208,4,64,6,True,True,0.011743733333333332,-0.954069
8140,6421412,60,4,0.576917,102,6448221,-1,68.0,6759753,6759813,338341,60,66,1,True,True,0.047316666666666674,-0.576917
8141,6421880,8849,32,0.001678,102,6448221,-1,1216.0,11101655,11110504,4679775,8849,25,12,True,True,75.35573955555556,-0.001612031628247709
8142,6421934,8333,15,0.061885,102,6448221,-1,315.0,13097855,13106188,6675921,8333,18,12,True,True,74.66703475,-0.06087271550972399
8143,6422009,22,1,0.535603,102,6448221,-1,49.0,11188055,11188077,4766046,22,26,12,True,True,0.03839776111111111,-0.535603
8144,6422033,20390,32,0.847119,102,6448221,-1,384.0,6968308,6988698,546275,20390,63,6,True,True,220.90143999999998,-0.8322822829109533
8145,6422764,6751,32,0.979849,102,6448221,-1,1216.0,6588721,6595472,165957,6751,78,2,True,True,227.73292248888887,-0.5757515767521096
8146,6423734,14,1,0.319643,102,6448221,-1,19.0,14226655,14226669,7802921,14,11,12,True,True,0.01085797222222222,-0.319643
8147,6423866,23216,101,0.365024,102,6448221,-1,1616.0,6956824,6980040,532958,23216,65,8,True,True,1155.2477319111113,-0.3548664778520113
8148,6423995,349,4,0.679302,102,6448221,-1,156.0,6715082,6715431,291087,349,78,8,True,True,1.9507587666666668,-0.679302
8149,6424009,34,8,0.796565,102,6448221,-1,312.0,7349819,7349853,925810,34,57,10,True,True,0.14503493333333334,-0.796565
8150,6424161,8,1,0.519751,102,6448221,-1,44.0,8257358,8257366,1833197,8,49,10,True,True,0.013191199999999998,-0.519751
8151,6424189,31,2,0.601618,102,6448221,-1,60.0,6720482,6720513,296293,31,80,1,True,True,0.06671200000000001,-0.601618
8152,6424395,7,1,0.222142,102,6448221,-1,21.0,15489655,15489662,9065260,7,6,12,True,True,0.005150308333333333,-0.222142
8153,6424449,25172,64,0.395312,102,6448221,-1,1152.0,7129308,7154480,704859,25172,64,7,True,True,266.0988928,-0.3911740626960391
8154,6424472,20451,2,0.538293,102,6448221,-1,84.0,6580621,6601072,156149,20451,89,11,True,True,60.24166446666667,-0.49837970738437243
8155,6424527,15,4,0.460603,102,6448221,-1,196.0,10610855,10610870,4186328,15,35,12,True,True,0.04660716666666667,-0.460603
8156,6425008,71,1,0.144701,102,6448221,-1,16.0,15835255,15835326,9410247,71,6,12,True,True,0.04547155555555555,-0.144701
8157,6425300,7485,4,0.94289,102,6448221,-1,192.0,7102708,7110193,677408,7485,68,11,True,True,7.867105066666666,-0.6689692508429812
8158,6425396,13324,16,0.837217,102,6448221,-1,192.0,7259619,7272943,834223,13324,64,10,True,True,24.446576,-0.8144594569198784
8159,6425461,47,1,0.499833,102,6448221,-1,36.0,7227619,7227666,802158,47,65,7,True,True,0.0161304,-0.499833
8160,6425543,224,1,0.455785,102,6448221,-1,7.0,13967455,13967679,7541912,224,15,11,True,True,0.02659937777777778,-0.455785
8161,6425595,2,19,0.601465,102,6448221,-1,532.0,12320255,12320257,5894660,2,25,12,True,True,0.024052311111111113,-0.601465
8162,6425609,443,1,0.145871,102,6448221,-1,28.0,12145655,12146098,5720046,443,27,7,True,True,0.25135327777777783,-0.145871
8163,6426025,8,1,0.665351,102,6448221,-1,40.0,7597219,7597227,1171194,8,61,12,True,True,0.016076444444444445,-0.665351
8164,6426378,7081,128,0.801292,102,6448221,-1,6144.0,9653825,9660906,3227447,7081,49,12,True,True,784.2548565333334,-0.7637075139564214
8165,6426457,11,1,0.702967,102,6448221,-1,46.0,8347358,8347369,1920901,11,56,8,True,True,0.016370505555555553,-0.702967
8166,6455460,21180,4,0.59888,176,6534621,-1,196.0,6716882,6738062,261422,21180,94,7,True,True,72.44008971111111,-0.4962263515625077
8167,6455719,12,32,0.308891,176,6534621,-1,1056.0,15316855,15316867,8861136,12,8,11,True,True,0.30036160000000006,-0.30889099999999997
8168,6455822,29177,128,0.990335,176,6534621,-1,3712.0,9003448,9032625,2547626,29177,56,12,True,True,1979.603093688889,-0.9419407158703792
8169,6455887,16,2,0.123464,176,6534621,-1,20.0,16138655,16138671,9682768,16,3,12,True,True,0.01653688888888889,-0.123464
8170,6456027,100,1,0.996849,176,6534621,-1,47.0,7234819,7234919,778792,100,74,9,True,True,0.04492416666666666,-0.996849
8171,6456047,127,2,0.706522,176,6534621,-1,84.0,8376669,8376796,1920622,127,58,10,True,True,0.24269700000000002,-0.706522
8172,6462804,16,1,0.478283,176,6534621,-1,44.0,8624769,8624785,2161965,16,58,2,True,True,0.01668871111111111,-0.478283
8173,6468167,12202,32,0.828687,176,6534621,-1,896.0,8744248,8756450,2276081,12202,58,11,True,True,268.7244572444444,-0.7837152308570817
8174,6468858,69,16,0.495026,176,6534621,-1,480.0,6816553,6816622,347695,69,93,8,True,True,0.25861199999999995,-0.49502600000000013
8175,6468963,23944,16,0.70414,176,6534621,-1,256.0,11794655,11818599,5325692,23944,32,12,True,True,138.066688,-0.6986567778268918
8176,6470414,2,40,0.376709,176,6534621,-1,600.0,6816622,6816624,346208,2,94,1,True,True,0.00937,-0.376709
8177,6471051,30,4,0.981143,176,6534621,-1,88.0,6846824,6846854,375773,30,92,8,True,True,0.017159999999999998,-0.981143
8178,6472282,19,8,0.333145,176,6534621,-1,232.0,13011455,13011474,6539173,19,25,12,True,True,0.1323257111111111,-0.3331450000000001
8179,6472694,35,2,0.827885,176,6534621,-1,72.0,7012508,7012543,539814,35,88,10,True,True,0.056021,-0.827885
8180,6481475,21285,8,0.210613,176,6534621,-1,80.0,15096255,15117540,8614780,21285,13,8,True,True,40.28174666666667,-0.20234309530213915
8181,6482751,3,1,0.732658,176,6534621,-1,40.0,6789953,6789956,307202,3,101,7,True,True,0.001951,-0.732658
8182,6482913,22,4,0.810419,176,6534621,-1,116.0,8016319,8016341,1533406,22,68,12,True,True,0.05891575555555557,-0.810419
8183,6483235,9208,8,0.700407,176,6534621,-1,272.0,9249625,9258833,2766390,9208,58,12,True,True,25.010612311111114,-0.6984169863289312
8184,6484147,1,32,0.052566,176,6534621,-1,1152.0,11881055,11881056,5396908,1,34,0,True,True,0.034384,-0.052566
8185,6485258,9,16,0.865432,176,6534621,-1,688.0,6711482,6711491,226224,9,114,11,True,True,0.21962679999999998,-0.8654320000000002
8186,6485563,36,20,0.17902,176,6534621,-1,540.0,15662455,15662491,9176892,36,8,12,True,True,0.42503399999999997,-0.17902
8187,6492039,8,26,0.487505,176,6534621,-1,390.0,14747055,14747063,8255016,8,16,12,True,True,0.08206466666666667,-0.487505
8188,6492231,31,32,0.391808,176,6534621,-1,1440.0,6909024,6909055,416793,31,98,1,True,True,1.315516,-0.391808
8189,6495591,2,1,0.98439,176,6534621,-1,8.0,6737582,6737584,241991,2,111,8,True,True,0.00016497777777777775,-0.98439
8190,6495648,26,8,0.65925,176,6534621,-1,96.0,7281719,7281745,786071,26,84,10,True,True,0.042861866666666665,-0.65925
8191,6495954,8,1,0.848518,176,6534621,-1,39.0,6812053,6812061,316099,8,108,10,True,True,0.0030315999999999997,-0.848518
8192,6496746,14074,4,0.991063,176,6534621,-1,132.0,6891024,6905098,394278,14074,102,11,True,True,47.48134893333334,-0.8006979337442873
8193,6498268,835,2,0.547943,176,6534621,-1,44.0,6730382,6731217,232114,835,115,6,True,True,0.34913205555555554,-0.547943
8194,6498325,12165,64,0.33741,176,6534621,-1,1408.0,14270855,14283020,7772530,12165,18,11,True,True,588.0585137777778,-0.32996219794249293
8195,6498584,9640,64,0.677899,176,6534621,-1,1664.0,7176248,7185888,677664,9640,89,6,True,True,96.38098773333333,-0.6474396477358672
8196,6498674,14962,32,0.990314,176,6534621,-1,800.0,6737646,6752608,238972,14962,115,1,True,True,107.33422222222221,-0.9394041987606025
8197,6501826,1213,32,0.757714,176,6534621,-1,1312.0,7442719,7443932,940893,1213,81,7,True,True,67.44236871111111,-0.757714
8198,6502035,6153,1,0.391063,176,6534621,-1,30.0,10741455,10747608,4239420,6153,48,11,True,True,4.5827785,-0.38397845204846665
8199,6502111,9289,8,0.527844,176,6534621,-1,120.0,8347369,8356658,1845258,9289,71,1,True,True,29.361910333333334,-0.4874684140540503
8200,6502185,26,1,0.28304,176,6534621,-1,8.0,16315071,16315097,9812886,26,2,12,True,True,0.009587644444444444,-0.28304
8201,6502386,77,27,0.696376,176,6534621,-1,675.0,6724082,6724159,221696,77,126,2,True,True,1.125403125,-0.696376
8202,6504417,98,8,0.195092,176,6534621,-1,88.0,16445671,16445769,9941254,98,1,11,True,True,0.22832039999999998,-0.195092
8203,6506506,16072,16,0.856252,176,6534621,-1,576.0,7201048,7217120,694542,16072,94,7,True,True,103.94754559999998,-0.8525106079640122
8204,6506530,393,2,0.393772,176,6534621,-1,60.0,12493055,12493448,5986525,393,34,12,True,True,0.547187,-0.393772
8205,6506670,9,10,0.130901,176,6534621,-1,60.0,8830648,8830657,2323978,9,70,12,True,True,0.0077339999999999996,-0.130901
8206,6506850,53,32,0.752266,176,6534621,-1,1120.0,8343758,8343811,1836908,53,77,12,True,True,2.2922853333333335,-0.7522660000000002
8207,6506902,10238,16,0.580384,176,6534621,-1,656.0,6623082,6633320,116180,10238,136,1,True,True,201.39880053333331,-0.4999487525964618
8208,6514749,11,4,0.805072,176,6534621,-1,148.0,6614421,6614432,99672,11,139,10,True,True,0.07664262222222222,-0.805072
8209,6515182,17122,16,0.84981,176,6534621,-1,640.0,7237519,7254641,722337,17122,95,7,True,True,176.0103537777778,-0.8375534227955235
8210,6515205,5924,65,0.709588,176,6534621,-1,2405.0,7396719,7402643,881514,5924,90,7,True,True,527.8676445972221,-0.6394777172524541
8211,6515302,21,4,0.457533,176,6534621,-1,180.0,10003025,10003046,3487723,21,59,12,True,True,0.07386749999999999,-0.457533
8212,6515336,13,4,0.163694,176,6534621,-1,156.0,15748855,15748868,9233519,13,10,12,True,True,0.07118843333333333,-0.163694
8213,6518831,318,1,0.137561,176,6534621,-1,23.0,9567425,9567743,3048594,318,65,9,True,True,0.09410679999999999,-0.13756100000000002
8214,6519316,9030,256,0.695956,176,6534621,-1,1536.0,6761553,6770583,242237,9030,127,7,True,True,161.7145728,-0.6821361826541845
8215,6520167,30595,8,0.291082,176,6534621,-1,56.0,10827855,10858450,4307688,30595,52,12,True,True,43.256038000000004,-0.2896421612024453
8216,6521012,76,8,0.144823,176,6534621,-1,136.0,11708255,11708331,5187243,76,43,12,True,True,0.2332777777777778,-0.144823
8217,6521112,549,11,0.218136,176,6534621,-1,429.0,14053855,14054404,7532743,549,24,12,True,True,6.03590845,-0.19497503119550477
8218,6521118,54,4,0.748383,176,6534621,-1,32.0,6592321,6592375,71203,54,149,1,True,True,0.054168,-0.748383
8219,6523224,6,4,0.735319,176,6534621,-1,44.0,10004825,10004831,3481601,6,63,7,True,True,0.006837599999999999,-0.735319
8220,6523228,25123,128,0.009133,176,6534621,-1,3456.0,15403255,15428378,8880027,25123,13,12,True,True,5722.6640928,-0.008979090286437215
8221,6523268,45,32,0.725958,176,6534621,-1,1440.0,6667282,6667327,144014,45,147,11,True,True,0.61776,-0.725958
8222,6523290,5278,1,0.575682,176,6534621,-1,23.0,7922719,7927997,1399429,5278,90,12,True,True,4.827246197222222,-0.5484701088379016
8223,6523551,26792,8,0.678318,176,6534621,-1,376.0,8350969,8377761,1827418,26792,83,8,True,True,277.42214777777775,-0.646474517338829
8224,6523577,26,32,0.988484,176,6534621,-1,512.0,8060658,8060684,1537081,26,88,1,True,True,0.12790613333333334,-0.988484
8225,6523687,13863,2,0.147605,176,6534621,-1,94.0,13357055,13370918,6833368,13863,31,12,True,True,27.207191583333334,-0.1328296622756067
8226,6523887,47,32,0.950398,176,6534621,-1,960.0,7283519,7283566,759632,47,106,7,True,True,1.7497786666666668,-0.950398
8227,6525544,23,3,0.427111,176,6534621,-1,141.0,10697255,10697278,4171711,23,58,12,True,True,0.09354253333333334,-0.427111
8228,6525619,311,2,0.84166,176,6534621,-1,32.0,10317266,10317577,3791647,311,63,7,True,True,0.10684577777777778,-0.84166
8229,6525992,180,14,0.925985,176,6534621,-1,406.0,6892824,6893004,366832,180,130,6,True,True,2.0023920000000004,-0.925985
8230,6526033,15294,16,0.096048,176,6534621,-1,128.0,16228671,16243965,9702638,15294,4,8,True,True,78.9516544,-0.09416903844904537
8231,6526045,205,1,0.974159,176,6534621,-1,34.0,6788153,6788358,262108,205,141,2,True,True,0.11721216666666666,-0.974159
8232,6526122,1222,1,0.179633,176,6534621,-1,49.0,14487855,14489077,7961733,1222,22,12,True,True,1.3482529666666667,-0.179633
8233,6526796,10402,8,0.052472,176,6534621,-1,232.0,11360855,11371257,4834059,10402,50,12,True,True,82.33096842222223,-0.051369390226049874
8234,6526905,17,2,0.980277,176,6534621,-1,78.0,6536421,6536438,9516,17,169,7,True,True,0.05568463333333334,-0.980277
8235,6526907,11573,6,0.650098,176,6534621,-1,234.0,7201948,7213521,675041,11573,117,6,True,True,30.850810250000006,-0.6466132370789203
8236,6526938,14957,64,0.593392,176,6534621,-1,384.0,9163225,9178182,2636287,14957,81,12,True,True,67.3248384,-0.5803206024023536
8237,6527026,8,13,0.969727,176,6534621,-1,247.0,6891924,6891932,364898,8,136,6,True,True,0.0541424,-0.969727
8238,6531734,19,16,0.626973,176,6534621,-1,512.0,14574255,14574274,8042521,19,22,12,True,True,0.30397297777777776,-0.626973
8239,6531754,102,4,0.403994,176,6534621,-1,136.0,10524455,10524557,3992701,102,64,12,True,True,0.33747493333333334,-0.40399399999999996
8240,6533797,30,16,0.033993,176,6534621,-1,320.0,8621169,8621199,2087372,30,90,7,True,True,0.19461333333333333,-0.033993
8241,6537960,162,32,0.240855,196,6580621,-1,640.0,13706255,13706417,7168295,162,31,12,True,True,4.433472,-0.240855
8242,6537985,38206,4,0.488626,196,6580621,-1,44.0,10928855,10967061,4390870,38206,57,0,True,True,25.00952947777777,-0.47428429945517253
8243,6539007,11,16,0.687984,196,6580621,-1,304.0,8694669,8694680,2155662,11,91,11,True,True,0.08706475555555557,-0.687984
8244,6547958,81,1,0.954555,196,6580621,-1,7.0,7394919,7395000,846961,81,115,11,True,True,0.022892625,-0.954555
8245,6547981,6,8,0.652797,196,6580621,-1,240.0,6903624,6903630,355643,6,140,2,True,True,0.048112,-0.652797
8246,6548054,15766,1,0.375372,196,6580621,-1,41.0,11881055,11896821,5333001,15766,49,12,True,True,18.62109117777778,-0.3723625370470566
8247,6548764,1472,6,0.691795,196,6580621,-1,264.0,10229066,10230538,3680302,1472,72,12,True,True,5.359552000000001,-0.691795
8248,6549100,15973,4,0.795325,196,6580621,-1,148.0,6821124,6837097,272024,15973,150,8,True,True,13.645783766666666,-0.7571164964412019
8249,6549404,11,16,0.658519,196,6580621,-1,512.0,8696480,8696491,2147076,11,93,7,True,True,0.1466353777777778,-0.658519
8250,6549461,127,2,0.777731,196,6580621,-1,40.0,8148858,8148985,1599397,127,104,7,True,True,0.06245577777777777,-0.777731
8251,6549590,12228,128,0.864896,196,6580621,-1,5248.0,6905424,6917652,355834,12228,144,7,True,True,1739.4083157333334,-0.81624163916188
8252,6550270,447,16,0.650311,196,6580621,-1,640.0,7350719,7351166,800449,447,120,6,True,True,3.9113493333333333,-0.650311
8253,6550672,574,8,0.275216,196,6580621,-1,320.0,15006255,15006829,8455583,574,20,12,True,True,5.651221333333334,-0.27521599999999996
8254,6550906,17,1,0.653195,196,6580621,-1,43.0,6784553,6784570,233647,17,163,6,True,True,0.012315319444444445,-0.653195
8255,6551317,9,4,0.367323,196,6580621,-1,44.0,12406655,12406664,5855338,9,44,12,True,True,0.015252599999999998,-0.367323
8256,6555872,21,16,0.12,196,6580621,-1,80.0,14660655,14660676,8104783,21,23,12,True,True,0.06929533333333335,-0.12
8257,6556914,38837,32,0.082637,196,6580621,-1,1536.0,15092655,15131492,8535741,38837,20,12,True,True,1393.4442367999998,-0.07971167469978023
8258,6556980,7,1,0.489218,196,6580621,-1,32.0,9556625,9556632,2999645,7,88,12,True,True,0.0022362666666666665,-0.489218
8259,6557207,20,8,0.668792,196,6580621,-1,360.0,11620055,11620075,5062848,20,56,12,True,True,0.17824,-0.668792
8260,6557226,30122,16,0.509748,196,6580621,-1,224.0,12147455,12177577,5590229,30122,49,7,True,True,147.45529866666666,-0.5062412507145256
8261,6560365,24923,8,0.023027,196,6580621,-1,152.0,16618481,16643404,10058116,24923,0,12,True,True,295.26104837777774,-0.021845459454186707
8262,6561375,4,4,0.572982,196,6580621,-1,140.0,7177148,7177152,615773,4,140,6,True,True,0.003859333333333333,-0.572982
8263,6584225,8636,32,0.572631,198,6585121,-1,384.0,8700048,8708684,2115823,8636,101,1,True,True,77.08191573333333,-0.46656867122489765
8264,6584326,115,1,0.273725,198,6585121,-1,14.0,13792655,13792770,7208329,115,35,12,True,True,0.05801366666666666,-0.273725
8265,6584470,5285,1,0.745359,198,6585121,-1,13.0,8650469,8655754,2065999,5285,105,8,True,True,1.1334988166666666,-0.6309546519003569
8266,6584524,17,8,0.794344,198,6585121,-1,368.0,10008425,10008442,3423901,17,84,8,True,True,0.11149582222222222,-0.794344
8267,6586397,15006,2,0.181097,198,6588721,-1,36.0,8549469,8564475,1963072,15006,109,12,True,True,15.4184712,-0.1700292667009595
8268,6595995,36,1,0.484191,246,6614421,-1,19.0,8463069,8463105,1867074,36,110,12,True,True,0.0091219,-0.484191
8269,6598188,13,2,0.644597,246,6614421,-1,100.0,7175335,7175348,577147,13,149,11,True,True,0.008959166666666666,-0.644597
8270,6598204,29295,1,0.433656,246,6614421,-1,18.0,8619369,8648664,2021165,29295,109,10,True,True,10.5484143,-0.42012559561346263
8271,6598230,8526,1,0.571423,246,6614421,-1,28.0,8553069,8561595,1954839,8526,110,7,True,True,6.448051633333333,-0.5024325846740079
8272,6598245,6341,32,0.099441,246,6614421,-1,928.0,14315055,14321396,7716810,6341,29,11,True,True,134.0169344,-0.09807567984930343
8273,6598319,6,32,0.063498,246,6614421,-1,1440.0,15576055,15576061,8977736,6,14,12,True,True,0.17892000000000002,-0.063498
8274,6598385,98,4,0.908881,246,6614421,-1,32.0,8646869,8646967,2048484,98,109,10,True,True,0.0708736,-0.908881
8275,6598409,63,4,0.795225,246,6614421,-1,200.0,6816624,6816687,218215,63,177,1,True,True,0.09838500000000001,-0.795225
8276,6598586,39,1,0.18489,246,6614421,-1,42.0,10928855,10928894,4330269,39,69,10,True,True,0.028660450000000004,-0.18489
8277,6598637,103,32,0.812868,246,6614421,-1,736.0,8917048,8917151,2318411,103,104,12,True,True,0.5710869333333333,-0.812868
8278,6601227,155,32,0.019746,246,6614421,-1,1280.0,16704881,16705036,10103654,155,0,12,True,True,12.510222222222222,-0.019746000000000003
8279,6601244,6,11,0.55606,246,6614421,-1,132.0,8551269,8551275,1950025,6,117,7,True,True,0.026919200000000004,-0.55606
8280,6601275,10,1,0.536417,246,6614421,-1,34.0,7749919,7749929,1148644,10,134,12,True,True,0.007440333333333334,-0.536417
8281,6601296,8,1,0.812196,246,6614421,-1,9.0,6990408,6990416,389112,8,167,10,True,True,0.0019636,-0.812196
8282,6601430,4,2,0.488563,246,6614421,-1,94.0,7199248,7199252,597818,4,156,10,True,True,0.003220022222222222,-0.488563
8283,6601507,326,2,0.518901,246,6614421,-1,64.0,9076825,9077151,2475318,326,102,11,True,True,0.20290239999999998,-0.518901
8284,6601557,3,8,0.584722,246,6614421,-1,40.0,8597269,8597272,1995712,3,117,11,True,True,0.003608666666666667,-0.584722
8285,6601724,7,16,0.713749,246,6614421,-1,368.0,9470225,9470232,2868501,7,98,12,True,True,0.10353373333333334,-0.713749
8286,6601793,12,2,0.790068,246,6614421,-1,82.0,6957724,6957736,355931,12,173,6,True,True,0.03960053333333334,-0.790068
8287,6602243,16242,8,0.124089,246,6614421,-1,168.0,12752255,12768497,6150012,16242,49,12,True,True,57.6274468,-0.12194838284416147
8288,6602328,45256,3,0.752988,246,6614421,-1,63.0,11447255,11492511,4844927,45256,65,12,True,True,86.53813525,-0.7399238713455892
8289,6602357,1768,4,0.965681,246,6614421,-1,48.0,8698280,8700048,2095923,1768,113,7,True,True,2.293921066666667,-0.965681
8290,6602381,3627,16,0.897602,246,6614421,-1,624.0,7127508,7131135,525127,3627,169,7,True,True,20.4753744,-0.8891798425366577
8291,6602432,111,70,0.180664,246,6614421,-1,420.0,7103608,7103719,501176,111,171,6,True,True,0.2350425,-0.180664
8292,6602439,5630,63,0.599103,246,6614421,-1,1134.0,10897755,10903385,4295316,5630,76,10,True,True,96.86913075,-0.5838597964699381
8293,6602850,587,4,0.179938,246,6614421,-1,72.0,13879055,13879642,7276205,587,38,12,True,True,1.315467,-0.179938
8294,6602886,1,8,0.554722,246,6614421,-1,88.0,12053855,12053856,5450969,1,59,12,True,True,0.0028714888888888884,-0.5547219999999999
8295,6602918,561,8,0.800513,246,6614421,-1,224.0,6622521,6623082,19603,561,221,1,True,True,5.303718933333332,-0.800513
8296,6602928,8,1,0.123045,246,6614421,-1,22.0,14919855,14919863,8316927,8,25,12,True,True,0.006654755555555555,-0.123045
8297,6602934,6208,3,0.128816,246,6614421,-1,99.0,13360655,13366863,6757721,6208,45,8,True,True,11.5617337,-0.10605375732045053
8298,6603044,9451,256,0.20623,246,6614421,-1,4352.0,16138671,16148122,9535627,9451,8,1,True,True,2032.2149248,-0.19703215988533243
8299,6603431,3571,256,0.16121,246,6614421,-1,5888.0,7224048,7227619,620617,3571,166,10,True,True,206.76026026666668,-0.15149848057944282
8300,6603479,6939,4,0.562496,246,6614421,-1,168.0,10094866,10101805,3491387,6939,95,1,True,True,15.715732666666668,-0.553646179079352
8301,6603637,8,1,0.85145,246,6614421,-1,39.0,10315466,10315474,3711829,8,92,12,True,True,0.0033496666666666666,-0.85145
8302,6603653,369,2,0.035005,246,6614421,-1,66.0,9383825,9384194,2780172,369,109,8,True,True,0.6536343,-0.035005
8303,6603719,80,8,0.979928,246,6614421,-1,296.0,7235719,7235799,632000,80,167,6,True,True,0.2263413333333333,-0.979928
8304,6604464,116,12,0.506148,246,6614421,-1,96.0,10831455,10831571,4226991,116,83,8,True,True,0.28440106666666665,-0.506148
8305,6604573,1322,28,0.36356,246,6614421,-1,1120.0,9826625,9827947,3222052,1322,104,12,True,True,13.905677333333335,-0.36356
8306,6604621,9127,32,0.544427,246,6614421,-1,1088.0,6783653,6792780,179032,9127,214,10,True,True,165.13874044444447,-0.5417931087742501
8307,6604631,7934,1,0.423051,246,6614421,-1,8.0,12140255,12148189,5535624,7934,62,12,True,True,1.2982034222222225,-0.4166446498398026
8308,6606881,33034,2,0.945228,246,6614421,-1,18.0,8147058,8180092,1540177,33034,146,12,True,True,17.2725092,-0.8982276675418756
8309,6606899,42,16,8.6e-05,246,6614421,-1,592.0,16532081,16532123,9925182,42,2,1,True,True,0.6412149333333333,-8.6e-05
8310,6606945,21,64,0.3006,246,6614421,-1,1920.0,12579455,12579476,5972510,21,56,12,True,True,0.7804160000000001,-0.3006
8311,6606974,17,16,0.946215,246,6614421,-1,688.0,6733982,6733999,127008,17,225,2,True,True,0.12813617777777778,-0.946215
8312,6607002,13375,128,0.519443,246,6614421,-1,1152.0,11621855,11635230,5014853,13375,71,7,True,True,523.2715039999999,-0.4944043718121735
8313,6607032,18378,32,0.782802,246,6614421,-1,1376.0,8235258,8253636,1628226,18378,148,12,True,True,1012.5113450666664,-0.7597211082770587
8314,6607069,163,13,0.659158,246,6614421,-1,598.0,8694680,8694843,2087611,163,130,1,True,True,2.5378438944444444,-0.659158
8315,6607310,9106,128,0.44492,246,6614421,-1,6272.0,12925055,12934161,6317745,9106,53,12,True,True,1251.539724088889,-0.4397255503087333
8316,6607654,318,16,0.577071,246,6614421,-1,560.0,8257358,8257676,1649704,318,149,0,True,True,6.673548,-0.577071
8317,6607660,14,1,0.695101,246,6614421,-1,41.0,7486919,7486933,879259,14,166,11,True,True,0.02486376666666667,-0.695101
4463,3615840,28,1,0.996973,1,3615840,-1,35.0,3702240,3702268,86400,28,0,12,True,True,0.012233666666666667,-0.996973
4464,3615880,7607,32,0.625132,177,3702240,-1,1600.0,8762341,8769948,5146461,7607,0,12,True,True,259.3718488888889,-0.5848451869068467
4465,3615923,14759,32,0.059775,177,3702240,-1,832.0,13468097,13482856,9852174,14759,0,12,True,True,517.3475539555556,-0.05298170953510887
4466,3615992,10,32,0.644575,177,3702240,-1,640.0,7117722,7117732,3501730,10,2,12,True,True,0.21514666666666668,-0.644575
4467,3627860,12820,256,0.701328,177,3702240,-1,4864.0,6576513,6589333,2948653,12820,3,11,True,True,957.1597269333332,-0.561404857973446
4468,3628129,6,4,0.791466,177,3702240,-1,140.0,4171807,4171813,543678,6,4,11,True,True,0.009037,-0.791466
4469,3628218,19,32,0.125827,177,3702240,-1,1600.0,7927541,7927560,4299323,19,2,12,True,True,1.0445777777777778,-0.125827
4470,3628580,26,4,0.232675,177,3702240,-1,172.0,4079807,4079833,451227,26,6,8,True,True,0.14335244444444442,-0.232675
4471,3628688,27,16,0.981676,177,3702240,-1,512.0,4216007,4216034,587319,27,5,11,True,True,0.12771839999999998,-0.981676
4472,3628874,34,4,0.788562,177,3702240,-1,24.0,4081607,4081641,452733,34,7,6,True,True,0.026157333333333338,-0.788562
4473,3628952,22,8,0.756698,177,3702240,-1,400.0,7314422,7314444,3685470,22,3,12,True,True,0.22594000000000006,-0.756698
4474,3628991,27,1,0.805525,177,3702240,-1,30.0,4071988,4072015,442997,27,10,8,True,True,0.014427,-0.805525
4475,3641283,24,10,0.438719,177,3702240,-1,310.0,4012366,4012390,371083,24,11,8,True,True,0.18442933333333333,-0.438719
4476,3641363,6696,4,0.192965,177,3702240,-1,136.0,8407741,8414437,4766378,6696,2,12,True,True,17.042650733333335,-0.1927840954407011
4477,3643034,67,1,0.68925,177,3702240,-1,50.0,4400707,4400774,757673,67,7,6,True,True,0.041521388888888885,-0.68925
4478,3643821,17,8,0.358167,177,3702240,-1,304.0,5242687,5242704,1598866,17,7,12,True,True,0.053488799999999996,-0.358167
4479,3659990,2,4,0.134732,177,3702240,-1,120.0,12774897,12774899,9114907,2,1,12,True,True,0.00624,-0.134732
4480,3660044,204,25,0.898663,177,3702240,-1,425.0,3986666,3986870,326622,204,16,1,True,True,1.0589441666666666,-0.898663
4481,3660260,7004,128,0.485302,177,3702240,-1,2176.0,4819187,4826191,1158927,7004,9,11,True,True,216.9211786666667,-0.43507342079873546
4482,3660679,5,16,0.4375,177,3702240,-1,368.0,12383297,12383302,8722618,5,2,12,True,True,0.12431244444444446,-0.4375
4483,3660746,5,1,0.294715,177,3702240,-1,13.0,8102341,8102346,4441595,5,5,10,True,True,0.0008641388888888888,-0.294715
4484,3660784,140,34,0.697038,177,3702240,-1,1360.0,4017766,4017906,356982,140,18,6,True,True,6.926857777777778,-0.697038
4485,3660860,9450,32,0.189776,177,3702240,-1,1088.0,10554994,10564444,6894134,9450,3,1,True,True,258.9435950222222,-0.17553727040343386
4486,3661028,773,1,0.186627,177,3702240,-1,37.0,11041097,11041870,7380069,773,3,12,True,True,0.8161426083333333,-0.1601783967216084
4487,3661037,3,2,0.347665,177,3702240,-1,30.0,7949641,7949644,4288604,3,8,10,True,True,0.0025697500000000004,-0.347665
4488,3661057,9,16,0.732402,177,3702240,-1,192.0,3968651,3968660,307594,9,24,1,True,True,0.019435200000000003,-0.732402
4489,3661097,2714,1,0.275324,177,3702240,-1,42.0,7839322,7842036,4178225,2714,10,11,True,True,3.5180352666666668,-0.27450263828723576
4490,3661187,11,16,0.83135,177,3702240,-1,96.0,7139822,7139833,3478635,11,12,10,True,True,0.036018400000000006,-0.83135
4491,3661202,4,6,0.914474,177,3702240,-1,210.0,5152687,5152691,1491485,4,16,7,True,True,0.017308666666666667,-0.914474
4492,3661241,8,1,0.55452,177,3702240,-1,27.0,4067480,4067488,406239,8,24,11,True,True,0.0035808,-0.55452
4493,3661274,20842,1,0.068877,177,3702240,-1,13.0,14078497,14099339,10417223,20842,0,12,True,True,11.263787888888888,-0.06265911493166147
4494,3661337,35594,16,0.155025,177,3702240,-1,656.0,10205541,10241135,6544204,35594,6,12,True,True,622.4656225777777,-0.15359500708410886
4495,3661440,101,8,0.295673,177,3702240,-1,368.0,8852341,8852442,5190901,101,7,8,True,True,0.7273509777777778,-0.26237545286148467
4496,3661501,63,1,0.263349,177,3702240,-1,42.0,11951297,11951360,8289796,63,4,11,True,True,0.10373055,-0.263349
4497,3662111,8148,64,0.367113,177,3702240,-1,832.0,8585941,8594089,4923830,8148,10,12,True,True,192.01881226666666,-0.3575328188826533
4498,3662159,5579,4,0.00072,177,3702240,-1,136.0,12644297,12649876,8982138,5579,3,7,True,True,28.397085977777778,-0.0007151261874570038
4499,3662220,11570,1,0.638026,177,3702240,-1,10.0,5143687,5155257,1481467,11570,23,11,True,True,2.1018344444444446,-0.5979346254616857
4500,3663788,609,1,0.379044,177,3702240,-1,5.0,6595722,6596331,2931934,609,20,8,True,True,0.020350749999999997,-0.3790439999999999
4501,3663875,76,8,0.185534,177,3702240,-1,240.0,11820697,11820773,8156822,76,6,12,True,True,0.7732746666666667,-0.185534
4502,3663967,14665,10,0.01872,177,3702240,-1,460.0,9597141,9611806,5933174,14665,10,6,True,True,122.9988198888889,-0.018615380958839967
4503,3664153,27,2,0.856829,177,3702240,-1,40.0,4076207,4076234,412054,27,33,2,True,True,0.030233999999999997,-0.856829
4504,3664169,5448,2,0.776017,177,3702240,-1,56.0,3898751,3904199,234582,5448,40,1,True,True,8.389607333333334,-0.66269176280977
4505,3664201,8450,4,0.238787,177,3702240,-1,48.0,9419841,9428291,5755640,8450,11,11,True,True,7.627766533333333,-0.2386555873141129
4506,3664343,84,16,0.721004,177,3702240,-1,144.0,6246507,6246591,2582164,84,25,7,True,True,0.2621136,-0.721004
4507,3664361,91,1,0.658289,177,3702240,-1,18.0,4023166,4023257,358805,91,38,7,True,True,0.06491029999999999,-0.658289
4508,3664393,22,2,0.538957,177,3702240,-1,80.0,6768522,6768544,3104129,22,23,12,True,True,0.0792928888888889,-0.538957
4509,3664433,6,13,0.387491,177,3702240,-1,65.0,8277141,8277147,4612708,6,16,12,True,True,0.0073244166666666674,-0.387491
4510,3664610,111,4,0.52407,177,3702240,-1,188.0,3898640,3898751,234030,111,46,1,True,True,0.6735147,-0.52407
4511,3664644,4,32,0.497549,177,3702240,-1,1600.0,6130807,6130811,2466163,4,28,12,True,True,0.07475555555555555,-0.497549
4512,3664668,188,32,0.551468,177,3702240,-1,160.0,9352641,9352829,5687973,188,12,12,True,True,1.174703111111111,-0.550682525647826
4513,3664712,4,8,0.613039,177,3702240,-1,64.0,8940741,8940745,5276029,4,13,11,True,True,0.006845866666666666,-0.613039
4514,3664784,6124,1,0.3226,177,3702240,-1,32.0,8848741,8854865,5183957,6124,15,12,True,True,3.8607922666666665,-0.2517874698908714
4515,3664816,16150,121,0.640904,177,3702240,-1,1815.0,8411341,8427491,4746525,16150,18,8,True,True,607.8926512083333,-0.6396040850355741
4516,3665011,232,32,0.110464,177,3702240,-1,992.0,11734297,11734529,8069286,232,7,11,True,True,9.253067377777777,-0.110464
4517,3665100,33,4,0.523201,177,3702240,-1,104.0,10291941,10291974,6626841,33,10,12,True,True,0.09782153333333332,-0.523201
4518,3665246,165,101,0.06668,177,3702240,-1,4242.0,14341297,14341462,10676051,165,0,8,True,True,16.9655255,-0.06668
4519,3665281,7,64,0.835193,177,3702240,-1,2880.0,4636987,4636994,971706,7,40,6,True,True,0.9102800000000001,-0.835193
4520,3665449,6317,8,0.129774,177,3702240,-1,104.0,11258097,11264414,7592648,6317,9,12,True,True,50.60668079999999,-0.12785652622372956
4521,3665460,328,4,0.873493,177,3702240,-1,88.0,3942951,3943279,277491,328,55,11,True,True,0.660264,-0.873493
4522,3665924,9014,74,0.202079,177,3702240,-1,2220.0,4260207,4269221,594283,9014,43,11,True,True,975.9977968333335,-0.20198371524343847
4523,3665959,15066,4,0.48537,177,3702240,-1,128.0,3841840,3856906,175881,15066,59,11,True,True,50.5847296,-0.4552950660084947
4524,3665973,7608,3,0.098754,177,3702240,-1,15.0,13819297,13826905,10153324,7608,2,12,True,True,3.2050892916666665,-0.09853410418930142
4525,3666177,10056,113,0.571012,177,3702240,-1,1921.0,9049241,9059297,5383064,10056,18,12,True,True,290.69638688611116,-0.5587559784922896
4526,3666436,7,1,0.8363,177,3702240,-1,10.0,4636087,4636094,969651,7,44,12,True,True,0.0031626388888888893,-0.8363
4527,3667058,8,8,0.657921,177,3702240,-1,48.0,9375641,9375649,5708583,8,17,6,True,True,0.011963733333333332,-0.657921
4528,3667074,37,8,0.525821,177,3702240,-1,136.0,4013266,4013303,346192,37,57,6,True,True,0.12473768888888889,-0.525821
4529,3668186,12,8,0.701314,177,3702240,-1,72.0,5011087,5011099,1342901,12,43,8,True,True,0.0297312,-0.7013140000000001
4530,3668196,39839,1,0.255939,177,3702240,-1,44.0,10382141,10421980,6713945,39839,13,11,True,True,68.99720654444445,-0.2559141757320471
4531,3668426,38,4,0.366354,177,3702240,-1,24.0,4408807,4408845,740381,38,48,7,True,True,0.0068704000000000005,-0.366354
4532,3668615,13,64,0.605954,177,3702240,-1,640.0,6044407,6044420,2375792,13,41,10,True,True,0.10899199999999999,-0.605954
4533,3668830,23991,4,0.070874,177,3702240,-1,92.0,12210497,12234488,8541667,23991,7,12,True,True,157.0870554888889,-0.06974003180849069
4534,3668847,12081,256,0.930211,177,3702240,-1,12288.0,5459704,5471785,1790857,12081,43,12,True,True,2469.826628266667,-0.9286740165788891
4535,3668865,5,1,0.208738,177,3702240,-1,33.0,6591222,6591227,2922357,5,39,0,True,True,0.0012031250000000002,-0.208738
4536,3669374,4541,184,0.491406,177,3702240,-1,4048.0,7622322,7626863,3952948,4541,34,12,True,True,509.61339097777784,-0.4812434225911584
4537,3669407,7819,4,0.889767,177,3702240,-1,96.0,4068388,4076207,398981,7819,62,6,True,True,13.741469333333335,-0.729047930083272
4538,3669434,2,4,0.079957,177,3702240,-1,112.0,10606394,10606396,6936960,2,13,11,True,True,0.004689688888888889,-0.079957
4539,3669546,5723,2,0.80102,177,3702240,-1,38.0,8497741,8503464,4828195,5723,28,12,True,True,7.038562138888889,-0.785851134663293
4540,3669588,33704,64,0.0607,177,3702240,-1,1024.0,10607294,10640998,6937706,33704,13,6,True,True,737.6423310222222,-0.06039664058611105
4541,3669597,10,1,0.55802,177,3702240,-1,26.0,8321341,8321351,4651744,10,32,11,True,True,0.00546,-0.55802
4542,3670045,612,43,0.938244,177,3702240,-1,430.0,4549687,4550299,879642,612,57,11,True,True,5.256621,-0.938244
4543,3670118,3,16,0.415953,177,3702240,-1,96.0,11085297,11085300,7415179,3,12,11,True,True,0.010296800000000002,-0.415953
4544,3670126,12,8,0.369069,177,3702240,-1,120.0,5632504,5632516,1962378,12,50,12,True,True,0.017488,-0.36906900000000004
4545,3670158,26577,128,0.708434,177,3702240,-1,4352.0,7535922,7562499,3865764,26577,40,7,True,True,3468.9784384,-0.7024346638114257
4546,3670351,9,2,0.823643,177,3702240,-1,70.0,3705840,3705849,35489,9,82,8,True,True,0.011838750000000002,-0.823643
4547,3670440,3747,1,0.265816,177,3702240,-1,30.0,7316222,7319969,3645782,3747,41,7,True,True,2.534121916666667,-0.25255781757515594
4548,3672786,28250,128,0.040653,177,3702240,-1,4224.0,14427697,14455947,10754911,28250,0,12,True,True,3532.8478944000003,-0.039619557250660964
4549,3672822,13457,128,0.070388,177,3702240,-1,3072.0,11907097,11920554,8234275,13457,10,12,True,True,1301.3537706666668,-0.06433476219801419
4550,3673201,21313,16,0.303905,177,3702240,-1,144.0,12861297,12882610,9188096,21313,5,0,True,True,76.790168,-0.28654832633785515
4551,3673565,89,1,0.944603,177,3702240,-1,12.0,4398007,4398096,724442,89,67,7,True,True,0.012012033333333333,-0.9446029999999999
4552,3673625,16711,4,0.960587,177,3702240,-1,68.0,4681187,4697898,1007562,16711,62,11,True,True,19.42196091111111,-0.956874586491413
4553,3673741,75,2,0.097119,177,3702240,-1,16.0,13164697,13164772,9490956,75,5,12,True,True,0.029973333333333334,-0.097119
4554,3673762,201,1,0.725172,177,3702240,-1,41.0,3972260,3972461,298498,201,84,2,True,True,0.09836549166666667,-0.725172
4555,3673920,5,1,0.531661,177,3702240,-1,25.0,9374741,9374746,5700821,5,27,10,True,True,0.0038944444444444443,-0.5316609999999999
4556,3674946,25,1,0.18946,177,3702240,-1,24.0,10693694,10693719,7018748,25,18,12,True,True,0.013086666666666665,-0.18946
4557,3674980,12598,32,0.526192,177,3702240,-1,1440.0,9179841,9192439,5504861,12598,30,11,True,True,705.3619960000001,-0.509589382726006
4558,3675045,21116,45,0.248763,177,3702240,-1,1215.0,13646497,13667613,9971452,21116,4,1,True,True,807.122424375,-0.2473133514839469
4559,3675284,288,3,0.625325,177,3702240,-1,105.0,5147287,5147575,1472003,288,64,1,True,True,0.5190359999999999,-0.625325
4560,3675406,1649,5,0.178898,177,3702240,-1,220.0,11603697,11605346,7928291,1649,16,12,True,True,15.555200222222224,-0.178898
4561,3675425,101,1,0.749194,177,3702240,-1,6.0,5546104,5546205,1870679,101,62,12,True,True,0.015000183333333335,-0.749194
4562,3675572,12,2,0.415185,177,3702240,-1,28.0,9509841,9509853,5834269,12,28,8,True,True,0.004868266666666667,-0.415185
4563,3675590,8667,16,0.105514,177,3702240,-1,400.0,14514097,14522764,10838507,8667,0,12,True,True,100.66884666666667,-0.10435549936019622
4564,3675622,29,12,0.638624,177,3702240,-1,216.0,7317122,7317151,3641500,29,52,6,True,True,0.1496922,-0.638624
4565,3675637,7754,128,0.357963,177,3702240,-1,1920.0,11517297,11525051,7841660,7754,18,12,True,True,616.8944266666666,-0.3426928323645731
4566,3675654,189,32,0.458721,177,3702240,-1,320.0,9946341,9946530,6270687,189,29,12,True,True,1.5729839999999997,-0.458721
4567,3675688,10761,1,0.665242,177,3702240,-1,46.0,4407007,4417768,731319,10761,80,7,True,True,3.884937155555555,-0.586670910030046
4568,3675741,8744,4,0.882824,177,3702240,-1,196.0,3895040,3903784,219299,8744,102,6,True,True,50.14761484444445,-0.8145317098968083
4569,3675872,9308,1,0.166809,177,3702240,-1,44.0,7339222,7348530,3663350,9308,54,10,True,True,9.602481777777777,-0.16538141841905296
4570,3675903,11829,72,0.180397,177,3702240,-1,2232.0,13642897,13654726,9966994,11829,6,11,True,True,833.3001438000001,-0.17583022639991988
4571,3676012,238,1,0.401557,177,3702240,-1,35.0,4265607,4265845,589595,238,85,7,True,True,0.4082625555555555,-0.401557
4572,3676024,33,8,0.337513,177,3702240,-1,360.0,13992097,13992130,10316073,33,4,12,True,True,0.229317,-0.337513
4573,3676082,23,5,0.158176,177,3702240,-1,70.0,8080241,8080264,4404159,23,51,0,True,True,0.026149083333333337,-0.158176
4574,3676130,45,1,0.998434,177,3702240,-1,50.0,3893240,3893285,217110,45,108,11,True,True,0.06660625,-0.998434
4575,3676133,2356,2,0.443012,177,3702240,-1,18.0,9596241,9598597,5920108,2356,33,12,True,True,0.6911619999999999,-0.4348046117370936
4576,3676184,230,8,0.352324,177,3702240,-1,128.0,12688497,12688727,9012313,230,12,11,True,True,1.1980444444444442,-0.352324
4577,3677867,53,45,0.315155,177,3702240,-1,1710.0,10554941,10554994,6877074,53,29,12,True,True,1.18649775,-0.315155
4578,3677893,32,1,0.991463,177,3702240,-1,33.0,3795840,3795872,117947,32,113,12,True,True,0.018961066666666665,-0.991463
4579,3677973,1043,1,0.324654,177,3702240,-1,43.0,8146541,8147584,4468568,1043,53,11,True,True,1.1026415944444443,-0.30997390311244327
4580,3677995,13208,38,0.37172,177,3702240,-1,608.0,13732897,13746105,10054902,13208,6,12,True,True,162.52132515555556,-0.34976808255385494
4581,3678079,1889,4,0.764184,177,3702240,-1,168.0,6589333,6591222,2911254,1889,71,0,True,True,2.314025,-0.764184
4582,3678090,14913,128,0.430588,177,3702240,-1,1792.0,10119141,10134054,6441051,14913,34,12,True,True,713.7277055999999,-0.40736067002010773
4583,3678108,13165,16,0.725868,177,3702240,-1,128.0,4401607,4414772,723499,13165,92,6,True,True,14.721610666666667,-0.6545221425420769
4584,3678125,7,4,0.608413,177,3702240,-1,108.0,10558594,10558601,6880469,7,29,1,True,True,0.01449,-0.608413
4585,3678176,6,37,0.563145,177,3702240,-1,1295.0,4021366,4021372,343190,6,107,8,True,True,0.3079078333333333,-0.563145
4586,3678377,8869,256,0.213928,177,3702240,-1,9472.0,13295297,13304166,9616920,8869,10,12,True,True,2227.795403377778,-0.2126213064785221
4587,3678440,12027,210,0.765708,177,3702240,-1,5250.0,10337941,10349968,6659501,12027,34,11,True,True,2307.6805791666666,-0.7513906005367536
4588,3679211,14,64,0.926147,177,3702240,-1,2176.0,3709440,3709454,30229,14,123,8,True,True,0.3359502222222223,-0.926147
4589,3679280,44,128,0.254089,177,3702240,-1,5632.0,10952897,10952941,7273617,44,27,12,True,True,8.663643022222221,-0.254089
4590,3679312,4,1,0.961652,177,3702240,-1,31.0,3968660,3968664,289348,4,116,1,True,True,0.0013946555555555558,-0.961652
4591,3679372,7906,32,0.4475,177,3702240,-1,992.0,7512022,7519928,3832650,7906,67,12,True,True,193.94599715555557,-0.4318166722694514
4592,3680172,1984,32,0.397091,177,3702240,-1,1024.0,6154707,6156691,2474535,1984,80,7,True,True,50.083575466666666,-0.363757633432083
4593,3680281,13,14,0.726313,177,3702240,-1,574.0,5156287,5156300,1476006,13,87,7,True,True,0.15409029999999999,-0.726313
4594,3680922,11742,86,0.982956,177,3702240,-1,602.0,4067488,4079230,386566,11742,111,1,True,True,146.9733100888889,-0.8109745452326154
4595,3681024,1300,8,0.595763,177,3702240,-1,168.0,9859941,9861241,6178917,1300,40,12,True,True,3.739144733333333,-0.5447983378953436
4596,3681070,19,1,0.517609,177,3702240,-1,28.0,8848741,8848760,5167671,19,52,0,True,True,0.01461817777777778,-0.5176090000000001
4597,3681095,23,32,0.993412,177,3702240,-1,288.0,4023257,4023280,342162,23,115,1,True,True,0.2624944,-0.993412
4598,3681213,5,32,0.301842,177,3702240,-1,1408.0,6506613,6506618,2825400,5,81,12,True,True,0.17310577777777775,-0.301842
4599,3681391,13,8,0.300334,177,3702240,-1,264.0,9773541,9773554,6092150,13,41,8,True,True,0.1077934,-0.300334
4600,3681904,3459,4,0.221887,177,3702240,-1,156.0,7534122,7537581,3852218,3459,70,10,True,True,13.620233899999999,-0.21529601076520358
4601,3682096,13849,4,0.85572,177,3702240,-1,152.0,5055287,5069136,1373191,13849,96,11,True,True,24.313133399999998,-0.8456082942442755
4602,3682167,19827,32,0.021701,177,3702240,-1,352.0,13905697,13925524,10223530,19827,5,12,True,True,277.71251297777775,-0.019287709618525536
4603,3682283,6,1,0.82194,177,3702240,-1,19.0,6420207,6420213,2737924,6,85,12,True,True,0.0019946833333333333,-0.82194
4604,3682525,22,32,0.689719,177,3702240,-1,1248.0,5154487,5154509,1471962,22,95,7,True,True,0.5657461333333335,-0.689719
4605,3682574,13,1,0.275957,177,3702240,-1,35.0,9266241,9266254,5583667,13,50,12,True,True,0.019127694444444444,-0.275957
4606,3682589,3,4,0.553663,177,3702240,-1,56.0,6022304,6022307,2339715,3,91,12,True,True,0.003368866666666667,-0.553663
4607,3683826,2914,1,0.556323,177,3702240,-1,29.0,8962841,8965755,5279015,2914,53,10,True,True,1.7893221527777778,-0.5340845404027548
4608,3685104,2,1,0.925922,177,3702240,-1,14.0,4915687,4915689,1230583,2,104,11,True,True,0.0005016666666666666,-0.925922
4609,3688341,561,1,0.154715,177,3702240,-1,38.0,9135641,9136202,5447300,561,52,12,True,True,0.5116912166666666,-0.154715
4610,3688365,19295,64,0.037736,177,3702240,-1,2112.0,14164897,14184192,10476532,19295,3,12,True,True,1577.5206656000003,-0.03561928393239435
4611,3688398,12603,8,0.355656,177,3702240,-1,128.0,4774987,4787590,1086589,12603,108,7,True,True,16.74349617777778,-0.3453583818179805
4612,3688772,56,1,0.138408,177,3702240,-1,42.0,9769941,9769997,6081169,56,44,12,True,True,0.08313666666666666,-0.138408
4613,3688871,53,8,0.367083,177,3702240,-1,160.0,4919287,4919340,1230416,53,107,7,True,True,0.21117555555555556,-0.367083
4614,3688977,11,8,0.582156,177,3702240,-1,112.0,4075588,4075599,386611,11,127,2,True,True,0.03448915555555555,-0.582156
4615,3689104,7367,16,0.232994,177,3702240,-1,768.0,12469697,12477064,8780593,7367,18,12,True,True,290.0713472,-0.22655480626188726
4616,3689453,19,1,0.811074,177,3702240,-1,11.0,7841122,7841141,4151669,19,74,7,True,True,0.006427330555555555,-0.811074
4617,3690701,14513,16,0.091905,177,3702240,-1,592.0,13512297,13526810,9821596,14513,11,11,True,True,442.14747248888887,-0.0903706080429549
4618,3690792,149,32,0.399798,177,3702240,-1,1568.0,4826387,4826536,1135595,149,112,9,True,True,2.2571447111111116,-0.399798
4619,3690846,16952,256,0.917882,177,3702240,-1,12800.0,5805304,5822256,2114458,16952,99,12,True,True,3137.4572088888895,-0.783247696078103
4620,3690876,21615,64,0.734266,177,3702240,-1,896.0,3965051,3986666,274175,21615,147,10,True,True,220.84664995555556,-0.7257733511799423
4621,3690903,30,8,0.723581,177,3702240,-1,160.0,3849040,3849070,158137,30,153,2,True,True,0.10737333333333333,-0.723581
4622,3691207,140,16,0.792904,177,3702240,-1,768.0,4505487,4505627,814280,140,120,9,True,True,0.9189973333333333,-0.792904
4623,3691710,20607,32,0.172902,177,3702240,-1,1312.0,13078297,13098904,9386587,20607,15,12,True,True,1110.8200483555556,-0.1725684562511086
4624,3691896,6844,35,0.825705,177,3702240,-1,1540.0,5242704,5249548,1550808,6844,104,1,True,True,106.42021133333333,-0.8142236632389215
4625,3692532,17,8,0.689595,177,3702240,-1,256.0,6152907,6152924,2460375,17,97,10,True,True,0.11711715555555555,-0.689595
4626,3692654,1207,32,0.576232,177,3702240,-1,608.0,7031322,7032529,3338668,1207,88,12,True,True,15.873712977777778,-0.576232
4627,3692800,10,1,0.907656,177,3702240,-1,50.0,4023280,4023290,330480,10,142,1,True,True,0.019813888888888888,-0.907656
4628,3692903,3,12,0.595231,177,3702240,-1,456.0,4728987,4728990,1036084,3,120,11,True,True,0.0094278,-0.595231
4629,3693006,11,21,0.300393,177,3702240,-1,861.0,6592122,6592133,2899116,11,91,6,True,True,0.06884890833333335,-0.300393
4630,3699045,8653,32,0.730789,177,3702240,-1,928.0,6158307,6166960,2459262,8653,98,8,True,True,131.38621164444444,-0.5925639680267172
4631,3699066,22116,32,0.576284,177,3702240,-1,288.0,6591222,6613338,2892156,22116,93,2,True,True,45.07346879999999,-0.5510024378896179
4632,3699271,21,1,0.078477,177,3702240,-1,16.0,13381697,13381718,9682426,21,13,12,True,True,0.012796,-0.078477
4633,3699282,111,18,0.055923,177,3702240,-1,612.0,7708722,7708833,4009440,111,79,12,True,True,1.2946707000000002,-0.055923
4634,3699352,13,4,0.770902,177,3702240,-1,48.0,4125807,4125820,426455,13,140,11,True,True,0.0103896,-0.770902
4635,3699478,11,4,0.34793,177,3702240,-1,172.0,5891704,5891715,2192226,11,107,12,True,True,0.020854044444444445,-0.34793
4636,3699527,13020,12,0.817142,177,3702240,-1,600.0,4396207,4409227,696680,13020,137,11,True,True,81.78580166666666,-0.8038477231400092
4637,3700163,6,11,0.416522,177,3702240,-1,187.0,11171697,11171703,7471534,6,31,12,True,True,0.03047476666666667,-0.416522
4638,3701086,44,32,0.867831,177,3702240,-1,1088.0,6244707,6244751,2543621,44,102,12,True,True,1.0031843555555557,-0.867831
4639,3701224,130,1,0.869787,177,3702240,-1,36.0,3797640,3797770,96416,130,172,7,True,True,0.08403199999999998,-0.869787
4640,3701346,187,32,0.226718,177,3702240,-1,928.0,5373304,5373491,1671958,187,114,12,True,True,1.5618239999999999,-0.226718
4641,3712058,24,36,0.652779,252,3795840,-1,216.0,4016866,4016890,304808,24,159,8,True,True,0.161352,-0.652779
4642,3712151,13959,64,0.602302,252,3795840,-1,704.0,7228022,7241981,3515871,13959,89,12,True,True,252.28378951111108,-0.5909685513543234
4643,3714914,7407,9,0.011434,252,3795840,-1,288.0,12991897,12999304,9276983,7407,17,11,True,True,52.9764,-0.011195247842420443
4644,3715223,18,16,0.777419,252,3795840,-1,592.0,6420213,6420231,2704990,18,102,1,True,True,0.18645040000000002,-0.777419
4645,3715324,18,16,0.382487,252,3795840,-1,800.0,6941322,6941340,3225998,18,94,12,True,True,0.41904,-0.382487
4646,3715542,5,8,0.304783,252,3795840,-1,136.0,7841141,7841146,4125599,5,79,1,True,True,0.02091188888888889,-0.304783
4647,3720730,18,16,0.041182,252,3795840,-1,304.0,12124097,12124115,8403367,18,25,12,True,True,0.479484,-0.041182
4648,3720939,56,4,0.53993,252,3795840,-1,104.0,10032741,10032797,6311802,56,48,12,True,True,0.1522167111111111,-0.53993
4649,3721655,12,1,0.14958,252,3795840,-1,44.0,8896541,8896553,5174886,12,66,11,True,True,0.012204133333333332,-0.14958
4650,3723113,108,2,0.502402,252,3795840,-1,54.0,6854922,6855030,3131809,108,99,12,True,True,0.20582099999999998,-0.502402
4651,3723509,38,1,0.220797,252,3795840,-1,43.0,6682122,6682160,2958613,38,101,12,True,True,0.09425456666666666,-0.220797
4652,3723658,819,1,0.05052,252,3795840,-1,22.0,8190741,8191560,4467083,819,77,11,True,True,0.41556515,-0.05052
4653,3723949,12732,20,0.731579,252,3795840,-1,920.0,4498287,4511019,774338,12732,146,11,True,True,133.36141366666666,-0.5104776201652855
4654,3724018,394,4,0.392883,252,3795840,-1,32.0,9683541,9683935,5959523,394,53,12,True,True,0.23608479999999998,-0.392883
4655,3733006,4,16,0.445616,252,3795840,-1,112.0,7425622,7425626,3692616,4,92,12,True,True,0.011635555555555555,-0.445616
4656,3733414,122,4,0.595132,252,3795840,-1,96.0,5150887,5151009,1417473,122,133,8,True,True,0.1973146666666667,-0.5951319999999999
4657,3736777,71,3,0.504729,252,3795840,-1,114.0,5718904,5718975,1982127,71,124,12,True,True,0.1452873,-0.504729
4658,3736867,291,2,0.222086,252,3795840,-1,94.0,8080241,8080532,4343374,291,82,12,True,True,0.44427454999999993,-0.222086
4659,3737473,40,1,0.289783,252,3795840,-1,29.0,11690097,11690137,7952624,40,30,12,True,True,0.045124,-0.289783
4660,3737586,14,4,0.394322,252,3795840,-1,200.0,10780097,10780111,7042511,14,38,1,True,True,0.06072111111111111,-0.394322
4661,3737606,16503,3,0.132189,252,3795840,-1,123.0,4263807,4280310,526201,16503,161,1,True,True,83.97408235,-0.12624608327290826
4662,3737796,274,12,0.082545,252,3795840,-1,552.0,11344497,11344771,7606701,274,33,12,True,True,6.964550266666668,-0.082545
4663,3740770,18193,1,0.571441,252,3795840,-1,22.0,4352007,4370200,611237,18193,161,12,True,True,7.024388799999999,-0.554305394170732
4664,3740870,2,4,0.049311,252,3795840,-1,60.0,12642497,12642499,8901627,2,22,12,True,True,0.004232666666666667,-0.04931099999999999
4665,3740946,4650,1,0.399191,252,3795840,-1,42.0,10293741,10298391,6552795,4650,49,7,True,True,6.778477650000001,-0.3870536102756028
4666,3741105,22,1,0.085079,252,3795840,-1,42.0,5286904,5286926,1545799,22,135,11,True,True,0.007327833333333335,-0.08507900000000002
4667,3741132,20,4,0.501823,252,3795840,-1,116.0,6332907,6332927,2591775,20,120,12,True,True,0.06315555555555556,-0.501823
4668,3741765,21010,1,0.773825,252,3795840,-1,12.0,4917487,4938497,1175722,21010,148,7,True,True,6.628322566666668,-0.7697988005611345
4669,3741794,1379,32,0.130375,252,3795840,-1,448.0,13208897,13210276,9467103,1379,15,11,True,True,13.61030097777778,-0.130375
4670,3741818,8052,16,0.134871,252,3795840,-1,144.0,14251297,14259349,10509479,8052,3,12,True,True,38.457581999999995,-0.13484037395340123
4671,3742130,11773,256,0.559296,252,3795840,-1,2560.0,6532313,6544086,2790183,11773,119,10,True,True,686.4935822222222,-0.5466967941689571
4672,3742226,27737,2,0.487861,252,3795840,-1,30.0,4127607,4155344,385381,27737,175,7,True,True,13.697780833333333,-0.47287651028281735
4673,3744910,24,1,0.652248,252,3795840,-1,47.0,4870587,4870611,1125677,24,153,11,True,True,0.03832066666666667,-0.652248
4674,3745166,37,4,0.196099,252,3795840,-1,152.0,12037697,12037734,8292531,37,29,12,True,True,0.14142797777777777,-0.196099
4675,3745225,5,16,0.615997,252,3795840,-1,800.0,6510213,6510218,2764988,5,121,8,True,True,0.09055555555555556,-0.615997
4676,3745556,5180,2,0.735668,252,3795840,-1,42.0,7993841,7999021,4248285,5180,91,11,True,True,6.0278160833333345,-0.7355278472456906
4677,3745892,345,7,0.246246,252,3795840,-1,91.0,6589333,6589678,2843441,345,120,8,True,True,0.22892187500000002,-0.246246
4678,3745926,7556,18,0.071644,252,3795840,-1,774.0,14337697,14345253,10591771,7556,3,12,True,True,145.22770765,-0.06301361574239175
4679,3746126,1346,1,0.776772,252,3795840,-1,38.0,5007487,5008833,1261361,1346,155,12,True,True,1.7461755777777777,-0.7706445647654995
4680,3746157,12869,5,0.323412,252,3795840,-1,25.0,7141622,7154491,3395465,12869,109,7,True,True,9.1176375,-0.3028119033178938
4681,3746241,9785,64,0.924138,252,3795840,-1,2816.0,5935904,5945689,2189663,9785,138,11,True,True,853.806663111111,-0.7813317427685877
4682,3746249,7103,1,0.089595,252,3795840,-1,10.0,13598697,13605800,9852448,7103,13,12,True,True,2.9199103055555558,-0.08800339563570883
4683,3755003,82,3,0.671748,252,3795840,-1,39.0,3845440,3845522,90437,82,214,1,True,True,0.08377871666666668,-0.6717480000000001
4684,3755163,75,16,0.423541,252,3795840,-1,688.0,4080707,4080782,325544,75,188,6,True,True,1.6540666666666666,-0.423541
4685,3755216,149,15,0.348308,252,3795840,-1,75.0,9506241,9506390,5751025,149,67,12,True,True,0.15911958333333334,-0.34830800000000006
4686,3755303,664,1,0.320738,252,3795840,-1,49.0,10866497,10867161,7111194,664,45,12,True,True,1.0386214222222223,-0.320738
4687,3755563,12,7,0.593877,252,3795840,-1,154.0,8672341,8672353,4916778,12,84,12,True,True,0.0314006,-0.593877
4688,3755616,5197,2,0.024207,252,3795840,-1,72.0,12947697,12952894,9192081,5197,22,12,True,True,6.7427674,-0.023479052531962488
4689,3755685,162,1,0.304819,252,3795840,-1,12.0,6333807,6333969,2578122,162,134,6,True,True,0.05292,-0.304819
4690,3755779,25,4,0.987652,252,3795840,-1,44.0,6022307,6022332,2266528,25,143,1,True,True,0.02205805555555555,-0.987652
4691,3755886,133,1,0.616221,252,3795840,-1,39.0,3894140,3894273,138254,133,219,6,True,True,0.15354960833333334,-0.616221
4692,3756006,65,1,0.990159,252,3795840,-1,18.0,4773187,4773252,1017181,65,172,11,True,True,0.010487749999999999,-0.990159
4693,3756031,311,16,0.44221,252,3795840,-1,800.0,4405207,4405518,649176,311,182,2,True,True,2.5384511111111108,-0.44221
4694,3756055,4751,128,0.145818,252,3795840,-1,1792.0,8675941,8680692,4919886,4751,85,8,True,True,171.99168995555556,-0.14579186017783327
4695,3756222,13626,35,0.044878,252,3795840,-1,315.0,12861297,12874923,9105075,13626,24,12,True,True,110.07748237500002,-0.04118003236154731
4696,3756261,33,32,0.818172,252,3795840,-1,1408.0,5099487,5099520,1343226,33,164,11,True,True,0.6417194666666666,-0.818172
4697,3756506,69,2,0.199685,252,3795840,-1,88.0,12556097,12556166,8799591,69,29,12,True,True,0.3224569333333333,-0.199685
4698,3756759,40,8,0.373821,252,3795840,-1,312.0,4399807,4399847,643048,40,189,7,True,True,0.15468266666666666,-0.373821
4699,3756843,17162,1,0.757734,252,3795840,-1,14.0,4454087,4471249,697244,17162,184,11,True,True,7.220573227777779,-0.7156347344025341
4700,3756862,6542,32,0.852764,252,3795840,-1,160.0,3983261,3989803,226399,6542,219,9,True,True,13.095607555555555,-0.7419392177440666
4701,3756895,3,1,0.112372,252,3795840,-1,40.0,6944922,6944925,3188027,3,121,8,True,True,0.0038250000000000003,-0.112372
4702,3756915,8,32,0.054538,252,3795840,-1,1472.0,10954697,10954705,7197782,8,47,7,True,True,0.4117020444444444,-0.054538
4703,3757054,179,8,0.948941,252,3795840,-1,360.0,4921087,4921266,1164033,179,171,0,True,True,1.800887,-0.7997927249657536
4704,3757085,210,1,0.92673,252,3795840,-1,18.0,4008766,4008976,251681,210,221,10,True,True,0.124614,-0.9267299999999999
4705,3762278,398,1,0.868752,252,3795840,-1,5.0,3972461,3972859,210183,398,224,1,True,True,0.02375286111111111,-0.868752
4706,3762315,1072,16,0.820134,252,3795840,-1,384.0,4921087,4922159,1158772,1072,172,7,True,True,13.291336533333334,-0.7986100444741611
4707,3762596,873,2,0.013733,252,3795840,-1,32.0,12296897,12297770,8534301,873,32,12,True,True,0.9514768,-0.013580483808554566
4708,3762738,3561,13,0.693795,252,3795840,-1,182.0,4409887,4413448,647149,3561,190,1,True,True,4.885854711111111,-0.6937787760055975
4709,3763357,38,8,0.111278,252,3795840,-1,224.0,11430897,11430935,7667540,38,43,12,True,True,0.4040362666666667,-0.111278
4710,3763829,30,16,0.450062,252,3795840,-1,800.0,7795122,7795152,4031293,30,109,12,True,True,0.4226666666666667,-0.450062
4711,3763901,3,1,0.022748,252,3795840,-1,35.0,10780094,10780097,7016193,3,53,12,True,True,0.002277041666666667,-0.022748
4712,3764374,127,1,0.20901,252,3795840,-1,45.0,4684787,4684914,920413,127,186,1,True,True,0.093218,-0.20901
4713,3764568,25,1,0.538005,252,3795840,-1,45.0,8499541,8499566,4734973,25,94,7,True,True,0.037853124999999994,-0.538005
4714,3765006,404,1,0.203801,252,3795840,-1,8.0,10562194,10562598,6797188,404,57,8,True,True,0.0960776,-0.19689625213335632
4715,3765081,180,8,0.523266,252,3795840,-1,368.0,4409707,4409887,644626,180,197,6,True,True,0.499008,-0.523266
4716,3765135,8,64,0.258658,252,3795840,-1,2432.0,10468541,10468549,6703406,8,61,12,True,True,0.5624945777777778,-0.258658
4717,3765185,10,13,0.483026,252,3795840,-1,364.0,3976061,3976071,210876,10,235,8,True,True,0.041748777777777774,-0.483026
4718,3766817,15506,16,0.729924,252,3795840,-1,192.0,4871487,4886993,1104670,15506,183,6,True,True,88.37494293333334,-0.7008818057576859
2412,2106290,17,16,0.418239,1,2106290,-1,320.0,2192690,2192707,86400,17,0,12,True,True,0.35897955555555555,-0.418239
2413,2106514,39,2,0.137867,146,2192690,-1,84.0,8681194,8681233,6574680,39,0,12,True,True,0.0310856,-0.137867
2414,2107603,2989,8,0.38371,146,2192690,-1,56.0,5359585,5362574,3251982,2989,1,12,True,True,4.175639377777778,-0.38357025177059134
2415,2108333,8303,4,0.185754,146,2192690,-1,64.0,7381594,7389897,5273261,8303,1,12,True,True,4.527018844444445,-0.17660434895087937
2416,2108437,24111,8,0.635502,146,2192690,-1,128.0,3692871,3716982,1584434,24111,3,10,True,True,206.1206432,-0.6310778020315314
2417,2108484,12,32,0.693433,146,2192690,-1,992.0,4212823,4212835,2104339,12,3,12,True,True,0.14539413333333334,-0.693433
2418,2108758,197,16,0.64526,146,2192690,-1,128.0,2940357,2940554,831599,197,5,0,True,True,0.22911537777777777,-0.64526
2419,2108788,39,8,0.9999,146,2192690,-1,64.0,3172357,3172396,1063569,39,5,7,True,True,0.058454933333333334,-0.9999
2420,2108947,3,8,0.554913,146,2192690,-1,312.0,5437874,5437877,3328927,3,2,10,True,True,0.042268200000000006,-0.554913
2421,2108974,32,32,0.489642,146,2192690,-1,1440.0,5008585,5008617,2899611,32,4,11,True,True,1.7441279999999997,-0.489642
2422,2109516,18,16,0.140297,146,2192690,-1,624.0,9199594,9199612,7090078,18,0,0,True,True,0.27218879999999995,-0.140297
2423,2111377,14909,1,0.31458,146,2192690,-1,10.0,6725331,6740240,4613954,14909,3,12,True,True,6.5944015,-0.3126811608200547
2424,2112022,3,1,0.451001,146,2192690,-1,16.0,5533378,5533381,3421356,3,4,0,True,True,0.0006842666666666667,-0.451001
2425,2112643,18751,1,0.053611,146,2192690,-1,30.0,10892604,10911355,8779961,18751,0,12,True,True,22.060654666666665,-0.05306708096735304
2426,2113179,13130,1,0.359039,146,2192690,-1,19.0,6289731,6302861,4176552,13130,5,11,True,True,6.4068454416666665,-0.3538105184402853
2427,2113265,28,16,0.009583,146,2192690,-1,656.0,3052457,3052485,939192,28,13,7,True,True,0.4868030222222222,-0.009583
2428,2113530,9,2,0.136535,146,2192690,-1,40.0,9372394,9372403,7258864,9,1,12,True,True,0.0046890000000000005,-0.136535
2429,2113630,12319,142,0.815216,146,2192690,-1,2698.0,3056057,3068376,942427,12319,14,8,True,True,687.403185,-0.7466317084940738
2430,2113724,4,14,0.963829,146,2192690,-1,210.0,2492314,2492318,378590,4,17,10,True,True,0.05235766666666666,-0.963829
2431,2113880,30,1,0.505438,146,2192690,-1,21.0,4219123,4219153,2105243,30,11,7,True,True,0.01021825,-0.505438
2432,2113923,63,1,0.49497,146,2192690,-1,22.0,7032331,7032394,4918408,63,5,12,True,True,0.04591895,-0.49497
2433,2114019,3743,64,0.684697,146,2192690,-1,2112.0,7032394,7036137,4918375,3743,5,1,True,True,265.05303146666665,-0.6760825080108013
2434,2114322,7782,32,0.41563,146,2192690,-1,640.0,2940357,2948139,826035,7782,20,12,True,True,91.47140266666666,-0.40499244998941564
2435,2114423,162,1,0.839892,146,2192690,-1,19.0,3316716,3316878,1202293,162,16,8,True,True,0.16907624999999998,-0.839892
2436,2114439,8491,1,0.4887,146,2192690,-1,33.0,3346916,3355407,1232477,8491,16,10,True,True,15.477900533333335,-0.4670677584242989
2437,2114630,20986,16,0.082671,146,2192690,-1,112.0,10802604,10823590,8687974,20986,1,12,True,True,62.984329333333335,-0.08020919792040254
2438,2114633,6696,8,0.030861,146,2192690,-1,288.0,4309785,4316481,2195152,6696,14,12,True,True,40.576176,-0.030585148723060326
2439,2115210,34,1,0.761057,146,2192690,-1,9.0,2556548,2556582,441338,34,25,2,True,True,0.0113254,-0.761057
2440,2115263,60,1,0.29209,146,2192690,-1,31.0,5384674,5384734,3269411,60,12,10,True,True,0.039726500000000005,-0.29209
2441,2115285,85,1,0.274853,146,2192690,-1,9.0,5634431,5634516,3519146,85,10,12,True,True,0.007958125,-0.274853
2442,2117492,9,14,0.537609,146,2192690,-1,658.0,6376131,6376140,4258639,9,9,12,True,True,0.09080400000000001,-0.537609
2443,2117508,17722,1,0.168209,146,2192690,-1,30.0,10806204,10823926,8688696,17722,1,1,True,True,14.792126499999998,-0.1641679994455857
2444,2117559,200,4,0.457321,146,2192690,-1,32.0,2618748,2618948,501189,200,29,9,True,True,0.38519111111111104,-0.457321
2445,2117770,10177,85,0.742518,146,2192690,-1,1785.0,5524274,5534451,3406504,10177,14,12,True,True,290.43012074999996,-0.7145246430717304
2446,2117824,8,32,0.76592,146,2192690,-1,864.0,2282690,2282698,164866,8,33,8,True,True,0.24476160000000002,-0.7659199999999999
2447,2117897,13108,8,0.549726,146,2192690,-1,136.0,5273185,5286293,3155288,13108,18,2,True,True,28.10685026666667,-0.5371001148955812
2448,2117914,7364,8,0.113211,146,2192690,-1,168.0,9026794,9034158,6908880,7364,5,12,True,True,16.391843066666667,-0.10944038995059716
2449,2117989,8629,5,0.114207,146,2192690,-1,215.0,8420194,8428823,6302205,8629,7,12,True,True,17.284007069444446,-0.11134693069503762
2450,2118041,4874,32,0.775113,146,2192690,-1,1184.0,2460798,2465672,342757,4874,36,11,True,True,301.81826151111113,-0.7715830368402247
2451,2118061,719,4,0.823283,146,2192690,-1,160.0,3079057,3079776,960996,719,29,6,True,True,1.8534222222222223,-0.8232830000000002
2452,2118189,8698,1,0.366862,146,2192690,-1,47.0,3082657,3091355,964468,8698,29,2,True,True,6.572243302777778,-0.3621038852694848
2453,2119686,8688,2,0.822611,146,2192690,-1,56.0,2773257,2781945,653571,8688,35,11,True,True,10.797037533333333,-0.8129384886470457
2454,2119735,139,1,0.041611,146,2192690,-1,19.0,11196004,11196143,9076269,139,0,11,True,True,0.04988555555555556,-0.041611
2455,2119857,8904,106,0.71898,146,2192690,-1,2226.0,3240516,3249420,1120659,8904,29,7,True,True,617.4949228,-0.7097313563782846
2456,2120189,19141,1,0.546353,146,2192690,-1,34.0,2326898,2346039,206709,19141,42,11,True,True,18.76457553888889,-0.5141251023846996
2457,2120488,210,59,0.989776,146,2192690,-1,649.0,2729057,2729267,608569,210,38,6,True,True,3.1869145000000003,-0.989776
2458,2120501,11,4,0.102416,146,2192690,-1,184.0,7293394,7293405,5172893,11,10,12,True,True,0.05492911111111111,-0.102416
2459,2120528,857,1,0.830071,146,2192690,-1,23.0,3904023,3904880,1783495,857,27,10,True,True,0.2254719388888889,-0.830071
2460,2120571,19559,9,0.751345,146,2192690,-1,396.0,3391116,3410675,1270545,19559,29,11,True,True,488.35199049999994,-0.7487114437195515
2461,2120598,31,4,0.297709,146,2192690,-1,80.0,8940394,8940425,6819796,31,7,12,True,True,0.07172711111111112,-0.297709
2462,2121350,12,1,0.999313,146,2192690,-1,48.0,2552948,2552960,431598,12,45,7,True,True,0.023144,-0.999313
2463,2121572,14650,128,0.449732,146,2192690,-1,2048.0,5533381,5548031,3411809,14650,18,2,True,True,475.10708906666673,-0.44007999266492165
2464,2121578,235,1,0.348577,146,2192690,-1,9.0,3192157,3192392,1070579,235,35,7,True,True,0.096303,-0.348577
2465,2124500,112,2,0.816729,146,2192690,-1,100.0,2728157,2728269,603657,112,45,12,True,True,0.3103644444444445,-0.816729
2466,2124543,239,4,0.43907,146,2192690,-1,164.0,2547548,2547787,423005,239,49,2,True,True,1.7741633888888888,-0.43907
2467,2124689,6917,15,0.993958,146,2192690,-1,600.0,2563748,2570665,439059,6917,47,9,True,True,157.28342666666666,-0.868832664403654
2468,2124740,12,1,0.775632,146,2192690,-1,10.0,2849457,2849469,724717,12,43,7,True,True,0.002134666666666667,-0.775632
2469,2124925,6261,128,0.236946,146,2192690,-1,3072.0,8594794,8601055,6469869,6261,9,12,True,True,136.75808426666666,-0.22931425737558378
2470,2124997,143,4,0.810703,146,2192690,-1,56.0,5532374,5532517,3407377,143,21,2,True,True,0.11940817777777776,-0.8107030000000002
2471,2125054,13211,4,0.587924,146,2192690,-1,72.0,4616085,4629296,2491031,13211,28,11,True,True,14.1196086,-0.5723972535646366
2472,2125176,104,4,0.350631,146,2192690,-1,40.0,5533274,5533378,3408098,104,21,0,True,True,0.05930311111111111,-0.350631
2473,2125179,31,1,0.710754,146,2192690,-1,41.0,2640848,2640879,515669,31,51,10,True,True,0.03791816666666667,-0.710754
2474,2125414,19212,16,0.632771,146,2192690,-1,288.0,3648607,3667819,1523193,19212,35,8,True,True,356.18749679999996,-0.6313794221037705
2475,2132350,15615,1,0.165982,146,2192690,-1,39.0,8074594,8090209,5942244,15615,11,12,True,True,7.150628333333334,-0.15504722195828552
2476,2132729,25,64,0.139235,146,2192690,-1,960.0,10197794,10197819,8065065,25,4,12,True,True,0.5303333333333333,-0.139235
2477,2132819,14871,256,0.20662,146,2192690,-1,9728.0,5548031,5562902,3415212,14871,21,7,True,True,1666.1514723555554,-0.20335594572962012
2478,2134008,14246,1,0.206943,146,2192690,-1,28.0,4703385,4717631,2569377,14246,32,6,True,True,15.769667511111109,-0.17390526357925024
2479,2134043,15,2,0.059358,146,2192690,-1,48.0,7295194,7295209,5161151,15,14,7,True,True,0.014394,-0.059358
2480,2134317,25475,128,0.350815,146,2192690,-1,3840.0,4216423,4241898,2082106,25475,37,8,True,True,1339.4067733333334,-0.34643279814211125
2481,2134804,225,8,0.281085,146,2192690,-1,72.0,2543714,2543939,408910,225,64,2,True,True,0.85896,-0.281085
2482,2134927,18621,64,0.538769,146,2192690,-1,2880.0,3701871,3720492,1566944,18621,40,7,True,True,3204.83952,-0.5206131445744818
2483,2134934,7127,2,0.323654,146,2192690,-1,58.0,4331885,4339012,2196951,7127,35,10,True,True,8.639649066666667,-0.2780105783036526
2484,2134970,77,1,0.704054,146,2192690,-1,23.0,3403716,3403793,1268746,77,44,3,True,True,0.11332924166666665,-0.704054
2485,2135214,3631,41,0.289333,146,2192690,-1,1927.0,5181385,5185016,3046171,3631,32,12,True,True,315.56971657777774,-0.27734970228368383
2486,2135239,16457,1,0.267343,146,2192690,-1,5.0,7988194,8004651,5852955,16457,13,12,True,True,2.0070665833333337,-0.23321132370923134
2487,2135398,391,8,0.858017,146,2192690,-1,104.0,3534316,3534707,1398918,391,46,12,True,True,0.4998283333333333,-0.858017
2488,2135495,20,64,0.985488,146,2192690,-1,1664.0,2796257,2796277,660762,20,61,6,True,True,1.0329742222222222,-0.985488
2489,2135551,18,1,0.679299,146,2192690,-1,44.0,3181357,3181375,1045806,18,53,2,True,True,0.030245599999999994,-0.679299
2490,2135886,4,32,0.095225,146,2192690,-1,960.0,9721594,9721598,7585708,4,5,12,True,True,0.09146666666666667,-0.095225
2491,2136844,10695,140,0.962772,146,2192690,-1,5180.0,3027657,3038352,890813,10695,60,12,True,True,947.8184858333333,-0.9621226154290425
2492,2139597,62,2,0.785691,146,2192690,-1,36.0,3104257,3104319,964660,62,56,2,True,True,0.0294128,-0.785691
2493,2139648,15967,16,0.918769,146,2192690,-1,304.0,2279090,2295057,139442,15967,80,12,True,True,172.17416284444442,-0.9163551742298746
2494,2139768,17844,2,0.992486,146,2192690,-1,40.0,2540114,2557958,400346,17844,76,7,True,True,32.64664666666667,-0.9449630331635258
2495,2139994,19,10,0.867048,146,2192690,-1,420.0,2470214,2470233,330220,19,78,1,True,True,0.3895126666666667,-0.867048
2496,2140004,18,1,0.126888,146,2192690,-1,29.0,10111394,10111412,7971390,18,5,12,True,True,0.017547899999999998,-0.126888
2497,2140073,70,32,0.866079,146,2192690,-1,672.0,2468071,2468141,327998,70,80,1,True,True,2.2959440000000004,-0.866079
2498,2140389,2,16,0.249677,146,2192690,-1,576.0,5533378,5533380,3392989,2,28,2,True,True,0.0164224,-0.249677
2499,2140483,10688,1,0.711395,146,2192690,-1,39.0,4964385,4975073,2823902,10688,38,12,True,True,7.18609905,-0.6018170809434923
2500,2147589,73,8,0.828482,146,2192690,-1,184.0,2467998,2468071,320409,73,83,8,True,True,0.6555935333333334,-0.828482
2501,2148088,63,16,0.761474,146,2192690,-1,608.0,2551148,2551211,403060,63,77,2,True,True,1.7132528000000002,-0.761474
2502,2148106,8109,128,0.676235,146,2192690,-1,1536.0,3078157,3086266,930051,8109,62,10,True,True,196.38626133333335,-0.6723255292146508
2503,2148766,53,2,0.489459,146,2192690,-1,80.0,4219499,4219552,2070733,53,43,1,True,True,0.06690955555555556,-0.48945899999999987
2504,2150347,22243,64,0.577426,146,2192690,-1,1920.0,5362574,5384817,3212227,22243,34,1,True,True,1054.7002506666665,-0.5619966135472828
2505,2150391,9,1,0.268717,146,2192690,-1,11.0,3795523,3795532,1645132,9,49,1,True,True,0.00519035,-0.268717
2506,2150734,417,32,0.414225,146,2192690,-1,448.0,8160994,8161411,6010260,417,14,12,True,True,3.1208999111111115,-0.35695328323098796
2507,2150755,1489,1,0.451992,146,2192690,-1,5.0,2342198,2343687,191443,1489,91,3,True,True,0.136075125,-0.37650883783930617
2508,2151909,206,1,0.633628,146,2192690,-1,25.0,5723531,5723737,3571622,206,25,12,True,True,0.07852319444444444,-0.633628
2509,2155978,12334,64,0.880125,146,2192690,-1,2816.0,2608848,2621182,452870,12334,80,6,True,True,1948.6383957333333,-0.8242786551296833
2510,2156228,71,1,0.093095,146,2192690,-1,34.0,9852194,9852265,7695966,71,6,12,True,True,0.07877686666666667,-0.093095
2511,2156396,10,2,0.515613,146,2192690,-1,60.0,7988194,7988204,5831798,10,17,0,True,True,0.011655,-0.515613
2512,2156730,10,2,0.278226,146,2192690,-1,26.0,5896331,5896341,3739601,10,27,12,True,True,0.009967388888888888,-0.278226
2513,2159566,9504,4,0.936336,146,2192690,-1,120.0,2611548,2621052,451982,9504,83,6,True,True,65.881956,-0.8919155385683094
2514,2159629,64,2,0.369071,146,2192690,-1,36.0,3670707,3670771,1511078,64,57,10,True,True,0.1555712,-0.36907100000000004
2515,2160021,9,16,0.950254,146,2192690,-1,176.0,2345798,2345807,185777,9,98,3,True,True,0.0347556,-0.950254
2516,2160104,10,1,0.327289,146,2192690,-1,50.0,9462394,9462404,7302290,10,8,12,True,True,0.004926388888888889,-0.327289
2517,2160248,10513,32,0.002473,146,2192690,-1,320.0,7034194,7044707,4873946,10513,23,7,True,True,97.92835555555557,-0.0022413699856892342
2518,2168533,11303,32,0.774135,146,2192690,-1,192.0,2337698,2349001,169165,11303,102,3,True,True,47.9945728,-0.7023026229993088
2519,2170528,45,1,0.732724,146,2192690,-1,24.0,2941257,2941302,770729,45,77,6,True,True,0.017070000000000002,-0.732724
2520,2171776,42,1,0.730932,146,2192690,-1,35.0,2543939,2543981,372163,42,94,1,True,True,0.07794266666666667,-0.730932
2521,2172033,50,32,0.458449,146,2192690,-1,384.0,3645007,3645057,1472974,50,61,7,True,True,0.9980266666666666,-0.458449
2522,2177531,42,1,0.664144,146,2192690,-1,33.0,4217323,4217365,2039792,42,53,6,True,True,0.02248015,-0.664144
2523,2177773,9989,34,0.358223,146,2192690,-1,1190.0,9938594,9948583,7760821,9989,6,12,True,True,352.0635196944444,-0.3470169951783768
2524,2178120,19,1,0.063331,146,2192690,-1,40.0,6245531,6245550,4067411,19,30,12,True,True,0.011824333333333334,-0.06333100000000001
2525,2179651,3,2,0.534424,146,2192690,-1,26.0,3447916,3447919,1268265,3,66,11,True,True,0.0018286666666666668,-0.534424
2526,2179836,44885,1,0.21783,146,2192690,-1,38.0,10979004,11023889,8799168,44885,1,12,True,True,36.22726590555556,-0.20856635642600477
2527,2180791,11359,1,0.429643,146,2192690,-1,29.0,3183157,3194516,1002366,11359,74,7,True,True,13.480504033333334,-0.4280744816483956
2528,2180801,34,4,0.211851,146,2192690,-1,24.0,8421994,8422028,6241193,34,17,7,True,True,0.007856266666666667,-0.211851
2529,2180879,7170,1,0.268537,146,2192690,-1,16.0,8767594,8774764,6586715,7170,15,12,True,True,1.9616639111111112,-0.25220086360226246
2530,2181396,263,8,0.828344,146,2192690,-1,192.0,4789785,4790048,2608389,263,52,12,True,True,1.2884896,-0.828344
2531,2181471,25629,33,0.337755,146,2192690,-1,297.0,5982731,6008360,3801260,25629,34,12,True,True,231.341898975,-0.3091211235562028
2532,2181633,26487,1,0.577934,146,2192690,-1,36.0,7640794,7667281,5459161,26487,24,12,True,True,10.6535,-0.5748178060299304
2533,2181686,17746,1,0.566142,146,2192690,-1,11.0,3396516,3414262,1214830,17746,74,7,True,True,12.217757933333331,-0.5544526925412563
2534,2181740,275,8,0.485338,146,2192690,-1,72.0,3705471,3705746,1523731,275,66,8,True,True,1.365485,-0.4853380000000001
2535,2183780,63,32,0.34374,146,2192690,-1,192.0,10457004,10457067,8273224,63,5,1,True,True,0.40992000000000006,-0.34374
2536,2186989,42441,32,0.682552,146,2192690,-1,1408.0,3696471,3738912,1509482,42441,69,1,True,True,3281.6654698666666,-0.6431787071743229
2537,2187170,35360,128,0.048409,146,2192690,-1,6272.0,11151804,11187164,8964634,35360,1,12,True,True,5156.305907200001,-0.04732196180249703
2538,2187180,3613,4,0.099575,146,2192690,-1,96.0,10024994,10028607,7837814,3613,9,12,True,True,7.163952533333333,-0.09510292734489709
2539,2187316,13,42,0.78389,146,2192690,-1,840.0,3323916,3323929,1136600,13,82,9,True,True,0.352352,-0.78389
2540,2187337,81,16,0.459582,146,2192690,-1,592.0,5525174,5525255,3337837,81,48,6,True,True,0.8571419999999998,-0.459582
2541,2187483,4,1,0.124237,146,2192690,-1,21.0,8508394,8508398,6320911,4,21,12,True,True,0.0013001333333333333,-0.124237
2542,2187802,222,4,0.857652,146,2192690,-1,92.0,2607948,2608170,420146,222,110,11,True,True,1.1462402666666667,-0.857652
2543,2187819,142,16,0.441286,146,2192690,-1,144.0,7813594,7813736,5625775,142,28,12,True,True,0.34324239999999995,-0.4412860000000001
2544,2187867,9,1,0.000676,146,2192690,-1,6.0,11065404,11065413,8877537,9,2,12,True,True,0.0010452,-0.000676
2545,2188238,603,1,0.958032,146,2192690,-1,41.0,3262616,3263219,1074378,603,88,10,True,True,1.09426745,-0.958032
2546,2189734,3130,32,0.202318,146,2192690,-1,1216.0,9375994,9379124,7186260,3130,15,8,True,True,45.55558222222223,-0.18996896442179767
2547,2189831,55185,1,0.688592,146,2192690,-1,49.0,7901794,7956979,5711963,55185,30,7,True,True,86.23375821666667,-0.6748153253906763
2548,2190353,4,32,0.131913,146,2192690,-1,1376.0,5637131,5637135,3446778,4,46,6,True,True,0.057256888888888885,-0.131913
2549,2190388,645,6,0.649997,146,2192690,-1,174.0,6072731,6073376,3882343,645,43,8,True,True,7.830442249999999,-0.6485175028909262
2550,2190559,1,8,0.158977,146,2192690,-1,112.0,6159131,6159132,3968572,1,43,12,True,True,0.008459733333333334,-0.158977
2551,2190639,2713,2,0.932726,146,2192690,-1,18.0,2851257,2853970,660618,2713,109,7,True,True,0.77578235,-0.932726
2552,2190992,4281,32,0.274019,146,2192690,-1,800.0,6638931,6643212,4447939,4281,40,12,True,True,95.11978666666667,-0.2068894560568422
2553,2191522,74,1,0.654588,146,2192690,-1,37.0,2412098,2412172,220576,74,134,10,True,True,0.10722312222222222,-0.654588
2554,2191699,664,1,0.250389,146,2192690,-1,14.0,7120594,7121258,4928895,664,36,12,True,True,0.13760848888888888,-0.2226127930279677
2555,2192292,119,8,0.371844,146,2192690,-1,376.0,5269585,5269704,3077293,119,65,7,True,True,0.7538121111111111,-0.371844
2556,2192359,69,1,0.9038,146,2192690,-1,5.0,3394716,3394785,1202357,69,92,1,True,True,0.019597916666666663,-0.9038
2557,2192404,5243,16,0.165525,146,2192690,-1,464.0,9635194,9640437,7442790,5243,14,12,True,True,22.13933466666667,-0.16463886561249355
2558,2192462,6613,128,0.396342,146,2192690,-1,1152.0,5412174,5418787,3219712,6613,62,8,True,True,66.52988159999998,-0.2708733244719402
2559,2193211,15,4,0.305509,254,2279090,-1,24.0,6466131,6466146,4272920,15,43,12,True,True,0.006640000000000001,-0.305509
2560,2193371,9234,32,0.699441,254,2279090,-1,224.0,2538314,2547548,344943,9234,135,7,True,True,108.26995697777778,-0.6943003727175255
2561,2193805,9,1,0.234144,254,2279090,-1,40.0,7467994,7468003,5274189,9,34,12,True,True,0.004733,-0.234144
2562,2193848,46,8,0.655485,254,2279090,-1,88.0,3089857,3089903,896009,46,108,7,True,True,0.06968182222222222,-0.655485
2563,2193938,41,1,0.703698,254,2279090,-1,41.0,3050657,3050698,856719,41,114,10,True,True,0.04455116944444445,-0.7036979999999999
2564,2193984,79,1,0.001086,254,2279090,-1,39.0,4485485,4485564,2291501,79,76,12,True,True,0.10841696666666667,-0.001086
2565,2193987,10037,32,0.476807,254,2279090,-1,800.0,4122823,4132860,1928836,10037,84,12,True,True,98.00695333333334,-0.4745492312779879
2566,2193998,237,32,0.1327,254,2279090,-1,448.0,10629804,10630041,8435806,237,7,12,True,True,2.1515386666666663,-0.1327
2567,2194621,25,1,0.226191,254,2279090,-1,5.0,7899994,7900019,5705373,25,33,12,True,True,0.0023982638888888886,-0.226191
2568,2194663,77,1,0.679983,254,2279090,-1,22.0,4126423,4126500,1931760,77,86,1,True,True,0.020266827777777774,-0.679983
2569,2194709,10,32,0.009287,254,2279090,-1,288.0,10456994,10457004,8262285,10,9,12,True,True,0.09759999999999999,-0.009287
2570,2194764,859,1,0.695597,254,2279090,-1,33.0,3126357,3127216,931593,859,113,10,True,True,0.350321675,-0.695597
2571,2194836,28342,1,0.817109,254,2279090,-1,46.0,6942331,6970673,4747495,28342,45,11,True,True,15.76630807777778,-0.7901117211890843
2572,2194945,9,8,0.988155,254,2279090,-1,288.0,2610648,2610657,415703,9,136,7,True,True,0.1183032,-0.988155
2573,2194955,18693,16,0.422314,254,2279090,-1,544.0,5267785,5286478,3072830,18693,74,12,True,True,163.41800951111114,-0.4193538255861182
2574,2195011,19,1,0.132175,254,2279090,-1,30.0,10716204,10716223,8521193,19,7,12,True,True,0.005570166666666666,-0.132175
2575,2195223,77,16,0.070828,254,2279090,-1,752.0,9113194,9113271,6917971,77,22,12,True,True,0.6169992888888888,-0.070828
2576,2195238,15430,32,0.38307,254,2279090,-1,1504.0,7554394,7569824,5359156,15430,39,12,True,True,233.1037902222222,-0.3624196094231928
2577,2195505,32,4,0.730763,254,2279090,-1,104.0,4036423,4036455,1840918,32,94,11,True,True,0.11625813333333333,-0.7307629999999999
2578,2195658,10815,128,0.102427,254,2279090,-1,2560.0,10284194,10295009,8088536,10815,11,12,True,True,586.6130844444444,-0.09993585611993974
2579,2195893,78,4,0.313351,254,2279090,-1,100.0,9765794,9765872,7569901,78,17,11,True,True,0.23400000000000004,-0.31335100000000005
2580,2206570,9594,128,0.880989,254,2279090,-1,4480.0,3881923,3891517,1675353,9594,98,12,True,True,565.1911004444445,-0.8809246042772088
2581,2206573,16617,3,0.137129,254,2279090,-1,69.0,3190357,3206974,983784,16617,119,2,True,True,42.03755425000001,-0.13501168224640397
2582,2206646,72,32,0.77346,254,2279090,-1,1376.0,4376985,4377057,2170339,72,87,6,True,True,1.8980544,-0.77346
2583,2206689,13325,2,0.753158,254,2279090,-1,28.0,5094985,5108310,2888296,13325,81,12,True,True,17.21028361111111,-0.7495046424326741
2584,2206734,10,1,0.133146,254,2279090,-1,28.0,4702485,4702495,2495751,10,86,12,True,True,0.017947222222222222,-0.133146
2585,2206764,18494,1,0.99294,254,2279090,-1,38.0,2853057,2871551,646293,18494,139,7,True,True,15.95729228888889,-0.9907952851603813
2586,2206779,1110,4,0.142853,254,2279090,-1,132.0,3238716,3239826,1031937,1110,121,11,True,True,8.715905000000001,-0.142853
2587,2206857,26637,32,0.530508,254,2279090,-1,1280.0,6898131,6924768,4691274,26637,51,12,True,True,1003.4878400000001,-0.5252604199368628
2588,2207013,25,32,0.008475,254,2279090,-1,1472.0,5533274,5533299,3326261,25,70,6,True,True,0.5246044444444444,-0.008475
2589,2207065,18862,128,0.65002,254,2279090,-1,2944.0,3087157,3106019,880092,18862,132,6,True,True,833.3196526222223,-0.6366573403805571
2590,2207184,21992,4,0.440099,254,2279090,-1,160.0,4376085,4398077,2168901,21992,92,11,True,True,99.57481555555557,-0.4196304330480414
2591,2207357,15,2,0.722432,254,2279090,-1,46.0,3709071,3709086,1501714,15,106,4,True,True,0.039822583333333335,-0.722432
2592,2208090,232,1,0.62808,254,2279090,-1,33.0,3643207,3643439,1435117,232,114,10,True,True,0.3979631333333334,-0.62808
2593,2208115,17,13,0.151374,254,2279090,-1,403.0,2853957,2853974,645842,17,146,6,True,True,0.10883574722222222,-0.151374
2594,2208129,286,16,0.41171,254,2279090,-1,640.0,4223099,4223385,2014970,286,95,2,True,True,2.6596728888888888,-0.41171
2595,2208414,12148,4,0.686566,254,2279090,-1,40.0,3621107,3633255,1412693,12148,116,12,True,True,29.039059222222225,-0.6829900148781946
2596,2208490,9,1,0.859963,254,2279090,-1,28.0,2641748,2641757,433258,9,156,6,True,True,0.007518000000000001,-0.859963
2597,2208498,3658,1,0.086688,254,2279090,-1,16.0,11455204,11458862,9246706,3658,0,12,True,True,1.1820368888888892,-0.08121071222852204
2598,2208577,29,29,0.100465,254,2279090,-1,986.0,3177757,3177786,969180,29,134,8,True,True,0.8224746388888888,-0.100465
2599,2208764,14,2,0.752446,254,2279090,-1,98.0,3313116,3313130,1104352,14,127,10,True,True,0.07833738888888889,-0.752446
2600,2208837,20,45,0.589574,254,2279090,-1,450.0,2847657,2847677,638820,20,155,8,True,True,0.16010000000000002,-0.589574
2601,2208985,23370,128,0.384032,254,2279090,-1,1536.0,9199594,9222964,6990609,23370,25,12,True,True,929.3259775999999,-0.3835482670778082
2602,2208989,13,16,0.963249,254,2279090,-1,112.0,3267116,3267129,1058127,13,129,8,True,True,0.060023599999999996,-0.963249
2603,2209089,77,2,0.314504,254,2279090,-1,18.0,2641757,2641834,432668,77,162,1,True,True,0.041349,-0.314504
2604,2209115,20024,16,0.13983,254,2279090,-1,496.0,6945931,6965955,4736816,20024,52,8,True,True,115.06470328888888,-0.1373250790742218
2605,2209312,12,8,0.276968,254,2279090,-1,112.0,7206994,7207006,4997682,12,48,12,True,True,0.021373333333333334,-0.276968
2606,2209681,7,8,0.084249,254,2279090,-1,144.0,11368804,11368811,9159123,7,1,12,True,True,0.028551599999999996,-0.084249
2607,2209843,7,4,0.553397,254,2279090,-1,76.0,5636231,5636238,3426388,7,69,7,True,True,0.005534277777777778,-0.553397
2608,2209869,14334,200,0.600008,254,2279090,-1,7200.0,4876185,4890519,2666316,14334,92,12,True,True,1407.03366,-0.5497572407984538
2609,2210022,15128,16,0.607593,254,2279090,-1,528.0,3194516,3209644,984494,15128,138,2,True,True,278.52574346666665,-0.5969843510142231
2610,2210067,27,1,0.77897,254,2279090,-1,5.0,3088057,3088084,877990,27,148,6,True,True,0.0021206249999999997,-0.77897
2611,2210090,13392,4,0.690476,254,2279090,-1,56.0,4223385,4236777,2013295,13392,102,1,True,True,9.8525126,-0.6846394259565052
2612,2210114,5508,64,0.847892,254,2279090,-1,1664.0,2389998,2395506,179884,5508,193,11,True,True,333.62426239999996,-0.8431724378338002
2613,2210138,12475,95,0.658405,254,2279090,-1,1900.0,4399085,4411560,2188947,12475,98,10,True,True,919.7734277777778,-0.5892568275074214
2614,2210185,85,1,0.301649,254,2279090,-1,9.0,8247394,8247479,6037209,85,36,12,True,True,0.0065705,-0.301649
2615,2210269,8658,16,0.517749,254,2279090,-1,336.0,8853994,8862652,6643725,8658,30,12,True,True,35.02826133333333,-0.5132583443749331
2616,2210293,1166,14,0.509523,254,2279090,-1,70.0,5528774,5529940,3318481,1166,80,2,True,True,1.3240118888888892,-0.4931241617244988
2617,2210526,487,5,0.747844,254,2279090,-1,125.0,3028557,3029044,818031,487,161,6,True,True,1.0884788194444446,-0.747844
2618,2210579,16,2,0.295542,254,2279090,-1,28.0,5406774,5406790,3196195,16,85,10,True,True,0.002573511111111111,-0.295542
2619,2210710,57968,83,0.054569,254,2279090,-1,498.0,10370594,10428562,8159884,57968,13,12,True,True,794.3044196333332,-0.05414900578007499
2620,2210889,7752,64,0.897913,254,2279090,-1,1664.0,2330498,2338250,119609,7752,204,8,True,True,409.1173909333333,-0.8356015621157082
2621,2210918,5,2,0.954672,254,2279090,-1,90.0,2412998,2413003,202080,5,199,6,True,True,0.0176225,-0.954672
2622,2211017,122,4,0.494888,254,2279090,-1,132.0,4309785,4309907,2098768,122,107,0,True,True,0.3567483333333334,-0.494888
2623,2211488,280,3,0.112744,254,2279090,-1,87.0,7727194,7727474,5515706,280,46,12,True,True,0.31187566666666666,-0.112744
2624,2211789,27,2,0.499583,254,2279090,-1,80.0,5809931,5809958,3598142,27,71,12,True,True,0.105972,-0.499583
2625,2211797,10983,64,0.59393,254,2279090,-1,2304.0,5408574,5419557,3196777,10983,88,7,True,True,209.1019776,-0.4813092969537236
2626,2211812,15454,1,0.528287,254,2279090,-1,34.0,3100657,3116111,888845,15454,158,2,True,True,7.291553677777777,-0.5259539363749457
2627,2211845,4,4,0.977697,254,2279090,-1,72.0,2545739,2545743,333894,4,195,7,True,True,0.013035999999999997,-0.977697
2628,2211964,343,32,0.986883,254,2279090,-1,192.0,2469871,2470214,257907,343,202,7,True,True,3.2145045333333337,-0.986883
2629,2211969,76,4,0.933924,254,2279090,-1,104.0,3086257,3086333,874288,76,162,2,True,True,0.12415866666666667,-0.933924
2630,2211985,12454,1,0.131983,254,2279090,-1,36.0,8333794,8346248,6121809,12454,38,12,True,True,4.4251347999999995,-0.12945442401709914
2631,2212785,6,32,0.860814,254,2279090,-1,1184.0,2844057,2844063,631272,6,180,8,True,True,0.12238613333333334,-0.860814
2632,2217450,13,4,0.56838,254,2279090,-1,152.0,3670771,3670784,1453321,13,131,1,True,True,0.1334239111111111,-0.5683800000000001
2633,2217922,28,64,0.365412,254,2279090,-1,2816.0,6811731,6811759,4593809,28,62,12,True,True,5.726335999999999,-0.365412
2634,2218080,3,8,0.682942,254,2279090,-1,120.0,4877985,4877988,2659905,3,102,7,True,True,0.0060880000000000005,-0.682942
2635,2218177,21171,128,0.762726,254,2279090,-1,2944.0,3170557,3191728,952380,21171,160,11,True,True,2118.4870666666666,-0.7211386979019988
2636,2218200,4916,16,0.954453,254,2279090,-1,624.0,2282698,2287614,64498,4916,221,1,True,True,117.13126186666666,-0.8761728107773326
2637,2218257,19,32,0.770367,254,2279090,-1,640.0,5415774,5415793,3197517,19,89,2,True,True,0.1080888888888889,-0.770367
2638,2218294,549,1,0.016689,254,2279090,-1,26.0,4571885,4572434,2353591,549,109,12,True,True,0.2674153444444444,-0.016623429768387037
2639,2218364,346,27,0.067533,254,2279090,-1,1323.0,4219153,4219499,2000789,346,120,1,True,True,7.250966099999999,-0.06595382687668229
2640,2218378,6,1,0.262185,254,2279090,-1,50.0,3992223,3992229,1773845,6,128,7,True,True,0.0034541666666666675,-0.262185
2641,2218446,1149,8,0.039827,254,2279090,-1,216.0,3174157,3175306,955711,1149,163,7,True,True,5.9346978,-0.033109667617759284
2642,2220087,297,16,0.060469,254,2279090,-1,576.0,11282404,11282701,9062317,297,2,12,True,True,2.6411615999999998,-0.060469
2643,2220171,31,13,0.78929,254,2279090,-1,481.0,2464398,2464429,244227,31,218,1,True,True,0.7972828861111112,-0.78929
2644,2220465,52,4,0.506611,254,2279090,-1,24.0,3795471,3795523,1575006,52,133,12,True,True,0.06542986666666667,-0.506611
2645,2223616,112,7,0.628571,254,2279090,-1,238.0,3291016,3291128,1067400,112,155,10,True,True,0.535637511111111,-0.628571
2646,2223755,4483,1,0.501049,254,2279090,-1,41.0,6552531,6557014,4328776,4483,66,12,True,True,2.1647153805555557,-0.4929649458554019
2647,2223976,4,6,0.415432,254,2279090,-1,294.0,6069131,6069135,3845155,4,73,12,True,True,0.0714126,-0.415432
2648,2224069,34,3,0.701811,254,2279090,-1,144.0,3268916,3268950,1044847,34,158,7,True,True,0.19393599999999997,-0.701811
2649,2224162,9841,64,0.082428,254,2279090,-1,512.0,3990423,4000264,1766261,9841,132,12,True,True,52.017631288888886,-0.06543640652971551
2650,2224894,3827,1,0.536565,254,2279090,-1,22.0,3097057,3100884,872163,3827,176,9,True,True,1.199525738888889,-0.5150692348427784
2651,2224911,713,4,0.616047,254,2279090,-1,56.0,2795357,2796070,570446,713,199,10,True,True,1.2393207555555557,-0.616047
2652,2224927,116,8,0.277468,254,2279090,-1,328.0,9852194,9852310,7627267,116,20,0,True,True,1.2416330666666668,-0.277468
2653,2226269,118,8,0.309907,254,2279090,-1,88.0,9548794,9548912,7322525,118,25,12,True,True,0.14009746666666667,-0.309907
2654,2226296,4979,17,0.511305,254,2279090,-1,799.0,3700071,3705050,1473775,4979,142,2,True,True,314.6334381944445,-0.48731832555813487
2655,2226375,73,4,0.203197,254,2279090,-1,76.0,3263516,3263589,1037141,73,164,6,True,True,0.24556064444444442,-0.203197
2656,2226742,2595,16,0.80806,254,2279090,-1,624.0,2840457,2843052,613715,2595,202,11,True,True,26.659646,-0.80806
2657,2226774,23165,1,0.53639,254,2279090,-1,39.0,2338598,2361763,111824,23165,238,6,True,True,29.117678633333334,-0.4899294589423994
2658,2227829,24,4,0.390732,254,2279090,-1,164.0,3534707,3534731,1306878,24,151,1,True,True,0.048380000000000006,-0.390732
2659,2228113,10,8,0.634294,254,2279090,-1,144.0,2536514,2536524,308401,10,227,11,True,True,0.08572799999999998,-0.6342939999999999
2660,2228175,6,16,0.834526,254,2279090,-1,768.0,3400116,3400122,1171941,6,155,2,True,True,0.32244480000000003,-0.834526
2661,2228383,432,32,0.681056,254,2279090,-1,1152.0,2416598,2417030,188215,432,236,8,True,True,18.669311999999998,-0.681056
2662,2228637,7092,1,0.066115,254,2279090,-1,42.0,10543404,10550496,8314767,7092,12,12,True,True,9.1049854,-0.059530099961234664
2663,2229278,185,1,0.698676,254,2279090,-1,25.0,2334098,2334283,104820,185,245,1,True,True,0.14404305555555558,-0.698676
2664,2229642,11216,1,0.729958,254,2279090,-1,40.0,3324816,3336032,1095174,11216,161,6,True,True,16.327020444444443,-0.7265092767515084
2665,2229695,804,2,0.846468,254,2279090,-1,96.0,3186757,3187561,957062,804,175,1,True,True,3.0050304,-0.846468
2666,2229769,19826,32,0.057906,254,2279090,-1,896.0,9285994,9305820,7056225,19826,30,12,True,True,283.42759324444444,-0.05572044553594202
2667,2229799,5,1,0.086213,254,2279090,-1,36.0,6379731,6379736,4149932,5,72,8,True,True,0.0032439999999999995,-0.086213
5518,4447222,5,1,0.647793,1,4447222,-1,15.0,4533622,4533627,86400,5,0,12,True,True,0.0019489583333333331,-0.647793
5519,4447274,9180,256,0.176618,166,4533622,-1,10496.0,7725741,7734921,3278467,9180,0,11,True,True,4721.6534144,-0.17636831788021692
5520,4447328,14,32,0.039331,166,4533622,-1,256.0,12477866,12477880,8030538,14,0,12,True,True,0.03971271111111111,-0.039331
5521,4447560,21273,4,0.384164,166,4533622,-1,80.0,7681541,7702814,3233981,21273,2,12,True,True,68.23595244444445,-0.37017720115037345
5522,4447584,229,4,0.191003,166,4533622,-1,52.0,7734921,7735150,3287337,229,1,1,True,True,0.5526965888888888,-0.191003
5523,4447982,25979,118,0.695882,166,4533622,-1,3776.0,6929010,6954989,2481028,25979,4,10,True,True,3058.885711466666,-0.676744636719853
5524,4448069,22,1,0.896461,166,4533622,-1,7.0,6725107,6725129,2277038,22,5,9,True,True,0.005040505555555555,-0.896461
5525,4448097,102,16,0.630617,166,4533622,-1,160.0,8702621,8702723,4254524,102,1,6,True,True,0.5910106666666666,-0.630617
5526,4448179,5,15,0.359261,166,4533622,-1,75.0,10403158,10403163,5954979,5,1,12,True,True,0.008532291666666667,-0.359261
5527,4448207,22666,32,0.084862,166,4533622,-1,928.0,10879358,10902024,6431151,22666,1,11,True,True,642.4379486222223,-0.08481968028452228
5528,4448248,31,4,0.632791,166,4533622,-1,116.0,4954822,4954853,506574,31,9,7,True,True,0.10434393333333333,-0.632791
5529,4448319,7814,128,0.735324,166,4533622,-1,3456.0,7028418,7036232,2580099,7814,7,0,True,True,923.6180544,-0.7223632508823276
5530,4448730,31,16,0.139943,166,4533622,-1,208.0,12170866,12170897,7722136,31,1,10,True,True,0.4304577333333333,-0.13994300000000004
5531,4448774,16,4,0.193093,166,4533622,-1,200.0,6063398,6063414,1614624,16,11,1,True,True,0.14507555555555557,-0.193093
5532,4448838,33,2,0.719739,166,4533622,-1,20.0,6820510,6820543,2371672,33,10,9,True,True,0.016421166666666667,-0.719739
5533,4449247,7918,1,0.592945,166,4533622,-1,8.0,7587223,7595141,3137976,7918,8,11,True,True,3.322388311111111,-0.5870981559608952
5534,4449408,16395,12,0.489233,166,4533622,-1,168.0,7341623,7358018,2892215,16395,9,10,True,True,107.90731326666668,-0.4884712188209438
5535,4449879,56,1,0.062993,166,4533622,-1,38.0,7264518,7264574,2814639,56,10,6,True,True,0.07576271111111109,-0.062993
5536,4449895,2398,16,0.540552,166,4533622,-1,432.0,7869121,7871519,3419226,2398,5,12,True,True,46.0876992,-0.4844436042782561
5537,4450351,3163,1,0.307731,166,4533622,-1,24.0,9180621,9183784,4730270,3163,4,12,True,True,1.6089286666666667,-0.3032822112899955
5538,4450360,14342,4,0.53394,166,4533622,-1,128.0,4620022,4634364,169662,14342,19,12,True,True,82.35747982222223,-0.5249717942614621
5539,4450400,39,8,0.83425,166,4533622,-1,320.0,4975522,4975561,525122,39,18,7,True,True,0.480376,-0.83425
5540,4450560,13230,1,0.449307,166,4533622,-1,44.0,9491221,9504451,5040661,13230,4,12,True,True,27.09029693333333,-0.42093734488002793
5541,4450635,25896,1,0.995834,166,4533622,-1,11.0,5139372,5165268,688737,25896,19,6,True,True,7.966113466666667,-0.9776581626323246
5542,4450670,16527,32,0.037043,166,4533622,-1,800.0,11320060,11336587,6869390,16527,2,12,True,True,452.3268777777778,-0.035071833348757506
5543,4450960,155,9,0.056054,166,4533622,-1,108.0,9314821,9314976,4863861,155,6,12,True,True,0.45993149999999994,-0.056054000000000014
5544,4451396,7764,4,0.787779,166,4533622,-1,176.0,4662822,4670586,211426,7764,24,9,True,True,50.74935653333333,-0.7422069486854854
5545,4451584,107,82,0.042815,166,4533622,-1,2624.0,12834964,12835071,8383380,107,0,12,True,True,14.049318755555557,-0.042815
5546,4451620,44,32,0.118187,166,4533622,-1,1408.0,9577758,9577802,5126138,44,6,1,True,True,3.4182015999999997,-0.118187
5547,4451634,8215,9,0.807104,166,4533622,-1,360.0,4655622,4663837,203988,8215,27,10,True,True,138.46609,-0.8067958275707776
5548,4452803,26155,4,0.667316,166,4533622,-1,48.0,7035618,7061773,2582815,26155,18,8,True,True,41.733216399999996,-0.6567685879645531
5549,4452848,156,2,0.45837,166,4533622,-1,78.0,8699921,8700077,4247073,156,11,11,True,True,0.37142820000000004,-0.4583700000000001
5550,4453339,29,8,0.678078,166,4533622,-1,72.0,5743375,5743404,1290036,29,25,11,True,True,0.10108239999999999,-0.678078
5551,4453369,15,7,0.874255,166,4533622,-1,112.0,5141172,5141187,687803,15,26,7,True,True,0.03585866666666667,-0.874255
5552,4453378,6,32,0.148954,166,4533622,-1,1056.0,10143958,10143964,5690580,6,6,12,True,True,0.15811840000000002,-0.148954
5553,4453717,113,1,0.579346,166,4533622,-1,44.0,8392921,8393034,3939204,113,13,12,True,True,0.22963734444444447,-0.579346
5554,4453925,74,8,0.924816,166,4533622,-1,216.0,4806022,4806096,352097,74,32,9,True,True,0.5503380000000001,-0.924816
5555,4453933,9,1,0.036878,166,4533622,-1,38.0,13533364,13533373,9079431,9,0,12,True,True,0.017636750000000003,-0.036878
5556,4453955,12221,8,0.14159,166,4533622,-1,248.0,11700566,11712787,7246611,12221,4,12,True,True,138.9879619777778,-0.14078575943536178
5557,4454014,19588,16,0.653832,166,4533622,-1,432.0,6037675,6057263,1583661,19588,29,10,True,True,211.64476560000003,-0.6443542579377484
5558,4454143,24945,32,0.47122,166,4533622,-1,864.0,8875421,8900366,4421278,24945,13,12,True,True,543.3491472000001,-0.44819997372174236
5559,4454163,5965,16,0.918019,166,4533622,-1,96.0,4966522,4972487,512359,5965,35,6,True,True,20.95990586666667,-0.8890707052063013
5560,4454391,10287,188,0.045802,166,4533622,-1,3008.0,8041921,8052208,3587530,10287,17,12,True,True,1168.4314304,-0.04090936190250248
5561,4454436,55,16,0.701297,166,4533622,-1,800.0,6811510,6811565,2357074,55,29,1,True,True,1.3225666666666667,-0.701297
5562,4454459,501,64,0.130538,166,4533622,-1,1728.0,12921364,12921865,8466905,501,1,12,True,True,11.725804799999999,-0.130538
5563,4454483,14827,128,0.172249,166,4533622,-1,2304.0,13446964,13461791,8992481,14827,1,12,True,True,2157.9445824,-0.17008075000017941
5564,4454632,15,32,0.049958,166,4533622,-1,352.0,6942018,6942033,2487386,15,29,2,True,True,0.15157999999999996,-0.049958
5565,4454811,9,1,0.307337,166,4533622,-1,41.0,8701721,8701730,4246910,9,17,7,True,True,0.013362925000000001,-0.307337
5566,4454844,13049,16,0.793697,166,4533622,-1,384.0,6813310,6826359,2358466,13049,33,7,True,True,128.54743679999999,-0.7660780164052738
5567,4455102,16479,32,0.456185,166,4533622,-1,1312.0,5653175,5669654,1198073,16479,39,9,True,True,597.4427540444444,-0.45019483482256634
5568,4455208,4,32,0.170689,166,4533622,-1,1536.0,6070607,6070611,1615399,4,36,1,True,True,0.23379626666666667,-0.170689
5569,4455263,5,16,0.591042,166,4533622,-1,512.0,6119307,6119312,1664044,5,36,6,True,True,0.07425422222222222,-0.591042
5570,4455308,375,2,0.8178,166,4533622,-1,70.0,4798822,4799197,343514,375,48,7,True,True,0.8620208333333335,-0.8178
5571,4455339,34906,1,0.106331,166,4533622,-1,16.0,11492860,11527766,7037521,34906,7,12,True,True,19.554815733333335,-0.10214611365789734
5572,4455394,18,4,0.497143,166,4533622,-1,188.0,11059060,11059078,6603666,18,9,12,True,True,0.0741284,-0.497143
5573,4455785,17910,1,0.799175,166,4533622,-1,17.0,5030138,5048048,574353,17910,46,9,True,True,10.447755733333333,-0.7771956116971018
5574,4455800,37228,37,0.220573,166,4533622,-1,740.0,12575764,12612992,8119964,37228,4,7,True,True,1844.667132444444,-0.21482444034101583
5575,4455844,11896,34,0.804454,166,4533622,-1,1190.0,5269672,5281568,813828,11896,45,9,True,True,529.649008,-0.7468950947233862
5576,4455958,137,1,0.426211,166,4533622,-1,21.0,9577621,9577758,5121663,137,15,12,True,True,0.15873847500000002,-0.426211
5577,4457648,36,1,0.811521,166,4533622,-1,7.0,6065198,6065234,1607550,36,42,0,True,True,0.011424700000000001,-0.811521
5578,4463451,4177,64,0.982193,166,4533622,-1,1024.0,4953022,4957199,489571,4177,54,8,True,True,124.7411655111111,-0.9569370186781039
5579,4463634,4,1,0.678398,166,4533622,-1,20.0,4633522,4633526,169888,4,59,7,True,True,0.003324888888888889,-0.678398
5580,4463694,276,4,0.324235,166,4533622,-1,80.0,12391466,12391742,7927772,276,6,12,True,True,0.226872,-0.324235
5581,4463947,536,24,0.975853,166,4533622,-1,888.0,5014838,5015374,550891,536,52,1,True,True,19.564929066666664,-0.975853
5582,4464265,6,8,0.575967,166,4533622,-1,336.0,7037418,7037424,2573153,6,33,7,True,True,0.0667744,-0.575967
5583,4464805,14525,1,0.137329,166,4533622,-1,42.0,10489558,10504083,6024753,14525,13,12,True,True,16.840936233333334,-0.13388909345564445
5584,4464867,73,1,0.836427,166,4533622,-1,19.0,4949422,4949495,484555,73,59,0,True,True,0.04678428055555555,-0.836427
5585,4464895,499,4,0.793102,166,4533622,-1,160.0,6013775,6014274,1548880,499,48,11,True,True,2.9651688888888885,-0.793102
5586,4465011,103,8,0.764228,166,4533622,-1,104.0,5600772,5600875,1135761,103,51,12,True,True,0.36242266666666667,-0.764228
5587,4465046,13,2,0.593085,166,4533622,-1,100.0,4981822,4981835,516776,13,57,1,True,True,0.057116944444444435,-0.593085
5588,4465557,56,8,0.335504,166,4533622,-1,112.0,12174466,12174522,7708909,56,7,8,True,True,0.3454826666666667,-0.335504
5589,4465601,18274,1,0.120745,166,4533622,-1,29.0,13101364,13119638,8635763,18274,2,12,True,True,28.45334565,-0.11871241384195937
5590,4465636,78,2,0.141237,166,4533622,-1,58.0,8479321,8479399,4013685,78,27,12,True,True,0.12691076666666667,-0.141237
5591,4476701,15193,1,0.415154,166,4533622,-1,36.0,9401221,9416414,4924520,15193,21,12,True,True,22.0831989,-0.41184725977546643
5592,4476870,237,1,0.696296,166,4533622,-1,34.0,5092472,5092709,615602,237,59,7,True,True,0.3086437833333333,-0.696296
5593,4476890,59,2,0.553408,166,4533622,-1,84.0,8045521,8045580,3568631,59,30,8,True,True,0.19497730000000002,-0.553408
5594,4477000,18387,1,0.438661,166,4533622,-1,24.0,9840558,9858945,5363558,18387,18,12,True,True,13.1602672,-0.4251077044997986
5595,4477331,7032,32,0.925676,166,4533622,-1,256.0,7273523,7280555,2796192,7032,39,8,True,True,84.45475555555556,-0.9090839933565371
5596,4477589,2634,1,0.040699,166,4533622,-1,5.0,13360564,13363198,8882975,2634,2,12,True,True,0.7352884166666667,-0.04069899999999999
5597,4479098,38,36,0.099968,166,4533622,-1,864.0,10748758,10748796,6269660,38,16,12,True,True,0.3564096,-0.099968
5598,4479574,116,32,0.847367,166,4533622,-1,448.0,5014722,5014838,535148,116,67,10,True,True,2.5986961777777777,-0.7797548721222505
5599,4479759,23,1,0.612442,166,4533622,-1,35.0,6063375,6063398,1583616,23,56,7,True,True,0.03649556944444445,-0.612442
5600,4479965,23122,85,0.777662,166,4533622,-1,425.0,5052238,5075360,572273,23122,66,10,True,True,362.96616416666666,-0.7645758514465474
5601,4479974,874,1,0.01563,166,4533622,-1,33.0,12260866,12261740,7780892,874,9,12,True,True,0.97650685,-0.015497210023155072
5602,4480013,903,2,0.486967,166,4533622,-1,48.0,6249907,6250810,1769894,903,53,11,True,True,1.2853904,-0.486967
5603,4480707,9507,16,0.00635,166,4533622,-1,320.0,10972660,10982167,6491953,9507,16,0,True,True,76.45511377777778,-0.006335952648651988
5604,4480767,60,1,0.179413,166,4533622,-1,5.0,7495223,7495283,3014456,60,42,12,True,True,0.007395,-0.179413
5605,4480810,29,1,0.089141,166,4533622,-1,13.0,12928564,12928593,8447754,29,4,9,True,True,0.009634444444444444,-0.089141
5606,4480861,9072,3,0.651756,166,4533622,-1,72.0,7239718,7248790,2758857,9072,47,0,True,True,22.1484976,-0.6513393498021104
5607,4482498,10,121,0.886915,166,4533622,-1,847.0,6938418,6938428,2455920,10,52,8,True,True,0.2357718611111111,-0.886915
5608,4483981,53,28,0.416222,166,4533622,-1,1344.0,9007821,9007874,4523840,53,30,12,True,True,2.4598784,-0.416222
5609,4485144,20673,1,0.807412,166,4533622,-1,23.0,4813222,4833895,328078,20673,84,9,True,True,13.894186661111112,-0.8032191938128274
5610,4487909,4,1,0.772563,166,4533622,-1,7.0,4628122,4628126,140213,4,90,6,True,True,0.0013144444444444445,-0.772563
5611,4487985,15,64,0.692358,166,4533622,-1,1856.0,6582807,6582822,2094822,15,59,10,True,True,1.166728,-0.692358
5612,4510866,85,16,0.20616,166,4533622,-1,608.0,11961566,11961651,7450700,85,13,7,True,True,1.5880115555555556,-0.20616
5613,4510882,3,3,0.639826,166,4533622,-1,141.0,7263618,7263621,2752736,3,49,7,True,True,0.015059974999999998,-0.639826
5614,4511154,16606,8,0.523087,166,4533622,-1,64.0,6560707,6577313,2049553,16606,62,7,True,True,42.852591644444445,-0.51200656557955
5615,4511179,215,32,0.412031,166,4533622,-1,1024.0,5791175,5791390,1279996,215,71,11,True,True,3.992846222222223,-0.412031
5616,4511310,19035,8,0.93809,166,4533622,-1,208.0,5969575,5988610,1458265,19035,71,12,True,True,143.70170822222224,-0.9078909872581714
5617,4511499,4827,1,0.610538,166,4533622,-1,22.0,4835322,4840149,323823,4827,90,10,True,True,2.812625933333333,-0.6083645325180435
5618,4511753,13257,16,0.037621,166,4533622,-1,560.0,7028418,7041675,2516665,13257,54,12,True,True,250.48114933333335,-0.03720774948893207
5619,4511871,26313,256,0.18,166,4533622,-1,7680.0,11527766,11554079,7015895,26313,15,7,True,True,7557.7653119999995,-0.17633739031049608
5620,4511897,9,1,0.499888,166,4533622,-1,27.0,5622975,5622984,1111078,9,77,10,True,True,0.00946215,-0.499888
5621,4512052,29,1,0.950298,166,4533622,-1,13.0,4901622,4901651,389570,29,93,11,True,True,0.014345897222222221,-0.950298
5622,4512336,7,4,0.627192,166,4533622,-1,148.0,5146572,5146579,634236,7,80,7,True,True,0.025917266666666664,-0.627192
5623,4512344,10183,128,0.782583,166,4533622,-1,1664.0,7364623,7374806,2852279,10183,47,10,True,True,702.8542143999999,-0.7576547564915843
5624,4512484,6867,1,0.347854,166,4533622,-1,40.0,7342523,7349390,2830039,6867,48,6,True,True,10.46851988888889,-0.33579181660469914
5625,4512523,10641,4,0.00457,166,4533622,-1,56.0,11233660,11244301,6721137,10641,18,12,True,True,14.9238446,-0.0037606471527677978
5626,4512568,9408,20,0.235639,166,4533622,-1,700.0,6929010,6938418,2416442,9408,61,0,True,True,233.25321833333334,-0.2270426323793308
5627,4513133,10312,256,0.117508,166,4533622,-1,8960.0,13536964,13547276,9023831,10312,0,8,True,True,5457.761792000001,-0.1069680258503144
5628,4513172,278,8,0.530199,166,4533622,-1,200.0,6074207,6074485,1561035,278,72,2,True,True,1.457801111111111,-0.530199
5629,4513229,131,1,0.095684,166,4533622,-1,36.0,13187764,13187895,8674535,131,4,12,True,True,0.19382759999999996,-0.095684
5630,4513502,29923,8,0.361901,166,4533622,-1,96.0,7042818,7072741,2529316,29923,57,7,True,True,93.78835253333334,-0.35801960787701326
5631,4513893,115,4,0.761128,166,4533622,-1,24.0,4627222,4627337,113329,115,111,8,True,True,0.12956666666666666,-0.761128
5632,4513961,12531,206,0.539723,166,4533622,-1,7622.0,6336307,6348838,1822346,12531,72,12,True,True,2834.527837677778,-0.5265365283257788
5633,4514005,12786,1,0.219276,166,4533622,-1,16.0,11786966,11799752,7272961,12786,16,12,True,True,10.185004888888889,-0.21239517178810124
5634,4516809,8,128,0.770331,166,4533622,-1,3968.0,6630607,6630615,2113798,8,71,11,True,True,1.0637767111111112,-0.770331
5635,4516825,14,2,0.659327,166,4533622,-1,72.0,6813310,6813324,2296485,14,68,0,True,True,0.030298799999999997,-0.659327
5636,4516932,25708,1,0.276427,166,4533622,-1,42.0,6118407,6144115,1601475,25708,78,11,True,True,26.829251283333335,-0.2671732063910049
5637,4517075,17,1,0.193719,166,4533622,-1,41.0,12047966,12047983,7530891,17,15,12,True,True,0.026803522222222223,-0.193719
5638,4517257,2,1,0.796613,166,4533622,-1,34.0,4631722,4631724,114465,2,116,8,True,True,0.0033187777777777777,-0.796613
5639,4517345,1051,16,0.685244,166,4533622,-1,528.0,6061575,6062626,1544230,1051,85,7,True,True,21.178587466666666,-0.5768479185125768
5640,4517516,8846,64,0.968574,166,4533622,-1,1216.0,6586407,6595253,2068891,8846,74,8,True,True,408.19420977777776,-0.9309653686629515
5641,4517639,67,16,0.474413,166,4533622,-1,288.0,6384107,6384174,1866468,67,77,11,True,True,0.34127119999999994,-0.474413
5642,4518334,13,4,0.176324,166,4533622,-1,140.0,10835158,10835171,6316824,13,26,12,True,True,0.012401277777777778,-0.176324
5643,4518433,41,4,0.670143,166,4533622,-1,72.0,6015575,6015616,1497142,41,90,7,True,True,0.11626119999999998,-0.6153369738753809
5644,4519280,15706,216,0.043116,166,4533622,-1,2376.0,11406460,11422166,6887180,15706,21,12,True,True,770.2517328,-0.040298646720718825
5645,4520412,26,4,0.644861,166,4533622,-1,24.0,7041018,7041044,2520606,26,62,8,True,True,0.020687333333333332,-0.644861
5646,4521523,8,1,0.285065,166,4533622,-1,42.0,9754158,9754166,5232635,8,33,12,True,True,0.016266133333333335,-0.285065
5647,4521690,260,24,0.434672,166,4533622,-1,696.0,9404821,9405081,4883131,260,37,1,True,True,7.1383693333333325,-0.434672
5648,4521909,11,2,0.334295,166,4533622,-1,22.0,7275323,7275334,2753414,11,59,7,True,True,0.011612638888888888,-0.334295
5649,4522729,3,1,0.805154,166,4533622,-1,25.0,5675275,5675278,1152546,3,100,10,True,True,0.00255125,-0.805154
5650,4522899,35,3,0.758408,166,4533622,-1,69.0,5019338,5019373,496439,35,111,8,True,True,0.099518125,-0.758408
5651,4522924,5,1,0.043317,166,4533622,-1,9.0,13274164,13274169,8751240,5,4,12,True,True,0.002386125,-0.043317
5652,4522944,39,8,0.740417,166,4533622,-1,152.0,4989022,4989061,466078,39,115,9,True,True,0.2000206,-0.740417
5653,4522957,35,16,0.924861,166,4533622,-1,576.0,5514372,5514407,991415,35,105,8,True,True,0.8723120000000001,-0.924861
5654,4523140,9578,16,0.175888,166,4533622,-1,368.0,11145460,11155038,6622320,9578,25,12,True,True,158.53254773333336,-0.17478138092725523
5655,4523250,9,1,0.785492,166,4533622,-1,43.0,5114572,5114581,591322,9,111,10,True,True,0.011140224999999998,-0.785492
5656,4523363,12532,2,0.485061,166,4533622,-1,60.0,4752822,4765354,229459,12532,130,8,True,True,26.748240333333328,-0.4691457403342098
5657,4524246,9,3,0.116065,166,4533622,-1,141.0,12662164,12662173,8137918,9,10,12,True,True,0.09822765,-0.116065
5658,4524794,22,8,0.895079,166,4533622,-1,296.0,4970122,4970144,445328,22,122,2,True,True,0.24349453333333337,-0.895079
5659,4526009,18052,32,0.721403,166,4533622,-1,864.0,5262472,5280524,736463,18052,109,8,True,True,561.3745535999999,-0.7055791315553253
5660,4526106,312,1,0.592707,166,4533622,-1,15.0,5746975,5747287,1220869,312,102,8,True,True,0.23060699999999998,-0.592707
5661,4526425,95,4,0.325972,166,4533622,-1,32.0,7173418,7173513,2646993,95,67,11,True,True,0.05787822222222223,-0.325972
5662,4528509,10985,7,0.198751,166,4533622,-1,70.0,8789021,8800006,4260512,10985,46,12,True,True,19.174055250000002,-0.1691219399557864
5663,4528532,13,2,0.676853,166,4533622,-1,42.0,5466572,5466585,938040,13,111,11,True,True,0.02649465,-0.676853
5664,4528542,6902,256,0.325685,166,4533622,-1,7168.0,10965758,10972660,6437216,6902,29,12,True,True,946.308408888889,-0.3256222141320647
5665,4528627,58,1,0.778975,166,4533622,-1,46.0,4977322,4977380,448695,58,127,7,True,True,0.10269576666666666,-0.778975
5666,4528643,5,16,0.326132,166,4533622,-1,544.0,7268118,7268123,2739475,5,66,8,True,True,0.09990711111111111,-0.326132
5667,4528671,7501,2,0.098064,166,4533622,-1,44.0,6558907,6566408,2030236,7501,90,12,True,True,13.670286911111111,-0.09805151648606593
5668,4529621,14,2,0.737748,166,4533622,-1,54.0,5087072,5087086,557451,14,122,10,True,True,0.029351699999999998,-0.737748
5669,4529931,4,6,0.869886,166,4533622,-1,276.0,5335972,5335976,806041,4,115,11,True,True,0.0428904,-0.869886
5670,4530007,7692,8,0.375532,166,4533622,-1,96.0,8655721,8663413,4125714,7692,51,12,True,True,12.537713866666666,-0.35549426274127205
5671,4530554,17,10,0.220663,166,4533622,-1,110.0,11147260,11147277,6616706,17,26,7,True,True,0.07940227777777778,-0.220663
5672,4530578,845,1,0.47099,166,4533622,-1,17.0,4623622,4624467,93044,845,152,1,True,True,0.6484201388888889,-0.4709899999999999
5673,4530844,8764,4,0.484408,166,4533622,-1,28.0,8131921,8140685,3601077,8764,55,12,True,True,7.785963266666667,-0.42941127481511104
5674,4531169,3,32,0.890489,166,4533622,-1,640.0,5192572,5192575,661403,3,121,10,True,True,0.06530133333333334,-0.890489
5675,4531344,21,1,0.144941,166,4533622,-1,39.0,8306521,8306542,3775177,21,55,12,True,True,0.04823455,-0.14494100000000001
5676,4531526,20,16,0.927887,166,4533622,-1,240.0,5623875,5623895,1092349,20,115,6,True,True,0.16806666666666667,-0.927887
5677,4531638,26,1,0.454991,166,4533622,-1,50.0,8921421,8921447,4389783,26,47,7,True,True,0.024754166666666664,-0.454991
5678,4531659,557,1,0.38733,166,4533622,-1,47.0,10662358,10662915,6130699,557,34,12,True,True,0.6552749138888889,-0.38733
5679,4531671,7658,4,0.136405,166,4533622,-1,60.0,12058766,12066424,7527095,7658,17,2,True,True,13.944146333333332,-0.10831498061705758
5680,4531782,62,1,0.719821,166,4533622,-1,45.0,6472507,6472569,1940725,62,98,11,True,True,0.08283975,-0.719821
5681,4531933,1006,32,0.632021,166,4533622,-1,480.0,5291772,5292778,759839,1006,125,10,True,True,18.560642666666666,-0.6153214361982612
5682,4532622,14,1,0.975556,166,4533622,-1,24.0,4958422,4958436,425800,14,146,7,True,True,0.0098588,-0.975556
5683,4532680,5732,128,0.202211,166,4533622,-1,1280.0,10057558,10063290,5524878,5732,39,11,True,True,222.33805511111112,-0.19782778150897987
5684,4532800,98,8,0.127212,166,4533622,-1,336.0,9664158,9664256,5131358,98,42,12,True,True,1.0183898666666669,-0.127212
5685,4534150,9493,16,0.692211,254,4620022,-1,720.0,6428307,6437800,1894157,9493,101,11,True,True,192.942888,-0.6600004499194997
5686,4534165,11917,32,0.059652,254,4620022,-1,1184.0,6339907,6351824,1805742,11917,103,8,True,True,422.91954435555556,-0.05817918048493323
5687,4534238,47,1,0.136501,254,4620022,-1,7.0,6205707,6205754,1671469,47,106,12,True,True,0.009776783333333336,-0.136501
5688,4534246,13,16,0.851651,254,4620022,-1,368.0,5645975,5645988,1111729,13,124,10,True,True,0.15590524444444442,-0.851651
5689,4534395,78,41,0.458579,254,4620022,-1,328.0,5510772,5510850,976377,78,129,11,True,True,1.0654314666666667,-0.458579
5690,4534431,2356,32,0.171201,254,4620022,-1,1120.0,7239718,7242074,2705287,2356,79,10,True,True,84.10187022222223,-0.171201
5691,4534672,3,4,0.343576,254,4620022,-1,180.0,8569321,8569324,4034649,3,58,8,True,True,0.013548000000000001,-0.343576
5692,4534701,127,1,0.886409,254,4620022,-1,38.0,4905222,4905349,370521,127,159,8,True,True,0.17309253333333333,-0.886409
5693,4534756,8,1,0.603636,254,4620022,-1,20.0,6384107,6384115,1849351,8,104,0,True,True,0.002829777777777778,-0.603636
5694,4534783,7493,13,0.789547,254,4620022,-1,585.0,5699175,5706668,1164392,7493,125,7,True,True,116.385735375,-0.6798625351778664
5695,4535473,14324,32,0.637999,254,4620022,-1,768.0,5697375,5711699,1161902,14324,126,10,True,True,326.0913216,-0.6079393954462726
5696,4536952,7,2,0.611528,254,4620022,-1,22.0,9926958,9926965,5390006,7,40,12,True,True,0.0063957055555555545,-0.611528
5697,4537101,22782,64,0.169935,254,4620022,-1,960.0,8218321,8241103,3681220,22782,63,12,True,True,655.8848053333334,-0.1520150592585193
5698,4537167,10152,2,0.970136,254,4620022,-1,56.0,4949422,4959574,412255,10152,164,11,True,True,16.906589155555558,-0.9258724260924036
5699,4537238,12,4,0.855004,254,4620022,-1,168.0,5090672,5090684,553434,12,148,2,True,True,0.0772184,-0.855004
5700,4537337,23,4,0.086474,254,4620022,-1,192.0,8220121,8220144,3682784,23,63,7,True,True,0.08135253333333332,-0.086474
5701,4537344,189,1,0.856974,254,4620022,-1,25.0,5835375,5835564,1298031,189,125,11,True,True,0.1538775,-0.8569740000000002
5702,4537367,11498,256,0.489213,254,4620022,-1,11264.0,12564266,12575764,8026899,11498,12,12,True,True,2259.479552,-0.3239590016764399
5703,4537480,15,12,0.995664,254,4620022,-1,468.0,5168672,5168687,631192,15,146,10,True,True,0.168441,-0.995664
5704,4537510,203,32,0.591581,254,4620022,-1,1216.0,7032018,7032221,2494508,203,90,8,True,True,8.151469511111111,-0.591581
5705,4537875,9,1,0.836989,254,4620022,-1,31.0,5060472,5060481,522597,9,155,1,True,True,0.0115816,-0.836989
5706,4537929,4,4,0.279171,254,4620022,-1,52.0,9228421,9228425,4690492,4,51,8,True,True,0.0083512,-0.279171
5707,4537994,9,2,0.730018,254,4620022,-1,84.0,4797022,4797031,259028,9,179,11,True,True,0.0152712,-0.730018
5708,4538286,7597,2,0.736179,254,4620022,-1,84.0,5600875,5608472,1062589,7597,139,1,True,True,25.190326,-0.7275254009620418
5709,4538325,12320,1,0.246654,254,4620022,-1,9.0,11959766,11972086,7421441,12320,21,12,True,True,4.063106149999999,-0.23050437380446923
5710,4538828,2,16,0.327296,254,4620022,-1,448.0,4857422,4857424,318594,2,177,10,True,True,0.02004302222222222,-0.327296
5711,4538836,3,4,0.579467,254,4620022,-1,68.0,6811507,6811510,2272671,3,103,12,True,True,0.006131900000000001,-0.579467
5712,4539024,19,4,0.891823,254,4620022,-1,180.0,5214672,5214691,675648,19,150,10,True,True,0.13661,-0.891823
5713,4539041,7308,2,0.591772,254,4620022,-1,34.0,5144772,5152080,605731,7308,154,3,True,True,7.086069200000001,-0.5510095136330049
5714,4539072,11767,4,0.14897,254,4620022,-1,200.0,12051566,12063333,7512494,11767,19,8,True,True,87.83616555555557,-0.1405286646441955
5715,4539154,266,4,0.573701,254,4620022,-1,72.0,5056738,5057004,517584,266,163,6,True,True,0.8275792000000001,-0.573701
5716,4539197,12,32,0.005078,254,4620022,-1,608.0,12305066,12305078,7765869,12,15,11,True,True,0.05686826666666666,-0.005078
5717,4539250,24,1,0.980184,254,4620022,-1,34.0,5015738,5015762,476488,24,168,6,True,True,0.033542133333333335,-0.980184
5718,4539326,9,1,0.040059,254,4620022,-1,32.0,9667758,9667767,5128432,9,47,8,True,True,0.008964,-0.040059
5719,4539362,12486,128,0.470653,254,4620022,-1,3584.0,7595141,7607627,3055779,12486,78,6,True,True,2373.095115377778,-0.4552557689462241
5720,4539386,549,16,0.768606,254,4620022,-1,464.0,7129218,7129767,2589832,549,92,12,True,True,7.468010400000001,-0.768606
5721,4539400,38,11,0.033621,254,4620022,-1,308.0,11614166,11614204,7074766,38,26,12,True,True,0.5560700444444444,-0.033621
5722,4539428,6673,11,0.531122,254,4620022,-1,187.0,9094221,9100894,4554793,6673,58,12,True,True,32.833885425,-0.530075402954147
5723,4539570,29,1,0.479269,254,4620022,-1,33.0,6906910,6906939,2367340,29,106,12,True,True,0.04639323333333334,-0.479269
5724,4539617,41,4,0.798018,254,4620022,-1,112.0,5064972,5065013,525355,41,169,8,True,True,0.18883324444444444,-0.798018
5725,4539651,11,4,0.821291,254,4620022,-1,48.0,6066998,6067009,1527347,11,130,7,True,True,0.021023200000000002,-0.821291
5726,4539700,12,8,0.452441,254,4620022,-1,360.0,4749222,4749234,209522,12,199,12,True,True,0.12314400000000002,-0.452441
5727,4539973,16323,2,0.240511,254,4620022,-1,34.0,12062366,12078689,7522393,16323,19,3,True,True,34.629631172222226,-0.2188983153871525
5728,4540032,20468,8,0.558487,254,4620022,-1,144.0,5138472,5158940,598440,20468,167,7,True,True,78.56109279999998,-0.5206932550215198
5729,4540119,7,1,0.012423,254,4620022,-1,43.0,10316758,10316765,5776639,7,44,12,True,True,0.013978105555555554,-0.012423
5730,4540204,452,2,0.731786,254,4620022,-1,14.0,7268123,7268575,2727919,452,90,1,True,True,0.24934276111111112,-0.6608395071794204
5731,4540698,84,4,0.949934,254,4620022,-1,172.0,5136672,5136756,595974,84,170,10,True,True,0.35923346666666667,-0.949934
5732,4540838,16624,128,0.132712,254,4620022,-1,4864.0,11873366,11889990,7332528,16624,25,12,True,True,3020.911259022222,-0.12999330395058845
5733,4541331,1361,16,0.29579,254,4620022,-1,320.0,6717907,6719268,2176576,1361,117,12,True,True,15.06778222222222,-0.29578999999999994
5734,4542711,39803,32,0.64764,254,4620022,-1,576.0,7782721,7822524,3240010,39803,80,8,True,True,1090.3043488,-0.6384057944075183
5735,4542733,93,16,0.09073,254,4620022,-1,640.0,7955521,7955614,3412788,93,79,12,True,True,2.43536,-0.09073
5736,4542757,20619,20,0.479783,254,4620022,-1,200.0,10230358,10250977,5687601,20619,46,12,True,True,90.60362722222223,-0.44148712006162166
5737,4542826,24541,128,0.304837,254,4620022,-1,640.0,12055166,12079707,7512340,24541,21,8,True,True,861.3887591111111,-0.27631035961438793
5738,4542922,7192,32,0.703304,254,4620022,-1,1408.0,6063398,6070590,1520476,7192,141,0,True,True,420.9593500444444,-0.6866426544943199
5739,4545593,10098,1,0.857922,254,4620022,-1,32.0,4965622,4975720,420029,10098,197,9,True,True,11.904808888888889,-0.8312960293296762
5740,4545652,134,1,0.747287,254,4620022,-1,11.0,5060338,5060472,514686,134,184,8,True,True,0.06118737777777777,-0.747287
5741,4545678,8,3,0.024413,254,4620022,-1,45.0,12148766,12148774,7603088,8,19,12,True,True,0.009717,-0.024413
5742,4546241,62,1,0.454841,254,4620022,-1,38.0,9224821,9224883,4678580,62,63,11,True,True,0.09700175555555555,-0.454841
5743,4546266,5,8,0.771835,254,4620022,-1,264.0,5422372,5422377,876106,5,167,12,True,True,0.046185333333333335,-0.771835
5744,4546278,312,1,0.874199,254,4620022,-1,16.0,7319523,7319835,2773245,312,95,11,True,True,0.19833493333333335,-0.874199
5745,4546309,18,2,0.40536,254,4620022,-1,36.0,10013358,10013376,5467049,18,51,12,True,True,0.0212022,-0.40536
5746,4546313,22560,16,0.789859,254,4620022,-1,416.0,4973722,4996282,427409,22560,201,3,True,True,338.4800177777778,-0.7688602699729252
5747,4546388,15476,256,0.37042,254,4620022,-1,8704.0,10575958,10591434,6029570,15476,45,12,True,True,1251.5669703111112,-0.3409359062529694
5748,4547692,5567,32,0.464296,254,4620022,-1,1280.0,7261818,7267385,2714126,5567,104,10,True,True,257.4284408888889,-0.46166831628949
5749,4547799,23,32,0.633402,254,4620022,-1,192.0,6631507,6631530,2083708,23,128,6,True,True,0.12050773333333333,-0.633402
5750,4548559,15,2,0.860383,254,4620022,-1,54.0,5061372,5061387,512813,15,191,6,True,True,0.033624,-0.860383
5751,4548601,49,1,0.070699,254,4620022,-1,43.0,7543023,7543072,2994422,49,93,8,True,True,0.05621593055555554,-0.07069900000000001
5752,4548870,23,4,0.893434,254,4620022,-1,40.0,6059775,6059798,1510905,23,153,10,True,True,0.033304,-0.893434
5753,4548920,25,8,0.332906,254,4620022,-1,384.0,4956622,4956647,407702,25,212,7,True,True,0.27856,-0.332906
5754,4548991,127,32,0.032714,254,4620022,-1,864.0,13014964,13015091,8465973,127,7,12,True,True,2.7459431999999997,-0.032714
5755,4549079,9,1,0.425902,254,4620022,-1,30.0,6070598,6070607,1521519,9,148,8,True,True,0.01027425,-0.425902
5756,4549091,7,8,0.269789,254,4620022,-1,128.0,8565721,8565728,4016630,7,78,12,True,True,0.024844088888888886,-0.269789
5757,4550800,140,2,0.946095,254,4620022,-1,70.0,5838975,5839115,1288175,140,161,8,True,True,0.43806000000000006,-0.946095
5758,4550857,10170,8,0.542435,254,4620022,-1,56.0,7408823,7418993,2857966,10170,97,11,True,True,14.044980288888887,-0.5420232349982708
5759,4551076,11945,4,0.794479,254,4620022,-1,164.0,6065198,6077143,1514122,11945,153,7,True,True,68.57333913333335,-0.7014838887607145
5760,4551090,221,8,0.787692,254,4620022,-1,256.0,5258872,5259093,707782,221,185,11,True,True,1.9503004444444443,-0.787692
5761,4551512,47,1,0.080959,254,4620022,-1,32.0,12748564,12748611,8197052,47,11,12,True,True,0.05467040000000001,-0.080959
5762,4551543,9,2,0.880847,254,4620022,-1,46.0,5170472,5170481,618929,9,189,7,True,True,0.012807550000000001,-0.880847
5763,4551700,51326,1,0.735761,254,4620022,-1,34.0,4978222,5029548,426522,51326,214,6,True,True,67.05864143333334,-0.7090253382393816
5764,4551709,72,4,0.054812,254,4620022,-1,128.0,7539423,7539495,2987714,72,97,11,True,True,0.2779392,-0.054812
5765,4551801,1050,2,0.945322,254,4620022,-1,46.0,5883175,5884225,1331374,1050,165,11,True,True,1.7318233333333335,-0.945322
5766,4551830,14819,1,0.674653,254,4620022,-1,8.0,7269923,7284742,2718093,14819,106,7,True,True,5.351950488888889,-0.6689841375279216
5767,4553656,7380,16,0.887978,254,4620022,-1,528.0,4992622,5000002,438966,7380,215,8,True,True,120.15040106666666,-0.8810267264869244
5768,4554141,18,6,0.110967,254,4620022,-1,156.0,8919621,8919639,4365480,18,72,11,True,True,0.06921719999999999,-0.110967
5769,4554431,72,1,0.365591,254,4620022,-1,27.0,7217618,7217690,2663187,72,115,11,True,True,0.0651996,-0.365591
5770,4554453,5978,128,0.619133,254,4620022,-1,2176.0,7590823,7596801,3036370,5978,96,1,True,True,671.0720412444444,-0.6127081021823696
5771,4554771,52873,10,0.365571,254,4620022,-1,70.0,5055838,5108711,501067,52873,212,8,True,True,135.92661716666666,-0.3604768342960609
5772,4554882,283,32,0.175267,254,4620022,-1,960.0,7779121,7779404,3224239,283,92,11,True,True,13.793042666666668,-0.175267
5773,4554941,70,8,0.55879,254,4620022,-1,176.0,5022938,5023008,467997,70,216,8,True,True,0.4995759999999999,-0.55879
862,803344,420,32,0.443679,1,803344,-1,416.0,889744,890164,86400,420,0,12,True,True,6.796607999999999,-0.443679
863,803495,6902,4,0.694001,85,889744,-1,120.0,1018444,1025346,214949,6902,0,9,True,True,34.68613933333333,-0.6561479754761346
864,803568,20120,2,0.903424,85,889744,-1,46.0,2231431,2251551,1427863,20120,0,6,True,True,15.999238533333333,-0.820605418996775
865,803679,7452,128,0.045991,85,889744,-1,768.0,5479539,5486991,4675860,7452,0,6,True,True,167.5029824,-0.045919824497571954
866,804449,15046,128,0.796143,85,889744,-1,4352.0,1159716,1174762,355267,15046,2,7,True,True,2835.3606158222224,-0.7923135353870236
867,804482,33606,16,0.293368,85,889744,-1,208.0,1446959,1480565,642477,33606,2,6,True,True,265.54993226666664,-0.27929267891396353
868,805102,62,32,0.374841,85,889744,-1,1312.0,4072814,4072876,3267712,62,1,2,True,True,2.270401422222222,-0.374841
869,805220,10332,32,0.14557,85,889744,-1,704.0,2720815,2731147,1915595,10332,2,6,True,True,384.4289406222222,-0.1453987201239831
870,805230,29,1,0.531166,85,889744,-1,10.0,1171425,1171454,366195,29,5,2,True,True,0.012092194444444445,-0.531166
871,805243,4,1,0.565928,85,889744,-1,12.0,2475931,2475935,1670688,4,3,7,True,True,0.0010549333333333335,-0.565928
872,805292,77,5,0.792519,85,889744,-1,75.0,1266312,1266389,461020,77,6,11,True,True,0.19395979166666663,-0.792519
873,811926,8,12,0.169984,85,889744,-1,588.0,4186386,4186394,3374460,8,1,6,True,True,0.19952799999999998,-0.169984
874,812010,19832,32,0.078968,85,889744,-1,1248.0,5627491,5647323,4815481,19832,0,6,True,True,1674.9048749333333,-0.07807431133151216
875,812082,21614,3,0.87084,85,889744,-1,48.0,1376659,1398273,564577,21614,8,6,True,True,49.351666533333336,-0.8193247114034006
876,812749,20,16,0.61971,85,889744,-1,96.0,3707817,3707837,2895068,20,4,9,True,True,0.06366933333333333,-0.6197099999999999
877,812915,14297,64,0.24083,85,889744,-1,1024.0,5864598,5878895,5051683,14297,0,11,True,True,689.9703523555555,-0.2310536115856425
878,813568,1417,1,0.912829,85,889744,-1,34.0,1176633,1178050,363065,1417,12,2,True,True,2.0020173722222223,-0.8988091112372953
879,813725,9665,1,0.143118,85,889744,-1,25.0,5963598,5973263,5149873,9665,0,7,True,True,17.925266944444445,-0.14263475487805494
880,813919,40458,1,0.46115,85,889744,-1,21.0,4413484,4453942,3599565,40458,4,12,True,True,36.63923421666667,-0.45673877256529516
881,822832,22853,1,0.253977,85,889744,-1,29.0,5340839,5363692,4518007,22853,4,12,True,True,23.318063269444444,-0.25326073031816665
882,822838,110,64,0.255327,85,889744,-1,960.0,5342639,5342749,4519801,110,4,7,True,True,3.2598133333333332,-0.255327
883,822900,33,32,0.009397,85,889744,-1,224.0,5818598,5818631,4995698,33,2,11,True,True,0.5233536,-0.009397000000000003
884,822952,4,8,0.804633,85,889744,-1,96.0,1491159,1491163,668207,4,14,11,True,True,0.012865066666666666,-0.804633
885,822990,16,1,0.901209,85,889744,-1,28.0,1045044,1045060,222054,16,21,8,True,True,0.015676266666666668,-0.9012090000000003
886,823196,6103,1,0.677611,85,889744,-1,10.0,3144417,3150520,2321221,6103,11,10,True,True,3.0416371388888885,-0.6478739705697555
887,823236,17,8,0.157976,85,889744,-1,376.0,5733713,5733730,4910477,17,3,12,True,True,0.5823644666666667,-0.157976
888,825223,23,6,0.44173,85,889744,-1,48.0,5433539,5433562,4608316,23,6,12,True,True,0.031135866666666668,-0.44173
889,825864,1998,1,0.345566,85,889744,-1,45.0,4188186,4190184,3362322,1998,10,7,True,True,4.237758,-0.345566
890,825996,5,1,0.587572,85,889744,-1,20.0,1200012,1200017,374016,5,22,10,True,True,0.002784166666666667,-0.587572
891,826016,18972,12,0.638939,85,889744,-1,516.0,4027617,4046589,3201601,18972,13,6,True,True,402.20477850000003,-0.6197488806476475
892,826170,219,16,0.424309,85,889744,-1,640.0,1157916,1158135,331746,219,27,11,True,True,5.818586666666667,-0.424309
893,826200,20,1,0.250098,85,889744,-1,17.0,4499884,4499904,3673684,20,9,12,True,True,0.01683188888888889,-0.250098
894,826364,216,7,0.845304,85,889744,-1,259.0,1106516,1106732,280152,216,29,6,True,True,2.4094770000000003,-0.845304
895,826367,752,1,0.199217,85,889744,-1,27.0,4610384,4611136,3784017,752,9,11,True,True,0.8563776000000001,-0.199217
896,849581,23,1,0.384693,85,889744,-1,24.0,4276584,4276607,3427003,23,12,12,True,True,0.031517666666666666,-0.384693
897,855437,12693,16,0.483208,85,889744,-1,480.0,893344,906037,37907,12693,34,8,True,True,232.63413199999997,-0.4786803482980834
898,855480,6,16,0.237206,85,889744,-1,512.0,3210717,3210723,2355237,6,18,10,True,True,0.10752000000000002,-0.237206
899,855897,7,2,0.571923,85,889744,-1,60.0,2474131,2474138,1618234,7,22,0,True,True,0.009230666666666667,-0.571923
900,855953,8,6,0.574812,85,889744,-1,270.0,3214317,3214325,2358364,8,18,2,True,True,0.05430000000000001,-0.574812
901,856547,12,3,0.992692,85,889744,-1,144.0,1564269,1564281,707722,12,25,11,True,True,0.058406400000000004,-0.992692
902,856672,8973,256,0.295231,85,889744,-1,6656.0,5761825,5770798,4905153,8973,3,6,True,True,2142.0668856888888,-0.2850778833922887
903,856901,5276,1,0.977944,85,889744,-1,22.0,1397359,1402635,540458,5276,29,8,True,True,7.584502444444444,-0.9574725627684921
904,857055,2147,1,0.65823,85,889744,-1,22.0,1269912,1272059,412857,2147,31,8,True,True,1.6103889388888888,-0.6473018427364974
905,857294,280,4,0.27448,85,889744,-1,180.0,3807017,3807297,2949723,280,18,7,True,True,1.99766,-0.27448
906,857423,10533,256,0.565929,85,889744,-1,2816.0,5254439,5264972,4397016,10533,10,8,True,True,1071.9476650666666,-0.560344226395475
907,857764,2,16,0.685799,85,889744,-1,160.0,3122315,3122317,2264551,2,24,7,True,True,0.013135111111111113,-0.685799
908,857872,23,32,0.744669,85,889744,-1,832.0,2545115,2545138,1687243,23,26,1,True,True,0.7592208000000001,-0.744669
909,857926,13543,41,0.049044,85,889744,-1,984.0,5956398,5969941,5098472,13543,1,6,True,True,978.5166818666667,-0.04815000634926885
910,858044,130,2,0.606406,85,889744,-1,36.0,2023969,2024099,1165925,130,31,10,True,True,0.18972199999999995,-0.606406
911,858080,14815,32,0.496727,85,889744,-1,224.0,4696784,4711599,3838704,14815,12,12,True,True,271.83943173333336,-0.48627858222925385
912,858233,4292,256,0.904155,85,889744,-1,10496.0,2523009,2527301,1664776,4292,29,6,True,True,1241.6237077333335,-0.6832044056974389
913,858316,633,8,0.286194,85,889744,-1,344.0,3752017,3752650,2893701,633,22,10,True,True,7.052745333333333,-0.286194
914,858633,5104,16,0.79886,85,889744,-1,464.0,1351859,1356963,493226,5104,40,11,True,True,176.79819324444446,-0.7880518257179744
915,869045,28,4,0.607065,85,889744,-1,28.0,979744,979772,110699,28,51,12,True,True,0.02585675555555556,-0.607065
916,872125,2,4,0.352321,85,889744,-1,192.0,3937617,3937619,3065492,2,21,12,True,True,0.013112533333333334,-0.352321
917,872597,2,8,0.636618,85,889744,-1,368.0,3755617,3755619,2883020,2,23,8,True,True,0.023999733333333332,-0.6366179999999999
918,872822,7,1,0.620891,85,889744,-1,49.0,2031169,2031176,1158347,7,36,0,True,True,0.013266477777777778,-0.620891
919,874005,8,3,0.677764,85,889744,-1,81.0,1498359,1498367,624354,8,39,9,True,True,0.0223182,-0.6777640000000001
920,874367,121,4,0.720928,85,889744,-1,64.0,1511069,1511190,636702,121,39,8,True,True,0.2550357333333334,-0.720928
921,874462,30081,118,0.659182,85,889744,-1,2950.0,3612217,3642298,2737755,30081,26,9,True,True,2528.113387222222,-0.6485549892309446
922,874661,25,8,0.838337,85,889744,-1,264.0,1389259,1389284,514598,25,45,2,True,True,0.26766666666666666,-0.838337
923,875287,124,1,0.628248,85,889744,-1,8.0,4034817,4034941,3159530,124,20,2,True,True,0.0440448,-0.628248
924,875915,116,1,0.903404,85,889744,-1,22.0,1375759,1375875,499844,116,48,10,True,True,0.12291424444444442,-0.903404
925,876833,31818,22,0.646341,85,889744,-1,770.0,3188617,3220435,2311784,31818,30,11,True,True,807.0105205555556,-0.6065348546791612
926,879025,6633,4,0.308933,85,889744,-1,64.0,3215217,3221850,2336192,6633,28,6,True,True,19.625447466666667,-0.3075518559377976
927,879294,29,1,0.440823,85,889744,-1,9.0,5042384,5042413,4163090,29,12,12,True,True,0.019352424999999996,-0.440823
928,879729,170,1,0.579574,85,889744,-1,33.0,1304059,1304229,424330,170,53,8,True,True,0.19740966666666668,-0.579574
929,880101,14947,8,0.73236,85,889744,-1,360.0,1010344,1025291,130243,14947,64,7,True,True,240.686447,-0.7125210880827769
930,880390,8887,73,0.090133,85,889744,-1,2847.0,6222798,6231685,5342408,8887,0,12,True,True,2163.739818283333,-0.08958191713143242
931,880414,11490,32,0.29511,85,889744,-1,352.0,5242949,5254439,4362535,11490,13,1,True,True,138.0473072,-0.2847516565649442
932,880813,36514,15,0.747481,85,889744,-1,270.0,3757417,3793931,2876604,36514,27,7,True,True,319.02983175,-0.7413781466550384
933,881078,5,8,0.17564,85,889744,-1,184.0,4783184,4783189,3902106,5,15,12,True,True,0.08592544444444446,-0.17564
934,881223,28,16,0.13216,85,889744,-1,656.0,4069214,4069242,3187991,28,24,2,True,True,0.6245630222222223,-0.13216
935,881791,19419,2,0.539408,85,889744,-1,78.0,1420359,1439778,538568,19419,53,6,True,True,109.46819,-0.5371399431860877
936,882069,133,32,0.97149,85,889744,-1,576.0,1162416,1162549,280347,133,65,6,True,True,3.4788544,-0.97149
937,883386,108,31,0.530852,85,889744,-1,1147.0,2233231,2233339,1349845,108,45,7,True,True,2.9799059999999993,-0.530852
938,883775,287,2,0.913487,85,889744,-1,40.0,994144,994431,110369,287,73,7,True,True,0.39800522222222223,-0.913487
939,883852,219,2,0.830473,85,889744,-1,88.0,2947715,2947934,2063863,219,40,8,True,True,0.3732879333333333,-0.830473
940,883929,246,8,0.25697,85,889744,-1,288.0,3612217,3612463,2728288,246,33,0,True,True,2.4048959999999995,-0.25697
941,884401,10356,1,0.82469,85,889744,-1,49.0,1008544,1018900,124143,10356,75,6,True,True,24.01160175555556,-0.8216617171667336
942,886266,17,42,0.481848,85,889744,-1,1470.0,2407831,2407848,1521565,17,47,12,True,True,0.4805021666666666,-0.481848
943,886308,10,16,0.806488,85,889744,-1,448.0,1274759,1274769,388451,10,64,7,True,True,0.1591768888888889,-0.806488
944,887364,49,8,0.746559,85,889744,-1,96.0,2813515,2813564,1926151,49,42,6,True,True,0.18464506666666666,-0.746559
945,887483,4,16,0.338715,85,889744,-1,240.0,5735513,5735517,4848030,4,6,7,True,True,0.08501333333333334,-0.338715
946,888404,19181,64,0.11517,85,889744,-1,2880.0,3707817,3726998,2819413,19181,33,0,True,True,1602.7936320000001,-0.1093457760234472
947,888428,7,4,0.962893,85,889744,-1,60.0,1005844,1005851,117416,7,81,7,True,True,0.019359666666666667,-0.962893
948,890340,32,8,0.140757,86,893344,-1,168.0,6049998,6050030,5159658,32,1,12,True,True,0.3473045333333334,-0.140757
949,890943,933,1,0.9665,86,893344,-1,49.0,1278359,1279292,387416,933,68,2,True,True,1.6162229416666665,-0.9665
950,898449,8685,8,0.860141,234,979744,-1,200.0,1222112,1230797,323663,8685,72,10,True,True,44.75530222222223,-0.8597453185469068
951,898487,4,31,0.724217,234,979744,-1,1178.0,2162805,2162809,1264318,4,54,12,True,True,0.09554888888888888,-0.724217
952,899563,16,16,0.979942,234,979744,-1,544.0,1105616,1105632,206053,16,81,9,True,True,0.37487644444444446,-0.979942
953,899573,6726,4,0.96727,234,979744,-1,52.0,1300459,1307185,400886,6726,69,10,True,True,12.248550744444445,-0.9317048232795327
954,899742,37,1,0.804588,234,979744,-1,29.0,1113716,1113753,213974,37,81,9,True,True,0.03526891388888889,-0.804588
955,900455,21812,4,0.365775,234,979744,-1,92.0,5740013,5761825,4839558,21812,7,6,True,True,155.2929893,-0.3493671604091821
956,900532,88,64,0.790682,234,979744,-1,448.0,985144,985232,84612,88,91,8,True,True,1.310848,-0.790682
957,900557,1004,1,0.013919,234,979744,-1,42.0,5346239,5347243,4445682,1004,13,2,True,True,1.4128622666666668,-0.013919
958,900601,3,2,0.536572,234,979744,-1,96.0,1446059,1446062,545458,3,64,8,True,True,0.015009600000000001,-0.536572
959,900967,2394,2,0.454786,234,979744,-1,24.0,2498031,2500425,1597064,2394,51,0,True,True,1.509582,-0.4250601549897471
960,900973,1191,16,0.672828,234,979744,-1,128.0,2809015,2810206,1908042,1191,48,12,True,True,6.339719466666667,-0.672828
961,901023,7663,1,0.672341,234,979744,-1,26.0,1011244,1018907,110221,7663,91,6,True,True,9.3306057,-0.6559160139795793
962,901302,88,4,0.58456,234,979744,-1,140.0,1442459,1442547,541157,88,67,10,True,True,0.679276888888889,-0.58456
963,901346,11,2,0.822417,234,979744,-1,32.0,1419459,1419470,518113,11,69,10,True,True,0.022213155555555558,-0.8224170000000002
964,901612,8,1,0.940292,234,979744,-1,22.0,2001869,2001877,1100257,8,61,12,True,True,0.004761777777777777,-0.940292
965,901663,23878,7,0.108346,234,979744,-1,224.0,5955498,5979376,5053835,23878,4,8,True,True,395.16957884444446,-0.10817331892796972
966,902461,19,2,0.233822,234,979744,-1,46.0,3805217,3805236,2902756,19,34,7,True,True,0.03464196111111111,-0.233822
967,902471,1293,1,0.025025,234,979744,-1,48.0,2230531,2231824,1328060,1293,60,10,True,True,1.587804,-0.025025
968,902499,7017,42,0.884235,234,979744,-1,1512.0,1169616,1176633,267117,7017,89,2,True,True,445.61677860000003,-0.8689134473443156
969,902511,126,8,0.561407,234,979744,-1,344.0,3301617,3301743,2399106,126,42,12,True,True,1.7215996000000002,-0.561407
970,902522,52,1,0.915256,234,979744,-1,17.0,1353659,1353711,451137,52,79,7,True,True,0.06514588888888889,-0.915256
971,902557,23,32,0.221367,234,979744,-1,1280.0,1385659,1385682,483102,23,77,7,True,True,1.1472604444444445,-0.221367
972,902661,93,1,0.063217,234,979744,-1,10.0,6136398,6136491,5233737,93,1,12,True,True,0.060948583333333334,-0.063217
973,903095,8782,32,0.823855,234,979744,-1,768.0,1390159,1398941,487064,8782,77,6,True,True,382.9183381333333,-0.7987355800723064
974,903110,860,16,0.909388,234,979744,-1,752.0,2452031,2452891,1548921,860,59,11,True,True,15.866197333333332,-0.909388
975,903135,6,16,0.30219,234,979744,-1,352.0,5220784,5220790,4317649,6,20,7,True,True,0.06912106666666666,-0.30219
976,903148,44954,1,0.408296,234,979744,-1,35.0,4042552,4087506,3139404,44954,32,2,True,True,56.4121730277778,-0.39376907626875324
977,903524,11752,256,0.139777,234,979744,-1,6912.0,4566184,4577936,3662660,11752,25,11,True,True,3316.7772672,-0.13940062943908443
978,903601,92,1,0.946262,234,979744,-1,17.0,1272059,1272151,368458,92,92,2,True,True,0.054223011111111115,-0.946262
979,903638,68,1,0.304365,234,979744,-1,40.0,3803417,3803485,2899779,68,39,11,True,True,0.1089511111111111,-0.304365
980,903680,4122,32,0.492625,234,979744,-1,672.0,2207531,2211653,1303851,4122,68,2,True,True,70.3062752,-0.47384568204148003
981,903718,45,8,0.097192,234,979744,-1,192.0,4049752,4049797,3146034,45,33,8,True,True,0.297744,-0.097192
982,904017,60,2,0.887259,234,979744,-1,12.0,1001344,1001404,97327,60,115,9,True,True,0.032172000000000006,-0.887259
983,904225,19,1,0.135664,234,979744,-1,12.0,4117014,4117033,3212789,19,31,10,True,True,0.016891633333333333,-0.135664
984,904339,39,33,0.453644,234,979744,-1,429.0,1650669,1650708,746330,39,75,12,True,True,0.419343925,-0.453644
985,905570,22716,12,0.670486,234,979744,-1,252.0,1759169,1781885,853599,22716,75,12,True,True,282.1751163,-0.6443462420719809
986,905590,9,4,0.74314,234,979744,-1,60.0,1915469,1915478,1009879,9,75,11,True,True,0.023094,-0.74314
987,905623,13136,1,0.945974,234,979744,-1,32.0,981544,994680,75921,13136,122,7,True,True,14.52053048888889,-0.9378812901681857
988,906078,9022,64,0.419127,234,979744,-1,768.0,5631091,5640113,4725013,9022,12,2,True,True,509.6111104,-0.3973502239685676
989,906231,66,8,0.742269,234,979744,-1,168.0,1383859,1383925,477628,66,92,9,True,True,0.4320932,-0.742269
990,906267,19,2,0.154523,234,979744,-1,40.0,4189086,4189105,3282819,19,30,6,True,True,0.03582133333333334,-0.154523
991,906314,10719,32,0.414885,234,979744,-1,736.0,5487891,5498610,4581577,10719,14,6,True,True,260.64765946666665,-0.3832520537413498
992,906561,65,1,0.099022,234,979744,-1,33.0,5242884,5242949,4336323,65,22,10,True,True,0.07630241666666666,-0.099022
993,906605,6836,4,0.489347,234,979744,-1,52.0,3120515,3127351,2213910,6836,60,12,True,True,15.2303307,-0.4689369109318413
994,906648,38,16,0.408116,234,979744,-1,128.0,4024917,4024955,3118269,38,42,12,True,True,0.21613724444444443,-0.408116
995,907346,10685,256,0.951522,234,979744,-1,1792.0,1307659,1318344,400313,10685,102,6,True,True,1050.1086449777777,-0.7752890755270885
996,907418,22137,186,0.032716,234,979744,-1,1674.0,5640113,5662250,4732695,22137,12,6,True,True,2956.7903106000003,-0.031208948604208878
997,907611,11406,130,0.37053,234,979744,-1,4420.0,5486991,5498397,4579380,11406,16,7,True,True,1639.3750165000001,-0.3407565807396584
998,907659,13541,8,0.443383,234,979744,-1,72.0,1784869,1798410,877210,13541,84,10,True,True,46.4198584,-0.44224642512582135
999,908719,13369,32,0.950555,234,979744,-1,512.0,1002244,1015613,93525,13369,130,6,True,True,321.44963982222225,-0.9461506342163135
1000,908991,87,16,0.85545,234,979744,-1,176.0,1004044,1004131,95053,87,130,7,True,True,0.6841912,-0.85545
1001,909120,27,4,0.099355,234,979744,-1,84.0,5647313,5647340,4738193,27,12,8,True,True,0.13677930000000002,-0.099355
1002,909179,43100,1,0.68568,234,979744,-1,12.0,1762769,1805869,853590,43100,86,8,True,True,24.16547436666667,-0.669424582105215
1003,909201,123,2,0.544466,234,979744,-1,44.0,4094914,4095037,3185713,123,39,10,True,True,0.2946834,-0.544466
1004,909536,33,1,0.977843,234,979744,-1,49.0,1161516,1161549,251980,33,122,7,True,True,0.07342976666666666,-0.977843
1005,909593,16765,128,0.358674,234,979744,-1,5632.0,4170214,4186979,3260621,16765,38,10,True,True,4323.230927644444,-0.34544504068447024
1006,909608,12,4,0.39814,234,979744,-1,192.0,2208431,2208443,1298823,12,81,6,True,True,0.057241600000000004,-0.39814
1007,909629,54,39,0.189809,234,979744,-1,507.0,5634691,5634745,4725062,54,14,2,True,True,2.1347234999999998,-0.189809
1008,909664,402,8,0.12216,234,979744,-1,256.0,5736413,5736815,4826749,402,10,6,True,True,9.113429333333334,-0.12216
1009,909671,508,32,0.848033,234,979744,-1,800.0,1040544,1041052,130873,508,133,10,True,True,14.75006222222222,-0.848033
1010,909734,7262,128,0.454717,234,979744,-1,2944.0,5773498,5780760,4863764,7262,8,6,True,True,683.0045653333333,-0.45189957163714817
1011,910051,9,1,0.662769,234,979744,-1,6.0,4320784,4320793,3410733,9,37,11,True,True,0.0021391500000000003,-0.662769
1012,910264,145,32,0.641704,234,979744,-1,864.0,2031169,2031314,1120905,145,89,9,True,True,4.8455520000000005,-0.641704
1013,912627,17,11,0.597146,234,979744,-1,517.0,3759217,3759234,2846590,17,56,7,True,True,0.2891825138888889,-0.597146
1014,913063,10,8,0.021357,234,979744,-1,136.0,5634745,5634755,4721682,10,16,1,True,True,0.10604222222222223,-0.021357
1015,913159,10,2,0.786795,234,979744,-1,24.0,2812615,2812625,1899456,10,75,8,True,True,0.009420666666666667,-0.786795
1016,913181,4,32,0.243569,234,979744,-1,256.0,5772598,5772602,4859417,4,9,7,True,True,0.032512,-0.243569
1017,913189,52,2,0.125924,234,979744,-1,28.0,4324384,4324436,3411195,52,39,8,True,True,0.05565964444444444,-0.125924
1018,913206,10652,32,0.564578,234,979744,-1,448.0,2076405,2087057,1163199,10652,93,1,True,True,113.60770897777778,-0.5640229781497932
1019,913376,10586,4,0.06861,234,979744,-1,72.0,2653615,2664201,1740239,10586,80,12,True,True,32.365656,-0.06819959866366841
1020,913679,13,1,0.765157,234,979744,-1,8.0,1520069,1520082,606390,13,105,3,True,True,0.003570377777777778,-0.765157
1021,913776,5090,128,0.207157,234,979744,-1,2560.0,5532991,5538081,4619215,5090,21,11,True,True,351.87945244444444,-0.19352496059531035
1022,913837,8334,86,0.215951,234,979744,-1,3440.0,3700617,3708951,2786780,8334,66,10,True,True,975.9241873333333,-0.206234733895708
1023,913856,34,1,0.869695,234,979744,-1,5.0,992344,992378,78488,34,156,9,True,True,0.005731833333333333,-0.869695
1024,913878,12987,102,0.32856,234,979744,-1,2856.0,3851217,3864204,2937339,12987,57,11,True,True,1395.4376015999999,-0.323797802737207
1025,914416,1453,8,0.147554,234,979744,-1,88.0,5086584,5088037,4172168,1453,33,11,True,True,7.009026688888889,-0.14478689317693544
1026,914447,10233,26,0.900531,234,979744,-1,234.0,1871269,1881502,956822,10233,104,12,True,True,102.9985632,-0.8922093473826658
1027,917303,12378,32,0.002836,234,979744,-1,864.0,5961798,5974176,5044495,12378,4,0,True,True,791.5935311999999,-0.0028287571333013685
1028,917615,29897,224,0.858406,234,979744,-1,10976.0,4035717,4065614,3118102,29897,55,6,True,True,11897.849391555555,-0.8560530515491361
1029,917671,30,8,0.144688,234,979744,-1,216.0,5770798,5770828,4853127,30,11,7,True,True,0.20761919999999998,-0.12841560997229917
1030,917677,24,1,0.129992,234,979744,-1,39.0,2567215,2567239,1649538,24,88,10,True,True,0.04215120000000001,-0.12999199999999997
1031,918317,103,8,0.250654,234,979744,-1,264.0,3605017,3605120,2686700,103,74,11,True,True,0.9321568666666668,-0.250654
1032,918364,38,2,0.174497,234,979744,-1,46.0,5958198,5958236,5039834,38,5,7,True,True,0.13435322222222223,-0.174497
1033,918775,3,9,0.661058,234,979744,-1,333.0,1171416,1171419,252641,3,146,7,True,True,0.041655525000000006,-0.661058
1034,919307,9385,1,0.02578,234,979744,-1,32.0,4521984,4531369,3602677,9385,42,10,True,True,15.25880968888889,-0.0256575194501495
1035,919364,89,32,0.01486,234,979744,-1,1600.0,5478639,5478728,4559275,89,28,6,True,True,4.340035555555556,-0.01486
1036,919452,3,64,0.789985,234,979744,-1,2688.0,2899915,2899918,1980463,3,87,12,True,True,0.23262400000000003,-0.789985
1037,920324,34,8,0.237932,234,979744,-1,112.0,5774398,5774432,4854074,34,10,6,True,True,0.12380106666666665,-0.23758451804453548
1038,920891,48,2,0.323771,234,979744,-1,70.0,5487891,5487939,4567000,48,26,0,True,True,0.09601200000000001,-0.323771
1039,920971,97,16,0.174246,234,979744,-1,704.0,5961798,5961895,5040827,97,5,8,True,True,4.984075555555556,-0.174246
1040,921010,137,32,0.052399,234,979744,-1,1248.0,5483139,5483276,4562129,137,30,8,True,True,4.976351466666667,-0.052399
1041,921138,19,32,0.741718,234,979744,-1,1024.0,1177012,1177031,255874,19,151,1,True,True,0.8210972444444444,-0.741718
1042,921155,4,16,0.526086,234,979744,-1,352.0,5218984,5218988,4297829,4,41,11,True,True,0.04618239999999999,-0.5260859999999999
1043,921476,16,2,0.745665,234,979744,-1,48.0,2321431,2321447,1399955,16,106,12,True,True,0.027127466666666666,-0.745665
1044,922091,7318,1,0.476246,234,979744,-1,21.0,1272959,1280277,350868,7318,148,6,True,True,5.425705833333334,-0.47458538155240787
1045,922453,8,32,0.778017,234,979744,-1,832.0,3729917,3729925,2807464,8,77,10,True,True,0.23216497777777775,-0.778017
1046,923100,8145,4,0.513238,234,979744,-1,180.0,3678517,3686662,2755417,8145,81,10,True,True,52.5685645,-0.5121493436015155
1047,923295,14,4,0.109054,234,979744,-1,112.0,2719915,2719929,1796620,14,99,11,True,True,0.07725884444444445,-0.109054
1048,924235,1805,4,0.503839,234,979744,-1,192.0,2722615,2724420,1798380,1805,98,7,True,True,20.154389333333334,-0.503839
1049,924270,4,4,0.945416,234,979744,-1,76.0,1007644,1007648,83374,4,176,7,True,True,0.01401271111111111,-0.945416
1050,924347,478,32,0.043365,234,979744,-1,960.0,4325284,4325762,3400937,478,51,6,True,True,17.541962666666663,-0.043365
1051,924458,5852,24,0.783227,234,979744,-1,792.0,1041444,1047296,116986,5852,172,6,True,True,164.8160976,-0.7781412520277022
1052,924597,126,1,0.866981,234,979744,-1,30.0,1174762,1174888,250165,126,161,2,True,True,0.15952650000000004,-0.866981
1053,924998,6,8,0.521451,234,979744,-1,312.0,2207005,2207011,1282007,6,117,11,True,True,0.0465088,-0.521451
1054,925011,39,16,0.458043,234,979744,-1,688.0,3938517,3938556,3013506,39,69,6,True,True,0.9435174666666666,-0.458043
1055,936420,9172,256,0.964026,234,979744,-1,3072.0,1089244,1098416,152824,9172,174,11,True,True,1281.1429546666668,-0.9409196063713511
1056,940082,17,1,0.060825,234,979744,-1,35.0,4327084,4327101,3387002,17,51,7,True,True,0.02274552777777778,-0.060825
1057,946443,136,4,0.478982,234,979744,-1,120.0,2076269,2076405,1129826,136,122,6,True,True,0.37440799999999996,-0.478982
1058,947436,101,4,0.401617,234,979744,-1,52.0,4046152,4046253,3098716,101,65,2,True,True,0.19702294444444446,-0.401617
1059,948335,228,2,0.686097,234,979744,-1,78.0,1500269,1500497,551934,228,137,1,True,True,0.6125106000000001,-0.686097
1060,948427,60,128,0.490269,234,979744,-1,1664.0,4185486,4185546,3237059,60,59,2,True,True,4.2348799999999995,-0.490269
1061,950872,20,1,0.909701,234,979744,-1,21.0,1516469,1516489,565597,20,137,1,True,True,0.014474833333333334,-0.909701
1062,951596,93,6,0.073491,234,979744,-1,114.0,4039317,4039410,3087721,93,68,2,True,True,0.38134805000000005,-0.073491
1063,952049,4,1,0.08079,234,979744,-1,40.0,5738213,5738217,4786164,4,17,6,True,True,0.01416888888888889,-0.08079
1064,954290,6001,1,0.608297,234,979744,-1,27.0,2474131,2480132,1519841,6001,115,10,True,True,3.7814052,-0.6054584550635679
1065,954364,14892,1,0.065682,234,979744,-1,28.0,4955984,4970876,4001620,14892,45,12,True,True,23.88262551111111,-0.06482242976991413
1066,958951,49,2,0.275016,234,979744,-1,70.0,5488791,5488840,4529840,49,28,6,True,True,0.09801225000000001,-0.275016
1067,959062,1,16,0.633077,234,979744,-1,96.0,4118814,4118815,3159752,1,64,7,True,True,0.006266133333333333,-0.633077
1068,960718,5,1,0.548356,234,979744,-1,16.0,2520131,2520136,1559413,5,115,10,True,True,0.002088222222222222,-0.548356
1069,961037,26,1,0.325185,234,979744,-1,45.0,2498031,2498057,1536994,26,117,10,True,True,0.03289,-0.325185
1070,961492,11010,4,0.994628,234,979744,-1,140.0,1098416,1109426,136924,11010,188,7,True,True,64.81529366666668,-0.9874631467364986
1071,962758,3023,14,0.530557,234,979744,-1,616.0,2675715,2678738,1712957,3023,111,10,True,True,76.42891837777776,-0.41771353693558866
1072,964846,8,16,0.453715,234,979744,-1,688.0,4126014,4126022,3161168,8,64,9,True,True,0.25167039999999996,-0.453715
1073,965817,8624,1,0.605427,234,979744,-1,15.0,1520069,1528693,554252,8624,146,0,True,True,4.489508,-0.605192086046114
1074,967377,34871,32,0.099178,234,979744,-1,1248.0,4065614,4100485,3098237,34871,70,8,True,True,1815.9934381333335,-0.09241778471832397
1075,967509,1078,4,0.701779,234,979744,-1,196.0,2521931,2523009,1554422,1078,118,7,True,True,5.515203711111112,-0.701779
1076,968389,9,5,0.852793,234,979744,-1,155.0,1171416,1171425,203027,9,184,0,True,True,0.058167625,-0.852793
1077,968414,72,16,0.650917,234,979744,-1,160.0,1270812,1270884,302398,72,176,6,True,True,0.399392,-0.650917
1078,969769,154,39,0.768963,234,979744,-1,1170.0,3656417,3656571,2686648,154,94,11,True,True,6.4214150000000005,-0.768963
1079,971202,34,2,0.72084,234,979744,-1,52.0,3560817,3560851,2589615,34,98,12,True,True,0.050859466666666665,-0.72084
1080,971335,38,5,0.215023,234,979744,-1,225.0,4869584,4869622,3898249,38,47,12,True,True,0.7219049999999999,-0.215023
1081,971395,4,1,0.451555,234,979744,-1,26.0,4031217,4031221,3059822,4,78,2,True,True,0.0049634,-0.451555
1082,971409,19,16,0.228494,234,979744,-1,736.0,4175614,4175633,3204205,19,64,8,True,True,0.7129120888888889,-0.228494
1083,972347,8440,4,0.338932,234,979744,-1,132.0,5174784,5183224,4202437,8440,44,12,True,True,51.129604533333335,-0.3340591064365142
1084,972419,46,64,0.453499,234,979744,-1,2752.0,3122317,3122363,2149898,46,109,1,True,True,5.1962499555555555,-0.453499
1085,972472,202,7,0.41599,234,979744,-1,252.0,4148114,4148316,3175642,202,67,10,True,True,1.9213432,-0.41599
1086,972562,9,16,0.095086,234,979744,-1,368.0,5477739,5477748,4505177,9,35,11,True,True,0.1009424,-0.095086
1087,973330,8268,1,0.426764,234,979744,-1,38.0,5626591,5634859,4653261,8268,27,12,True,True,16.59842343333333,-0.3528799797329119
1088,976350,1795,8,0.665108,234,979744,-1,392.0,3034115,3035910,2057765,1795,115,12,True,True,26.250432444444442,-0.6280430365082097
1089,977243,39,1,0.374301,234,979744,-1,30.0,2944115,2944154,1966872,39,117,11,True,True,0.021999249999999998,-0.374301
1090,977252,11,1,0.152639,234,979744,-1,22.0,5347139,5347150,4369887,11,38,6,True,True,0.008108344444444445,-0.15263900000000002
1091,977766,685,12,0.922985,234,979744,-1,132.0,2235031,2235716,1257265,685,141,7,True,True,2.1129621333333333,-0.8966159560088335
1092,977881,13472,8,0.067133,234,979744,-1,104.0,4172014,4185486,3194133,13472,69,7,True,True,63.95498315555555,-0.06446956164892137
1093,977908,132,1,0.831772,234,979744,-1,41.0,3474417,3474549,2496509,132,108,12,True,True,0.17252253333333334,-0.831772
1094,978328,59,16,0.09323,234,979744,-1,528.0,5540191,5540250,4561863,59,28,9,True,True,0.9242625333333334,-0.09323
1095,978363,3,8,0.096564,234,979744,-1,48.0,5820398,5820401,4842035,3,10,7,True,True,0.010195200000000001,-0.096564
1096,978418,13818,1,0.738796,234,979744,-1,8.0,2075369,2089187,1096951,13818,155,11,True,True,2.641502066666667,-0.7228637113240692
1097,978486,10996,1,0.811769,234,979744,-1,20.0,1166016,1177012,187530,10996,207,8,True,True,9.330397555555557,-0.8016431613552595
1098,978991,526,1,0.556371,234,979744,-1,36.0,2207005,2207531,1228014,526,151,0,True,True,0.4704544,-0.556371
1099,980530,24,4,0.586465,239,981544,-1,28.0,3937617,3937641,2957087,24,91,0,True,True,0.022946933333333336,-0.586465
1100,980556,14205,5,0.561586,239,981544,-1,140.0,1507469,1521674,526913,14205,173,9,True,True,68.4099363888889,-0.5527923873717581
1101,980782,174,1,0.329646,239,981544,-1,21.0,5088384,5088558,4107602,174,50,7,True,True,0.20412665000000002,-0.329646
1102,981035,110,1,0.122231,239,981544,-1,18.0,5643713,5643823,4662678,110,23,2,True,True,0.14193849999999997,-0.122231
1103,981285,15835,1,0.353598,239,981544,-1,28.0,4026717,4042552,3045432,15835,91,7,True,True,18.73131547777778,-0.34522226128905287
1104,981445,6,1,0.665341,239,981544,-1,25.0,2545109,2545115,1563664,6,138,10,True,True,0.005951250000000002,-0.665341
1105,982056,602,32,0.750284,251,985144,-1,1600.0,1672769,1673371,690713,602,171,10,True,True,49.891084444444445,-0.750284
1106,982101,37,4,0.868092,251,985144,-1,160.0,1177912,1177949,195811,37,208,6,True,True,0.24344355555555555,-0.868092
1107,982123,110,8,0.721061,251,985144,-1,176.0,1500159,1500269,518036,110,180,7,True,True,0.6667906666666665,-0.721061
1108,982164,7,8,0.968399,251,985144,-1,224.0,1393759,1393766,411595,7,189,2,True,True,0.08907982222222223,-0.968399
1109,982252,5,1,0.60041,251,985144,-1,6.0,1305859,1305864,323607,5,199,7,True,True,0.0010556666666666668,-0.60041
1110,982290,4761,32,0.351646,251,985144,-1,256.0,4190184,4194945,3207894,4761,68,2,True,True,55.138412800000005,-0.32700869089377144
1111,982603,17270,32,0.577919,251,985144,-1,1504.0,5739113,5756383,4756510,17270,18,6,True,True,2199.7275559111113,-0.5732881694022501
1112,982610,6,1,0.212739,251,985144,-1,30.0,5737313,5737319,4754703,6,20,6,True,True,0.015940000000000003,-0.212739
1113,982622,638,32,0.656736,251,985144,-1,160.0,1306759,1307397,324137,638,202,6,True,True,3.8006337777777772,-0.6542703857910361
1114,982989,235,32,0.224245,251,985144,-1,960.0,5950998,5951233,4968009,235,9,12,True,True,7.636559999999999,-0.224245
1115,983056,39,1,0.108218,251,985144,-1,17.0,5951898,5951937,4968842,39,9,6,True,True,0.022442550000000002,-0.10821800000000002
1116,983155,9737,1,0.845373,251,985144,-1,48.0,3388017,3397754,2404862,9737,120,12,True,True,15.439955600000001,-0.8369024889727693
1117,983164,29666,2,0.367561,251,985144,-1,10.0,1512869,1542535,529705,29666,183,7,True,True,10.218016,-0.3666878121087078
8108,6377131,47,4,0.476302,1,6377131,-1,120.0,6378931,6378978,1800,47,0,7,True,True,0.11001133333333334,-0.476302
8109,6378238,10,1,0.897511,2,6378931,-1,32.0,6423131,6423141,44893,10,0,11,True,True,0.010346666666666667,-0.897511
8110,6378720,26,11,0.123098,2,6378931,-1,462.0,6467341,6467367,88621,26,0,11,True,True,0.3129459666666667,-0.123098
8111,6378935,136,8,0.135756,36,6423131,-1,352.0,6686556,6686692,307621,136,0,7,True,True,4.293320533333333,-0.135756
8112,6378951,139,64,0.534543,36,6423131,-1,1152.0,7726887,7727026,1347936,139,0,7,True,True,7.2755936,-0.534543
8113,6379393,5,2,0.725414,36,6423131,-1,68.0,7082749,7082754,703356,5,1,6,True,True,0.02228038888888889,-0.725414
8114,6379472,188,16,0.090442,36,6423131,-1,656.0,9172739,9172927,2793267,188,0,12,True,True,2.8569984444444443,-0.0875417619433908
8115,6380095,12873,4,0.691785,36,6423131,-1,20.0,6537926,6550799,157831,12873,4,7,True,True,7.006951833333334,-0.6888874319125635
8116,6391925,24763,3,0.871941,36,6423131,-1,36.0,6948449,6973212,556524,24763,3,7,True,True,64.61577039999999,-0.8279993625966197
8117,6393083,6,2,0.93178,36,6423131,-1,62.0,6541526,6541532,148443,6,5,8,True,True,0.009914833333333335,-0.93178
8118,6402404,10865,16,0.766337,36,6423131,-1,496.0,6423141,6434006,20737,10865,8,1,True,True,194.0881287111111,-0.7451150930904884
8119,6402494,34078,256,0.600679,36,6423131,-1,7680.0,6640778,6674856,238284,34078,5,2,True,True,20152.049962666668,-0.560872460327291
8120,6402669,20,1,0.643987,36,6423131,-1,39.0,6482926,6482946,80257,20,8,7,True,True,0.022500833333333334,-0.6439869999999999
8121,6404470,327,1,0.37701,36,6423131,-1,18.0,6527126,6527453,122656,327,8,11,True,True,0.20653319999999997,-0.37701
8122,6405043,16695,8,0.717443,36,6423131,-1,144.0,7215764,7232459,810721,16695,2,2,True,True,148.42294,-0.607508122343539
8123,6405474,12420,141,0.736002,36,6423131,-1,3666.0,7612509,7624929,1207035,12420,2,11,True,True,2011.1643616999997,-0.7099890224264505
8124,6405788,47,4,0.381651,36,6423131,-1,152.0,8566103,8566150,2160315,47,1,12,True,True,0.43231122222222224,-0.381651
8125,6406712,10245,128,0.642102,36,6423131,-1,3968.0,7473764,7484009,1067052,10245,4,10,True,True,3523.501443555556,-0.6416839161114365
8126,6406866,2,4,0.5619,36,6423131,-1,172.0,6852456,6852458,445590,2,8,6,True,True,0.028690555555555552,-0.5619
8127,6409679,62,16,0.856141,36,6423131,-1,752.0,6844356,6844418,434677,62,9,2,True,True,3.5010738666666663,-0.856141
8128,6411880,3461,4,0.808447,36,6423131,-1,100.0,6553226,6556687,141346,3461,12,2,True,True,9.626372222222223,-0.8002142576959624
8129,6412361,433,2,0.223551,36,6423131,-1,52.0,9259139,9259572,2846778,433,0,12,True,True,0.4783854111111111,-0.22293098793746668
8130,6412410,16,2,0.11569,36,6423131,-1,88.0,9345539,9345555,2933129,16,0,12,True,True,0.03808639999999999,-0.11569
8131,6412419,8503,32,0.08768,36,6423131,-1,672.0,9653639,9662142,3241220,8503,0,11,True,True,163.27284960000003,-0.08554035945769943
8132,6412478,35,4,0.089139,36,6423131,-1,168.0,7065649,7065684,653171,35,10,2,True,True,0.3751276666666667,-0.089139
8133,6413657,15493,8,0.740581,36,6423131,-1,240.0,6677556,6693049,263899,15493,15,7,True,True,284.9731473333334,-0.6885168746227226
8134,6413715,7,1,0.937211,36,6423131,-1,45.0,6626605,6626612,212890,7,17,7,True,True,0.01501325,-0.937211
8135,6413904,35,5,0.744618,36,6423131,-1,155.0,6423131,6423166,9227,35,25,0,True,True,0.17540833333333333,-0.7446179999999999
8136,6414290,126,1,0.116106,36,6423131,-1,24.0,6470041,6470167,55751,126,23,6,True,True,0.08972040000000002,-0.116106
8137,6414603,58,4,0.367737,36,6423131,-1,124.0,7181057,7181115,766454,58,9,11,True,True,0.6311978888888888,-0.367737
8138,6421226,22,8,0.85333,36,6423131,-1,208.0,6900480,6900502,479254,22,13,7,True,True,0.33838248888888883,-0.85333
8139,6421316,4,8,0.954069,36,6423131,-1,376.0,6834456,6834460,413140,4,16,6,True,True,0.09786862222222222,-0.9540689999999998
8140,6421412,60,4,0.576917,36,6423131,-1,68.0,7518709,7518769,1097297,60,7,10,True,True,0.31621133333333334,-0.576917
8141,6421880,8849,32,0.001678,36,6423131,-1,1216.0,6839856,6848705,417976,8849,17,2,True,True,812.8505452444443,-0.0016586912537400508
8142,6421934,8333,15,0.061885,36,6423131,-1,315.0,10664839,10673172,4242905,8333,0,12,True,True,111.08385050000001,-0.061107133783684424
8143,6422009,22,1,0.535603,36,6423131,-1,49.0,6911021,6911043,489012,22,15,6,True,True,0.0830389388888889,-0.535603
8144,6422033,20390,32,0.847119,36,6423131,-1,384.0,7620609,7640999,1198576,20390,7,2,True,True,344.3893258666667,-0.835538237660939
8145,6422764,6751,32,0.979849,36,6423131,-1,1216.0,6530726,6537477,107962,6751,29,8,True,True,242.62403822222223,-0.9786976492690171
8146,6423734,14,1,0.319643,60,6467341,-1,19.0,6902280,6902294,478546,14,17,7,True,True,0.01993374444444444,-0.319643
8147,6423866,23216,101,0.365024,60,6467341,-1,1616.0,8370087,8393303,1946221,23216,6,12,True,True,2287.8098942222223,-0.3641316435016561
8148,6423995,349,4,0.679302,60,6467341,-1,156.0,6479041,6479390,55046,349,34,2,True,True,1.4061675333333334,-0.679302
8149,6424009,34,8,0.796565,60,6467341,-1,312.0,6710456,6710490,286447,34,24,7,True,True,0.33111693333333336,-0.7965650000000002
8150,6424161,8,1,0.519751,60,6467341,-1,44.0,7306664,7306672,882503,8,12,7,True,True,0.02629928888888889,-0.519751
8151,6424189,31,2,0.601618,60,6467341,-1,60.0,6946649,6946680,522460,31,18,7,True,True,0.14349383333333335,-0.601618
8152,6424395,7,1,0.222142,60,6467341,-1,21.0,10361439,10361446,3937044,7,1,8,True,True,0.013818408333333334,-0.222142
8153,6424449,25172,64,0.395312,60,6467341,-1,1152.0,9086339,9111511,2661890,25172,6,7,True,True,1273.7170848,-0.39363015614498403
8154,6424472,20451,2,0.538293,60,6467341,-1,84.0,6549626,6570077,125154,20451,34,8,True,True,76.98532613333334,-0.435526493298984
8155,6424527,15,4,0.460603,60,6467341,-1,196.0,7873187,7873202,1448660,15,9,7,True,True,0.17087552222222221,-0.4582929394613787
8156,6425008,71,1,0.144701,60,6467341,-1,16.0,9748339,9748410,3323331,71,2,6,True,True,0.03733968888888888,-0.144701
8157,6425300,7485,4,0.94289,60,6467341,-1,192.0,6473641,6481126,48341,7485,43,8,True,True,39.3345648,-0.8992026644546177
8158,6425396,13324,16,0.837217,60,6467341,-1,192.0,6885356,6898680,459960,13324,26,8,True,True,172.8465408,-0.7783301865357963
8159,6425461,47,1,0.499833,60,6467341,-1,36.0,8998103,8998150,2572642,47,8,12,True,True,0.0871286,-0.499833
8160,6425543,224,1,0.455785,60,6467341,-1,7.0,7568309,7568533,1142766,224,15,6,True,True,0.06845191111111111,-0.455785
8161,6425595,2,19,0.601465,60,6467341,-1,532.0,6739756,6739758,314161,2,33,6,True,True,0.09853526666666668,-0.601465
8162,6425609,443,1,0.145871,60,6467341,-1,28.0,10357839,10358282,3932230,443,2,12,True,True,1.2021198777777777,-0.145871
8163,6426025,8,1,0.665351,60,6467341,-1,40.0,6481126,6481134,55101,8,47,2,True,True,0.009231111111111112,-0.665351
8164,6426378,7081,128,0.801292,60,6467341,-1,6144.0,6564026,6571107,137648,7081,40,2,True,True,3130.722747733333,-0.691758668643912
8165,6426457,11,1,0.702967,60,6467341,-1,46.0,6895256,6895267,468799,11,29,2,True,True,0.03693097222222222,-0.702967
8166,6455460,21180,4,0.59888,60,6467341,-1,196.0,6966449,6987629,510989,21180,24,6,True,True,290.5835746333333,-0.5880527685324901
8167,6455719,12,32,0.308891,60,6467341,-1,1056.0,8197287,8197299,1741568,12,12,12,True,True,0.8125920000000001,-0.308891
8168,6455822,29177,128,0.990335,60,6467341,-1,3712.0,6572628,6601805,116806,29177,43,3,True,True,8888.9900768,-0.9529582759642925
8169,6455887,16,2,0.123464,60,6467341,-1,20.0,9835639,9835655,3379752,16,3,12,True,True,0.010873777777777777,-0.123464
8170,6456027,100,1,0.996849,60,6467341,-1,47.0,6469141,6469241,13114,100,57,7,True,True,0.12941737222222222,-0.925155388463627
8171,6456047,127,2,0.706522,60,6467341,-1,84.0,7475564,7475691,1019517,127,20,7,True,True,0.9403249333333333,-0.706522
8172,6462804,16,1,0.478283,60,6467341,-1,44.0,7721487,7721503,1258683,16,16,6,True,True,0.030672888888888885,-0.478283
8173,6468167,12202,32,0.828687,62,6469141,-1,896.0,6560426,6572628,92259,12202,48,2,True,True,735.7307875555556,-0.7889788273371724
8174,6468858,69,16,0.495026,62,6469141,-1,480.0,7081849,7081918,612991,69,27,7,True,True,2.1703719999999995,-0.495026
8175,6468963,23944,16,0.70414,62,6469141,-1,256.0,6544226,6568170,75263,23944,52,7,True,True,234.2168391111111,-0.6390159322297344
8176,6470414,2,40,0.376709,64,6473641,-1,600.0,7090849,7090851,620435,2,26,2,True,True,0.06821333333333332,-0.376709
8177,6471051,30,4,0.981143,64,6473641,-1,88.0,6761856,6761886,290805,30,42,10,True,True,0.22071133333333331,-0.981143
8178,6472282,19,8,0.333145,64,6473641,-1,232.0,7673687,7673706,1201405,19,17,7,True,True,0.1897154222222222,-0.333145
8179,6472694,35,2,0.827885,64,6473641,-1,72.0,6475441,6475476,2747,35,63,7,True,True,0.072527,-0.827885
8180,6481475,21285,8,0.210613,63,6482926,-1,80.0,7751187,7772472,1269712,21285,15,6,True,True,77.416746,-0.2092475254761111
8181,6482751,3,1,0.732658,63,6482926,-1,40.0,6935321,6935324,452570,3,35,7,True,True,0.008694666666666667,-0.732658
8182,6482913,22,4,0.810419,63,6482926,-1,116.0,6944321,6944343,461408,22,35,2,True,True,0.1886140666666667,-0.810419
8183,6483235,9208,8,0.700407,117,6527126,-1,272.0,7210364,7219572,727129,9208,27,10,True,True,196.10798648888888,-0.6813458929270423
8184,6484147,1,32,0.052566,117,6527126,-1,1152.0,9477039,9477040,2992892,1,6,12,True,True,0.0407296,-0.052566
8185,6485258,9,16,0.865432,117,6527126,-1,688.0,6898680,6898689,413422,9,42,2,True,True,0.45788119999999993,-0.865432
8186,6485563,36,20,0.17902,117,6527126,-1,540.0,9084503,9084539,2598940,36,11,12,True,True,0.7421760000000001,-0.17902
8187,6492039,8,26,0.487505,117,6527126,-1,390.0,7542609,7542617,1050570,8,24,10,True,True,0.1732206666666667,-0.487505
8188,6492231,31,32,0.391808,117,6527126,-1,1440.0,7720587,7720618,1228356,31,20,7,True,True,1.94494,-0.391808
8189,6495591,2,1,0.98439,117,6527126,-1,8.0,6546026,6546028,50435,2,64,7,True,True,0.00043844444444444443,-0.98439
8190,6495648,26,8,0.65925,117,6527126,-1,96.0,7062049,7062075,566401,26,37,2,True,True,0.172952,-0.65925
8191,6495954,8,1,0.848518,117,6527126,-1,39.0,6542426,6542434,46472,8,67,6,True,True,0.008315666666666667,-0.848518
8192,6496746,14074,4,0.991063,117,6527126,-1,132.0,6569426,6583500,72680,14074,61,7,True,True,139.67329933333335,-0.9307318883474384
8193,6498268,835,2,0.547943,117,6527126,-1,44.0,7671887,7672722,1173619,835,22,2,True,True,1.5812487777777775,-0.547943
8194,6498325,12165,64,0.33741,117,6527126,-1,1408.0,6896156,6908321,397831,12165,48,6,True,True,1271.2753699555553,-0.33737203549997097
8195,6498584,9640,64,0.677899,117,6527126,-1,1664.0,6681156,6690796,182572,9640,59,6,True,True,1313.752664177778,-0.6633461193910479
8196,6498674,14962,32,0.990314,117,6527126,-1,800.0,6574428,6589390,75754,14962,63,6,True,True,926.0686311111112,-0.9368755868805156
8197,6501826,1213,32,0.757714,117,6527126,-1,1312.0,6905880,6907093,404054,1213,45,8,True,True,118.2009736888889,-0.757714
8198,6502035,6153,1,0.391063,117,6527126,-1,30.0,8652503,8658656,2150468,6153,13,12,True,True,11.094583833333333,-0.37960222110429603
8199,6502111,9289,8,0.527844,117,6527126,-1,120.0,6738856,6748145,236745,9289,59,10,True,True,95.33310499999999,-0.5020196022055166
8200,6502185,26,1,0.28304,117,6527126,-1,8.0,7871387,7871413,1369202,26,18,10,True,True,0.012150088888888888,-0.28304
8201,6502386,77,27,0.696376,117,6527126,-1,675.0,7494809,7494886,992423,77,30,7,True,True,2.830183125,-0.696376
8202,6504417,98,8,0.195092,117,6527126,-1,88.0,8024487,8024585,1520070,98,17,12,True,True,0.41744951111111106,-0.19509199999999996
8203,6506506,16072,16,0.856252,117,6527126,-1,576.0,6881756,6897828,375250,16072,56,7,True,True,546.5913023999999,-0.7425104590631711
8204,6506530,393,2,0.393772,117,6527126,-1,60.0,6963749,6964142,457219,393,44,7,True,True,1.709026,-0.393772
8205,6506670,9,10,0.130901,117,6527126,-1,60.0,9746539,9746548,3239869,9,5,11,True,True,0.017749499999999998,-0.130901
8206,6506850,53,32,0.752266,117,6527126,-1,1120.0,6926321,6926374,419471,53,50,2,True,True,4.671796888888889,-0.752266
8207,6506902,10238,16,0.580384,117,6527126,-1,656.0,7567409,7577647,1060507,10238,30,10,True,True,299.0294601333333,-0.5792936425817519
8208,6514749,11,4,0.805072,117,6527126,-1,148.0,7184664,7184675,669915,11,39,1,True,True,0.1404918777777778,-0.805072
8209,6515182,17122,16,0.84981,117,6527126,-1,640.0,6956549,6973671,441367,17122,48,9,True,True,746.9839128888889,-0.785535710545874
8210,6515205,5924,65,0.709588,117,6527126,-1,2405.0,6928121,6934045,412916,5924,53,7,True,True,1053.4403179444444,-0.7017915431462272
8211,6515302,21,4,0.457533,117,6527126,-1,180.0,7883087,7883108,1367785,21,19,2,True,True,0.1300845,-0.457533
8212,6515336,13,4,0.163694,117,6527126,-1,156.0,9563439,9563452,3048103,13,7,12,True,True,0.0585754,-0.163694
8213,6518831,318,1,0.137561,117,6527126,-1,23.0,9747439,9747757,3228608,318,5,6,True,True,0.24040711666666664,-0.137561
8214,6519316,9030,256,0.695956,117,6527126,-1,1536.0,6601805,6610835,82489,9030,80,2,True,True,1173.7099306666667,-0.6388678219931478
8215,6520167,30595,8,0.291082,117,6527126,-1,56.0,9925839,9956434,3405672,30595,3,7,True,True,127.09828444444447,-0.2907477430986439
8216,6521012,76,8,0.144823,117,6527126,-1,136.0,7303064,7303140,782052,76,41,6,True,True,0.878272888888889,-0.144823
8217,6521112,549,11,0.218136,117,6527126,-1,429.0,6556826,6557375,35714,549,88,7,True,True,6.403554299999999,-0.218136
8218,6521118,54,4,0.748383,117,6527126,-1,32.0,7671109,7671163,1149991,54,31,8,True,True,0.0708864,-0.748383
8219,6523224,6,4,0.735319,117,6527126,-1,44.0,6879956,6879962,356732,6,70,10,True,True,0.0070796,-0.735319
8220,6523228,25123,128,0.009133,117,6527126,-1,3456.0,10271439,10296562,3748211,25123,3,12,True,True,8252.840649599999,-0.009078621157620809
8221,6523268,45,32,0.725958,117,6527126,-1,1440.0,6929021,6929066,405753,45,60,6,True,True,4.91184,-0.725958
8222,6523290,5278,1,0.575682,117,6527126,-1,23.0,7666609,7671887,1143319,5278,33,11,True,True,4.923578886111112,-0.5507107937703231
8223,6523551,26792,8,0.678318,117,6527126,-1,376.0,6847956,6874748,324405,26792,75,2,True,True,744.3667488,-0.6693531857669776
8224,6523577,26,32,0.988484,117,6527126,-1,512.0,6678456,6678482,154879,26,85,6,True,True,0.9703338666666668,-0.988484
8225,6523687,13863,2,0.147605,117,6527126,-1,94.0,7086349,7100212,562662,13863,50,2,True,True,65.35123590555555,-0.14003893694810812
8226,6523887,47,32,0.950398,117,6527126,-1,960.0,6912821,6912868,388934,47,65,7,True,True,3.7581200000000003,-0.950398
8227,6525544,23,3,0.427111,117,6527126,-1,141.0,7718787,7718810,1193243,23,30,6,True,True,0.14129570833333333,-0.427111
8228,6525619,311,2,0.84166,117,6527126,-1,32.0,6567626,6567937,42007,311,96,7,True,True,0.7759795555555555,-0.84166
8229,6525992,180,14,0.925985,117,6527126,-1,406.0,6937121,6937301,411129,180,62,6,True,True,5.1691863611111115,-0.9039739425776125
8230,6526033,15294,16,0.096048,117,6527126,-1,128.0,10185039,10200333,3659006,15294,4,12,True,True,156.0884544,-0.08722468620798798
8231,6526045,205,1,0.974159,117,6527126,-1,34.0,6536126,6536331,10081,205,109,2,True,True,0.21244947222222224,-0.974159
8232,6526122,1222,1,0.179633,117,6527126,-1,49.0,7749387,7750609,1223265,1222,28,2,True,True,2.7289398499999997,-0.179633
8233,6526796,10402,8,0.052472,117,6527126,-1,232.0,10447839,10458241,3921043,10402,1,12,True,True,105.76480895555557,-0.05163633813963514
8234,6526905,17,2,0.980277,117,6527126,-1,78.0,6840756,6840773,313851,17,84,6,True,True,0.09945736666666667,-0.980277
8235,6526907,11573,6,0.650098,117,6527126,-1,234.0,7849287,7860860,1322380,11573,28,12,True,True,97.5271986,-0.6302643245011981
8236,6526938,14957,64,0.593392,117,6527126,-1,384.0,6532526,6547483,5588,14957,114,7,True,True,161.07536960000002,-0.5867221609358506
8237,6527026,8,13,0.969727,117,6527126,-1,247.0,6565826,6565834,38800,8,103,7,True,True,0.10888857777777777,-0.969727
8238,6531734,19,16,0.626973,117,6532526,-1,512.0,6961949,6961968,430215,19,62,7,True,True,0.43813831111111107,-0.626973
8239,6531754,102,4,0.403994,117,6532526,-1,136.0,7754787,7754889,1223033,102,29,0,True,True,0.6229684,-0.403994
8240,6533797,30,16,0.033993,117,6536126,-1,320.0,7304864,7304894,771067,30,50,7,True,True,0.7172533333333334,-0.033993
8241,6537960,162,32,0.240855,118,6541526,-1,640.0,9390639,9390801,2852679,162,14,6,True,True,3.097152,-0.240855
8242,6537985,38206,4,0.488626,118,6541526,-1,44.0,7725087,7763293,1187102,38206,34,8,True,True,75.46485613333333,-0.48783983672313325
8243,6539007,11,16,0.687984,118,6541526,-1,304.0,6555026,6555037,16019,11,112,7,True,True,0.0939664,-0.687984
8244,6547958,81,1,0.954555,122,6549626,-1,7.0,6910121,6910202,362163,81,78,7,True,True,0.043676325,-0.954555
8245,6547981,6,8,0.652797,122,6549626,-1,240.0,7622409,7622415,1074428,6,42,7,True,True,0.05933200000000001,-0.652797
8246,6548054,15766,1,0.375372,122,6549626,-1,41.0,7745787,7761553,1197733,15766,33,2,True,True,28.89499805,-0.3742429086151967
8247,6548764,1472,6,0.691795,122,6549626,-1,264.0,7402964,7404436,854200,1472,53,7,True,True,13.437201066666669,-0.691795
8248,6549100,15973,4,0.795325,122,6549626,-1,148.0,6624805,6640778,75705,15973,107,6,True,True,73.52994706666667,-0.7665285392684361
8249,6549404,11,16,0.658519,122,6549626,-1,512.0,6573528,6573539,24124,11,110,6,True,True,0.4987761777777778,-0.658519
8250,6549461,127,2,0.777731,122,6549626,-1,40.0,7401164,7401291,851703,127,54,9,True,True,0.17593733333333333,-0.777731
8251,6549590,12228,128,0.864896,122,6549626,-1,5248.0,6932621,6944849,383031,12228,77,2,True,True,4633.751367822222,-0.8386239444685878
8252,6550270,447,16,0.650311,125,6553226,-1,640.0,7010649,7011096,460379,447,68,11,True,True,25.962554666666666,-0.650311
8253,6550672,574,8,0.275216,125,6553226,-1,320.0,9702339,9702913,3151667,574,11,11,True,True,5.292024888888889,-0.275216
8254,6550906,17,1,0.653195,125,6553226,-1,43.0,7071049,7071066,520143,17,67,2,True,True,0.04667028888888889,-0.653195
8255,6551317,9,4,0.367323,125,6553226,-1,44.0,7667509,7667518,1116192,9,43,6,True,True,0.015383499999999998,-0.367323
8256,6555872,21,16,0.12,124,6556826,-1,80.0,10492039,10492060,3936167,21,1,11,True,True,0.07918400000000002,-0.12
8257,6556914,38837,32,0.082637,128,6560426,-1,1536.0,10578439,10617276,4021525,38837,1,12,True,True,2885.6472832000004,-0.0820634173412149
8258,6556980,7,1,0.489218,128,6560426,-1,32.0,8110887,8110894,1553907,7,28,12,True,True,0.018718311111111108,-0.489218
8259,6557207,20,8,0.668792,128,6560426,-1,360.0,6675756,6675776,118549,20,114,6,True,True,0.6312000000000001,-0.668792
8260,6557226,30122,16,0.509748,128,6560426,-1,224.0,6836256,6866378,279030,30122,105,7,True,True,532.4395340444445,-0.509747298261271
8261,6560365,24923,8,0.023027,128,6560426,-1,152.0,8479703,8504626,1919338,24923,26,12,True,True,296.8650309111111,-0.02283084334068442
8262,6561375,4,4,0.572982,128,6564026,-1,140.0,6960149,6960153,398774,4,79,2,True,True,0.025221777777777777,-0.572982
8263,6584225,8636,32,0.572631,145,6601805,-1,384.0,6851556,6860192,267331,8636,103,2,True,True,281.0486912,-0.5686230795788954
8264,6584326,115,1,0.273725,145,6601805,-1,14.0,9389739,9389854,2805413,115,18,11,True,True,0.04809427777777778,-0.273725
8265,6584470,5285,1,0.745359,145,6601805,-1,13.0,6623905,6629190,39435,5285,123,10,True,True,2.8365156805555554,-0.726076255074409
8266,6584524,17,8,0.794344,145,6601805,-1,368.0,7482764,7482781,898240,17,58,9,True,True,0.5293618666666666,-0.794344
8267,6586397,15006,2,0.181097,145,6601805,-1,36.0,7755687,7770693,1169290,15006,36,6,True,True,24.552332999999997,-0.17870876789350965
8268,6595995,36,1,0.484191,145,6601805,-1,19.0,7762887,7762923,1166892,36,36,5,True,True,0.030039,-0.484191
8269,6598188,13,2,0.644597,145,6601805,-1,100.0,7493009,7493022,894821,13,60,7,True,True,0.07078861111111111,-0.644597
8270,6598204,29295,1,0.433656,145,6601805,-1,18.0,8911703,8940998,2313499,29295,25,12,True,True,23.500451899999998,-0.4248238895531051
8271,6598230,8526,1,0.571423,145,6601805,-1,28.0,7728687,7737213,1130457,8526,43,7,True,True,10.805448033333334,-0.5688038821007724
8272,6598245,6341,32,0.099441,145,6601805,-1,928.0,9924039,9930380,3325794,6341,9,11,True,True,344.56101502222225,-0.08476184774900411
8273,6598319,6,32,0.063498,145,6601805,-1,1440.0,8825303,8825309,2226984,6,27,12,True,True,0.3380640000000001,-0.063498
8274,6598385,98,4,0.908881,145,6601805,-1,32.0,6890756,6890854,292371,98,108,7,True,True,0.24103644444444441,-0.908881
8275,6598409,63,4,0.795225,145,6601805,-1,200.0,6674856,6674919,76447,63,129,7,True,True,1.1046000000000002,-0.795225
8276,6598586,39,1,0.18489,145,6601805,-1,42.0,7886687,7886726,1288101,39,35,8,True,True,0.05864495,-0.18489
8277,6598637,103,32,0.812868,145,6601805,-1,736.0,6708656,6708759,110019,103,125,10,True,True,2.468182133333333,-0.812868
8278,6601227,155,32,0.019746,145,6601805,-1,1280.0,9879839,9879994,3278612,155,10,11,True,True,6.61168,-0.019746
8279,6601244,6,11,0.55606,145,6601805,-1,132.0,7080049,7080055,478805,6,83,9,True,True,0.050111600000000006,-0.55606
8280,6601275,10,1,0.536417,145,6601805,-1,34.0,7054849,7054859,453574,10,87,11,True,True,0.010025277777777779,-0.536417
8281,6601296,8,1,0.812196,145,6601805,-1,9.0,6680256,6680264,78960,8,131,7,True,True,0.0052482,-0.812196
8282,6601430,4,2,0.488563,145,6601805,-1,94.0,6920021,6920025,318591,4,103,9,True,True,0.0303996,-0.488563
8283,6601507,326,2,0.518901,145,6601805,-1,64.0,6944849,6945175,343342,326,96,2,True,True,1.6095996444444445,-0.518901
8284,6601557,3,8,0.584722,145,6601805,-1,40.0,7750287,7750290,1148730,3,45,6,True,True,0.005469,-0.584722
8285,6601724,7,16,0.713749,145,6601805,-1,368.0,7184657,7184664,582933,7,79,7,True,True,0.22230164444444445,-0.713749
8286,6601793,12,2,0.790068,145,6601805,-1,82.0,6807856,6807868,206063,12,128,11,True,True,0.04357206666666667,-0.790068
8287,6602243,16242,8,0.124089,212,6623905,-1,168.0,9607639,9623881,3005396,16242,17,11,True,True,92.28985920000001,-0.1175377436158048
8288,6602328,45256,3,0.752988,212,6623905,-1,63.0,7056649,7101905,454321,45256,90,7,True,True,164.63909787499998,-0.7514916902106837
8289,6602357,1768,4,0.965681,212,6623905,-1,48.0,6856056,6857824,253699,1768,122,2,True,True,7.162757333333334,-0.965681
8290,6602381,3627,16,0.897602,212,6623905,-1,624.0,7067449,7071076,465068,3627,88,7,True,True,147.6108868,-0.8934553389502574
8291,6602432,111,70,0.180664,212,6623905,-1,420.0,7545309,7545420,942877,111,65,7,True,True,2.5883165,-0.180664
8292,6602439,5630,63,0.599103,212,6623905,-1,1134.0,7451664,7457294,849225,5630,73,2,True,True,505.5307109999999,-0.5925232010299745
8293,6602850,587,4,0.179938,212,6623905,-1,72.0,7908787,7909374,1305937,587,37,10,True,True,2.6810776,-0.1704240733719643
8294,6602886,1,8,0.554722,212,6623905,-1,88.0,7393964,7393965,791078,1,77,6,True,True,0.0030105777777777775,-0.554722
8295,6602918,561,8,0.800513,212,6623905,-1,224.0,7393064,7393625,790146,561,78,12,True,True,4.299105066666666,-0.800513
8296,6602928,8,1,0.123045,212,6623905,-1,22.0,7483664,7483672,880736,8,71,6,True,True,0.014892533333333333,-0.123045
8297,6602934,6208,3,0.128816,212,6623905,-1,99.0,7072849,7079057,469915,6208,93,7,True,True,39.02506575,-0.12842587345873713
8298,6603044,9451,256,0.20623,212,6623905,-1,4352.0,8393303,8402754,1790259,9451,33,7,True,True,2445.4235676444446,-0.2032781445286384
8299,6603431,3571,256,0.16121,212,6623905,-1,5888.0,9749239,9752810,3145808,3571,12,6,True,True,759.6040270222221,-0.12639504795330683
8300,6603479,6939,4,0.562496,212,6623905,-1,168.0,6888956,6895895,285477,6939,129,2,True,True,85.35853433333332,-0.5491857964552684
8301,6603637,8,1,0.85145,212,6623905,-1,39.0,6857856,6857864,254219,8,133,7,True,True,0.02633366666666667,-0.85145
8302,6603653,369,2,0.035005,212,6623905,-1,66.0,7491209,7491578,887556,369,73,9,True,True,1.18881345,-0.035005
8303,6603719,80,8,0.979928,212,6623905,-1,296.0,6933521,6933601,329802,80,115,6,True,True,1.7320514,-0.9798112533092842
8304,6604464,116,12,0.506148,212,6623905,-1,96.0,6940721,6940837,336257,116,113,2,True,True,0.7887466666666665,-0.48505661408781453
8305,6604573,1322,28,0.36356,212,6623905,-1,1120.0,7212164,7213486,607591,1322,87,7,True,True,120.44183822222222,-0.36356
8306,6604621,9127,32,0.544427,212,6623905,-1,1088.0,6949349,6958476,344728,9127,110,6,True,True,793.5228024888889,-0.5371766967730347
8307,6604631,7934,1,0.423051,212,6623905,-1,8.0,7754787,7762721,1150156,7934,48,2,True,True,2.816808466666666,-0.4225903946570987
8308,6606881,33034,2,0.945228,212,6623905,-1,18.0,6833556,6866590,226675,33034,149,7,True,True,46.196134699999995,-0.9452272265675603
8309,6606899,42,16,8.6e-05,212,6623905,-1,592.0,7543509,7543551,936610,42,70,6,True,True,1.3804354666666667,-8.600000000000002e-05
8310,6606945,21,64,0.3006,212,6623905,-1,1920.0,9654539,9654560,3047594,21,17,6,True,True,1.208256,-0.3006
8311,6606974,17,16,0.946215,212,6623905,-1,688.0,7058449,7058466,451475,17,105,7,True,True,0.42820355555555556,-0.946215
8312,6607002,13375,128,0.519443,212,6623905,-1,1152.0,7717887,7731262,1110885,13375,60,11,True,True,687.9547167999999,-0.5167516858354594
8313,6607032,18378,32,0.782802,212,6623905,-1,1376.0,7447164,7465542,840132,18378,83,11,True,True,2058.5691344,-0.776979431594929
8314,6607069,163,13,0.659158,212,6623905,-1,598.0,6714956,6715119,107887,163,159,8,True,True,3.10698375,-0.659158
8315,6607310,9106,128,0.44492,212,6623905,-1,6272.0,7666609,7675715,1059299,9106,65,0,True,True,2374.272743111111,-0.4361326063242166
8316,6607654,318,16,0.577071,212,6623905,-1,560.0,7136857,7137175,529203,318,98,7,True,True,14.283994666666668,-0.577071
8317,6607660,14,1,0.695101,212,6623905,-1,41.0,7759287,7759301,1151627,14,47,8,True,True,0.025284700000000004,-0.695101
8318,6607677,12718,2,0.522666,212,6623905,-1,10.0,7135057,7147775,527380,12718,100,10,True,True,9.723596666666667,-0.5052303442980981
8319,6607681,77,32,0.98602,212,6623905,-1,1120.0,6763656,6763733,155975,77,160,7,True,True,7.209903555555557,-0.98602
8320,6608094,151,1,0.352117,212,6623905,-1,42.0,7874087,7874238,1265993,151,43,0,True,True,0.3565261,-0.352117
8321,6608243,24,4,0.538209,212,6623905,-1,44.0,7448064,7448088,839821,24,86,6,True,True,0.0796312,-0.538209
8322,6608269,17286,72,0.20984,212,6623905,-1,3312.0,7849287,7866573,1241018,17286,46,0,True,True,2423.4332627999997,-0.18760387503464157
8323,6608636,12173,33,0.099009,212,6623905,-1,1254.0,10098639,10110812,3490003,12173,8,12,True,True,567.9280728,-0.09789338449056739
8324,6608641,7850,2,0.819763,212,6623905,-1,28.0,6684756,6692606,76115,7850,172,2,True,True,16.800197711111114,-0.7333377585354441
8325,6608689,14,16,0.2371,212,6623905,-1,320.0,7740387,7740401,1131698,14,58,2,True,True,0.20118933333333333,-0.2371
8326,6609037,2902,32,0.188074,212,6623905,-1,1152.0,7874087,7876989,1265050,2902,45,6,True,True,183.57815999999997,-0.18371084550346398
8327,6609647,18,32,0.299709,212,6623905,-1,1088.0,9658139,9658157,3048492,18,18,8,True,True,0.57664,-0.299709
8328,6609672,8,1,0.832628,212,6623905,-1,38.0,7302164,7302172,692492,8,100,12,True,True,0.025831555555555552,-0.832628
8329,6609718,136,8,0.957423,212,6623905,-1,328.0,6831756,6831892,222038,136,167,10,True,True,3.6600864,-0.957423
8330,6609805,11572,2,0.602144,212,6623905,-1,76.0,7616109,7627681,1006304,11572,76,8,True,True,37.337596455555556,-0.586116390683309
8331,6609811,28668,16,0.21604,212,6623905,-1,704.0,6922721,6951389,312910,28668,142,7,True,True,1517.7821159111108,-0.21186591394395365
8332,6610311,17,16,0.359065,212,6623905,-1,768.0,7934487,7934504,1324176,17,42,8,True,True,0.46860160000000006,-0.359065
8333,6610437,18881,16,0.128492,212,6623905,-1,704.0,7930887,7949768,1320450,18881,43,10,True,True,642.0092017777777,-0.11145022766037675
8334,6610602,61,2,0.622313,212,6623905,-1,24.0,6711356,6711417,100754,61,178,6,True,True,0.04569713333333334,-0.622313
8335,6610813,6518,1,0.07436,212,6623905,-1,24.0,10012239,10018757,3401426,6518,9,12,True,True,6.7215212,-0.07431607056754072
8336,6611122,34,5,0.254967,212,6623905,-1,110.0,7496609,7496643,885487,34,87,7,True,True,0.16762472222222222,-0.254967
8337,6615704,17343,3,0.381782,212,6623905,-1,72.0,7879487,7896830,1263783,17343,48,2,True,True,52.85620939999999,-0.3563448897776238
8338,6615735,16,22,0.90366,212,6623905,-1,264.0,6809656,6809672,193921,16,175,7,True,True,0.18704106666666664,-0.90366
8339,6616571,166,1,0.400059,212,6623905,-1,37.0,7938087,7938253,1321516,166,43,2,True,True,0.26019900555555553,-0.400059
8340,6616591,14827,128,0.083254,212,6623905,-1,3456.0,9609439,9624266,2992848,14827,22,7,True,True,1752.4724832,-0.07965033797030106
8341,6617362,14120,2,0.254179,212,6623905,-1,54.0,9084539,9098659,2467177,14120,32,1,True,True,34.59622065,-0.23876515433540987
8342,6617493,51,13,0.425343,212,6623905,-1,273.0,7742187,7742238,1124694,51,67,7,True,True,0.625258725,-0.425343
8343,6618406,2,4,0.694515,212,6623905,-1,200.0,6936221,6936223,317815,2,145,6,True,True,0.02898222222222222,-0.694515
8344,6618418,23,16,0.535904,212,6623905,-1,432.0,7484009,7484032,865591,23,96,2,True,True,0.8407512000000001,-0.535904
8345,6618438,11672,2,0.070558,212,6623905,-1,50.0,7875887,7887559,1257449,11672,52,7,True,True,21.646395138888888,-0.06214088457129849
8346,6618468,4,1,0.732675,212,6623905,-1,35.0,7087249,7087253,468781,4,122,6,True,True,0.009140055555555556,-0.732675
8347,6618580,26,32,0.995359,212,6623905,-1,384.0,6891656,6891682,273076,26,166,6,True,True,0.7673813333333334,-0.995359
8348,6619963,33909,64,0.696803,212,6623905,-1,2112.0,7188264,7222173,568301,33909,116,8,True,True,5671.514024000001,-0.6893635242207898
8349,6619988,15803,16,0.192627,212,6623905,-1,336.0,7617009,7632812,997021,15803,85,6,True,True,224.86911906666668,-0.18505224845557844
8350,6620056,9,1,0.372142,212,6623905,-1,38.0,7732287,7732296,1112231,9,70,8,True,True,0.01536055,-0.372142
8351,6622312,5,1,0.657318,212,6623905,-1,15.0,7182857,7182862,560545,5,121,7,True,True,0.006472291666666667,-0.657318
8352,6622397,12,8,0.820508,212,6623905,-1,48.0,6908321,6908333,285924,12,164,2,True,True,0.0427808,-0.820508
8353,6622983,8,1,0.604945,212,6623905,-1,22.0,7112949,7112957,489966,8,125,10,True,True,0.012358622222222221,-0.604945
8354,6622999,19984,1,0.419686,212,6623905,-1,43.0,7736787,7756771,1113788,19984,70,7,True,True,38.56431170833333,-0.4191384615771961
8355,6630985,28,1,0.153491,218,6640778,-1,47.0,8283687,8283715,1652702,28,42,12,True,True,0.05659165555555556,-0.153491
8356,6632064,10,2,0.992449,218,6640778,-1,40.0,6716756,6716766,84692,10,198,7,True,True,0.012750000000000001,-0.9924489999999999
8357,6632105,2358,32,0.433627,218,6640778,-1,896.0,6920921,6923279,288816,2358,163,6,True,True,169.89573937777777,-0.4312875972424241
8358,6632456,13,1,0.02591,218,6640778,-1,35.0,7734987,7735000,1102531,13,72,7,True,True,0.020798555555555556,-0.02591
8359,6632537,232,1,0.603607,218,6640778,-1,14.0,7112957,7113189,480420,232,128,1,True,True,0.22807275555555556,-0.603607
8360,6633392,16,64,0.077525,218,6640778,-1,3136.0,7733187,7733203,1099795,16,73,6,True,True,2.2936007111111114,-0.077525
8361,6633783,55,8,0.124621,218,6640778,-1,128.0,8738903,8738958,2105120,55,37,12,True,True,0.29712711111111106,-0.124621
8362,6635342,7653,128,0.10999,218,6640778,-1,5248.0,6965549,6973202,330207,7653,148,7,True,True,3029.7106929777774,-0.10998909396797062
8363,6635459,66,1,0.548369,218,6640778,-1,7.0,7520509,7520575,885050,66,99,7,True,True,0.035038849999999996,-0.548369
6249,4878338,11,32,0.304912,1,4878338,-1,992.0,4964738,4964749,86400,11,0,12,True,True,0.36052035555555556,-0.304912
6250,4879071,26,2,0.337594,65,4964738,-1,94.0,6736124,6736150,1857053,26,0,2,True,True,0.03348279999999999,-0.337594
6251,4879130,60,2,0.019712,65,4964738,-1,70.0,7051939,7051999,2172809,60,0,2,True,True,0.25026166666666666,-0.019712
6252,4879180,6680,256,0.326117,65,4964738,-1,2560.0,6694648,6701328,1815468,6680,2,8,True,True,1115.4854115555554,-0.3257884724186954
6253,4879208,137,1,0.460909,65,4964738,-1,10.0,7012368,7012505,2133160,137,1,7,True,True,0.05648966666666667,-0.460909
6254,4879296,7,1,0.863369,65,4964738,-1,13.0,5329131,5329138,449835,7,4,6,True,True,0.004532558333333333,-0.863369
6255,4879534,312,1,0.568049,65,4964738,-1,32.0,5215538,5215850,336004,312,5,2,True,True,0.3616149333333333,-0.568049
6256,4879804,7273,2,0.90141,65,4964738,-1,72.0,5051138,5058411,171334,7273,6,12,True,True,12.455335799999999,-0.8167289708844658
6257,4879828,53,5,0.266619,65,4964738,-1,140.0,10550139,10550192,5670311,53,0,12,True,True,0.17068061111111113,-0.266619
6258,4879844,274,4,0.695958,65,4964738,-1,140.0,6148342,6148616,1268498,274,5,10,True,True,1.3179856666666667,-0.695958
6259,4879850,72,16,0.587989,65,4964738,-1,576.0,6237642,6237714,1357792,72,5,0,True,True,1.7265024,-0.587989
6260,4880161,38027,32,0.985765,65,4964738,-1,608.0,5824038,5862065,943877,38027,7,1,True,True,976.5426808000001,-0.9705200854135512
6261,4880191,17280,16,0.377738,65,4964738,-1,752.0,9849739,9867019,4969548,17280,1,11,True,True,245.7868927111111,-0.3761340908142195
6262,4880221,16,8,0.390301,65,4964738,-1,264.0,8636339,8636355,3756118,16,2,12,True,True,0.054712533333333334,-0.390301
6263,4880293,160,16,0.572539,65,4964738,-1,336.0,7009668,7009828,2129375,160,5,8,True,True,2.216704,-0.572539
6264,4887016,13116,4,0.808327,65,4964738,-1,32.0,5054738,5067854,167722,13116,13,7,True,True,10.774791644444443,-0.7951037866650288
6265,4887503,7015,8,0.100057,65,4964738,-1,40.0,12248739,12255754,7361236,7015,0,8,True,True,4.262710666666667,-0.08539436997607434
6266,4887513,78,16,0.675111,65,4964738,-1,512.0,5304838,5304916,417325,78,13,6,True,True,1.3269845333333334,-0.675111
6267,4887636,911,32,0.335967,65,4964738,-1,1376.0,5356670,5357581,469034,911,12,10,True,True,54.44056853333333,-0.3293040319708526
6268,4887999,37,1,0.502769,65,4964738,-1,34.0,8213639,8213676,3325640,37,4,8,True,True,0.03091884444444445,-0.502769
6269,4888110,373,16,0.764904,65,4964738,-1,672.0,5365670,5366043,477560,373,13,7,True,True,11.190397866666666,-0.7649039999999998
6270,4888363,310,8,0.339539,65,4964738,-1,120.0,10636539,10636849,5748176,310,1,12,True,True,0.3864666666666666,-0.339539
6271,4888651,28881,256,0.614828,65,4964738,-1,4096.0,5499457,5528338,610806,28881,14,7,True,True,3880.838951822222,-0.5923266059750938
6272,4888977,17,4,0.363334,65,4964738,-1,104.0,6822524,6822541,1933547,17,9,12,True,True,0.03315,-0.363334
6273,4889116,13,16,0.435991,65,4964738,-1,704.0,6942924,6942937,2053808,13,9,7,True,True,0.6531223111111111,-0.435991
6274,4890037,71,32,0.496952,65,4964738,-1,1184.0,8202839,8202910,3312802,71,6,10,True,True,2.5553120888888885,-0.4969519999999999
6275,4890192,3313,1,0.847334,65,4964738,-1,6.0,5316538,5319851,426346,3313,21,9,True,True,0.8839588666666666,-0.8276830260725884
6276,4890349,18465,16,0.78715,65,4964738,-1,672.0,5528338,5546803,637989,18465,17,9,True,True,300.1666024,-0.7686430876522349
6277,4890532,7,16,0.84038,65,4964738,-1,416.0,5110035,5110042,219503,7,25,8,True,True,0.03475795555555555,-0.84038
6278,4890539,85,1,0.535834,65,4964738,-1,30.0,11548339,11548424,6657800,85,1,12,True,True,0.15484875,-0.535834
6279,4890755,96,32,0.287356,65,4964738,-1,352.0,10812939,10813035,5922184,96,2,8,True,True,0.20753919999999998,-0.287356
6280,4890793,21669,4,0.047531,65,4964738,-1,40.0,12447245,12468914,7556452,21669,0,1,True,True,12.217374555555555,-0.045055180769315376
6281,4891211,34,16,0.996228,65,4964738,-1,608.0,5309338,5309372,418127,34,26,6,True,True,0.8902167111111111,-0.996228
6282,4891255,335,1,0.402027,65,4964738,-1,29.0,5306638,5306973,415383,335,27,7,True,True,0.41836568055555556,-0.402027
6283,4891280,34,1,0.225886,65,4964738,-1,23.0,11634739,11634773,6743459,34,2,12,True,True,0.057029522222222226,-0.225886
6284,4891308,16879,123,0.742888,65,4964738,-1,2460.0,5202938,5219817,311630,16879,31,1,True,True,1687.5024906666667,-0.7326554369599659
6285,4891483,14135,2,0.091958,65,4964738,-1,90.0,11938139,11952274,7046656,14135,2,11,True,True,26.30054325,-0.08649279822588485
6286,4891580,37,14,0.844187,65,4964738,-1,588.0,5705638,5705675,814058,37,22,12,True,True,0.9303107333333333,-0.844187
6287,4891601,32005,16,0.094734,65,4964738,-1,192.0,12845634,12877639,7954033,32005,0,12,True,True,75.25860800000001,-0.09289783284274615
6288,4891744,15533,256,0.336838,65,4964738,-1,5888.0,7746939,7762472,2855195,15533,13,12,True,True,3458.617464177778,-0.31744252134853385
6289,4891751,25,1,0.06727,65,4964738,-1,37.0,9805539,9805564,4913788,25,10,12,True,True,0.01689409722222222,-0.06727
6290,4891772,333,1,0.801186,65,4964738,-1,46.0,5334570,5334903,442798,333,30,1,True,True,0.6342503,-0.801186
6291,4892703,136,1,0.475268,65,4964738,-1,32.0,7182539,7182675,2289836,136,15,12,True,True,0.043967288888888886,-0.475268
6292,4892784,23,1,0.209739,65,4964738,-1,46.0,5061938,5061961,169154,23,40,3,True,True,0.028445505555555556,-0.209739
6293,4892987,5403,13,0.795652,65,4964738,-1,377.0,6972224,6977627,2079237,5403,19,9,True,True,158.78907821111113,-0.7870792480386023
6294,4893037,9824,2,0.651537,65,4964738,-1,34.0,7017768,7027592,2124731,9824,17,6,True,True,22.237403066666666,-0.6126935749359093
6295,4893058,119,4,0.301847,65,4964738,-1,164.0,7047068,7047187,2154010,119,17,10,True,True,1.1471613222222223,-0.301847
6296,4893092,3,4,0.804127,65,4964738,-1,68.0,5106435,5106438,213343,3,43,10,True,True,0.001919866666666667,-0.804127
6297,4893139,107,2,0.43291,65,4964738,-1,42.0,6192542,6192649,1299403,107,27,11,True,True,0.30637845,-0.43291
6298,4893163,21,32,0.539948,65,4964738,-1,1376.0,10377339,10377360,5484176,21,9,11,True,True,0.6253576,-0.539948
6299,4893256,25,16,0.200077,65,4964738,-1,640.0,6260642,6260667,1367386,25,27,6,True,True,1.0571555555555556,-0.200077
6300,4893306,12864,64,0.402301,65,4964738,-1,2304.0,6994324,7007188,2101018,12864,22,10,True,True,1002.9089279999998,-0.38455680907052237
6301,4893349,211,8,0.624964,65,4964738,-1,312.0,9329339,9329550,4435990,211,12,7,True,True,1.2998162666666666,-0.624964
6302,4894139,371,1,0.453229,65,4964738,-1,8.0,7047068,7047439,2152929,371,19,0,True,True,0.1744606888888889,-0.4532290000000001
6303,4894205,48,32,0.763442,65,4964738,-1,1600.0,5619238,5619286,725033,48,36,6,True,True,0.9958400000000002,-0.763442
6304,4894231,44,8,0.180601,65,4964738,-1,352.0,7002424,7002468,2108193,44,24,9,True,True,0.5477159111111111,-0.180601
6305,4895612,10,32,0.018603,65,4964738,-1,1088.0,11807539,11807549,6911927,10,4,0,True,True,0.2475804444444445,-0.018603
6306,4895622,11994,8,0.703332,65,4964738,-1,208.0,5944242,5956236,1048620,11994,36,9,True,True,58.96037333333332,-0.6832453234502016
6307,4895882,3,1,0.86271,65,4964738,-1,9.0,5202935,5202938,307053,3,52,6,True,True,0.0011600249999999999,-0.86271
6308,4895968,23,2,0.576843,65,4964738,-1,70.0,8542739,8542762,3646771,23,15,12,True,True,0.03247280555555556,-0.576843
6309,4895984,8,16,0.212953,65,4964738,-1,480.0,11158539,11158547,6262555,8,7,12,True,True,0.018624,-0.212953
6310,4895993,11,8,0.962117,65,4964738,-1,152.0,5202035,5202046,306042,11,55,10,True,True,0.07183562222222221,-0.962117
6311,4896003,16,41,0.742208,65,4964738,-1,1722.0,5207438,5207454,311435,16,53,8,True,True,1.4651541333333333,-0.742208
6312,4896291,3098,16,0.467295,65,4964738,-1,176.0,7010568,7013666,2114277,3098,26,6,True,True,23.824500088888886,-0.408049821158753
6313,4896671,17362,128,0.937163,65,4964738,-1,4608.0,5363870,5381232,467199,17362,46,2,True,True,4007.72672,-0.9310031257559289
6314,4896798,333,2,0.532719,65,4964738,-1,78.0,5495857,5496190,599059,333,45,8,True,True,0.97467435,-0.532719
6315,4964811,8,1,0.614422,198,5051138,-1,49.0,6731528,6731536,1766717,8,34,3,True,True,0.01428077777777778,-0.614422
6316,4964818,13609,128,0.769119,198,5051138,-1,3584.0,5815038,5828647,850220,13609,42,10,True,True,1510.2013795555556,-0.71374382513694
6317,4964905,4,16,0.433724,198,5051138,-1,656.0,8369939,8369943,3405034,4,17,10,True,True,0.04573048888888889,-0.433724
6318,4965079,16,7,0.566116,198,5051138,-1,140.0,5360270,5360286,395191,16,51,6,True,True,0.09695466666666666,-0.566116
6319,4965091,8164,1,0.626758,198,5051138,-1,38.0,5211038,5219202,245947,8164,60,2,True,True,11.006137811111111,-0.6054450078997464
6320,4965152,13,1,0.52227,198,5051138,-1,20.0,7013268,7013281,2048116,13,26,6,True,True,0.01301011111111111,-0.52227
6321,4965209,19140,13,0.364275,198,5051138,-1,260.0,5366570,5385710,401361,19140,50,6,True,True,249.67021444444447,-0.3642163582715494
6322,4965225,5348,8,0.147744,198,5051138,-1,336.0,6656442,6661790,1691217,5348,38,11,True,True,21.546543200000002,-0.13721196209380385
6323,4965337,26,32,0.150473,198,5051138,-1,1440.0,12756045,12756071,7790708,26,1,11,True,True,1.1258,-0.150473
6324,4965341,44,16,0.685307,198,5051138,-1,480.0,5367470,5367514,402129,44,52,6,True,True,0.9428906666666667,-0.685307
6325,4965528,13,1,0.300276,198,5051138,-1,37.0,8722739,8722752,3757211,13,16,12,True,True,0.014913672222222221,-0.300276
6326,4965570,9,1,0.435389,198,5051138,-1,12.0,6965024,6965033,1999454,9,35,10,True,True,0.0073575,-0.435389
6327,4966013,54,4,0.318653,198,5051138,-1,128.0,9241139,9241193,4275126,54,16,12,True,True,0.3453888,-0.318653
6328,4966019,111,29,0.830214,198,5051138,-1,174.0,7024968,7025079,2058949,111,28,9,True,True,1.47628705,-0.830214
6329,4966028,14475,1,0.064428,198,5051138,-1,45.0,10809339,10823814,5843311,14475,10,12,True,True,4.03139925,-0.06367209510402853
6330,4967530,350,16,0.203558,198,5051138,-1,160.0,11072139,11072489,6104609,350,9,12,True,True,0.3178,-0.203558
6331,4967600,6113,1,0.412438,198,5051138,-1,37.0,7399539,7405652,2431939,6113,26,11,True,True,8.218836208333332,-0.35251120662222885
6332,4968036,187,16,0.823711,198,5051138,-1,400.0,6497442,6497629,1529406,187,47,12,True,True,0.6316444444444445,-0.823711
6333,4968040,16106,16,0.646043,198,5051138,-1,480.0,6678542,6694648,1710502,16106,46,10,True,True,487.5254453333333,-0.6423709084970147
6334,4968931,5,1,0.256447,198,5051138,-1,33.0,8895539,8895544,3926608,5,19,12,True,True,0.008706500000000002,-0.256447
6335,4969066,8270,24,0.601232,198,5051138,-1,144.0,9327539,9335809,4358473,8270,18,12,True,True,20.524130800000002,-0.5434563874145429
6336,4969076,22,1,0.405866,198,5051138,-1,14.0,6315642,6315664,1346566,22,51,11,True,True,0.0042273,-0.405866
6337,4972025,54,16,0.113559,198,5051138,-1,800.0,9373539,9373593,4401514,54,17,11,True,True,0.8171999999999999,-0.113559
6338,4972673,518,8,0.191916,198,5051138,-1,344.0,8257839,8258357,3285166,518,26,11,True,True,3.926163733333333,-0.191916
6339,4972718,376,1,0.245587,198,5051138,-1,22.0,12342339,12342715,7369621,376,3,8,True,True,0.26114244444444445,-0.245587
6340,4975919,5657,2,0.827229,198,5051138,-1,32.0,5370170,5375827,394251,5657,67,7,True,True,9.360900800000001,-0.826759998201061
6341,4976027,259,4,0.46416,198,5051138,-1,172.0,5990242,5990501,1014215,259,59,11,True,True,2.547299933333333,-0.44120847161584503
6342,4976257,34,8,0.559825,198,5051138,-1,280.0,9068339,9068373,4092082,34,22,12,True,True,0.19100822222222227,-0.559825
6343,4976907,30,2,0.436133,198,5051138,-1,84.0,9943339,9943369,4966432,30,16,12,True,True,0.047523,-0.436133
6344,4977065,26811,64,0.646922,198,5051138,-1,2816.0,9719139,9745950,4742074,26811,19,12,True,True,1098.0630847999998,-0.6010991494905641
6345,4978639,12,2,0.037004,198,5051138,-1,68.0,11807539,11807551,6828900,12,7,12,True,True,0.01856853333333334,-0.037004
6346,4978779,16654,94,0.159358,198,5051138,-1,2538.0,11202739,11219393,6223960,16654,10,11,True,True,664.6607741999999,-0.1532780439523124
6347,4978840,91,32,0.136431,198,5051138,-1,384.0,6941124,6941215,1962284,91,52,10,True,True,2.4937397333333338,-0.136431
6348,4986046,13928,256,0.258397,198,5051138,-1,2048.0,8007939,8021867,3021893,13928,35,7,True,True,1667.1303395555558,-0.25580526501415063
6349,4986058,7,8,0.803538,198,5051138,-1,360.0,5326431,5326438,340373,7,84,2,True,True,0.10700200000000001,-0.803538
6350,4986134,20,4,0.658671,198,5051138,-1,44.0,10463739,10463759,5477605,20,17,12,True,True,0.010623555555555554,-0.658671
6351,4986480,6,53,0.175985,198,5051138,-1,2491.0,8549939,8549945,3563459,6,31,9,True,True,0.3216711333333334,-0.175985
6352,4987189,67,64,0.852521,198,5051138,-1,1408.0,5932538,5932605,945349,67,70,10,True,True,2.897687466666666,-0.8525209999999999
6353,4987212,14787,128,0.963787,198,5051138,-1,4096.0,5381870,5396657,394658,14787,78,7,True,True,2467.0604401777778,-0.8789828984937642
6354,4987740,78,1,0.485842,198,5051138,-1,31.0,7355339,7355417,2367599,78,40,12,True,True,0.0607321,-0.485842
6355,4987840,365,4,0.019909,198,5051138,-1,24.0,12072339,12072704,7084499,365,5,12,True,True,0.3591843333333334,-0.019909
6356,4989169,109,8,0.859584,198,5051138,-1,80.0,6522242,6522351,1533073,109,64,10,True,True,0.28846244444444447,-0.859584
6357,4989371,31,8,0.08393,198,5051138,-1,328.0,12252339,12252370,7262968,31,4,2,True,True,0.13368095555555556,-0.08393
6358,4989557,10336,8,0.6016,198,5051138,-1,216.0,5052038,5062374,62481,10336,107,6,True,True,55.28926439999999,-0.5616801903309392
6359,4989575,14084,1,0.867172,198,5051138,-1,49.0,6237642,6251726,1248067,14084,70,6,True,True,34.39403617222223,-0.7324361524041899
6360,4990729,108,2,0.900575,198,5051138,-1,84.0,5259738,5259846,269009,108,98,11,True,True,0.29297520000000005,-0.900575
6361,4990830,666,2,0.407007,198,5051138,-1,98.0,8261439,8262105,3270609,666,36,8,True,True,1.4123955999999998,-0.3900527165270818
6362,4991259,16734,1,0.363434,198,5051138,-1,46.0,8347839,8364573,3356580,16734,36,12,True,True,14.911639833333336,-0.3299388527378758
6363,4991313,1000,3,0.657431,198,5051138,-1,117.0,8094339,8095339,3103026,1000,41,12,True,True,7.274475000000001,-0.657431
6364,4991342,21,8,0.090306,198,5051138,-1,360.0,8006139,8006160,3014797,21,43,12,True,True,0.45704399999999995,-0.09030599999999998
6365,4996152,288,8,0.943162,198,5051138,-1,88.0,5303938,5304226,307786,288,102,11,True,True,0.8421248,-0.943162
6366,4996383,9,1,0.724234,198,5051138,-1,40.0,6522242,6522251,1525859,9,69,0,True,True,0.011909000000000001,-0.724234
6367,4996738,11299,256,0.14056,198,5051138,-1,8192.0,12435946,12447245,7439208,11299,3,8,True,True,1063.8824561777778,-0.1400661860466197
6368,4996862,19,8,0.111932,198,5051138,-1,240.0,7015068,7015087,2018206,19,54,7,True,True,0.22817733333333332,-0.111932
6369,4997024,11651,2,0.73448,198,5051138,-1,32.0,7833339,7844990,2836315,11651,45,12,True,True,15.729920266666667,-0.7175112716355445
6370,4998240,68,32,0.932935,198,5051138,-1,1120.0,5397557,5397625,399317,68,91,6,True,True,2.8162275555555563,-0.932935
6371,4998380,9,2,0.521958,198,5051138,-1,18.0,7268939,7268948,2270559,9,49,12,True,True,0.00715635,-0.521958
6372,5001282,11,1,0.828982,198,5051138,-1,19.0,5792938,5792949,791656,11,87,12,True,True,0.009929822222222223,-0.828982
6373,5001393,8013,2,0.949675,198,5051138,-1,36.0,6500142,6508155,1498749,8013,75,7,True,True,7.878949499999999,-0.9219605410626206
6374,5003634,1429,2,0.931556,198,5051138,-1,36.0,6316542,6317971,1312908,1429,77,6,True,True,0.7060688999999999,-0.931556
6375,5003672,396,11,0.251808,198,5051138,-1,550.0,8981939,8982335,3978267,396,31,12,True,True,2.4740008333333336,-0.2111787882765307
6376,5003800,518,4,0.884565,198,5051138,-1,40.0,5818638,5819156,814838,518,89,1,True,True,0.5235828888888889,-0.884565
6377,5003985,4,16,0.238077,198,5051138,-1,576.0,6271442,6271446,1267457,4,80,9,True,True,0.16528639999999997,-0.238077
6378,5004083,382,8,0.122277,198,5051138,-1,120.0,8456339,8456721,3452256,382,37,12,True,True,0.5303463333333333,-0.11514505671981182
6379,5004332,179,1,0.806687,198,5051138,-1,48.0,5933442,5933621,929110,179,89,1,True,True,0.38306,-0.806687
6380,5004346,342,1,0.329286,198,5051138,-1,17.0,11893939,11894281,6889593,342,9,12,True,True,0.20681690000000003,-0.329286
6381,5004375,7617,128,0.584326,198,5051138,-1,1408.0,8206439,8214056,3202064,7617,44,8,True,True,264.4224938666667,-0.5542501673944361
6382,5004770,7207,53,0.389951,198,5051138,-1,2385.0,12428739,12435946,7423969,7207,4,12,True,True,191.07892574999997,-0.3748509868037998
6383,5008217,92,1,0.748374,198,5051138,-1,33.0,5052938,5053030,44721,92,131,6,True,True,0.0783794,-0.748374
6384,5008449,72,16,0.235938,198,5051138,-1,400.0,10029739,10029811,5021290,72,24,12,True,True,0.47648,-0.235938
6385,5008526,6200,16,0.422869,198,5051138,-1,624.0,6823424,6829624,1814898,6200,73,6,True,True,77.50319893333334,-0.3627568737423163
6386,5008573,5,8,0.144278,198,5051138,-1,152.0,9546339,9546344,4537766,5,29,12,True,True,0.013314777777777778,-0.144278
6387,5009035,112,4,0.175154,198,5051138,-1,48.0,12757434,12757546,7748399,112,1,1,True,True,0.16165333333333332,-0.175154
6388,5009187,92,16,0.969923,198,5051138,-1,336.0,5179935,5180027,170748,92,131,11,True,True,0.9647120000000001,-0.969923
6389,5011695,36736,16,0.439475,198,5051138,-1,336.0,8180739,8217475,3169044,36736,50,12,True,True,415.9577268000001,-0.42896181206248224
6390,5012350,143,32,0.254306,198,5051138,-1,928.0,5083435,5083578,71085,143,135,9,True,True,1.6400002666666667,-0.254306
6391,5012445,12,8,0.589481,198,5051138,-1,296.0,6236742,6236754,1224297,12,93,11,True,True,0.14787173333333334,-0.589481
6392,5013079,28,4,0.490359,198,5051138,-1,104.0,10333139,10333167,5320060,28,25,11,True,True,0.10514746666666666,-0.490359
6393,5013666,39,64,0.374705,198,5051138,-1,2688.0,5135735,5135774,122069,39,135,8,True,True,3.971968000000001,-0.374705
6394,5035595,4,1,0.948711,198,5051138,-1,30.0,5933438,5933442,897843,4,100,6,True,True,0.005350000000000001,-0.948711
6395,5035616,49,1,0.31649,198,5051138,-1,23.0,11461939,11461988,6426323,49,16,12,True,True,0.039529524999999996,-0.31649000000000005
6396,5035632,6541,32,0.423781,198,5051138,-1,1120.0,10899339,10905880,5863707,6541,20,12,True,True,251.97913066666666,-0.34740386289452524
6397,5035672,13689,1,0.682738,198,5051138,-1,17.0,5385470,5399159,349798,13689,114,4,True,True,8.972536155555556,-0.6368360606227624
6398,5035701,48,4,0.963315,198,5051138,-1,196.0,5084335,5084383,48634,48,142,6,True,True,0.1162672,-0.963315
6399,5038555,27,25,0.879434,198,5051138,-1,900.0,5618338,5618365,579783,27,110,12,True,True,0.31509,-0.879434
6400,5039384,9,8,0.936972,198,5051138,-1,128.0,5937042,5937051,897658,9,101,8,True,True,0.038304000000000005,-0.936972
6401,5039437,4609,128,0.362998,198,5051138,-1,640.0,7574139,7578748,2534702,4609,59,12,True,True,204.50393244444444,-0.34968941534476083
6402,5039447,15719,8,0.715671,198,5051138,-1,312.0,5820438,5836157,780991,15719,107,7,True,True,166.8746638,-0.693913926318324
6403,5039464,2,1,0.821365,198,5051138,-1,11.0,5308438,5308440,268974,2,132,6,True,True,0.0009474055555555555,-0.821365
6404,5039486,489,1,0.021074,198,5051138,-1,39.0,12756945,12757434,7717459,489,2,6,True,True,0.573454375,-0.021074
6405,5039769,60,1,0.966805,198,5051138,-1,16.0,6259742,6259802,1219973,60,96,10,True,True,0.062269333333333336,-0.966805
6406,5039891,10,4,0.605815,198,5051138,-1,144.0,7485939,7485949,2446048,10,61,12,True,True,0.08208399999999999,-0.605815
6407,5039964,11,2,0.841473,198,5051138,-1,68.0,5492257,5492268,452293,11,120,8,True,True,0.027087988888888893,-0.841473
6408,5040154,8196,8,0.662223,198,5051138,-1,168.0,6727928,6736124,1687774,8196,86,6,True,True,36.07139946666667,-0.6133262922962515
6409,5040184,9272,1,0.940848,198,5051138,-1,33.0,5317438,5326710,277254,9272,135,6,True,True,13.198160066666667,-0.9398723287401642
6410,5040190,24297,78,0.690682,198,5051138,-1,3120.0,6264242,6288539,1224052,24297,97,8,True,True,4856.072000000001,-0.6884163725191139
6411,5040213,572,8,0.788803,198,5051138,-1,328.0,6126242,6126814,1086029,572,105,10,True,True,7.97368,-0.788803
6412,5040272,2900,64,0.239676,198,5051138,-1,2880.0,5380070,5382970,339798,2900,127,6,True,True,417.91567999999995,-0.2307551708464955
6413,5040327,32,2,0.552728,198,5051138,-1,80.0,8347839,8347871,3307512,32,48,0,True,True,0.06383644444444445,-0.552728
6414,5040396,7193,1,0.309269,198,5051138,-1,14.0,5319238,5326431,278842,7193,139,7,True,True,4.319386322222223,-0.3057465999791259
6415,5040423,9,8,0.958484,198,5051138,-1,56.0,5497657,5497666,457234,9,123,7,True,True,0.019579000000000003,-0.958484
6416,5040900,48,4,0.362855,198,5051138,-1,64.0,5066438,5066486,25538,48,161,6,True,True,0.08454826666666668,-0.3628549999999999
6417,5040909,7,64,0.81225,198,5051138,-1,2496.0,5465657,5465664,424748,7,126,7,True,True,0.5146474666666666,-0.81225
6418,5041154,752,8,0.122054,198,5051138,-1,376.0,9856939,9857691,4815785,752,31,9,True,True,5.062831644444444,-0.122054
6419,5041162,10,1,0.866953,198,5051138,-1,30.0,5132135,5132145,90973,10,159,10,True,True,0.012135833333333332,-0.866953
6420,5041194,39,32,0.857647,198,5051138,-1,896.0,5334531,5334570,293337,39,140,8,True,True,1.4468757333333335,-0.857647
6421,5046220,1,16,0.388471,198,5051138,-1,752.0,5076235,5076236,30015,1,165,7,True,True,0.030366177777777777,-0.388471
6422,5046284,15625,4,0.909789,198,5051138,-1,192.0,5375570,5391195,329286,15625,132,8,True,True,140.21542666666664,-0.8972409535005678
6423,5046317,3,1,0.392976,198,5051138,-1,49.0,11721139,11721142,6674822,3,15,12,True,True,0.002781566666666667,-0.392976
6424,5046332,6729,4,0.977993,198,5051138,-1,44.0,5463857,5470586,417525,6729,129,10,True,True,8.371493166666665,-0.95406008066821
6425,5046363,260,1,0.255534,198,5051138,-1,29.0,9459939,9460199,4413576,260,37,12,True,True,0.09272105555555556,-0.255534
6426,5046749,11,9,0.09025,198,5051138,-1,99.0,12759234,12759245,7712485,11,1,7,True,True,0.044452375,-0.09025
6427,5046809,257,1,0.822708,198,5051138,-1,32.0,7660539,7660796,2613730,257,65,12,True,True,0.39646533333333334,-0.822708
6428,5046913,11,32,0.23546,198,5051138,-1,1248.0,12620045,12620056,7573132,11,5,12,True,True,0.1416272,-0.23546
6429,5047043,14,4,0.210386,198,5051138,-1,48.0,10288939,10288953,5241896,14,32,12,True,True,0.02553413333333333,-0.210386
6430,5047140,22571,16,0.890247,198,5051138,-1,736.0,5441757,5464328,394617,22571,135,11,True,True,467.4549562666666,-0.8561104244341167
6431,5047202,6,8,0.915891,198,5051138,-1,352.0,5073638,5073644,26436,6,175,9,True,True,0.06199893333333333,-0.915891
6432,5047254,11,12,0.631353,198,5051138,-1,108.0,7096139,7096150,2048885,11,74,11,True,True,0.0147675,-0.631353
6433,5048161,10364,23,0.879467,198,5051138,-1,276.0,5330931,5341295,282770,10364,151,6,True,True,119.73756606666666,-0.8271577424763535
6434,5048205,473,2,0.766741,198,5051138,-1,72.0,6104142,6104615,1055937,473,115,8,True,True,1.8790398,-0.766741
6435,5048623,20,54,0.406289,198,5051138,-1,270.0,5203838,5203858,155215,20,167,6,True,True,0.23200500000000002,-0.406289
6436,5048678,9806,32,0.033882,198,5051138,-1,1280.0,8210039,8219845,3161361,9806,59,8,True,True,312.62251733333335,-0.033863888565748596
6437,5049119,1583,2,0.866445,198,5051138,-1,74.0,6411042,6412625,1361923,1583,104,8,True,True,3.0537571777777774,-0.8440316354060835
6438,5049130,11094,128,0.823198,198,5051138,-1,768.0,6014142,6025236,965012,11094,118,7,True,True,304.142848,-0.8004910375795944
6439,5049135,11,80,0.940495,198,5051138,-1,2960.0,6701328,6701339,1652193,11,97,7,True,True,2.0991251111111113,-0.940495
6440,5049317,7704,256,0.471091,198,5051138,-1,6144.0,10722939,10730643,5673622,7704,27,12,True,True,533.3440512,-0.4646036869633283
6441,5049589,6,8,0.412961,198,5051138,-1,160.0,6608642,6608648,1559053,6,102,12,True,True,0.02291466666666667,-0.412961
6442,5049619,15133,8,0.841163,198,5051138,-1,384.0,6012342,6027475,962723,15133,122,10,True,True,200.91306240000003,-0.8352985967075681
6443,5049809,7295,16,0.717386,198,5051138,-1,640.0,7047439,7054734,1997630,7295,78,2,True,True,284.79264177777776,-0.7059545553447648
6444,5050464,16097,1,0.876761,198,5051138,-1,45.0,5058338,5074435,7874,16097,190,3,True,True,20.972102749999998,-0.8692446990099136
6445,5050620,3608,128,0.820241,198,5051138,-1,3712.0,5396657,5400265,346037,3608,147,4,True,True,498.32719431111116,-0.7609078728584466
6446,5050703,99,4,0.824401,198,5051138,-1,20.0,5946042,5946141,895339,99,125,7,True,True,0.063041,-0.824401
6447,5050777,49,2,0.698482,198,5051138,-1,84.0,6919024,6919073,1868247,49,94,10,True,True,0.11678006666666668,-0.698482
6448,5050915,24920,64,0.506335,198,5051138,-1,1344.0,6734268,6759188,1683353,24920,98,0,True,True,847.2120832,-0.4244006309587127
6449,5051602,7919,2,0.351856,206,5052038,-1,54.0,12245139,12253058,7193537,7919,12,12,True,True,6.774177299999999,-0.32882811317472843
6450,5051620,4940,16,0.602116,206,5052038,-1,128.0,6683942,6688882,1632322,4940,104,2,True,True,40.55627022222223,-0.5929850873474478
6451,5051644,11891,128,0.813428,206,5052038,-1,4992.0,7016868,7028759,1965224,11891,84,7,True,True,3960.5351968000004,-0.7865301896795646
6452,5051662,10,32,0.737786,206,5052038,-1,512.0,7006068,7006078,1954406,10,90,2,True,True,0.19568355555555558,-0.737786
6453,5051696,12002,128,0.453262,206,5052038,-1,4608.0,10116139,10128141,5064443,12002,35,12,True,True,1373.606592,-0.3795154019734775
6454,5051826,9,28,0.027351,206,5052038,-1,728.0,11985939,11985948,6934113,9,14,11,True,True,0.14465360000000002,-0.027351
6455,5051887,12955,4,0.052099,206,5052038,-1,176.0,11941739,11954694,6889852,12955,15,8,True,True,48.29521888888888,-0.05059569804626979
6456,5051994,549,1,0.641593,206,5052038,-1,48.0,5359370,5359919,307376,549,168,7,True,True,1.1406024,-0.641593
6457,5052030,7192,8,0.630156,206,5052038,-1,288.0,5357570,5364762,305540,7192,169,6,True,True,90.35161919999999,-0.6224973433322167
6458,5052093,9,1,0.791019,206,5052938,-1,34.0,5322838,5322847,270745,9,176,2,True,True,0.013025400000000001,-0.791019
6459,5053167,300,16,0.136092,224,5054738,-1,672.0,12158739,12159039,7105572,300,13,12,True,True,7.2727200000000005,-0.136092
6460,5053192,11523,32,0.400662,224,5054738,-1,320.0,9154739,9166262,4101547,11523,51,12,True,True,128.23804177777777,-0.34233108607687246
6461,5053311,60,4,0.628296,224,5054738,-1,136.0,6830624,6830684,1777313,60,103,9,True,True,0.20946266666666669,-0.628296
6462,5053321,42,1,0.313722,224,5054738,-1,22.0,7048339,7048381,1995018,42,84,6,True,True,0.054313233333333336,-0.313722
6463,5053390,9387,32,0.082232,224,5054738,-1,1600.0,12711845,12721232,7658455,9387,5,1,True,True,362.1948844444444,-0.07948232996523305
6464,5053409,409,1,0.157822,224,5054738,-1,32.0,6407442,6407851,1354033,409,123,6,True,True,0.23213022222222224,-0.157822
6465,5053471,669,40,0.516366,224,5054738,-1,880.0,5328231,5328900,274760,669,181,7,True,True,29.323162,-0.5163660000000001
6466,5053478,1370,4,0.969665,224,5054738,-1,68.0,6727028,6728398,1673550,1370,112,8,True,True,2.135951777777778,-0.969665
6467,5053524,4,1,0.830621,224,5054738,-1,28.0,5910438,5910442,856914,4,147,12,True,True,0.0032402222222222225,-0.830621
6468,5053546,607,1,0.763163,224,5054738,-1,22.0,6498342,6498949,1444796,607,122,6,True,True,0.2668945277777778,-0.763163
6469,5053558,18448,160,0.84696,224,5054738,-1,4960.0,5706538,5724986,652980,18448,154,6,True,True,3381.7265119999997,-0.810374219918123
6470,5053616,14,16,0.685753,224,5054738,-1,272.0,5371970,5371984,318354,14,172,7,True,True,0.19789964444444447,-0.685753
6471,5053649,94,1,0.792642,224,5054738,-1,32.0,6100542,6100636,1046893,94,139,12,True,True,0.1572849777777778,-0.7926420000000002
6472,5053681,194,8,0.319399,224,5054738,-1,192.0,10985739,10985933,5932058,194,29,12,True,True,0.8884682666666668,-0.319399
6473,5053696,1791,8,0.478365,224,5054738,-1,216.0,6320142,6321933,1266446,1791,127,8,True,True,5.458341600000001,-0.36211853264833865
6474,5054011,14447,128,0.735172,224,5054738,-1,4096.0,5065538,5079985,11527,14447,218,3,True,True,1938.9495296,-0.7336383358327829
6475,5054052,7887,29,0.26068,224,5054738,-1,986.0,12708245,12716132,7654193,7887,6,7,True,True,197.50658300555554,-0.25895034720013294
6476,5054099,10840,32,0.687467,224,5054738,-1,1120.0,6723428,6734268,1669329,10840,115,10,True,True,337.6883004444445,-0.6160351700634632
6477,5054492,21,8,0.826769,224,5054738,-1,152.0,6406542,6406563,1352050,21,129,12,True,True,0.056613666666666666,-0.8267690000000002
6478,5055358,13301,128,0.799529,236,5058338,-1,4224.0,6680342,6693643,1624984,13301,119,7,True,True,3562.8715349333334,-0.7921503060852118
6479,5055377,15508,140,0.198664,236,5058338,-1,2800.0,12706445,12721953,7651068,15508,7,12,True,True,1076.4352355555554,-0.19431219514545986
6480,5055439,17,16,0.414496,236,5058338,-1,352.0,6734268,6734285,1678829,17,113,2,True,True,0.10897528888888888,-0.414496
6481,5055712,8,16,0.181889,236,5058338,-1,800.0,8809139,8809147,3753427,8,59,12,True,True,0.28529777777777776,-0.181889
6482,5055757,3,8,0.87639,236,5058338,-1,344.0,5379170,5379173,323413,3,181,4,True,True,0.053635333333333333,-0.87639
6483,5055783,1034,4,0.944757,236,5058338,-1,72.0,5074435,5075469,18652,1034,224,2,True,True,2.1854624,-0.944757
6484,5056411,109,2,0.884341,236,5058338,-1,12.0,6612242,6612351,1555831,109,125,8,True,True,0.0253752,-0.884341
6485,5056458,266,9,0.224487,236,5058338,-1,225.0,7919739,7920005,2863281,266,78,12,True,True,2.5937618749999998,-0.20242462196403904
6486,5056472,345,8,0.948109,236,5058338,-1,176.0,5368370,5368715,311898,345,187,6,True,True,3.1075146666666664,-0.948109
6487,5056902,18,10,0.923112,236,5058338,-1,420.0,5330031,5330049,273129,18,199,6,True,True,0.37655099999999997,-0.923112
6488,5057043,9038,32,0.647107,236,5058338,-1,960.0,7487739,7496777,2430696,9038,83,7,True,True,551.2974453333334,-0.6326928803202608
6489,5058075,16,1,0.626627,236,5058338,-1,39.0,6995224,6995240,1937149,16,105,6,True,True,0.017787466666666668,-0.626627
6490,5058146,12,7,0.906845,236,5058338,-1,161.0,6852724,6852736,1794578,12,112,10,True,True,0.12083050000000002,-0.906845
6491,5058434,553,4,0.974128,249,5061938,-1,32.0,6896924,6897477,1838490,553,112,11,True,True,0.5914888,-0.9741280000000002
6492,5058632,386,1,0.198266,249,5061938,-1,15.0,6236742,6237128,1178110,386,149,0,True,True,0.24104091666666663,-0.198266
6493,5058801,18,16,0.701261,249,5061938,-1,144.0,5466557,5466575,407756,18,180,6,True,True,0.0763488,-0.701261
6494,5058827,10593,1,0.168756,249,5061938,-1,7.0,12533645,12544238,7474818,10593,9,12,True,True,1.3133880472222221,-0.1515720514969637
6495,5058866,27,16,0.401035,249,5061938,-1,544.0,7002468,7002495,1943602,27,105,1,True,True,0.5194248,-0.401035
6496,5058919,16733,1,0.428903,249,5061938,-1,7.0,12338739,12355472,7279820,16733,14,12,True,True,2.3418180722222224,-0.4055594931648538
6497,5058961,39,1,0.260158,249,5061938,-1,36.0,11375539,11375578,6316578,39,30,12,True,True,0.053823899999999994,-0.260158
6498,5059497,36,30,0.089061,249,5061938,-1,810.0,11289139,11289175,6229642,36,31,12,True,True,1.4306220000000003,-0.089061
6499,5059573,159,16,0.36792,249,5061938,-1,800.0,5488657,5488816,429084,159,185,10,True,True,4.007153333333333,-0.36791999999999997
6500,5059943,270,8,0.947244,249,5061938,-1,56.0,5307538,5307808,247595,270,221,6,True,True,0.651126,-0.947244
6501,5059974,12,1,0.117351,249,5061938,-1,36.0,10202539,10202551,5142565,12,46,12,True,True,0.0180576,-0.11735099999999997
6502,5060092,437,64,0.718583,249,5061938,-1,640.0,5531938,5532375,471846,437,181,8,True,True,7.276341333333333,-0.718583
6503,5060119,11,3,0.435159,249,5061938,-1,126.0,9632739,9632750,4572620,11,54,12,True,True,0.01786785,-0.4351589999999999
6504,5060145,147,4,0.919989,249,5061938,-1,132.0,5211938,5212085,151793,147,230,6,True,True,0.7431193,-0.919989
