job_id,submit_time,request_time,request_processors,carbon_consideration,queue_length_at_submission,submission_timestamp,user_id,power,scheduled_time,completion_time,wait_time,actual_runtime,action1,action2,scheduled,completed,carbon_emissions,carbon_reward
7599,6084716,8396,8,0.537604,1,6084716,-1,168.0,6128916,6137312,44200,8396,0,11,True,True,36.01713546666667,-0.5242234721643375
7600,6085683,12,4,0.32608,106,6128916,-1,120.0,9916661,9916673,3830978,12,0,9,True,True,0.093212,-0.32608
7601,6085768,291,64,0.02324,106,6128916,-1,2944.0,7770566,7770857,1684798,291,1,12,True,True,33.982592,-0.02324
7602,6085843,31,32,0.785358,106,6128916,-1,256.0,11979496,11979527,5893653,31,0,12,True,True,0.3763427555555556,-0.785358
7603,6085865,8087,26,0.922144,106,6128916,-1,858.0,13340961,13349048,7255096,8087,0,6,True,True,305.7450014666666,-0.818551452540827
7604,6093970,4,2,0.153691,106,6128916,-1,22.0,12660708,12660712,6566738,4,1,11,True,True,0.0013366222222222222,-0.153691
7605,6094137,1277,1,0.952638,106,6128916,-1,17.0,11702096,11703373,5607959,1277,3,1,True,True,1.018996338888889,-0.952638
7606,6094181,836,16,0.330251,106,6128916,-1,432.0,10732387,10733223,4638206,836,4,0,True,True,5.0170031999999996,-0.330251
7607,6094592,4818,1,0.629839,106,6128916,-1,8.0,11571489,11576307,5476897,4818,4,8,True,True,1.4810909333333333,-0.6072210954280104
7608,6094727,8,8,0.603003,106,6128916,-1,120.0,8656792,8656800,2562065,8,7,12,True,True,0.028408000000000003,-0.603003
7609,6094907,18787,2,0.607837,106,6128916,-1,84.0,13363061,13381848,7268154,18787,0,10,True,True,75.79021963333334,-0.6065021658764898
7610,6094978,10,4,0.866945,106,6128916,-1,116.0,11254889,11254899,5159911,10,6,7,True,True,0.046725444444444444,-0.866945
7611,6095254,11,44,0.980172,106,6128916,-1,528.0,7881766,7881777,1786512,11,10,12,True,True,0.26465120000000003,-0.980172
7612,6095273,34,1,0.204205,106,6128916,-1,8.0,7527534,7527568,1432261,34,12,12,True,True,0.006516666666666667,-0.204205
7613,6095276,750,8,0.390636,106,6128916,-1,120.0,10354387,10355137,4259111,750,8,10,True,True,2.97975,-0.390636
7614,6095281,697,1,0.534491,106,6128916,-1,33.0,9333403,9334100,3238122,697,10,7,True,True,0.8331473333333335,-0.534491
7615,6095288,87,1,0.188339,106,6128916,-1,36.0,11615689,11615776,5520401,87,5,11,True,True,0.161298,-0.188339
7616,6095300,5354,8,0.108638,106,6128916,-1,208.0,7057934,7063288,962634,5354,16,12,True,True,29.22137111111111,-0.10117483447270706
7617,6095363,19008,8,0.569515,106,6128916,-1,312.0,9635661,9654669,3540298,19008,11,10,True,True,300.171105,-0.5590037015900231
7618,6095534,31,4,0.451535,106,6128916,-1,80.0,8864692,8864723,2769158,31,13,9,True,True,0.05299622222222223,-0.451535
7619,6095582,113,2,0.894744,106,6128916,-1,62.0,6611334,6611447,515752,113,19,6,True,True,0.2571591222222222,-0.894744
7620,6095896,137,32,0.093242,106,6128916,-1,320.0,7433934,7434071,1338038,137,18,0,True,True,1.7853146666666664,-0.08403318837609076
7621,6095972,9,2,0.104313,106,6128916,-1,96.0,11567889,11567898,5471917,9,7,11,True,True,0.0338736,-0.104313
7622,6095994,6961,17,0.552907,106,6128916,-1,833.0,10072961,10079922,3976967,6961,11,8,True,True,223.58779529722221,-0.5526509340630285
7623,6096053,39045,8,0.032059,106,6128916,-1,80.0,13273761,13312806,7177708,39045,2,12,True,True,113.19793733333333,-0.02999806549085792
7624,6096103,12315,4,0.689025,106,6128916,-1,132.0,11163089,11175404,5066986,12315,10,11,True,True,37.93786076666667,-0.6110412723121105
7625,6096127,23680,2,0.488613,106,6128916,-1,66.0,7441134,7464814,1345007,23680,22,9,True,True,62.50209863333333,-0.48245422930161036
7626,6096190,11,1,0.186692,106,6128916,-1,30.0,9223092,9223103,3126902,11,17,11,True,True,0.008831166666666668,-0.186692
7627,6096215,699,18,0.069491,106,6128916,-1,666.0,6180316,6181015,84101,699,27,11,True,True,9.3830964,-0.069491
7628,6096769,50,1,0.962995,106,6128916,-1,9.0,10901889,10901939,4805120,50,11,8,True,True,0.019341249999999994,-0.962995
7629,6096778,13995,36,0.283818,106,6128916,-1,972.0,11118889,11132884,5022111,13995,11,12,True,True,563.5358919,-0.27438501439893637
7630,6096933,51,1,0.233039,106,6128916,-1,17.0,11259389,11259440,5162456,51,9,8,True,True,0.03572521666666667,-0.233039
7631,6096961,72,4,0.65957,106,6128916,-1,68.0,12001865,12001937,5904904,72,4,1,True,True,0.2619904,-0.65957
7632,6097020,8852,128,0.069979,106,6128916,-1,5504.0,12332765,12341617,6235745,8852,4,12,True,True,1777.4691292444443,-0.05715002518519908
7633,6097126,33,8,0.057453,106,6128916,-1,56.0,6136116,6136149,38990,33,33,9,True,True,0.04473186666666666,-0.057453
7634,6097130,279,4,0.518532,106,6128916,-1,132.0,8435936,8436215,2338806,279,25,12,True,True,2.1603714000000003,-0.518532
7635,6097184,6985,8,0.171826,106,6128916,-1,240.0,12661608,12668593,6564424,6985,3,6,True,True,25.29230666666667,-0.07668073651086568
7636,6097211,410,4,0.859707,106,6128916,-1,160.0,9424303,9424713,3327092,410,22,8,True,True,2.3989555555555557,-0.859707
7637,6097271,3,8,0.410861,106,6128916,-1,80.0,8145436,8145439,2048165,3,28,10,True,True,0.009731333333333333,-0.410861
7638,6097277,278,2,0.157035,106,6128916,-1,34.0,12977902,12978180,6880625,278,3,7,True,True,0.2901123666666667,-0.14803923175153252
7639,6097332,23,4,0.110744,106,6128916,-1,20.0,8723092,8723115,2625760,23,27,10,True,True,0.0072450000000000014,-0.11074400000000002
7640,6097351,23,32,0.536453,106,6128916,-1,704.0,10133364,10133387,4036013,23,20,7,True,True,0.4197326222222222,-0.536453
7641,6098046,203,8,0.478251,106,6128916,-1,200.0,9480261,9480464,3382215,203,24,1,True,True,2.080975555555556,-0.478251
7642,6098145,19,1,0.068763,106,6128916,-1,26.0,10822827,10822846,4724682,19,18,10,True,True,0.01956651666666667,-0.068763
7643,6098202,1062,2,0.955097,106,6128916,-1,20.0,10892727,10893789,4794525,1062,18,1,True,True,0.376533,-0.7665176199165331
7644,6098431,6,1,0.865699,106,6128916,-1,49.0,8791192,8791198,2692761,6,31,11,True,True,0.008475366666666666,-0.865699
7645,6098546,4961,16,0.129932,106,6128916,-1,480.0,12796708,12801669,6698162,4961,4,12,True,True,101.48696933333333,-0.12923149488884517
7646,6098955,14,1,0.205677,106,6128916,-1,28.0,12436508,12436522,6337553,14,7,6,True,True,0.012967577777777779,-0.205677
7647,6100368,8,26,0.432201,106,6128916,-1,442.0,10734427,10734435,4634059,8,22,6,True,True,0.04912093333333333,-0.432201
7648,6100373,624,1,0.709672,106,6128916,-1,39.0,13432966,13433590,7332593,624,0,10,True,True,1.1396684000000001,-0.709672
7649,6100434,3,2,0.47478,106,6128916,-1,32.0,10131561,10131564,4031127,3,27,9,True,True,0.0024885333333333334,-0.47478
7650,6100512,20254,16,0.603709,106,6128916,-1,736.0,7144334,7164588,1043822,20254,46,12,True,True,487.9538933333334,-0.5690745795283089
7651,6100987,28,2,0.939154,106,6128916,-1,14.0,8189636,8189664,2088649,28,40,11,True,True,0.013100422222222222,-0.939154
7652,6101020,9091,128,0.587492,106,6128916,-1,2816.0,10867027,10876118,4766007,9091,22,10,True,True,848.6128718222221,-0.5532830519292254
7653,6101026,128,16,0.502475,106,6128916,-1,800.0,13366666,13366794,7265640,128,1,1,True,True,4.642986666666666,-0.502475
7654,6101073,7,1,0.684836,106,6128916,-1,29.0,10621187,10621194,4520114,7,27,11,True,True,0.005451113888888889,-0.684836
7655,6106453,89,16,0.275441,106,6128916,-1,576.0,10732387,10732476,4625934,89,27,6,True,True,0.7121424,-0.275441
7656,6106775,9486,8,0.007443,106,6128916,-1,328.0,12424808,12434294,6318033,9486,10,10,True,True,111.21449533333333,-0.007426187868596693
7657,6106898,10,16,0.142692,106,6128916,-1,672.0,10733527,10733537,4626629,10,27,6,True,True,0.093352,-0.142692
7658,6107010,66,32,0.06397,106,6128916,-1,1568.0,9797361,9797427,3690351,66,36,7,True,True,3.7936976,-0.06397
7659,6107212,15,1,0.399237,106,6128916,-1,21.0,8480136,8480151,2372924,15,46,11,True,True,0.016511249999999998,-0.399237
7660,6107349,5513,1,0.807566,106,6128916,-1,41.0,10889127,10894640,4781778,5513,24,10,True,True,4.058194122222222,-0.7031561728229455
7661,6107760,42,4,0.525857,106,6128916,-1,100.0,7795366,7795408,1687606,42,52,10,True,True,0.2080516666666667,-0.525857
7662,6107783,6,4,0.910303,106,6128916,-1,36.0,6837334,6837340,729551,6,59,9,True,True,0.008344800000000001,-0.910303
7663,6108059,58,1,0.879239,106,6128916,-1,48.0,10310187,10310245,4202128,58,33,11,True,True,0.06673866666666667,-0.879239
7664,6108112,537,1,0.460205,106,6128916,-1,38.0,9788361,9788898,3680249,537,39,11,True,True,0.7766645833333332,-0.4589594634061744
7665,6108162,11,4,0.576133,106,6128916,-1,200.0,12884008,12884019,6775846,11,6,6,True,True,0.15709833333333337,-0.576133
7666,6108299,73,1,0.737291,106,6128916,-1,32.0,9037492,9037565,2929193,73,46,12,True,True,0.05213173333333333,-0.737291
7667,6109439,8251,8,0.287912,106,6128916,-1,344.0,11848896,11857147,5739457,8251,15,12,True,True,108.66815328888887,-0.2684276208938928
7668,6110021,745,2,0.880994,106,6128916,-1,70.0,13410866,13411611,7300845,745,1,11,True,True,3.4177081944444447,-0.880994
7669,6110292,24,16,0.456307,106,6128916,-1,144.0,13079108,13079132,6968816,24,6,9,True,True,0.056544,-0.456307
7670,6110560,683,2,0.700317,106,6128916,-1,82.0,8036936,8037619,1926376,683,58,10,True,True,2.310558644444445,-0.700317
7671,6110618,475,1,0.711648,106,6128916,-1,50.0,11520089,11520564,5409471,475,22,10,True,True,0.3714895833333334,-0.711648
7672,6111648,10744,4,0.297449,106,6128916,-1,104.0,11523689,11534433,5412041,10744,22,8,True,True,16.16082317777778,-0.25438033154879025
7673,6111677,29494,4,0.613028,106,6128916,-1,180.0,7429434,7458928,1317757,29494,67,12,True,True,211.519738,-0.6033212024385717
7674,6112290,396,7,0.809985,106,6128916,-1,63.0,10124361,10124757,4012071,396,42,11,True,True,0.5463612000000001,-0.809985
7675,6112402,206,1,0.175126,106,6128916,-1,42.0,13022102,13022308,6909700,206,7,11,True,True,0.2211066666666667,-0.17512599999999998
7676,6112602,13650,14,0.249135,106,6128916,-1,126.0,12976102,12989752,6863500,13650,9,8,True,True,60.5429391,-0.24066937323689877
7677,6112924,20785,193,0.899965,106,6128916,-1,7334.0,10622987,10643772,4510063,20785,39,7,True,True,3317.088646472222,-0.8488795537709164
7678,6116203,5,8,0.733244,106,6128916,-1,160.0,8014836,8014841,1898633,5,65,12,True,True,0.034453333333333336,-0.733244
7679,6116352,1695,8,0.457828,106,6128916,-1,400.0,11709296,11710991,5592944,1695,20,9,True,True,32.133162222222225,-0.456699919923784
7680,6116390,8,4,0.910833,106,6128916,-1,96.0,10398587,10398595,4282197,8,42,11,True,True,0.031048533333333333,-0.910833
7681,6116853,16547,64,0.183444,106,6128916,-1,2048.0,6354916,6371463,238063,16547,79,12,True,True,986.7184014222221,-0.18097055707743545
7682,6117029,5,2,0.568615,106,6128916,-1,90.0,7773266,7773271,1656237,5,70,7,True,True,0.015045000000000001,-0.5686149999999999
7683,6118255,11693,41,0.393551,106,6128916,-1,1230.0,12402708,12414401,6284453,11693,16,1,True,True,153.65733658333332,-0.3320367219199255
7684,6118441,9726,24,0.945687,106,6128916,-1,312.0,6840934,6850660,722493,9726,79,8,True,True,119.1132384,-0.9292801671921026
7685,6118880,394,1,0.239695,106,6128916,-1,19.0,9612661,9613055,3493781,394,54,10,True,True,0.3040563666666667,-0.239695
7686,6118914,18,1,0.87054,106,6128916,-1,21.0,6182116,6182134,63202,18,84,7,True,True,0.007610400000000001,-0.87054
7687,6118928,95,1,0.273776,106,6128916,-1,12.0,12665208,12665303,6546280,95,12,1,True,True,0.017521166666666664,-0.273776
7688,6119064,23817,2,0.628083,106,6128916,-1,10.0,6971534,6995351,852470,23817,81,11,True,True,5.3757165,-0.5286379859360592
7689,6119108,9,4,0.29189,106,6128916,-1,152.0,10529187,10529196,4410079,9,44,11,True,True,0.038817000000000004,-0.29189
7690,6123749,14,4,0.916296,106,6128916,-1,92.0,9436003,9436017,3312254,14,58,9,True,True,0.05942688888888888,-0.916296
7691,6123915,18,4,0.698044,106,6128916,-1,196.0,6606816,6606834,482901,18,87,11,True,True,0.14761739999999998,-0.698044
7692,6124059,81,1,0.722409,106,6128916,-1,45.0,13071908,13071989,6947849,81,7,6,True,True,0.059261625,-0.722409
7693,6124598,92,2,0.217255,106,6128916,-1,36.0,13025908,13026000,6901310,92,8,1,True,True,0.0874184,-0.217255
7694,6124770,8,1,0.493488,106,6128916,-1,36.0,12616508,12616516,6491738,8,17,12,True,True,0.0185672,-0.4934880000000001
7695,6125092,2,5,0.99239,106,6128916,-1,115.0,13187359,13187361,7062267,2,6,12,True,True,0.01007463888888889,-0.99239
7696,6125214,4,4,0.552824,106,6128916,-1,140.0,7212434,7212438,1087220,4,85,10,True,True,0.021026444444444445,-0.552824
7697,6125511,10193,16,0.995316,106,6128916,-1,672.0,10080161,10090354,3954650,10193,55,8,True,True,185.99109573333334,-0.9892187255057641
7698,6125774,15531,128,0.076534,106,6128916,-1,3328.0,12196765,12212296,6070991,15531,23,12,True,True,1870.0937493333333,-0.05963888867007928
7699,6126004,10,16,0.105225,106,6128916,-1,240.0,10893789,10893799,4767785,10,39,1,True,True,0.05301333333333333,-0.105225
7700,6126999,20414,256,0.766539,106,6128916,-1,9728.0,10245573,10265987,4118574,20414,54,12,True,True,9912.888989866666,-0.7490267574898151
7701,6127255,15208,4,0.326013,106,6128916,-1,192.0,9178892,9194100,3051637,15208,70,12,True,True,84.18554026666666,-0.3106524826001405
7702,6127551,151,16,0.450936,106,6128916,-1,96.0,10732476,10732627,4604925,151,46,1,True,True,0.2013736,-0.450936
7703,6128779,3,1,0.252767,106,6128916,-1,26.0,12402665,12402668,6273886,3,22,7,True,True,0.00065585,-0.252767
7704,6128835,200,32,0.506065,106,6128916,-1,1184.0,9245203,9245403,3116368,200,71,10,True,True,7.658506666666666,-0.506065
7705,6128855,154,2,0.462167,106,6128916,-1,66.0,12110365,12110519,5981510,154,25,12,True,True,0.7144419333333334,-0.45811014610122536
7706,6129010,26,32,0.073195,115,6136116,-1,288.0,13187361,13187387,7058351,26,6,1,True,True,0.3279952,-0.073195
7707,6130829,3,5,0.694486,115,6136116,-1,35.0,12928302,12928305,6797473,3,14,1,True,True,0.005254083333333334,-0.694486
7708,6132809,32539,37,0.749736,115,6136116,-1,1591.0,7433034,7465573,1300225,32539,95,1,True,True,2043.7366349694444,-0.7326699164931174
7709,6133298,352,1,0.381156,115,6136116,-1,34.0,7441134,7441486,1307836,352,93,0,True,True,0.4895244444444445,-0.37272692920706596
7710,6133568,34,106,0.745957,115,6136116,-1,4028.0,8568551,8568585,2434983,34,82,11,True,True,3.511677533333333,-0.745957
7711,6133731,53,4,0.855773,115,6136116,-1,32.0,9041092,9041145,2907361,53,77,8,True,True,0.03942728888888889,-0.855773
7712,6133928,6435,4,0.396674,115,6136116,-1,140.0,10484987,10491422,4351059,6435,56,12,True,True,34.170339000000006,-0.374804987611637
7713,6134348,3,8,0.010737,115,6136116,-1,336.0,8480151,8480154,2345803,3,85,1,True,True,0.052836,-0.010737
7714,6134461,109,4,0.114683,115,6136116,-1,140.0,10076561,10076670,3942100,109,65,8,True,True,0.6004386111111112,-0.114683
7715,6134542,144,8,0.917137,115,6136116,-1,152.0,11253089,11253233,5118547,144,40,12,True,True,0.917776,-0.917137
7716,6157938,30,8,0.32711,137,6180316,-1,264.0,9568461,9568491,3410523,30,73,12,True,True,0.356554,-0.32711
7717,6158059,72,1,0.748676,137,6180316,-1,50.0,7928436,7928508,1770377,72,95,7,True,True,0.16187,-0.748676
7718,6158070,1194,32,0.484759,137,6180316,-1,448.0,10265987,10267181,4107917,1194,61,0,True,True,23.317705600000004,-0.484759
7719,6158142,61,8,0.068237,137,6180316,-1,224.0,13100959,13101020,6942817,61,8,1,True,True,0.13125031111111113,-0.068237
7720,6166540,36,1,0.548429,137,6180316,-1,25.0,11407989,11408025,5241449,36,39,9,True,True,0.0325925,-0.548429
7721,6166801,8740,64,0.242294,137,6180316,-1,384.0,10155464,10164204,3988663,8740,65,10,True,True,105.64686080000001,-0.23236719996072633
7722,6167111,15477,8,0.950018,137,6180316,-1,64.0,9657761,9673238,3490650,15477,75,10,True,True,56.05915857777777,-0.9250436111102597
7723,6167127,12518,64,0.140256,137,6180316,-1,832.0,8570358,8582876,2403231,12518,92,1,True,True,292.68639111111105,-0.1401859220656298
7724,6167151,6896,1,0.820427,137,6180316,-1,22.0,11389989,11396885,5222838,6896,40,12,True,True,4.205348766666667,-0.7996366192725316
7725,6167179,4606,42,0.841563,137,6180316,-1,630.0,11711096,11715702,5543917,4606,32,7,True,True,134.118488,-0.8405176930388291
7726,6167293,35,32,0.170589,137,6180316,-1,1152.0,7433934,7433969,1266641,35,112,6,True,True,1.8219039999999997,-0.170589
7727,6167321,2351,32,0.018066,137,6180316,-1,576.0,7662066,7664417,1494745,2351,108,1,True,True,44.5717472,-0.018060125685112643
7728,6167402,3,64,0.100515,137,6180316,-1,448.0,10898289,10898292,4730887,3,48,6,True,True,0.03986453333333334,-0.100515
7729,6168363,50,16,0.294145,137,6180316,-1,512.0,12435608,12435658,6267245,50,23,8,True,True,0.8468622222222222,-0.294145
7730,6170285,6,15,0.534654,137,6180316,-1,615.0,9744161,9744167,3573876,6,79,12,True,True,0.18868200000000002,-0.534654
7731,6170812,28303,8,0.39085,137,6180316,-1,200.0,12246365,12274668,6075553,28303,28,8,True,True,309.19524722222224,-0.37660385903564153
7732,6170820,852,1,0.077585,137,6180316,-1,46.0,12443708,12444560,6272888,852,22,9,True,True,1.1943761999999998,-0.077585
7733,6171254,11,32,0.763589,137,6180316,-1,1216.0,8263136,8263147,2091882,11,104,10,True,True,0.5948232888888889,-0.763589
7734,6171266,6290,1,0.677383,137,6180316,-1,30.0,13477166,13483456,7305900,6290,0,11,True,True,8.985356166666666,-0.5713548498641005
7735,6171277,10237,3,0.153496,137,6180316,-1,63.0,8700992,8711229,2529715,10237,99,11,True,True,12.684278424999999,-0.15334752823853995
7736,6171329,8,10,0.358087,137,6180316,-1,360.0,6268516,6268524,97187,8,133,12,True,True,0.083184,-0.358087
7737,6171796,29,4,0.216672,137,6180316,-1,128.0,10732627,10732656,4560831,29,60,1,True,True,0.05156586666666667,-0.216672
7738,6171947,8514,128,0.034445,137,6180316,-1,1408.0,7343034,7351548,1171087,8514,125,11,True,True,349.830272,-0.032652763974011845
7739,6180587,10886,2,0.675044,145,6182116,-1,16.0,11893096,11903982,5712509,10886,35,11,True,True,10.33800071111111,-0.6705670667668164
7740,6180626,47,1,0.216166,145,6182116,-1,50.0,7529334,7529381,1348708,47,119,7,True,True,0.06537569444444445,-0.216166
7741,6180674,58,1,0.696742,145,6182116,-1,44.0,9480203,9480261,3299529,58,90,11,True,True,0.13080417777777775,-0.696742
7742,6180804,34,2,0.836501,145,6182116,-1,48.0,11411589,11411623,5230785,34,45,8,True,True,0.061240800000000005,-0.836501
7743,6180922,3,1,0.811512,145,6182116,-1,11.0,11010389,11010392,4829467,3,53,10,True,True,0.0008711083333333334,-0.811512
7744,6181531,14512,1,0.641012,145,6182116,-1,50.0,8241036,8255548,2059505,14512,112,11,True,True,32.96031777777778,-0.6357887831649525
7745,6181893,34,4,0.71641,145,6182116,-1,136.0,8570358,8570392,2388465,34,106,0,True,True,0.11856706666666668,-0.71641
7746,6181980,11445,16,0.89701,145,6182116,-1,160.0,12400865,12412310,6218885,11445,29,7,True,True,16.574226666666668,-0.8942604591667742
7747,6182070,10698,256,0.390618,145,6182116,-1,11520.0,13090257,13100955,6908187,10698,10,7,True,True,1548.531168,-0.3844730930922726
7748,6182223,59,2,0.308324,251,6268516,-1,40.0,13567366,13567425,7385143,59,0,0,True,True,0.08346533333333334,-0.308324
7749,6182229,14021,8,0.052415,251,6268516,-1,368.0,6432016,6446037,249787,14021,144,10,True,True,154.66092400000002,-0.05070566517113426
7750,6182245,6,7,0.004666,251,6268516,-1,126.0,10988289,10988295,4806044,6,57,12,True,True,0.022192800000000002,-0.004666
7751,6182363,11,15,0.77241,251,6268516,-1,165.0,10731487,10731498,4549124,11,71,12,True,True,0.025440250000000005,-0.77241
7752,6182386,12,2,0.767114,251,6268516,-1,18.0,10131564,10131576,3949178,12,83,1,True,True,0.0055991999999999995,-0.767114
7753,6182528,13,32,0.928821,251,6268516,-1,640.0,6476216,6476229,293688,13,147,11,True,True,0.18063644444444443,-0.928821
7754,6182662,527,8,0.374645,251,6268516,-1,208.0,13567366,13567893,7384704,527,1,11,True,True,3.8767525333333333,-0.37464499999999995
7755,6182694,1989,2,0.23854,251,6268516,-1,62.0,11166689,11168678,4983995,1989,55,1,True,True,2.623191238888889,-0.2297157775600309
7756,6182782,38,2,0.091386,251,6268516,-1,56.0,10576987,10577025,4394205,38,76,8,True,True,0.05246702222222223,-0.091386
7757,6182850,21,4,0.421683,251,6268516,-1,132.0,9590561,9590582,3407711,21,99,10,True,True,0.125972,-0.421683
7758,6182870,18,2,0.989291,251,6268516,-1,28.0,7298834,7298852,1115964,18,143,12,True,True,0.0137648,-0.989291
7759,6182876,16473,21,0.337117,251,6268516,-1,336.0,6699534,6716007,516658,16473,150,7,True,True,182.02431520000002,-0.3283125163791307
7760,6183019,13368,6,0.192152,251,6268516,-1,120.0,6610434,6623802,427415,13368,152,8,True,True,61.675472,-0.18873957782551032
7761,6183053,24,4,0.668949,251,6268516,-1,184.0,6358516,6358540,175463,24,156,8,True,True,0.1437776,-0.668949
7762,6184878,28,1,0.220568,251,6268516,-1,41.0,8813292,8813320,2628414,28,112,10,True,True,0.02798568888888889,-0.220568
7763,6186030,10651,4,0.882286,251,6268516,-1,136.0,13022308,13032959,6836278,10651,16,1,True,True,49.90975146666667,-0.7521521557433267
7764,6186037,134,4,0.796924,251,6268516,-1,168.0,9419803,9419937,3233766,134,106,12,True,True,0.7882326666666666,-0.796924
7765,6186291,7,1,0.830451,251,6268516,-1,43.0,13317961,13317968,7131670,7,8,11,True,True,0.008820972222222221,-0.830451
7766,6186296,4,1,0.167883,251,6268516,-1,7.0,6562616,6562620,376320,4,158,0,True,True,0.0006991444444444444,-0.167883
7767,6186359,9079,16,0.167047,251,6268516,-1,208.0,9613561,9622640,3427202,9079,100,6,True,True,82.7156015111111,-0.1666248326611059
7768,6186610,2,64,0.41568,251,6268516,-1,2560.0,10778627,10778629,4592017,2,69,11,True,True,0.20482844444444448,-0.41568
7769,6186646,12762,5,0.107684,251,6268516,-1,60.0,11762496,11775258,5575850,12762,43,8,True,True,39.386625,-0.10556682191150524
7770,6186691,94,4,0.327141,251,6268516,-1,188.0,12928208,12928302,6741517,94,22,11,True,True,0.8842872444444444,-0.327141
7771,6186720,10727,1,0.562054,251,6268516,-1,48.0,12530108,12540835,6343388,10727,29,12,True,True,16.994712933333332,-0.5139330320749026
7772,6186760,4,16,0.189548,251,6268516,-1,592.0,6409916,6409920,223156,4,166,8,True,True,0.07900568888888888,-0.189548
7773,6187354,35732,16,0.207119,251,6268516,-1,368.0,10025161,10060893,3837807,35732,98,10,True,True,399.9379686666666,-0.1974465786813294
7774,6187374,16088,32,0.541703,251,6268516,-1,448.0,7684166,7700254,1496792,16088,143,10,True,True,378.66233564444445,-0.5373208090821121
7775,6187428,7,4,0.938923,251,6268516,-1,68.0,8570351,8570358,2382923,7,128,7,True,True,0.012205433333333335,-0.938923
7776,6187452,40,4,0.120804,251,6268516,-1,80.0,12402668,12402708,6215216,40,35,1,True,True,0.02690666666666667,-0.12080400000000002
7777,6187476,230,32,0.21378,251,6268516,-1,1280.0,9092492,9092722,2905016,230,119,9,True,True,10.465102222222221,-0.21378
7778,6187562,4,1,0.356576,251,6268516,-1,44.0,13100955,13100959,6913393,4,13,8,True,True,0.0016905777777777775,-0.356576
7779,6187628,5482,64,0.173622,251,6268516,-1,2112.0,8746992,8752474,2559364,5482,126,10,True,True,181.76500906666666,-0.16481173714823338
7780,6187688,7780,16,0.402139,251,6268516,-1,320.0,10069361,10077141,3881673,7780,100,11,True,True,95.66045422222223,-0.39585215063197476
7781,6196956,48,8,0.31624,251,6268516,-1,40.0,8196836,8196884,1999880,48,140,1,True,True,0.080528,-0.31624
7782,6197065,8715,64,0.389187,251,6268516,-1,2624.0,8193236,8201951,1996171,8715,141,8,True,True,969.1835621333335,-0.3699725096860007
7783,6197309,20587,32,0.458776,251,6268516,-1,256.0,6362116,6382703,164807,20587,177,8,True,True,147.11833813333334,-0.45121433761798463
7784,6197333,132,8,0.066016,251,6268516,-1,304.0,7661934,7662066,1464601,132,153,11,True,True,1.3212144,-0.066016
7785,6197371,40,8,0.815085,251,6268516,-1,248.0,10800727,10800767,4603356,40,74,10,True,True,0.4231706666666667,-0.815085
7786,6197433,8,4,0.649945,251,6268516,-1,72.0,9909461,9909469,3712028,8,104,10,True,True,0.036420799999999996,-0.649945
7787,6198518,5,2,0.36898,251,6268516,-1,20.0,7771466,7771471,1572948,5,152,6,True,True,0.003966666666666667,-0.36898
7788,6198545,6037,1,0.067331,251,6268516,-1,45.0,11497989,11504026,5299444,6037,56,12,True,True,6.9551834999999995,-0.06595021854586924
7789,6198567,13942,3,0.218561,251,6268516,-1,111.0,11303589,11317531,5105022,13942,60,11,True,True,58.226137800000004,-0.2071954328001829
7790,6199325,12,4,0.301534,251,6268516,-1,132.0,8951092,8951104,2751767,12,128,12,True,True,0.030646000000000007,-0.301534
7791,6199601,9528,16,0.598869,251,6268516,-1,752.0,6830134,6839662,630533,9528,176,11,True,True,263.4421941333333,-0.5951040390000067
7792,6199623,16060,128,0.983102,251,6268516,-1,3328.0,10573387,10589447,4373764,16060,88,11,True,True,1427.7362481777777,-0.980038720300834
7793,6200106,14,3,0.101814,251,6268516,-1,78.0,11255789,11255803,5055683,14,62,6,True,True,0.04398636666666666,-0.101814
7794,6200395,17,19,0.536182,251,6268516,-1,855.0,11393589,11393606,5193194,17,59,1,True,True,0.36878525000000006,-0.536182
7795,6201790,98,3,0.990531,251,6268516,-1,138.0,12432008,12432106,6230218,98,34,9,True,True,0.48908043333333334,-0.990531
7796,6201992,13,32,0.850465,251,6268516,-1,1088.0,9331603,9331616,3129611,13,126,12,True,True,0.5123271111111112,-0.850465
7797,6202188,15248,8,0.171459,251,6268516,-1,224.0,7146134,7161382,943946,15248,176,7,True,True,109.6717937777778,-0.16602723834520938
7798,6202259,119,4,0.959035,251,6268516,-1,68.0,9887361,9887480,3685102,119,111,1,True,True,0.2799832,-0.959035
7799,6202348,13269,32,0.599867,251,6268516,-1,1120.0,10003061,10016330,3800713,13269,109,12,True,True,570.5579693333334,-0.5385087270321319
7800,6202504,4977,8,0.981416,251,6268516,-1,344.0,6927334,6932311,724830,4977,182,12,True,True,57.26640335555555,-0.9780473563845747
7801,6202738,9543,16,0.696315,251,6268516,-1,224.0,8570392,8579935,2367654,9543,143,1,True,True,60.659917422222215,-0.6902255000563856
7802,6202784,3,4,0.677901,251,6268516,-1,112.0,8524351,8524354,2321567,3,148,11,True,True,0.015388800000000001,-0.677901
7803,6202795,12009,1,0.972367,251,6268516,-1,35.0,11400789,11412798,5197994,12009,60,9,True,True,14.803894875000001,-0.9266411134503395
7804,6202868,670,1,0.693721,251,6268516,-1,24.0,7925966,7926636,1723098,670,162,11,True,True,0.7562066666666667,-0.693721
7805,6203049,269,8,0.332047,251,6268516,-1,216.0,12001596,12001865,5798547,269,45,10,True,True,3.1092095999999994,-0.332047
7806,6203171,1197,3,0.635353,251,6268516,-1,126.0,11714696,11715893,5511525,1197,50,1,True,True,6.874131600000001,-0.635353
7807,6204006,19249,128,0.883967,251,6268516,-1,4864.0,13071008,13090257,6867002,19249,17,11,True,True,1328.0145557333335,-0.7867981493742913
7808,6204286,8237,4,0.317967,251,6268516,-1,68.0,11758896,11767133,5554610,8237,51,11,True,True,28.44154494444445,-0.29834071777842525
7809,6204343,16776,1,0.851554,251,6268516,-1,30.0,10645087,10661863,4440744,16776,93,10,True,True,7.53975025,-0.8082285405607582
7810,6206461,119,16,0.48213,251,6268516,-1,784.0,6697734,6697853,491273,119,196,12,True,True,3.0518158222222223,-0.48213
7811,6207230,21,4,0.335105,251,6268516,-1,64.0,12710308,12710329,6503078,21,27,6,True,True,0.10649333333333334,-0.335105
7812,6207482,681,8,0.608533,251,6268516,-1,96.0,13026808,13027489,6819326,681,18,6,True,True,1.7255632,-0.608533
7813,6207629,10100,64,0.585037,251,6268516,-1,1792.0,12883108,12893208,6675479,10100,27,12,True,True,1367.4127786666666,-0.5821235791730824
7814,6207858,109,32,0.382371,251,6268516,-1,1376.0,10159064,10159173,3951206,109,108,8,True,True,4.321622311111111,-0.382371
7815,6207901,27,32,0.640592,251,6268516,-1,1312.0,12972502,12972529,6764601,27,24,11,True,True,1.8402768,-0.640592
7816,6208349,196,1,0.232425,251,6268516,-1,13.0,11032489,11032685,4824140,196,79,10,True,True,0.13251015555555554,-0.23242499999999994
7817,6210331,11382,10,0.587469,251,6268516,-1,470.0,9482061,9493443,3271730,11382,134,7,True,True,222.20220941666668,-0.5413227510243831
7818,6210539,12,2,0.988381,251,6268516,-1,94.0,10265987,10265999,4055448,12,109,0,True,True,0.04917140000000001,-0.988381
7819,6210662,20824,32,0.232606,251,6268516,-1,1376.0,10159173,10179997,3948511,20824,111,1,True,True,1232.977852888889,-0.2295648877517593
7820,6210840,189,3,0.616349,251,6268516,-1,114.0,12198565,12198754,5987725,189,47,7,True,True,1.0849608,-0.616349
7821,6210850,9410,4,0.896779,251,6268516,-1,88.0,8014836,8024246,1803986,9410,175,0,True,True,35.2046068,-0.8941775074679802
7822,6211134,23,4,0.308849,251,6268516,-1,84.0,7573534,7573557,1362400,23,187,11,True,True,0.044607733333333344,-0.308849
7823,6211443,21,5,0.737913,251,6268516,-1,95.0,9795561,9795582,3584118,21,129,9,True,True,0.08397841666666667,-0.737913
7824,6212544,5,2,0.757246,251,6268516,-1,96.0,13366661,13366666,7154117,5,6,1,True,True,0.021764,-0.757246
7825,6214784,7,16,0.619766,251,6268516,-1,560.0,6785934,6785941,571150,7,209,12,True,True,0.16056755555555557,-0.619766
7826,6214847,161,4,0.059923,251,6268516,-1,84.0,12354865,12355026,6140018,161,46,10,True,True,0.46180703333333334,-0.059923
7827,6219088,11,1,0.374524,251,6268516,-1,41.0,9425203,9425214,3206115,11,144,6,True,True,0.017667925,-0.374524
7828,6223783,10,4,0.296615,251,6268516,-1,136.0,7926636,7926646,1702853,10,182,1,True,True,0.0639577777777778,-0.296615
7829,6224187,10232,4,0.151671,251,6268516,-1,152.0,6406316,6416548,182129,10232,222,11,True,True,49.671186577777775,-0.14881420228040088
7830,6225090,18531,100,0.204385,251,6268516,-1,3900.0,10265987,10284518,4040897,18531,113,8,True,True,2457.2515608333333,-0.1851728854951265
7831,6225413,11946,113,0.037907,251,6268516,-1,2599.0,13521366,13533312,7295953,11946,2,11,True,True,1222.774574466667,-0.03306547260736125
7832,6226281,9339,64,0.923409,251,6268516,-1,2432.0,7617734,7627073,1391453,9339,194,11,True,True,617.0987267555555,-0.9222509319359264
7833,6226847,91,1,0.598075,251,6268516,-1,42.0,8349536,8349627,2122689,91,174,12,True,True,0.14398323333333335,-0.598075
7834,6232781,8,8,0.945876,251,6268516,-1,192.0,9085292,9085300,2852511,8,155,11,True,True,0.05393066666666667,-0.945876
7835,6234484,38,64,0.739256,251,6268516,-1,2368.0,12023965,12024003,5789481,38,53,10,True,True,5.377649066666667,-0.6883348415859174
7836,6234645,5418,32,0.32869,251,6268516,-1,416.0,6562616,6568034,327971,5418,225,12,True,True,62.629047288888884,-0.3249476547864502
7837,6234774,319,4,0.278126,251,6268516,-1,108.0,12399065,12399384,6164291,319,47,11,True,True,0.2685342,-0.278126
7838,6235408,28813,1,0.643602,251,6268516,-1,19.0,10897389,10926202,4661981,28813,90,8,True,True,13.051298655555554,-0.6395813996307034
7839,6237416,7,8,0.760494,251,6268516,-1,168.0,11702089,11702096,5464673,7,66,12,True,True,0.05520013333333333,-0.760494
7840,6237461,1018,1,0.520873,251,6268516,-1,17.0,12709408,12710426,6471947,1018,33,11,True,True,1.3712601388888892,-0.520873
7841,6237706,12201,1,0.977568,251,6268516,-1,29.0,8857492,8869693,2619786,12201,165,11,True,True,7.6454321583333344,-0.9730882520799802
7842,6237799,10444,14,0.648046,251,6268516,-1,378.0,13340061,13350505,7102262,10444,10,10,True,True,168.30998835000003,-0.5937826343173156
7843,6237848,14170,2,0.288455,251,6268516,-1,92.0,9883761,9897931,3645913,14170,138,12,True,True,51.996940011111114,-0.2816887493170145
7844,6239963,212,2,0.023693,251,6268516,-1,66.0,12242765,12242977,6002802,212,53,11,True,True,0.3776674,-0.023693
7845,6240057,14,1,0.846935,251,6268516,-1,45.0,13523166,13523180,7283109,14,2,7,True,True,0.02142175,-0.846935
7846,6240278,19618,2,0.33127,251,6268516,-1,44.0,8123336,8142954,1883058,19618,192,12,True,True,36.08519542222222,-0.321559161368192
7847,6241516,23,1,0.242249,251,6268516,-1,5.0,8724892,8724915,2483376,23,173,7,True,True,0.0018112500000000004,-0.24224900000000005
7848,6242557,54,4,0.539312,251,6268516,-1,72.0,10844927,10844981,4602370,54,100,10,True,True,0.04358879999999999,-0.539312
7849,6242604,9233,64,0.906632,251,6268516,-1,832.0,6606834,6616067,364230,9233,235,1,True,True,288.2671653333333,-0.8906598873126649
7850,6242942,14832,119,0.665006,251,6268516,-1,4879.0,9223103,9237935,2980161,14832,162,1,True,True,1874.8280947277776,-0.6010716898070484
7851,6244121,9,64,0.248338,251,6268516,-1,2944.0,9420703,9420712,3176582,9,158,6,True,True,0.927728,-0.248338
7852,6244172,10,8,0.68735,251,6268516,-1,104.0,10332287,10332297,4088115,10,120,10,True,True,0.016957777777777776,-0.68735
7853,6244213,24,1,0.719502,251,6268516,-1,12.0,7190334,7190358,946121,24,225,11,True,True,0.008094400000000002,-0.719502
7854,6244275,3,8,0.608063,251,6268516,-1,48.0,9428803,9428806,3184528,3,157,8,True,True,0.0058976,-0.608063
4420,3599033,10,8,0.121962,1,3599033,-1,256.0,3606233,3606243,7200,10,0,9,True,True,0.06100622222222223,-0.121962
4421,3601659,10,1,0.768146,18,3606233,-1,19.0,3608033,3608043,6374,10,0,7,True,True,0.005055583333333334,-0.7681460000000002
4422,3601907,6031,4,0.248962,18,3606233,-1,172.0,8541141,8547172,4939234,6031,0,10,True,True,36.58201111111111,-0.2391912437184025
4423,3601977,9968,128,0.771225,18,3606233,-1,768.0,5092976,5102944,1490999,9968,1,10,True,True,174.90885973333334,-0.7639922240635866
4424,3602335,9031,2,0.442961,18,3606233,-1,24.0,10362181,10371212,6759846,9031,0,10,True,True,5.998368599999999,-0.4384321624820903
4425,3602647,10350,1,0.737619,18,3606233,-1,18.0,10106124,10116474,6503477,10350,1,0,True,True,5.6483384999999995,-0.7307182788286084
4426,3602663,886,8,0.03351,18,3606233,-1,184.0,5992275,5993161,2389612,886,3,11,True,True,3.186213511111111,-0.03351
4427,3604547,6,6,0.460835,18,3606233,-1,132.0,4748673,4748679,1144126,6,5,1,True,True,0.020955000000000005,-0.460835
4428,3604641,1145,32,0.770996,18,3606233,-1,512.0,3611643,3612788,7002,1145,6,8,True,True,16.870684444444443,-0.770996
4429,3604922,15,1,0.521139,18,3606233,-1,22.0,4250561,4250576,645639,15,6,1,True,True,0.004321166666666666,-0.521139
4430,3604995,7,4,0.982116,18,3606233,-1,104.0,5945375,5945382,2340380,7,4,8,True,True,0.018723755555555555,-0.982116
4431,3605014,40369,50,0.472826,18,3606233,-1,1400.0,10386081,10426450,6781067,40369,0,7,True,True,3145.2632322222216,-0.4461368979947085
4432,3605223,9932,1,0.681442,18,3606233,-1,42.0,4837676,4847608,1232453,9932,7,10,True,True,6.8996984,-0.6316831955767983
4433,3605492,4812,256,0.312109,18,3606233,-1,8704.0,7066763,7071575,3461271,4812,4,8,True,True,1378.5687992888888,-0.3080887660400163
4434,3605570,579,4,0.323063,18,3606233,-1,200.0,10292281,10292860,6686711,579,2,0,True,True,2.2860477777777777,-0.2984106260980787
4435,3605841,241,2,0.629164,18,3606233,-1,32.0,3612788,3613029,6947,241,12,1,True,True,0.22193422222222223,-0.629164
4436,3605933,11431,2,0.042186,18,3606233,-1,66.0,6469998,6481429,2864065,11431,6,12,True,True,20.5103041,-0.0417070310309286
4437,3606018,184,16,0.937421,18,3606233,-1,672.0,3656988,3657172,50970,184,13,11,True,True,3.5559104000000006,-0.937421
4438,3606157,43,1,0.520926,18,3606233,-1,44.0,3928288,3928331,322131,43,13,11,True,True,0.05647094444444445,-0.520926
4439,3607787,11,8,0.253313,21,3608033,-1,120.0,7468365,7468376,3860578,11,5,12,True,True,0.097669,-0.253313
4440,3607835,3669,32,0.63852,21,3608033,-1,1472.0,10158081,10161750,6550246,3669,3,2,True,True,225.99746026666668,-0.6382048761178645
4441,3607893,10395,32,0.198724,21,3608033,-1,864.0,3608043,3618438,150,10395,19,1,True,True,249.8442696,-0.19824272972207568
4442,3607918,131,4,0.88752,21,3608033,-1,148.0,9556041,9556172,5948123,131,5,10,True,True,0.4657428444444444,-0.88752
4443,3608069,9617,128,0.863658,25,3611643,-1,3200.0,7156063,7165680,3547994,9617,8,6,True,True,609.5271555555556,-0.8027925870846512
4444,3608142,45,4,0.217788,25,3611643,-1,76.0,5941775,5941820,2333633,45,13,12,True,True,0.0866305,-0.217788
4445,3609215,18897,5,0.112928,25,3611643,-1,55.0,4435324,4454221,826109,18897,17,6,True,True,58.57951152777777,-0.1123890571271179
4446,3609235,6,16,0.632909,25,3611643,-1,752.0,5291689,5291695,1682454,6,14,11,True,True,0.09387466666666669,-0.632909
4447,3609295,102,1,0.324513,25,3611643,-1,41.0,7907627,7907729,4298332,102,7,0,True,True,0.17691021666666668,-0.324513
4448,3609324,52,1,0.16736,25,3611643,-1,27.0,5563923,5563975,1954599,52,15,1,True,True,0.031835699999999995,-0.16736
4449,3612264,97,32,0.2761,25,3612788,-1,192.0,7295565,7295662,3683301,97,9,1,True,True,0.36451306666666666,-0.2761
4450,3612998,3,8,0.11965,53,3656988,-1,360.0,9059841,9059844,5446843,3,6,10,True,True,0.05448300000000001,-0.11965
4451,3613280,117,16,0.789144,53,3656988,-1,512.0,8726741,8726858,5113461,117,7,11,True,True,2.7565824,-0.789144
4452,3613362,13488,8,0.00893,53,3656988,-1,368.0,4745068,4758556,1131706,13488,23,12,True,True,120.31956266666667,-0.008923417057393438
4453,3614472,25974,8,0.041993,53,3656988,-1,256.0,5788175,5814149,2173703,25974,18,12,True,True,231.34752426666665,-0.04053746684477925
4454,3614510,5239,4,0.783475,53,3656988,-1,124.0,9223341,9228580,5608831,5239,6,9,True,True,27.76426408888889,-0.783207844714716
4455,3614555,18,32,0.475271,53,3656988,-1,1504.0,6565398,6565416,2950843,18,15,1,True,True,0.7665888,-0.47527099999999994
4456,3614578,139,1,0.596212,53,3656988,-1,42.0,8176241,8176380,4561663,139,10,2,True,True,0.24994748333333333,-0.596212
4457,3614804,416,16,0.371399,53,3656988,-1,160.0,4770773,4771189,1155969,416,26,10,True,True,1.5184924444444443,-0.371399
4458,3615033,9,8,0.08948,53,3656988,-1,40.0,5069076,5069085,1454043,9,25,1,True,True,0.010746,-0.08948
4459,3615173,17,14,0.157698,53,3656988,-1,700.0,5947175,5947192,2332002,17,19,7,True,True,0.3060613888888889,-0.157698
4460,3615213,396,1,0.091402,53,3656988,-1,26.0,10131481,10131877,6516268,396,4,2,True,True,0.3536104,-0.091402
4461,3615711,16582,256,0.618645,53,3656988,-1,6912.0,10560881,10577463,6945170,16582,0,12,True,True,4425.393945600001,-0.5459191820416518
4462,3615813,15389,16,0.930849,53,3656988,-1,336.0,6791435,6806824,3175622,15389,18,12,True,True,137.80535813333336,-0.9301108509721745
4463,3615840,28,1,0.996973,53,3656988,-1,35.0,3701188,3701216,85348,28,37,11,True,True,0.02731477777777778,-0.996973
4464,3615880,7607,32,0.625132,53,3656988,-1,1600.0,4187388,4194995,571508,7607,36,7,True,True,247.40455555555556,-0.610951040950186
4465,3615923,14759,32,0.059775,53,3656988,-1,832.0,7652165,7666924,4036242,14759,14,1,True,True,442.55329848888886,-0.0593553050247105
4466,3615992,10,32,0.644575,53,3656988,-1,640.0,4390161,4390171,774169,10,36,12,True,True,0.19267555555555554,-0.6445749999999999
4467,3627860,12820,256,0.701328,53,3656988,-1,4864.0,7032933,7045753,3405073,12820,19,1,True,True,2821.9407189333333,-0.6701696931904797
4468,3628129,6,4,0.791466,53,3656988,-1,140.0,8671741,8671747,5043612,6,11,12,True,True,0.05934600000000001,-0.791466
4469,3628218,19,32,0.125827,53,3656988,-1,1600.0,5357996,5358015,1729778,19,30,1,True,True,0.4911288888888889,-0.125827
4470,3628580,26,4,0.232675,53,3656988,-1,172.0,5698175,5698201,2069595,26,29,11,True,True,0.10685595555555553,-0.232675
4471,3628688,27,16,0.981676,53,3656988,-1,512.0,5563896,5563923,1935208,27,31,7,True,True,0.3134592,-0.981676
4472,3628874,34,4,0.788562,53,3656988,-1,24.0,5811175,5811209,2182301,34,28,6,True,True,0.030960400000000003,-0.788562
4473,3628952,22,8,0.756698,53,3656988,-1,400.0,8175127,8175149,4546175,22,14,7,True,True,0.3940444444444445,-0.756698
4474,3628991,27,1,0.805525,53,3656988,-1,30.0,4301961,4301988,672970,27,44,11,True,True,0.0158265,-0.805525
4475,3641283,24,10,0.438719,53,3656988,-1,310.0,4544768,4544792,903485,24,42,6,True,True,0.19143533333333332,-0.438719
4476,3641363,6696,4,0.192965,53,3656988,-1,136.0,6190798,6197494,2549435,6696,25,12,True,True,25.407199644444443,-0.18026399967307902
4477,3643034,67,1,0.68925,53,3656988,-1,50.0,10292281,10292348,6649247,67,4,0,True,True,0.07159694444444445,-0.68925
4478,3643821,17,8,0.358167,53,3656988,-1,304.0,4159888,4159905,516067,17,50,9,True,True,0.05379026666666667,-0.358167
4479,3659990,2,4,0.134732,212,3701188,-1,120.0,10585563,10585565,6925573,2,0,6,True,True,0.011954000000000001,-0.134732
4480,3660044,204,25,0.898663,212,3701188,-1,425.0,6944141,6944345,3284097,204,24,1,True,True,3.8571866666666663,-0.898663
4481,3660260,7004,128,0.485302,212,3701188,-1,2176.0,7836865,7843869,4176605,7004,18,6,True,True,1181.7043505777779,-0.4825532497471825
4482,3660679,5,16,0.4375,212,3701188,-1,368.0,5247489,5247494,1586810,5,41,10,True,True,0.044936888888888894,-0.4375
4483,3660746,5,1,0.294715,212,3701188,-1,13.0,4979076,4979081,1318330,5,44,9,True,True,0.0015312916666666667,-0.294715
4484,3660784,140,34,0.697038,212,3701188,-1,1360.0,10122274,10122414,6461490,140,8,7,True,True,5.3597600000000005,-0.697038
4485,3660860,9450,32,0.189776,212,3701188,-1,1088.0,6660835,6670285,2999975,9450,28,1,True,True,254.27682755555557,-0.1895451167028735
4486,3661028,773,1,0.186627,212,3701188,-1,37.0,7862565,7863338,4201537,773,19,0,True,True,1.2728239472222225,-0.186627
4487,3661037,3,2,0.347665,212,3701188,-1,30.0,5488596,5488599,1827559,3,42,11,True,True,0.002732,-0.347665
4488,3661057,9,16,0.732402,212,3701188,-1,192.0,8901541,8901550,5240484,9,13,11,True,True,0.0451632,-0.732402
4489,3661097,2714,1,0.275324,212,3701188,-1,42.0,10589163,10591877,6928066,2714,0,2,True,True,5.6961384666666675,-0.24237807585992144
4490,3661187,11,16,0.83135,212,3701188,-1,96.0,9511841,9511852,5850654,11,12,12,True,True,0.01911066666666667,-0.83135
4491,3661202,4,6,0.914474,212,3701188,-1,210.0,6104398,6104402,2443196,4,36,1,True,True,0.024084666666666667,-0.914474
4492,3661241,8,1,0.55452,212,3701188,-1,27.0,5567575,5567583,1906334,8,44,1,True,True,0.0059562,-0.55452
4493,3661274,20842,1,0.068877,212,3701188,-1,13.0,7862565,7883407,4201291,20842,22,0,True,True,11.443257402777778,-0.06881927276608214
4494,3661337,35594,16,0.155025,212,3701188,-1,656.0,5562096,5597690,1900759,35594,48,10,True,True,761.8279463111112,-0.15501222161229344
4495,3661440,101,8,0.295673,212,3701188,-1,368.0,6971867,6971968,3310427,101,31,1,True,True,1.479079911111111,-0.295673
4496,3661501,63,1,0.263349,212,3701188,-1,42.0,4434361,4434424,772860,63,63,11,True,True,0.1259643,-0.263349
4497,3662111,8148,64,0.367113,212,3701188,-1,832.0,6383598,6391746,2721487,8148,37,8,True,True,83.53361813333333,-0.3592682774611915
4498,3662159,5579,4,0.00072,212,3701188,-1,136.0,8310441,8316020,4648282,5579,19,8,True,True,23.50516748888889,-0.0007197427323801252
4499,3662220,11570,1,0.638026,212,3701188,-1,10.0,4161688,4173258,499468,11570,70,7,True,True,1.8312602222222223,-0.5299902543053637
4500,3663788,609,1,0.379044,212,3701188,-1,5.0,5138989,5139598,1475201,609,56,11,True,True,0.08953991666666666,-0.37904399999999994
4501,3663875,76,8,0.185534,212,3701188,-1,240.0,9931147,9931223,6267272,76,11,11,True,True,0.8320986666666665,-0.185534
4502,3663967,14665,10,0.01872,212,3701188,-1,460.0,10584663,10599328,6920696,14665,2,9,True,True,363.93748827777785,-0.01785851081897843
4503,3664153,27,2,0.856829,212,3701188,-1,40.0,5855375,5855402,2191222,27,47,11,True,True,0.074997,-0.856829
4504,3664169,5448,2,0.776017,212,3701188,-1,56.0,4163488,4168936,499319,5448,74,7,True,True,3.7832990222222223,-0.5147195579971479
4505,3664201,8450,4,0.238787,212,3701188,-1,48.0,9734247,9742697,6070046,8450,13,12,True,True,14.784164666666669,-0.23518374225224628
4506,3664343,84,16,0.721004,212,3701188,-1,144.0,8451841,8451925,4787498,84,22,12,True,True,0.5299391999999999,-0.721004
4507,3664361,91,1,0.658289,212,3701188,-1,18.0,7863427,7863518,4199066,91,27,1,True,True,0.07289554999999999,-0.658289
4508,3664393,22,2,0.538957,212,3701188,-1,80.0,3972488,3972510,308095,22,80,11,True,True,0.047192444444444454,-0.538957
4509,3664433,6,13,0.387491,212,3701188,-1,65.0,4064488,4064494,400055,6,80,8,True,True,0.010575500000000002,-0.387491
4510,3664610,111,4,0.52407,212,3701188,-1,188.0,4152688,4152799,488078,111,80,12,True,True,0.23899656666666666,-0.5240699999999999
4511,3664644,4,32,0.497549,212,3701188,-1,1600.0,9557841,9557845,5893197,4,14,7,True,True,0.15374222222222222,-0.497549
4512,3664668,188,32,0.551468,212,3701188,-1,160.0,4655068,4655256,990400,188,71,12,True,True,0.39989688888888897,-0.551468
4513,3664712,4,8,0.613039,212,3701188,-1,64.0,10474481,10474485,6809769,4,4,11,True,True,0.008470755555555555,-0.613039
4514,3664784,6124,1,0.3226,212,3701188,-1,32.0,9533941,9540065,5869157,6124,17,10,True,True,5.151924266666667,-0.32064107331775266
4515,3664816,16150,121,0.640904,212,3701188,-1,1815.0,10106124,10122274,6441308,16150,13,2,True,True,867.4361134999999,-0.6359721045574515
4516,3665011,232,32,0.110464,212,3701188,-1,992.0,8361841,8362073,4696830,232,27,9,True,True,10.608359822222221,-0.110464
4517,3665100,33,4,0.523201,212,3701188,-1,104.0,8519041,8519074,4853941,33,26,6,True,True,0.14929199999999998,-0.523201
4518,3665246,165,101,0.06668,212,3701188,-1,4242.0,5701775,5701940,2036529,165,59,8,True,True,16.001177499999997,-0.06668
4519,3665281,7,64,0.835193,212,3701188,-1,2880.0,3704788,3704795,39507,7,92,8,True,True,0.5205759999999999,-0.835193
4520,3665449,6317,8,0.129774,212,3701188,-1,104.0,9081941,9088258,5416492,6317,21,10,True,True,26.11840631111111,-0.1233913755892229
4521,3665460,328,4,0.873493,212,3701188,-1,88.0,5070876,5071204,1405416,328,72,7,True,True,0.8615904,-0.8734930000000002
4522,3665924,9014,74,0.202079,212,3701188,-1,2220.0,10430281,10439295,6764357,9014,5,11,True,True,1779.1234290000002,-0.19857312965236182
4523,3665959,15066,4,0.48537,212,3701188,-1,128.0,7017867,7032933,3351908,15066,45,11,True,True,55.448982400000006,-0.4821092436315866
4524,3665973,7608,3,0.098754,212,3701188,-1,15.0,6922035,6929643,3256062,7608,48,12,True,True,3.5848195,-0.0971454904765851
4525,3666177,10056,113,0.571012,212,3701188,-1,1921.0,3749888,3759944,83711,10056,97,6,True,True,448.3765545555556,-0.5547770149791064
4526,3666436,7,1,0.8363,212,3701188,-1,10.0,6574398,6574405,2907962,7,51,9,True,True,0.0017091666666666668,-0.8363
4527,3667058,8,8,0.657921,212,3701188,-1,48.0,7056553,7056561,3389495,8,44,9,True,True,0.0117344,-0.657921
4528,3667074,37,8,0.525821,212,3701188,-1,136.0,6660798,6660835,2993724,37,52,12,True,True,0.12138302222222225,-0.525821
4529,3668186,12,8,0.701314,212,3701188,-1,72.0,7381965,7381977,3713779,12,41,12,True,True,0.018024,-0.701314
4530,3668196,39839,1,0.255939,212,3701188,-1,44.0,5653975,5693814,1985779,39839,69,12,True,True,39.83532006666666,-0.25208436518364336
4531,3668426,38,4,0.366354,212,3701188,-1,24.0,6945041,6945079,3276615,38,49,6,True,True,0.037533866666666665,-0.366354
4532,3668615,13,64,0.605954,212,3701188,-1,640.0,6949541,6949554,3280926,13,49,8,True,True,0.33804622222222225,-0.605954
4533,3668830,23991,4,0.070874,212,3701188,-1,92.0,10292281,10316272,6623451,23991,10,12,True,True,57.41906504444444,-0.06765219520234232
4534,3668847,12081,256,0.930211,212,3701188,-1,12288.0,8041827,8053908,4372980,12081,35,11,True,True,6821.429043199999,-0.9185365008184877
4535,3668865,5,1,0.208738,212,3701188,-1,33.0,4748668,4748673,1079803,5,90,1,True,True,0.004365625000000001,-0.208738
4536,3669374,4541,184,0.491406,212,3701188,-1,4048.0,10340081,10344622,6670707,4541,8,11,True,True,866.1487833777778,-0.48874520830052554
4537,3669407,7819,4,0.889767,212,3701188,-1,96.0,7997627,8005446,4328220,7819,37,1,True,True,41.065905066666666,-0.8650381726084326
4538,3669434,2,4,0.079957,212,3701188,-1,112.0,4568668,4568670,899234,2,95,7,True,True,0.005050577777777778,-0.079957
4539,3669546,5723,2,0.80102,212,3701188,-1,38.0,7696365,7702088,4026819,5723,43,11,True,True,4.4178355611111115,-0.7799854371760596
4540,3669588,33704,64,0.0607,212,3701188,-1,1024.0,3748988,3782692,79400,33704,112,11,True,True,826.5315783111112,-0.06007370240319949
4541,3669597,10,1,0.55802,212,3701188,-1,26.0,10386081,10386091,6716484,10,6,0,True,True,0.00877211111111111,-0.55802
4542,3670045,612,43,0.938244,212,3701188,-1,430.0,7749565,7750177,4079520,612,44,9,True,True,8.361909,-0.938244
4543,3670118,3,16,0.415953,212,3701188,-1,96.0,5313789,5313792,1643671,3,85,10,True,True,0.005883200000000001,-0.415953
4544,3670126,12,8,0.369069,212,3701188,-1,120.0,10205881,10205893,6535755,12,13,8,True,True,0.044936000000000004,-0.369069
4545,3670158,26577,128,0.708434,212,3701188,-1,4352.0,10101924,10128501,6431766,26577,19,6,True,True,3530.6347456000003,-0.7015373528315271
4546,3670351,9,2,0.823643,212,3701188,-1,70.0,6835635,6835644,3165284,9,62,11,True,True,0.018819500000000003,-0.823643
4547,3670440,3747,1,0.265816,212,3701188,-1,30.0,6473598,6477345,2803158,3747,68,8,True,True,3.0178665,-0.2622846905781858
4548,3672786,28250,128,0.040653,212,3701188,-1,4224.0,7652165,7680415,3979379,28250,48,0,True,True,4139.394042666666,-0.039816784277900724
4549,3672822,13457,128,0.070388,212,3701188,-1,3072.0,8585341,8598798,4912519,13457,32,11,True,True,1093.0630314666666,-0.06946189935816274
4550,3673201,21313,16,0.303905,212,3701188,-1,144.0,5539996,5561309,1866795,21313,89,8,True,True,47.824921999999994,-0.2990157367894664
4551,3673565,89,1,0.944603,212,3701188,-1,12.0,7863338,7863427,4189773,89,44,1,True,True,0.047528966666666665,-0.944603
4552,3673625,16711,4,0.960587,212,3701188,-1,68.0,10153581,10170292,6479956,16711,15,10,True,True,46.453026433333335,-0.9603193046313194
4553,3673741,75,2,0.097119,212,3701188,-1,16.0,10131274,10131349,6457533,75,17,8,True,True,0.04121333333333333,-0.097119
4554,3673762,201,1,0.725172,212,3701188,-1,41.0,6971666,6971867,3297904,201,63,1,True,True,0.3279460166666667,-0.725172
4555,3673920,5,1,0.531661,212,3701188,-1,25.0,5563923,5563928,1890003,5,90,0,True,True,0.0028343749999999997,-0.531661
4556,3674946,25,1,0.18946,212,3701188,-1,24.0,6971641,6971666,3296695,25,64,10,True,True,0.023876666666666664,-0.18946
4557,3674980,12598,32,0.526192,212,3701188,-1,1440.0,10131481,10144079,6456501,12598,16,0,True,True,699.38364,-0.5229101290938821
4558,3675045,21116,45,0.248763,212,3701188,-1,1215.0,8473941,8495057,4798896,21116,38,10,True,True,528.305601375,-0.23252333403408004
4559,3675284,288,3,0.625325,212,3701188,-1,105.0,4881876,4882164,1206592,288,108,11,True,True,0.6903959999999999,-0.625325
4560,3675406,1649,5,0.178898,212,3701188,-1,220.0,3794088,3795737,118682,1649,130,11,True,True,9.240070888888889,-0.1774516394006674
4561,3675425,101,1,0.749194,212,3701188,-1,6.0,9425441,9425542,5750016,101,29,9,True,True,0.013523900000000002,-0.7491940000000001
4562,3675572,12,2,0.415185,212,3701188,-1,28.0,6335798,6335810,2660226,12,81,9,True,True,0.009509733333333334,-0.415185
4563,3675590,8667,16,0.105514,212,3701188,-1,400.0,5065476,5074143,1389886,8667,109,12,True,True,105.96837000000001,-0.10309767135814395
4564,3675622,29,12,0.638624,212,3701188,-1,216.0,8945741,8945770,5270119,29,33,11,True,True,0.3117906,-0.638624
4565,3675637,7754,128,0.357963,212,3701188,-1,1920.0,8678941,8686695,5003304,7754,36,9,True,True,1228.3880799999997,-0.34789241635928086
4566,3675654,189,32,0.458721,212,3701188,-1,320.0,6475398,6475587,2799744,189,80,7,True,True,1.649592,-0.458721
4567,3675688,10761,1,0.665242,212,3701188,-1,46.0,7155163,7165924,3479475,10761,63,11,True,True,9.91513095,-0.6284707098417394
4568,3675741,8744,4,0.882824,212,3701188,-1,196.0,7862565,7871309,4186824,8744,54,10,True,True,74.51433212222223,-0.8817649972351229
4569,3675872,9308,1,0.166809,212,3701188,-1,44.0,7648565,7657873,3972693,9308,60,11,True,True,14.489557133333332,-0.1631106747963723
4570,3675903,11829,72,0.180397,212,3701188,-1,2232.0,6277198,6289027,2601295,11829,88,12,True,True,945.3359790000001,-0.17585835445294357
4571,3676012,238,1,0.401557,212,3701188,-1,35.0,10042097,10042335,6366085,238,23,11,True,True,0.38630374999999995,-0.401557
4572,3676024,33,8,0.337513,212,3701188,-1,360.0,7295532,7295565,3619508,33,65,7,True,True,0.23251799999999997,-0.337513
4573,3676082,23,5,0.158176,212,3701188,-1,70.0,6104375,6104398,2428293,23,93,10,True,True,0.04616227777777778,-0.158176
4574,3676130,45,1,0.998434,212,3701188,-1,50.0,5094789,5094834,1418659,45,116,1,True,True,0.052493750000000006,-0.9984340000000003
4575,3676133,2356,2,0.443012,212,3701188,-1,18.0,10577463,10579819,6901330,2356,3,0,True,True,2.0712774,-0.443012
4576,3676184,230,8,0.352324,212,3701188,-1,128.0,6945941,6946171,3269757,230,77,6,True,True,1.2116195555555553,-0.352324
4577,3677867,53,45,0.315155,212,3701188,-1,1710.0,4566868,4566921,889001,53,132,10,True,True,2.197274,-0.315155
4578,3677893,32,1,0.991463,212,3701188,-1,33.0,7907627,7907659,4229734,32,52,11,True,True,0.04467173333333333,-0.991463
4579,3677973,1043,1,0.324654,212,3701188,-1,43.0,8993541,8994584,5315568,1043,35,0,True,True,1.268603797222222,-0.324654
4580,3677995,13208,38,0.37172,212,3701188,-1,608.0,9418241,9431449,5740246,13208,32,12,True,True,192.28780942222224,-0.3676907509982079
4581,3678079,1889,4,0.764184,212,3701188,-1,168.0,5492196,5494085,1814117,1889,115,8,True,True,9.0264062,-0.7487144712085272
4582,3678090,14913,128,0.430588,212,3701188,-1,1792.0,4521768,4536681,843678,14913,138,1,True,True,703.3600149333333,-0.4289402774139172
4583,3678108,13165,16,0.725868,212,3701188,-1,128.0,7049353,7062518,3371245,13165,74,1,True,True,52.26872106666667,-0.7240928748149482
4584,3678125,7,4,0.608413,212,3701188,-1,108.0,5357989,5357996,1679864,7,119,11,True,True,0.012213599999999998,-0.608413
4585,3678176,6,37,0.563145,212,3701188,-1,1295.0,9647847,9647853,5969671,6,27,1,True,True,0.29765575,-0.563145
4586,3678377,8869,256,0.213928,212,3701188,-1,9472.0,7286663,7295532,3608286,8869,71,11,True,True,2042.0267768888887,-0.21192223080484626
4587,3678440,12027,210,0.765708,212,3701188,-1,5250.0,10089897,10101924,6411457,12027,24,8,True,True,2251.43515625,-0.7272070473743875
4588,3679211,14,64,0.926147,212,3701188,-1,2176.0,9997897,9997911,6318686,14,26,1,True,True,2.5052408888888893,-0.926147
4589,3679280,44,128,0.254089,212,3701188,-1,5632.0,6078675,6078719,2399395,44,104,12,True,True,3.925691733333333,-0.254089
4590,3679312,4,1,0.961652,212,3701188,-1,31.0,9886947,9886951,6207635,4,28,12,True,True,0.005532466666666667,-0.961652
4591,3679372,7906,32,0.4475,212,3701188,-1,992.0,4771376,4779282,1092004,7906,138,1,True,True,191.91626044444445,-0.43529893492631994
4592,3680172,1984,32,0.397091,212,3701188,-1,1024.0,8306841,8308825,4626669,1984,53,12,True,True,58.62370133333334,-0.3743535641262691
4593,3680281,13,14,0.726313,212,3701188,-1,574.0,5094776,5094789,1414495,13,132,7,True,True,0.17409260555555553,-0.7263130000000001
4594,3680922,11742,86,0.982956,212,3701188,-1,602.0,9085541,9097283,5404619,11742,38,8,True,True,261.7091706833333,-0.9323153731775923
4595,3681024,1300,8,0.595763,212,3701188,-1,168.0,7696365,7697665,4015341,1300,68,0,True,True,4.219021333333334,-0.5693544782697859
4596,3681070,19,1,0.517609,212,3701188,-1,28.0,7840465,7840484,4159395,19,66,1,True,True,0.04056204444444445,-0.517609
4597,3681095,23,32,0.993412,212,3701188,-1,288.0,5536396,5536419,1855301,23,126,11,True,True,0.1001696,-0.993412
4598,3681213,5,32,0.301842,212,3701188,-1,1408.0,4971876,4971881,1290663,5,142,12,True,True,0.1398808888888889,-0.301842
4599,3681391,13,8,0.300334,212,3701188,-1,264.0,9037741,9037754,5356350,13,41,11,True,True,0.16263866666666668,-0.300334
4600,3681904,3459,4,0.221887,212,3701188,-1,156.0,6284398,6287857,2602494,3459,106,8,True,True,18.393847766666667,-0.2113889133894922
4601,3682096,13849,4,0.85572,212,3701188,-1,152.0,7835965,7849814,4153869,13849,69,12,True,True,150.53667235555554,-0.8334163498479334
4602,3682167,19827,32,0.021701,212,3701188,-1,352.0,10086297,10106124,6404130,19827,25,11,True,True,256.8859538666667,-0.020416335120146904
4603,3682283,6,1,0.82194,212,3701188,-1,19.0,10202281,10202287,6519998,6,15,11,True,True,0.0035710499999999997,-0.82194
4604,3682525,22,32,0.689719,212,3701188,-1,1248.0,4060888,4060910,378363,22,171,11,True,True,0.7112629333333335,-0.689719
4605,3682574,13,1,0.275957,212,3701188,-1,35.0,6280798,6280811,2598224,13,110,8,True,True,0.017142124999999998,-0.275957
4606,3682589,3,4,0.553663,212,3701188,-1,56.0,10127674,10127677,6445085,3,21,8,True,True,0.005211266666666667,-0.553663
4607,3683826,2914,1,0.556323,212,3701188,-1,29.0,8173327,8176241,4489501,2914,61,6,True,True,3.747484158333333,-0.5509557741109277
4608,3685104,2,1,0.925922,212,3701188,-1,14.0,9557845,9557847,5872741,2,34,1,True,True,0.0006726222222222222,-0.925922
4609,3688341,561,1,0.154715,212,3701188,-1,38.0,4885476,4886037,1197135,561,152,8,True,True,0.4867017833333333,-0.154715
4610,3688365,19295,64,0.037736,212,3701188,-1,2112.0,7994027,8013322,4305662,19295,65,12,True,True,2185.1972736,-0.037328564962903356
4611,3688398,12603,8,0.355656,212,3701188,-1,128.0,4060888,4073491,372490,12603,177,0,True,True,41.211772800000006,-0.35513130952665495
4612,3688772,56,1,0.138408,212,3701188,-1,42.0,7110963,7111019,3422191,56,89,11,True,True,0.04508,-0.138408
4613,3688871,53,8,0.367083,212,3701188,-1,160.0,6945041,6945094,3256170,53,100,0,True,True,0.3489991111111111,-0.367083
4614,3688977,11,8,0.582156,212,3701188,-1,112.0,8220441,8220452,4531464,11,60,11,True,True,0.08362884444444445,-0.582156
4615,3689104,7367,16,0.232994,212,3701188,-1,768.0,4066288,4073655,377184,7367,179,7,True,True,141.1540032,-0.22591299732481793
4616,3689453,19,1,0.811074,212,3701188,-1,11.0,6082275,6082294,2392822,19,122,8,True,True,0.003172736111111111,-0.8110739999999999
4617,3690701,14513,16,0.091905,212,3701188,-1,592.0,8857341,8871854,5166640,14513,49,11,True,True,298.3204443111111,-0.09073608303266634
4618,3690792,149,32,0.399798,212,3701188,-1,1568.0,7512565,7512714,3821773,149,84,11,True,True,8.182960800000002,-0.3997980000000001
4619,3690846,16952,256,0.917882,212,3701188,-1,12800.0,6973667,6990619,3282821,16952,98,7,True,True,8410.835875555556,-0.9149052548408587
4620,3690876,21615,64,0.734266,212,3701188,-1,896.0,6561798,6583413,2870922,21615,114,12,True,True,501.7001845333333,-0.7126577411350788
4621,3690903,30,8,0.723581,212,3701188,-1,160.0,9557847,9557877,5866944,30,34,1,True,True,0.11530666666666667,-0.723581
4622,3691207,140,16,0.792904,212,3701188,-1,768.0,4815576,4815716,1124369,140,165,11,True,True,2.3917226666666664,-0.792904
4623,3691710,20607,32,0.172902,212,3701188,-1,1312.0,4434424,4455031,742714,20607,177,1,True,True,1499.7549772444445,-0.16923796056570434
4624,3691896,6844,35,0.825705,212,3701188,-1,1540.0,9644247,9651091,5952351,6844,34,12,True,True,418.47780761111113,-0.7847464130112514
4625,3692532,17,8,0.689595,212,3701188,-1,256.0,5444396,5444413,1751864,17,149,12,True,True,0.0997816888888889,-0.689595
4626,3692654,1207,32,0.576232,212,3701188,-1,608.0,7740565,7741772,4047911,1207,81,11,True,True,21.120783377777776,-0.576232
4627,3692800,10,1,0.907656,212,3701188,-1,50.0,4303761,4303771,610961,10,183,7,True,True,0.010227777777777778,-0.907656
4628,3692903,3,12,0.595231,212,3701188,-1,456.0,4194588,4194591,501685,3,186,9,True,True,0.029301800000000003,-0.595231
4629,3693006,11,21,0.300393,212,3701188,-1,861.0,9331841,9331852,5638835,11,43,12,True,True,0.24329946666666669,-0.300393
4630,3699045,8653,32,0.730789,212,3701188,-1,928.0,9778447,9787100,6079402,8653,32,11,True,True,225.18758293333332,-0.719714562831375
4631,3699066,22116,32,0.576284,212,3701188,-1,288.0,6705035,6727151,3005969,22116,115,11,True,True,272.75952879999994,-0.5707942788126037
4632,3699271,21,1,0.078477,212,3701188,-1,16.0,9800547,9800568,6101276,21,32,10,True,True,0.006503466666666668,-0.078477
4633,3699282,111,18,0.055923,212,3701188,-1,612.0,8993541,8993652,5294259,111,52,11,True,True,1.9215321,-0.055923
4634,3699352,13,4,0.770902,212,3701188,-1,48.0,7600765,7600778,3901413,13,91,7,True,True,0.012871733333333335,-0.770902
4635,3699478,11,4,0.34793,212,3701188,-1,172.0,9245441,9245452,5545963,11,46,10,True,True,0.06943114444444445,-0.34793
4636,3699527,13020,12,0.817142,212,3701188,-1,600.0,3884088,3897108,184561,13020,205,8,True,True,174.70777999999999,-0.80512320258409
4637,3700163,6,11,0.416522,212,3701188,-1,187.0,6944135,6944141,3243972,6,116,10,True,True,0.04991653333333334,-0.416522
4638,3701086,44,32,0.867831,212,3701188,-1,1088.0,4521724,4521768,820638,44,187,12,True,True,1.3600967111111113,-0.867831
4639,3701224,130,1,0.869787,213,3704788,-1,36.0,8365441,8365571,4664217,130,65,8,True,True,0.22786399999999996,-0.869787
4640,3701346,187,32,0.226718,213,3704788,-1,928.0,4771189,4771376,1069843,187,179,1,True,True,3.9590310222222223,-0.226718
4641,3712058,24,36,0.652779,247,3748988,-1,216.0,8354641,8354665,4642583,24,67,11,True,True,0.2253024,-0.652779
4642,3712151,13959,64,0.602302,247,3748988,-1,704.0,5563975,5577934,1851824,13959,152,2,True,True,296.31723146666667,-0.5621864148926065
4643,3714914,7407,9,0.011434,247,3748988,-1,288.0,10124074,10131481,6409160,7407,22,7,True,True,66.1944496,-0.010883647819280706
4644,3715223,18,16,0.777419,247,3748988,-1,592.0,8128227,8128245,4413004,18,75,12,True,True,0.5338952,-0.777419
4645,3715324,18,16,0.382487,247,3748988,-1,800.0,4185588,4185606,470264,18,203,10,True,True,0.40784,-0.38248699999999997
4646,3715542,5,8,0.304783,247,3748988,-1,136.0,8813141,8813146,5097599,5,58,12,True,True,0.026946888888888892,-0.304783
4647,3720730,18,16,0.041182,247,3748988,-1,304.0,8172427,8172445,4451697,18,76,11,True,True,0.245024,-0.041182
4648,3720939,56,4,0.53993,247,3748988,-1,104.0,9975347,9975403,6254408,56,31,11,True,True,0.4788783999999999,-0.53993
4649,3721655,12,1,0.14958,247,3748988,-1,44.0,10154481,10154493,6432826,12,17,6,True,True,0.0207636,-0.14958
4650,3723113,108,2,0.502402,247,3748988,-1,54.0,6567198,6567306,2844085,108,132,7,True,True,0.1578528,-0.502402
4651,3723509,38,1,0.220797,247,3748988,-1,43.0,5225389,5225427,1501880,38,174,12,True,True,0.027764383333333333,-0.220797
4652,3723658,819,1,0.05052,247,3748988,-1,22.0,7604365,7605184,3880707,819,100,8,True,True,0.36281244999999995,-0.050520000000000016
4653,3723949,12732,20,0.731579,247,3748988,-1,920.0,3880488,3893220,156539,12732,222,12,True,True,248.54609600000003,-0.7111493353126411
4654,3724018,394,4,0.392883,247,3748988,-1,32.0,9997503,9997897,6273485,394,32,10,True,True,1.036832888888889,-0.392883
4655,3733006,4,16,0.445616,247,3748988,-1,112.0,4658668,4658672,925662,4,196,8,True,True,0.006040533333333333,-0.445616
4656,3733414,122,4,0.595132,247,3748988,-1,96.0,8949341,8949463,5215927,122,58,8,True,True,0.4952874666666668,-0.595132
4657,3736777,71,3,0.504729,247,3748988,-1,114.0,4543868,4543939,807091,71,202,10,True,True,0.20826311666666664,-0.504729
4658,3736867,291,2,0.222086,247,3748988,-1,94.0,6328598,6328889,2591731,291,143,11,True,True,0.8940716,-0.2039980473116203
4659,3737473,40,1,0.289783,247,3748988,-1,29.0,5948075,5948115,2210602,40,153,6,True,True,0.030488666666666667,-0.289783
4660,3737586,14,4,0.394322,247,3748988,-1,200.0,4257761,4257775,520175,14,213,9,True,True,0.04177444444444445,-0.394322
4661,3737606,16503,3,0.132189,247,3748988,-1,123.0,9216141,9232644,5478535,16503,52,12,True,True,85.4706213,-0.13102915603326365
4662,3737796,274,12,0.082545,247,3748988,-1,552.0,8518141,8518415,4780345,274,70,11,True,True,6.579288000000001,-0.082545
4663,3740770,18193,1,0.571441,247,3748988,-1,22.0,10295881,10314074,6555111,18193,11,3,True,True,10.506607161111111,-0.5106382583556532
4664,3740870,2,4,0.049311,247,3748988,-1,60.0,7742365,7742367,4001495,2,99,7,True,True,0.003453666666666667,-0.049311
4665,3740946,4650,1,0.399191,247,3748988,-1,42.0,6379998,6384648,2639052,4650,146,11,True,True,3.0641407999999997,-0.38563442086941163
4666,3741105,22,1,0.085079,247,3748988,-1,42.0,4016688,4016710,275583,22,231,11,True,True,0.034152066666666675,-0.085079
4667,3741132,20,4,0.501823,247,3748988,-1,116.0,9975403,9975423,6234271,20,34,1,True,True,0.190762,-0.501823
4668,3741765,21010,1,0.773825,247,3748988,-1,12.0,7045753,7066763,3303988,21010,121,7,True,True,8.24436,-0.7680225098044976
4669,3741794,1379,32,0.130375,247,3748988,-1,448.0,8682541,8683920,4940747,1379,67,8,True,True,50.655335111111114,-0.12922752937787427
4670,3741818,8052,16,0.134871,247,3748988,-1,144.0,9129741,9137793,5387923,8052,55,11,True,True,42.616172399999996,-0.1279375877373158
4671,3742130,11773,256,0.559296,247,3748988,-1,2560.0,4238788,4250561,496658,11773,224,11,True,True,372.9625173333333,-0.5381312674730181
4672,3742226,27737,2,0.487861,247,3748988,-1,30.0,7242463,7270200,3500237,27737,117,12,True,True,16.52358883333333,-0.463000009538249
4673,3744910,24,1,0.652248,247,3748988,-1,47.0,5810275,5810299,2065365,24,169,10,True,True,0.039154133333333334,-0.6522479999999999
4674,3745166,37,4,0.196099,247,3748988,-1,152.0,10384281,10384318,6639115,37,9,10,True,True,0.1591592,-0.196099
4675,3745225,5,16,0.615997,247,3748988,-1,800.0,7598965,7598970,3853740,5,112,12,True,True,0.11124444444444445,-0.615997
