job_id,submit_time,request_time,request_processors,carbon_consideration,queue_length_at_submission,submission_timestamp,user_id,power,scheduled_time,completion_time,wait_time,actual_runtime,action1,action2,scheduled,completed,carbon_emissions,carbon_reward
7599,6084716,8396,8,0.537604,1,6084716,-1,168.0,6091916,6100312,7200,8396,0,9,True,True,42.420545066666676,-0.5192601291879538
7600,6085683,12,4,0.32608,4,6091916,-1,120.0,6136116,6136128,50433,12,0,11,True,True,0.034856000000000005,-0.32608
7601,6085768,291,64,0.02324,4,6091916,-1,2944.0,8183234,8183525,2097466,291,0,9,True,True,25.479804799999997,-0.02324
7602,6085843,31,32,0.785358,4,6091916,-1,256.0,6857722,6857753,771879,31,1,12,True,True,0.23887360000000002,-0.785358
7603,6085865,8087,26,0.922144,4,6091916,-1,858.0,9441344,9449431,3355479,8087,0,2,True,True,312.67198105,-0.876560998226366
7604,6093970,4,2,0.153691,115,6136116,-1,22.0,9520244,9520248,3426274,4,0,0,True,True,0.004002533333333333,-0.153691
7605,6094137,1277,1,0.952638,115,6136116,-1,17.0,10236570,10237847,4142433,1277,0,6,True,True,0.5417601555555557,-0.952638
7606,6094181,836,16,0.330251,115,6136116,-1,432.0,9425144,9425980,3330963,836,3,8,True,True,14.148129599999999,-0.330251
7607,6094592,4818,1,0.629839,115,6136116,-1,8.0,8701366,8706184,2606774,4818,4,7,True,True,0.7570263111111112,-0.6288980763803499
7608,6094727,8,8,0.603003,115,6136116,-1,120.0,9290944,9290952,3196217,8,4,8,True,True,0.018640000000000004,-0.603003
7609,6094907,18787,2,0.607837,115,6136116,-1,84.0,7502067,7520854,1407160,18787,7,12,True,True,37.4873422,-0.589509454088185
7610,6094978,10,4,0.866945,115,6136116,-1,116.0,9876666,9876676,3781688,10,1,11,True,True,0.04137011111111111,-0.866945
7611,6095254,11,44,0.980172,115,6136116,-1,528.0,9066086,9066097,2970832,11,6,7,True,True,0.2544388000000001,-0.980172
7612,6095273,34,1,0.204205,115,6136116,-1,8.0,6970722,6970756,875449,34,10,12,True,True,0.006821911111111112,-0.204205
7613,6095276,750,8,0.390636,115,6136116,-1,120.0,6697822,6698572,602546,750,12,12,True,True,2.9440000000000004,-0.390636
7614,6095281,697,1,0.534491,115,6136116,-1,33.0,8423766,8424463,2328485,697,8,10,True,True,0.9467524916666668,-0.5315884253465443
7615,6095288,87,1,0.188339,115,6136116,-1,36.0,9335144,9335231,3239856,87,5,11,True,True,0.1115688,-0.188339
7616,6095300,5354,8,0.108638,115,6136116,-1,208.0,8097096,8102450,2001796,5354,11,10,True,True,41.939615466666666,-0.10514804785575156
7617,6095363,19008,8,0.569515,115,6136116,-1,312.0,6393616,6412624,298253,19008,16,12,True,True,165.1948896,-0.5427775049680246
7618,6095534,31,4,0.451535,115,6136116,-1,80.0,7881290,7881321,1785756,31,12,7,True,True,0.11300533333333333,-0.451535
7619,6095582,113,2,0.894744,115,6136116,-1,62.0,7672490,7672603,1576908,113,13,9,True,True,0.4226953333333333,-0.894744
7620,6095896,137,32,0.093242,115,6136116,-1,320.0,6155016,6155153,59120,137,19,6,True,True,1.587008,-0.093242
7621,6095972,9,2,0.104313,115,6136116,-1,96.0,9287344,9287353,3191372,9,7,11,True,True,0.0168648,-0.104313
7622,6095994,6961,17,0.552907,115,6136116,-1,833.0,6604222,6611183,508228,6961,19,0,True,True,240.67671856666664,-0.5272283644925997
7623,6096053,39045,8,0.032059,115,6136116,-1,80.0,8227839,8266884,2131786,39045,11,8,True,True,135.01489333333333,-0.03143719203766479
7624,6096103,12315,4,0.689025,115,6136116,-1,132.0,10235670,10247985,4139567,12315,1,11,True,True,47.253877,-0.6802389768774424
7625,6096127,23680,2,0.488613,115,6136116,-1,66.0,9053486,9077166,2957359,23680,10,11,True,True,52.81208826666667,-0.47101874717149345
7626,6096190,11,1,0.186692,115,6136116,-1,30.0,6611422,6611433,515232,11,22,9,True,True,0.012112833333333331,-0.186692
7627,6096215,699,18,0.069491,115,6136116,-1,666.0,7874090,7874789,1777875,699,17,8,True,True,23.868962699999997,-0.069491
7628,6096769,50,1,0.962995,115,6136116,-1,9.0,6150516,6150566,53747,50,27,9,True,True,0.012063749999999998,-0.962995
7629,6096778,13995,36,0.283818,115,6136116,-1,972.0,8878686,8892681,2781908,13995,11,8,True,True,323.0202402,-0.2440071225367243
7630,6096933,51,1,0.233039,115,6136116,-1,17.0,9009286,9009337,2912353,51,11,0,True,True,0.025116508333333336,-0.233039
7631,6096961,72,4,0.65957,115,6136116,-1,68.0,7776890,7776962,1679929,72,20,9,True,True,0.2029528,-0.65957
7632,6097020,8852,128,0.069979,115,6136116,-1,5504.0,9068786,9077638,2971766,8852,9,7,True,True,1347.84016,-0.06932790950605267
7633,6097126,33,8,0.057453,115,6136116,-1,56.0,10147270,10147303,4050144,33,2,12,True,True,0.057431733333333325,-0.05745299999999999
7634,6097130,279,4,0.518532,115,6136116,-1,132.0,6143316,6143595,46186,279,33,9,True,True,1.003563,-0.518532
7635,6097184,6985,8,0.171826,115,6136116,-1,240.0,7277622,7284607,1180438,6985,25,10,True,True,40.46512533333333,-0.16705884251630373
7636,6097211,410,4,0.859707,115,6136116,-1,160.0,8428266,8428676,2331055,410,16,6,True,True,2.7761555555555555,-0.859707
7637,6097271,3,8,0.410861,115,6136116,-1,80.0,9523856,9523859,3426585,3,4,1,True,True,0.009761333333333334,-0.410861
7638,6097277,278,2,0.157035,115,6136116,-1,34.0,7179322,7179600,1082045,278,28,10,True,True,0.2807244,-0.15703499999999998
7639,6097332,23,4,0.110744,115,6136116,-1,20.0,7972190,7972213,1874858,23,22,2,True,True,0.020710222222222227,-0.110744
7640,6097351,23,32,0.536453,115,6136116,-1,704.0,7575567,7575590,1478216,23,27,10,True,True,0.3655344,-0.536453
7641,6098046,203,8,0.478251,115,6136116,-1,200.0,7230722,7230925,1132676,203,30,1,True,True,1.9325600000000003,-0.478251
7642,6098145,19,1,0.068763,115,6136116,-1,26.0,9753487,9753506,3655342,19,4,12,True,True,0.020157944444444447,-0.068763
7643,6098202,1062,2,0.955097,115,6136116,-1,20.0,8251239,8252301,2153037,1062,20,7,True,True,0.927775,-0.955097
7644,6098431,6,1,0.865699,115,6136116,-1,49.0,8028096,8028102,1929665,6,24,1,True,True,0.013304316666666666,-0.865699
7645,6098546,4961,16,0.129932,115,6136116,-1,480.0,9877566,9882527,3779020,4961,3,6,True,True,97.60650266666664,-0.12982255198305723
7646,6098955,14,1,0.205677,115,6136116,-1,28.0,7584590,7584604,1485635,14,31,9,True,True,0.008136177777777778,-0.205677
7647,6100368,8,26,0.432201,115,6136116,-1,442.0,8843866,8843874,2743498,8,18,6,True,True,0.06982617777777778,-0.432201
7648,6100373,624,1,0.709672,115,6136116,-1,39.0,8869962,8870586,2769589,624,18,1,True,True,0.53410825,-0.5538448533948271
7649,6100434,3,2,0.47478,115,6136116,-1,32.0,9824366,9824369,3723932,3,5,6,True,True,0.003243466666666667,-0.47478
7650,6100512,20254,16,0.603709,115,6136116,-1,736.0,8676566,8696820,2576054,20254,22,10,True,True,250.95521208888889,-0.5912543580171402
7651,6100987,28,2,0.939154,115,6136116,-1,14.0,6393616,6393644,292629,28,46,0,True,True,0.00833108888888889,-0.939154
7652,6101020,9091,128,0.587492,115,6136116,-1,2816.0,7223522,7232613,1122502,9091,40,11,True,True,1027.3393856,-0.5494430874044106
7653,6101026,128,16,0.502475,115,6136116,-1,800.0,9941566,9941694,3840540,128,3,8,True,True,2.9090133333333332,-0.502475
7654,6101073,7,1,0.684836,115,6136116,-1,29.0,8245839,8245846,2144766,7,27,9,True,True,0.009237627777777778,-0.684836
7655,6106453,89,16,0.275441,115,6136116,-1,576.0,8732466,8732555,2626013,89,22,6,True,True,0.8505552,-0.275441
7656,6106775,9486,8,0.007443,115,6136116,-1,328.0,9882966,9892452,3776191,9486,4,6,True,True,115.9721244,-0.007368351308645307
7657,6106898,10,16,0.142692,115,6136116,-1,672.0,8865966,8865976,2759068,10,22,10,True,True,0.14360266666666668,-0.142692
7658,6107010,66,32,0.06397,115,6136116,-1,1568.0,9825266,9825332,3718256,66,7,6,True,True,5.618823466666667,-0.06397
7659,6107212,15,1,0.399237,115,6136116,-1,21.0,8699566,8699581,2592354,15,27,6,True,True,0.00602525,-0.399237
7660,6107349,5513,1,0.807566,115,6136116,-1,41.0,9663487,9669000,3556138,5513,10,12,True,True,12.72430091388889,-0.8000428783412036
7661,6107760,42,4,0.525857,115,6136116,-1,100.0,7321822,7321864,1214062,42,46,11,True,True,0.18230333333333335,-0.525857
7662,6107783,6,4,0.910303,115,6136116,-1,36.0,6882522,6882528,774739,6,52,10,True,True,0.007891800000000001,-0.910303
7663,6108059,58,1,0.879239,115,6136116,-1,48.0,6165816,6165874,57757,58,59,9,True,True,0.10593893333333335,-0.879239
7664,6108112,537,1,0.460205,115,6136116,-1,38.0,8172396,8172933,2064284,537,36,7,True,True,0.7362598166666666,-0.460205
7665,6108162,11,4,0.576133,115,6136116,-1,200.0,8731566,8731577,2623404,11,27,6,True,True,0.03650166666666667,-0.576133
7666,6108299,73,1,0.737291,115,6136116,-1,32.0,8399866,8399939,2291567,73,33,11,True,True,0.13757742222222222,-0.737291
7667,6109439,8251,8,0.287912,115,6136116,-1,344.0,8170596,8178847,2061157,8251,39,11,True,True,101.29779944444444,-0.27551017399670935
7668,6110021,745,2,0.880994,115,6136116,-1,70.0,6158616,6159361,48595,745,64,8,True,True,2.3642781944444446,-0.880994
7669,6110292,24,16,0.456307,115,6136116,-1,144.0,7758890,7758914,1648598,24,46,12,True,True,0.12331199999999999,-0.456307
7670,6110560,683,2,0.700317,115,6136116,-1,82.0,7067222,7067905,956662,683,56,7,True,True,1.4634678944444444,-0.700317
7671,6110618,475,1,0.711648,115,6136116,-1,50.0,8516466,8516941,2405848,475,31,7,True,True,0.9911006944444445,-0.711648
7672,6111648,10744,4,0.297449,115,6136116,-1,104.0,7065422,7076166,953774,10744,58,10,True,True,29.673210666666666,-0.2841180112047486
7673,6111677,29494,4,0.613028,115,6136116,-1,180.0,8652666,8682160,2540989,29494,31,11,True,True,131.245136,-0.5947422274531631
7674,6112290,396,7,0.809985,115,6136116,-1,63.0,8869566,8869962,2757276,396,24,8,True,True,0.4821201,-0.809985
7675,6112402,206,1,0.175126,115,6136116,-1,42.0,6592316,6592522,479914,206,67,0,True,True,0.2848190333333334,-0.175126
7676,6112602,13650,14,0.249135,115,6136116,-1,126.0,9946966,9960616,3834364,13650,3,7,True,True,50.760706500000005,-0.24788147992405532
7677,6112924,20785,193,0.899965,115,6136116,-1,7334.0,9577087,9597872,3464163,20785,12,9,True,True,6761.625528094443,-0.8511208814346946
7678,6116203,5,8,0.733244,115,6136116,-1,160.0,7021222,7021227,905019,5,63,6,True,True,0.029151111111111114,-0.733244
7679,6116352,1695,8,0.457828,115,6136116,-1,400.0,9516644,9518339,3400292,1695,15,7,True,True,36.68545,-0.457828
7680,6116390,8,4,0.910833,115,6136116,-1,96.0,8238639,8238647,2122249,8,42,3,True,True,0.03795626666666666,-0.910833
7681,6116853,16547,64,0.183444,115,6136116,-1,2048.0,9812666,9829213,3695813,16547,10,10,True,True,1434.4281486222221,-0.16129589943891964
7682,6117029,5,2,0.568615,115,6136116,-1,90.0,6153216,6153221,36187,5,79,6,True,True,0.01629,-0.568615
7683,6118255,11693,41,0.393551,115,6136116,-1,1230.0,8723466,8735159,2605211,11693,33,10,True,True,232.51720124999997,-0.3873385349444473
7684,6118441,9726,24,0.945687,115,6136116,-1,312.0,6860422,6870148,741981,9726,70,7,True,True,99.20782213333334,-0.8982345247404776
7685,6118880,394,1,0.239695,115,6136116,-1,19.0,9239544,9239938,3120664,394,22,10,True,True,0.2500324,-0.239695
7686,6118914,18,1,0.87054,115,6136116,-1,21.0,6169416,6169434,50502,18,79,8,True,True,0.00991095,-0.87054
7687,6118928,95,1,0.273776,115,6136116,-1,12.0,6152316,6152411,33388,95,84,7,True,True,0.0318012,-0.2109723110206456
7688,6119064,23817,2,0.628083,115,6136116,-1,10.0,9243144,9266961,3124080,23817,22,8,True,True,8.586287,-0.6189264421810309
7689,6119108,9,4,0.29189,115,6136116,-1,152.0,8427366,8427375,2308258,9,42,8,True,True,0.056616200000000005,-0.29189
7690,6123749,14,4,0.916296,115,6136116,-1,92.0,6307216,6307230,183467,14,81,11,True,True,0.024135688888888885,-0.916296
7691,6123915,18,4,0.698044,115,6136116,-1,196.0,8654466,8654484,2530551,18,39,7,True,True,0.1043994,-0.6980439999999999
7692,6124059,81,1,0.722409,115,6136116,-1,45.0,6154116,6154197,30057,81,87,6,True,True,0.13194899999999998,-0.722409
7693,6124598,92,2,0.217255,115,6136116,-1,36.0,8074096,8074188,1949498,92,54,10,True,True,0.1250004,-0.217255
7694,6124770,8,1,0.493488,115,6136116,-1,36.0,7613890,7613898,1489120,8,62,9,True,True,0.007107199999999999,-0.493488
7695,6125092,2,5,0.99239,115,6136116,-1,115.0,9492744,9492746,3367652,2,17,8,True,True,0.008948277777777779,-0.99239
7696,6125214,4,4,0.552824,115,6136116,-1,140.0,10258670,10258674,4133456,4,0,10,True,True,0.03217355555555556,-0.552824
7697,6125511,10193,16,0.995316,115,6136116,-1,672.0,7983890,7994083,1858379,10193,58,9,True,True,342.84744666666666,-0.9939863069127836
7698,6125774,15531,128,0.076534,115,6136116,-1,3328.0,6461716,6477247,335942,15531,85,10,True,True,1119.8131406222224,-0.07289287567572916
7699,6126004,10,16,0.105225,115,6136116,-1,240.0,9432344,9432354,3306340,10,20,9,True,True,0.11982,-0.105225
7700,6126999,20414,256,0.766539,115,6136116,-1,9728.0,8207425,8227839,2080426,20414,53,7,True,True,7369.040850488889,-0.6978071565723493
7701,6127255,15208,4,0.326013,115,6136116,-1,192.0,8560666,8575874,2433411,15208,44,11,True,True,85.8250944,-0.2559987650748827
7702,6127551,151,16,0.450936,115,6136116,-1,96.0,8249439,8249590,2121888,151,51,2,True,True,0.6228045333333333,-0.450936
7703,6128779,3,1,0.252767,115,6136116,-1,26.0,9890166,9890169,3761387,3,6,4,True,True,0.0032268166666666667,-0.252767
7704,6128835,200,32,0.506065,115,6136116,-1,1184.0,8235039,8235239,2106204,200,55,8,True,True,9.51278222222222,-0.506065
7705,6128855,154,2,0.462167,115,6136116,-1,66.0,9514844,9514998,3385989,154,19,10,True,True,0.5499571,-0.462167
7706,6129010,26,32,0.073195,115,6136116,-1,288.0,10263174,10263200,4134164,26,0,6,True,True,0.39103999999999994,-0.073195
7707,6130829,3,5,0.694486,115,6136116,-1,35.0,7665290,7665293,1534461,3,73,9,True,True,0.003301666666666667,-0.694486
7708,6132809,32539,37,0.749736,115,6136116,-1,1591.0,7415664,7448203,1282855,32539,78,0,True,True,2042.4292660749998,-0.7405960378365726
7709,6133298,352,1,0.381156,115,6136116,-1,34.0,7870490,7870842,1737192,352,70,12,True,True,0.6076087111111113,-0.381156
7710,6133568,34,106,0.745957,115,6136116,-1,4028.0,6592522,6592556,458954,34,95,2,True,True,4.508383755555555,-0.7459569999999999
7711,6133731,53,4,0.855773,115,6136116,-1,32.0,6611422,6611475,477691,53,93,0,True,True,0.06225262222222221,-0.855773
7712,6133928,6435,4,0.396674,115,6136116,-1,140.0,10258674,10265109,4124746,6435,1,1,True,True,46.19470916666667,-0.3688216552874681
7713,6134348,3,8,0.010737,115,6136116,-1,336.0,8352039,8352042,2217691,3,54,12,True,True,0.046715200000000005,-0.010737
7714,6134461,109,4,0.114683,115,6136116,-1,140.0,7410264,7410373,1275803,109,82,11,True,True,0.567672,-0.114683
7715,6134542,144,8,0.917137,115,6136116,-1,152.0,7877690,7877834,1743148,144,71,7,True,True,1.0703840000000002,-0.917137
7716,6157938,30,8,0.32711,112,6158616,-1,264.0,10041070,10041100,3883132,30,6,2,True,True,0.235576,-0.32711
7717,6158059,72,1,0.748676,112,6158616,-1,50.0,7321864,7321936,1163805,72,85,1,True,True,0.15625999999999998,-0.748676
7718,6158070,1194,32,0.484759,112,6158616,-1,448.0,9790566,9791760,3632496,1194,16,1,True,True,20.414322133333332,-0.484759
7719,6158142,61,8,0.068237,112,6158616,-1,224.0,7020322,7020383,862180,61,95,7,True,True,0.49790097777777786,-0.068237
7720,6166540,36,1,0.548429,120,6169416,-1,25.0,7762490,7762526,1595950,36,77,8,True,True,0.0366575,-0.548429
7721,6166801,8740,64,0.242294,120,6169416,-1,384.0,6255816,6264556,89015,8740,111,12,True,True,90.79168,-0.2348232198700236
7722,6167111,15477,8,0.950018,120,6169416,-1,64.0,9893766,9909243,3726655,15477,9,5,True,True,40.82899893333334,-0.8713742243875335
7723,6167127,12518,64,0.140256,120,6169416,-1,832.0,9881166,9893684,3714039,12518,12,1,True,True,398.33395911111114,-0.1268406557780569
7724,6167151,6896,1,0.820427,120,6169416,-1,22.0,8727066,8733962,2559915,6896,46,1,True,True,2.4616954999999994,-0.7891089521491459
7725,6167179,4606,42,0.841563,120,6169416,-1,630.0,8231439,8236045,2064260,4606,65,8,True,True,111.34738475,-0.8249704522701796
7726,6167293,35,32,0.170589,120,6169416,-1,1152.0,9991166,9991201,3823873,35,7,11,True,True,1.664096,-0.170589
7727,6167321,2351,32,0.018066,120,6169416,-1,576.0,9556756,9559107,3389435,2351,23,9,True,True,65.15912959999999,-0.01718143115323903
7728,6167402,3,64,0.100515,120,6169416,-1,448.0,7415664,7415667,1248262,3,92,1,True,True,0.053397866666666675,-0.100515
7729,6168363,50,16,0.294145,120,6169416,-1,512.0,6593422,6593472,425059,50,112,6,True,True,0.8427377777777777,-0.294145
7730,6170285,6,15,0.534654,244,6255816,-1,615.0,6749222,6749228,578937,6,108,0,True,True,0.12473225,-0.534654
7731,6170812,28303,8,0.39085,244,6255816,-1,200.0,8355666,8383969,2184854,28303,61,0,True,True,227.08863944444448,-0.38976082440393073
7732,6170820,852,1,0.077585,244,6255816,-1,46.0,9945166,9946018,3774346,852,9,8,True,True,1.2632888,-0.077585
7733,6171254,11,32,0.763589,244,6255816,-1,1216.0,8119196,8119207,1947942,11,75,10,True,True,0.6436085333333333,-0.763589
7734,6171266,6290,1,0.677383,244,6255816,-1,30.0,9064286,9070576,2893020,6290,40,9,True,True,7.1808455,-0.6652209565442221
7735,6171277,10237,3,0.153496,244,6255816,-1,63.0,8258439,8268676,2087162,10237,65,9,True,True,28.461162100000003,-0.15347351335455128
7736,6171329,8,10,0.358087,244,6255816,-1,360.0,9549556,9549564,3378227,8,25,8,True,True,0.14298399999999997,-0.358087
7737,6171796,29,4,0.216672,244,6255816,-1,128.0,9127444,9127473,2955648,29,39,9,True,True,0.12604302222222222,-0.216672
7738,6171947,8514,128,0.034445,244,6255816,-1,1408.0,7253722,7262236,1081775,8514,104,10,True,True,511.67158044444443,-0.03189851369235958
7739,6180587,10886,2,0.675044,244,6255816,-1,16.0,8126396,8137282,1945809,10886,79,9,True,True,7.574174666666666,-0.6610646790181262
7740,6180626,47,1,0.216166,244,6255816,-1,50.0,6592316,6592363,411690,47,125,11,True,True,0.07736069444444446,-0.216166
7741,6180674,58,1,0.696742,244,6255816,-1,44.0,9112986,9113044,2932312,58,40,0,True,True,0.07624808888888888,-0.696742
7742,6180804,34,2,0.836501,244,6255816,-1,48.0,6699622,6699656,518818,34,119,7,True,True,0.052391733333333336,-0.8365010000000003
7743,6180922,3,1,0.811512,244,6255816,-1,11.0,7553467,7553470,1372545,3,99,11,True,True,0.0007490999999999999,-0.811512
7744,6181531,14512,1,0.641012,244,6255816,-1,50.0,9434144,9448656,3252613,14512,32,7,True,True,33.832166666666666,-0.6210810759586354
7745,6181893,34,4,0.71641,244,6255816,-1,136.0,8875086,8875120,2693193,34,48,6,True,True,0.08257693333333335,-0.71641
7746,6181980,11445,16,0.89701,244,6255816,-1,160.0,9832466,9843911,3650486,11445,17,0,True,True,105.83276888888889,-0.8871215364562761
7747,6182070,10698,256,0.390618,244,6255816,-1,11520.0,9779187,9789885,3597117,10698,22,7,True,True,4603.311839999999,-0.384621191439977
7748,6182223,59,2,0.308324,244,6255816,-1,40.0,7231622,7231681,1049399,59,112,6,True,True,0.11233600000000002,-0.308324
7749,6182229,14021,8,0.052415,244,6255816,-1,368.0,10037470,10051491,3855241,14021,7,6,True,True,142.03792906666666,-0.05131033996283191
7750,6182245,6,7,0.004666,244,6255816,-1,126.0,8028090,8028096,1845845,6,90,11,True,True,0.0342111,-0.004666
7751,6182363,11,15,0.77241,244,6255816,-1,165.0,9991470,9991481,3809107,11,8,1,True,True,0.07490908333333335,-0.77241
7752,6182386,12,2,0.767114,244,6255816,-1,18.0,10053670,10053682,3871284,12,6,2,True,True,0.0059568,-0.767114
7753,6182528,13,32,0.928821,244,6255816,-1,640.0,8730666,8730679,2548138,13,60,1,True,True,0.13804266666666665,-0.928821
7754,6182662,527,8,0.374645,244,6255816,-1,208.0,9131044,9131571,2948382,527,45,8,True,True,3.418192266666667,-0.374645
7755,6182694,1989,2,0.23854,244,6255816,-1,62.0,8987186,8989175,2804492,1989,53,10,True,True,2.0669467000000004,-0.23854
7756,6182782,38,2,0.091386,244,6255816,-1,56.0,9823466,9823504,3640684,38,23,8,True,True,0.07189684444444444,-0.09138599999999998
7757,6182850,21,4,0.421683,244,6255816,-1,132.0,9667087,9667108,3484237,21,28,8,True,True,0.1621928,-0.421683
7758,6182870,18,2,0.989291,244,6255816,-1,28.0,6548116,6548134,365246,18,143,12,True,True,0.014264600000000002,-0.9892910000000003
7759,6182876,16473,21,0.337117,244,6255816,-1,336.0,9520244,9536717,3337368,16473,35,8,True,True,189.44698920000002,-0.31251249145254384
7760,6183019,13368,6,0.192152,244,6255816,-1,120.0,8965086,8978454,2782067,13368,57,12,True,True,42.976076,-0.1726142221197334
7761,6183053,24,4,0.668949,244,6255816,-1,184.0,7606690,7606714,1423637,24,112,10,True,True,0.11096426666666666,-0.668949
7762,6184878,28,1,0.220568,244,6255816,-1,41.0,10060870,10060898,3875992,28,6,9,True,True,0.037335511111111115,-0.220568
7763,6186030,10651,4,0.882286,244,6255816,-1,136.0,8051996,8062647,1865966,10651,99,10,True,True,56.31766611111111,-0.8215253148635503
7764,6186037,134,4,0.796924,244,6255816,-1,168.0,6884322,6884456,698285,134,135,7,True,True,0.7741626666666666,-0.796924
7765,6186291,7,1,0.830451,244,6255816,-1,43.0,9057086,9057093,2870795,7,55,1,True,True,0.011225627777777775,-0.830451
7766,6186296,4,1,0.167883,244,6255816,-1,7.0,8608466,8608470,2422170,4,76,8,True,True,0.0008762444444444443,-0.167883
7767,6186359,9079,16,0.167047,244,6255816,-1,208.0,7967690,7976769,1781331,9079,106,12,True,True,86.26807164444443,-0.16631860287557482
7768,6186610,2,64,0.41568,244,6255816,-1,2560.0,8074996,8074998,1888386,2,100,6,True,True,0.19158755555555557,-0.41568
7769,6186646,12762,5,0.107684,244,6255816,-1,60.0,6771322,6784084,584676,12762,143,10,True,True,30.93830933333333,-0.10564892232460502
7770,6186691,94,4,0.327141,244,6255816,-1,188.0,9832466,9832560,3645775,94,22,9,True,True,1.0986584222222222,-0.327141
7771,6186720,10727,1,0.562054,244,6255816,-1,48.0,8776666,8787393,2589946,10727,67,11,True,True,16.07295,-0.5604759123286183
7772,6186760,4,16,0.189548,244,6255816,-1,592.0,9777387,9777391,3590627,4,29,7,True,True,0.08905653333333333,-0.189548
7773,6187354,35732,16,0.207119,244,6255816,-1,368.0,7412064,7447796,1224710,35732,128,7,True,True,518.6710373333333,-0.20575032104616367
7774,6187374,16088,32,0.541703,244,6255816,-1,448.0,10050070,10066158,3862696,16088,8,8,True,True,216.13914311111114,-0.5113799144992744
7775,6187428,7,4,0.938923,244,6255816,-1,68.0,8205625,8205632,2018197,7,98,10,True,True,0.022985511111111114,-0.938923
7776,6187452,40,4,0.120804,244,6255816,-1,80.0,8820866,8820906,2633414,40,69,11,True,True,0.06335111111111111,-0.120804
7777,6187476,230,32,0.21378,244,6255816,-1,1280.0,7577390,7577620,1389914,230,126,7,True,True,6.646079999999999,-0.21378
7778,6187562,4,1,0.356576,244,6255816,-1,44.0,6749222,6749226,561660,4,153,7,True,True,0.005949288888888888,-0.356576
7779,6187628,5482,64,0.173622,244,6255816,-1,2112.0,9489144,9494626,3301516,5482,43,8,True,True,451.7414410666667,-0.1692173513979727
7780,6187688,7780,16,0.402139,244,6255816,-1,320.0,7227122,7234902,1039434,7780,141,8,True,True,107.862416,-0.39782292814173814
7781,6196956,48,8,0.31624,244,6255816,-1,40.0,6858622,6858670,661666,48,152,6,True,True,0.07136,-0.31624
7782,6197065,8715,64,0.389187,244,6255816,-1,2624.0,10262274,10270989,4065209,8715,1,8,True,True,1048.6919429333332,-0.36974191859140887
7783,6197309,20587,32,0.458776,244,6255816,-1,256.0,10042870,10063457,3845561,20587,10,7,True,True,152.21492195555555,-0.4477851349566618
7784,6197333,132,8,0.066016,244,6255816,-1,304.0,8176034,8176166,1978701,132,104,8,True,True,1.3468517333333332,-0.066016
7785,6197371,40,8,0.815085,244,6255816,-1,248.0,10265109,10265149,4067738,40,0,2,True,True,0.4324293333333334,-0.815085
7786,6197433,8,4,0.649945,244,6255816,-1,72.0,9217444,9217452,3020011,8,56,12,True,True,0.018011199999999998,-0.6499450000000001
7787,6198518,5,2,0.36898,244,6255816,-1,20.0,9112986,9112991,2914468,5,60,11,True,True,0.002987777777777778,-0.36898
7788,6198545,6037,1,0.067331,244,6255816,-1,45.0,7672490,7678527,1473945,6037,128,0,True,True,15.174436499999999,-0.06591791502849582
7789,6198567,13942,3,0.218561,244,6255816,-1,111.0,8604866,8618808,2406299,13942,88,11,True,True,48.62247576666667,-0.2092384132291381
7790,6199325,12,4,0.301534,244,6255816,-1,132.0,6395416,6395428,196091,12,176,7,True,True,0.03366440000000001,-0.301534
7791,6199601,9528,16,0.598869,244,6255816,-1,752.0,7769690,7779218,1570089,9528,127,9,True,True,271.6612825777778,-0.5849262149487595
7792,6199623,16060,128,0.983102,244,6255816,-1,3328.0,8870586,8886646,2670963,16060,71,1,True,True,1267.2691199999997,-0.9462144862876497
7793,6200106,14,3,0.101814,244,6255816,-1,78.0,9066986,9067000,2866880,14,62,6,True,True,0.0478387,-0.101814
7794,6200395,17,19,0.536182,244,6255816,-1,855.0,8172434,8172451,1972039,17,111,1,True,True,0.524430875,-0.536182
7795,6201790,98,3,0.990531,244,6255816,-1,138.0,7415667,7415765,1213877,98,143,1,True,True,0.5373160333333333,-0.990531
7796,6201992,13,32,0.850465,244,6255816,-1,1088.0,7366064,7366077,1164072,13,148,11,True,True,0.6787155555555555,-0.850465
7797,6202188,15248,8,0.171459,244,6255816,-1,224.0,7014922,7030170,812734,15248,162,11,True,True,126.41962417777779,-0.17031699131463537
7798,6202259,119,4,0.959035,244,6255816,-1,68.0,7879490,7879609,1677231,119,126,7,True,True,0.3957212777777778,-0.959035
7799,6202348,13269,32,0.599867,244,6255816,-1,1120.0,8183525,8196794,1981177,13269,109,1,True,True,567.771652,-0.5940625330252899
7800,6202504,4977,8,0.981416,244,6255816,-1,344.0,9113044,9118021,2910540,4977,59,2,True,True,51.02399493333333,-0.9801437288501086
7801,6202738,9543,16,0.696315,244,6255816,-1,224.0,10266909,10276452,4064171,9543,0,7,True,True,91.5677448,-0.6652316589794426
7802,6202784,3,4,0.677901,244,6255816,-1,112.0,9120244,9120247,2917460,3,60,9,True,True,0.009826133333333334,-0.677901
7803,6202795,12009,1,0.972367,244,6255816,-1,35.0,8842966,8854975,2640171,12009,80,10,True,True,8.18836725,-0.9639712921756608
7804,6202868,670,1,0.693721,244,6255816,-1,24.0,6604222,6604892,401354,670,183,9,True,True,0.7252526666666667,-0.693721
7805,6203049,269,8,0.332047,244,6255816,-1,216.0,9991201,9991470,3788152,269,16,1,True,True,2.3980812,-0.332047
7806,6203171,1197,3,0.635353,244,6255816,-1,126.0,9437744,9438941,3234573,1197,50,1,True,True,6.9587595,-0.635353
7807,6204006,19249,128,0.883967,244,6255816,-1,4864.0,7509267,7528516,1305261,19249,150,9,True,True,2187.422812444445,-0.8333382318591657
7808,6204286,8237,4,0.317967,244,6255816,-1,68.0,10191470,10199707,3987184,8237,8,11,True,True,16.752145855555558,-0.28904667580351284
7809,6204343,16776,1,0.851554,244,6255816,-1,30.0,8514666,8531442,2310323,16776,100,12,True,True,22.8507015,-0.845697052275253
7810,6206461,119,16,0.48213,244,6255816,-1,784.0,8698666,8698785,2492205,119,93,10,True,True,1.7845451555555556,-0.48213
7811,6207230,21,4,0.335105,244,6255816,-1,64.0,8262039,8262060,2054809,21,108,8,True,True,0.05976693333333334,-0.335105
7812,6207482,681,8,0.608533,244,6255816,-1,96.0,9789885,9790566,3582403,681,35,1,True,True,2.4950024,-0.608533
7813,6207629,10100,64,0.585037,244,6255816,-1,1792.0,9485544,9495644,3277915,10100,51,11,True,True,719.1620750222223,-0.5607014633811273
7814,6207858,109,32,0.382371,244,6255816,-1,1376.0,6743822,6743931,535964,109,187,11,True,True,5.186946666666667,-0.382371
7815,6207901,27,32,0.640592,244,6255816,-1,1312.0,8355639,8355666,2147738,27,109,0,True,True,2.0392416,-0.640592
7816,6208349,196,1,0.232425,244,6255816,-1,13.0,8029896,8030092,1821547,196,134,7,True,True,0.11530407777777775,-0.232425
7817,6210331,11382,10,0.587469,244,6255816,-1,470.0,8265639,8277021,2055308,11382,111,2,True,True,220.31297783333335,-0.5872301413956555
7818,6210539,12,2,0.988381,244,6255816,-1,94.0,9523844,9523856,3313305,12,45,2,True,True,0.04587826666666667,-0.988381
7819,6210662,20824,32,0.232606,244,6255816,-1,1376.0,9832466,9853290,3621804,20824,29,0,True,True,1488.8117192888888,-0.22776238264818283
7820,6210840,189,3,0.616349,244,6255816,-1,114.0,7018522,7018711,807682,189,182,1,True,True,0.8242541999999999,-0.616349
7821,6210850,9410,4,0.896779,244,6255816,-1,88.0,9819866,9829276,3609016,9410,34,9,True,True,37.75736017777778,-0.77446459848207
7822,6211134,23,4,0.308849,244,6255816,-1,84.0,6747422,6747445,536288,23,194,8,True,True,0.06530696666666667,-0.308849
7823,6211443,21,5,0.737913,244,6255816,-1,95.0,8355639,8355660,2144196,21,113,8,True,True,0.1148455,-0.737913
7824,6212544,5,2,0.757246,244,6255816,-1,96.0,7255522,7255527,1042978,5,174,7,True,True,0.02272,-0.757246
7825,6214784,7,16,0.619766,244,6255816,-1,560.0,9009286,9009293,2794502,7,79,10,True,True,0.11356022222222224,-0.619766
7826,6214847,161,4,0.059923,244,6255816,-1,84.0,7973090,7973251,1758243,161,144,6,True,True,0.6088805333333334,-0.059923
7827,6219088,11,1,0.374524,244,6255816,-1,41.0,9937966,9937977,3718878,11,22,11,True,True,0.01333331388888889,-0.37452399999999997
7828,6223783,10,4,0.296615,244,6255816,-1,136.0,10046470,10046480,3822687,10,13,8,True,True,0.037513333333333336,-0.296615
7829,6224187,10232,4,0.151671,244,6255816,-1,152.0,9882066,9892298,3657879,10232,27,6,True,True,57.68174364444445,-0.15029196502537728
7830,6225090,18531,100,0.204385,244,6255816,-1,3900.0,9558556,9577087,3333466,18531,47,7,True,True,3102.5339474999996,-0.20284290653700726
7831,6225413,11946,113,0.037907,244,6255816,-1,2599.0,10036570,10048516,3811157,11946,17,11,True,True,848.4052869444445,-0.03703816587467099
7832,6226281,9339,64,0.923409,244,6255816,-1,2432.0,9886566,9895905,3660285,9339,27,8,True,True,928.1625248,-0.9104231307986603
7833,6226847,91,1,0.598075,244,6255816,-1,42.0,7658090,7658181,1431243,91,165,11,True,True,0.13815468333333333,-0.598075
7834,6232781,8,8,0.945876,244,6255816,-1,192.0,7043322,7043330,810541,8,192,10,True,True,0.04392533333333334,-0.945876
7835,6234484,38,64,0.739256,244,6255816,-1,2368.0,8172396,8172434,1937912,38,138,0,True,True,3.2466727111111107,-0.739256
7836,6234645,5418,32,0.32869,244,6255816,-1,416.0,8874186,8879604,2639541,5418,90,8,True,True,43.115245333333334,-0.31217203468239524
7837,6234774,319,4,0.278126,244,6255816,-1,108.0,7157222,7157541,922448,319,192,12,True,True,1.0161426,-0.278126
7838,6235408,28813,1,0.643602,244,6255816,-1,19.0,7784090,7812903,1548682,28813,160,9,True,True,22.072422813888892,-0.5994806571957318
7839,6237416,7,8,0.760494,244,6255816,-1,168.0,7575590,7575597,1338174,7,173,2,True,True,0.0265482,-0.760494
7840,6237461,1018,1,0.520873,244,6255816,-1,17.0,6439616,6440634,202155,1018,225,11,True,True,0.5371049888888888,-0.5072032037174333
7841,6237706,12201,1,0.977568,244,6255816,-1,29.0,9421544,9433745,3183838,12201,66,12,True,True,14.345117847222223,-0.9309425914996707
7842,6237799,10444,14,0.648046,244,6255816,-1,378.0,6263016,6273460,25217,10444,231,9,True,True,113.5187088,-0.6412415230735616
7843,6237848,14170,2,0.288455,244,6255816,-1,92.0,9992370,10006540,3754522,14170,18,6,True,True,56.07960688888888,-0.28693622848299843
7844,6239963,212,2,0.023693,244,6255816,-1,66.0,8401666,8401878,2161703,212,120,7,True,True,0.8240510666666667,-0.023693
7845,6240057,14,1,0.846935,244,6255816,-1,45.0,8355666,8355680,2115609,14,123,2,True,True,0.036267,-0.846935
7846,6240278,19618,2,0.33127,244,6255816,-1,44.0,7070822,7090440,830544,19618,199,2,True,True,30.719282488888886,-0.3184216755288481
7847,6241516,23,1,0.242249,244,6255816,-1,5.0,7875890,7875913,1634374,23,162,7,True,True,0.0058963055555555565,-0.242249
7848,6242557,54,4,0.539312,244,6255816,-1,72.0,7968590,7968644,1726033,54,158,6,True,True,0.17594279999999995,-0.539312
7849,6242604,9233,64,0.906632,244,6255816,-1,832.0,6597022,6606255,354418,9233,226,8,True,True,311.2654711111111,-0.8653115173442819
7850,6242942,14832,119,0.665006,244,6255816,-1,4879.0,9545956,9560788,3303014,14832,53,10,True,True,3663.179221333333,-0.6574415644848949
7851,6244121,9,64,0.248338,244,6255816,-1,2944.0,7976690,7976699,1732569,9,157,8,True,True,1.2442816,-0.248338
7852,6244172,10,8,0.68735,244,6255816,-1,104.0,7575567,7575577,1331395,10,182,0,True,True,0.023478,-0.68735
7853,6244213,24,1,0.719502,244,6255816,-1,12.0,9775587,9775611,3531374,24,46,10,True,True,0.0108312,-0.719502
7854,6244275,3,8,0.608063,244,6255816,-1,48.0,7043322,7043325,799047,3,208,0,True,True,0.004118,-0.608063
4420,3599033,10,8,0.121962,1,3599033,-1,256.0,3643233,3643243,44200,10,0,11,True,True,0.06482488888888889,-0.121962
4421,3601659,10,1,0.768146,57,3643233,-1,19.0,6758515,6758525,3156856,10,0,0,True,True,0.005249805555555555,-0.768146
4422,3601907,6031,4,0.248962,57,3643233,-1,172.0,5874079,5880110,2272172,6031,1,6,True,True,35.68445395555555,-0.23895759103586767
4423,3601977,9968,128,0.771225,57,3643233,-1,768.0,4300643,4310611,698666,9968,2,11,True,True,156.12987093333334,-0.7596862223568717
4424,3602335,9031,2,0.442961,57,3643233,-1,24.0,4753775,4762806,1151440,9031,2,7,True,True,4.6367696,-0.416980343914736
4425,3602647,10350,1,0.737619,57,3643233,-1,18.0,4147943,4158293,545296,10350,4,11,True,True,2.13360065,-0.7269228694996293
4426,3602663,886,8,0.03351,57,3643233,-1,184.0,6911546,6912432,3308883,886,0,1,True,True,5.413481377777778,-0.033382648132054174
4427,3604547,6,6,0.460835,57,3643233,-1,132.0,6983246,6983252,3378699,6,0,7,True,True,0.02916760000000001,-0.460835
4428,3604641,1145,32,0.770996,57,3643233,-1,512.0,3909542,3910687,304901,1145,7,6,True,True,14.506318222222223,-0.7698796476964958
4429,3604922,15,1,0.521139,57,3643233,-1,22.0,5614906,5614921,2009984,15,4,2,True,True,0.004939,-0.521139
4430,3604995,7,4,0.982116,57,3643233,-1,104.0,6608115,6608122,3003120,7,3,11,True,True,0.026770177777777775,-0.982116
4431,3605014,40369,50,0.472826,57,3643233,-1,1400.0,8150771,8191140,4545757,40369,0,11,True,True,2566.064705555556,-0.46801782087833127
4432,3605223,9932,1,0.681442,57,3643233,-1,42.0,4073143,4083075,467920,9932,10,6,True,True,11.039594766666667,-0.6749123077509763
4433,3605492,4812,256,0.312109,57,3643233,-1,8704.0,7614066,7618878,4008574,4812,1,10,True,True,826.5350314666669,-0.3044575146055035
4434,3605570,579,4,0.323063,57,3643233,-1,200.0,8172871,8173450,4567301,579,0,10,True,True,5.185266666666667,-0.323063
4435,3605841,241,2,0.629164,57,3643233,-1,32.0,4356596,4356837,750755,241,10,1,True,True,0.16495111111111113,-0.629164
4436,3605933,11431,2,0.042186,57,3643233,-1,66.0,6758515,6769946,3152582,11431,6,8,True,True,19.546230916666666,-0.04171674445862562
4437,3606018,184,16,0.937421,57,3643233,-1,672.0,4091143,4091327,485125,184,14,2,True,True,3.097725866666667,-0.937421
4438,3606157,43,1,0.520926,57,3643233,-1,44.0,3881142,3881185,274985,43,17,9,True,True,0.036762611111111114,-0.520926
4439,3607787,11,8,0.253313,57,3643233,-1,120.0,6708915,6708926,3101128,11,7,12,True,True,0.05444633333333334,-0.253313
4440,3607835,3669,32,0.63852,57,3643233,-1,1472.0,6819546,6823215,3211711,3669,5,7,True,True,147.40450986666667,-0.624232442595466
4441,3607893,10395,32,0.198724,57,3643233,-1,864.0,4743875,4754270,1135982,10395,13,0,True,True,221.285532,-0.19661492054515145
4442,3607918,131,4,0.88752,57,3643233,-1,148.0,8362071,8362202,4754153,131,0,0,True,True,0.8936790888888888,-0.88752
4443,3608069,9617,128,0.863658,57,3643233,-1,3200.0,7931210,7940827,4323141,9617,3,11,True,True,1213.5589066666666,-0.8564953846057393
4444,3608142,45,4,0.217788,57,3643233,-1,76.0,7885210,7885255,4277068,45,4,8,True,True,0.12768000000000002,-0.217788
4445,3609215,18897,5,0.112928,57,3643233,-1,55.0,7148468,7167365,3539253,18897,6,8,True,True,23.042083319444448,-0.10659106575911799
4446,3609235,6,16,0.632909,57,3643233,-1,752.0,6231317,6231323,2622082,6,14,9,True,True,0.0888112,-0.632909
4447,3609295,102,1,0.324513,57,3643233,-1,41.0,6330291,6330393,2720996,102,14,2,True,True,0.1488095,-0.324513
4448,3609324,52,1,0.16736,57,3643233,-1,27.0,4095643,4095695,486319,52,23,6,True,True,0.0354861,-0.16736
4449,3612264,97,32,0.2761,57,3643233,-1,192.0,7448529,7448626,3836265,97,6,1,True,True,0.7969520000000001,-0.2761
4450,3612998,3,8,0.11965,57,3643233,-1,360.0,8354871,8354874,4741873,3,1,0,True,True,0.04693800000000001,-0.11965
4451,3613280,117,16,0.789144,57,3643233,-1,512.0,5686606,5686723,2073326,117,19,6,True,True,1.3614848000000002,-0.789144
4452,3613362,13488,8,0.00893,57,3643233,-1,368.0,7580929,7594417,3967567,13488,7,10,True,True,189.7551744888889,-0.007985066637452383
4453,3614472,25974,8,0.041993,57,3643233,-1,256.0,6242117,6268091,2627645,25974,18,8,True,True,239.65713422222223,-0.039318032220452576
4454,3614510,5239,4,0.783475,57,3643233,-1,124.0,8034206,8039445,4419696,5239,4,8,True,True,31.794897866666666,-0.7794599873595718
4455,3614555,18,32,0.475271,57,3643233,-1,1504.0,6332091,6332109,2717536,18,18,7,True,True,0.963312,-0.475271
4456,3614578,139,1,0.596212,57,3643233,-1,42.0,4423715,4423854,809137,139,27,9,True,True,0.08855921666666666,-0.596212
4457,3614804,416,16,0.371399,57,3643233,-1,160.0,5179985,5180401,1565181,416,25,6,True,True,1.8585533333333335,-0.3712243842919877
4458,3615033,9,8,0.08948,57,3643233,-1,40.0,8363871,8363880,4748838,9,0,7,True,True,0.017528000000000002,-0.08948
4459,3615173,17,14,0.157698,57,3643233,-1,700.0,4307843,4307860,692670,17,31,9,True,True,0.24183444444444444,-0.157698
4460,3615213,396,1,0.091402,57,3643233,-1,26.0,7940210,7940606,4324997,396,6,7,True,True,0.4310306,-0.09140199999999998
4461,3615711,16582,256,0.618645,57,3643233,-1,6912.0,5975935,5992517,2360224,16582,24,3,True,True,2121.9864384,-0.6102174985548856
4462,3615813,15389,16,0.930849,57,3643233,-1,336.0,6907946,6923335,3292133,15389,15,11,True,True,172.2810226666667,-0.9209080698562226
4463,3615840,28,1,0.996973,57,3643233,-1,35.0,5266456,5266484,1650616,28,29,1,True,True,0.022142555555555558,-0.996973
4464,3615880,7607,32,0.625132,57,3643233,-1,1600.0,4965085,4972692,1349205,7607,31,1,True,True,229.4542488888889,-0.6117820579693773
4465,3615923,14759,32,0.059775,57,3643233,-1,832.0,4657475,4672234,1041552,14759,34,10,True,True,176.54768675555556,-0.05947622222104419
4466,3615992,10,32,0.644575,57,3643233,-1,640.0,4820075,4820085,1204083,10,32,10,True,True,0.12798222222222222,-0.644575
4467,3627860,12820,256,0.701328,57,3643233,-1,4864.0,6769946,6782766,3142086,12820,17,2,True,True,1706.732635022222,-0.6945798125192457
4468,3628129,6,4,0.791466,57,3643233,-1,140.0,4308743,4308749,680614,6,39,6,True,True,0.017070666666666668,-0.791466
4469,3628218,19,32,0.125827,57,3643233,-1,1600.0,7245668,7245687,3617450,19,12,1,True,True,0.8180133333333335,-0.125827
4470,3628580,26,4,0.232675,57,3643233,-1,172.0,5973979,5974005,2345399,26,28,6,True,True,0.08013575555555555,-0.232675
4471,3628688,27,16,0.981676,57,3643233,-1,512.0,3646833,3646860,18145,27,50,8,True,True,0.36537600000000003,-0.981676
4472,3628874,34,4,0.788562,57,3643233,-1,24.0,4082143,4082177,453269,34,47,3,True,True,0.023752400000000003,-0.788562
4473,3628952,22,8,0.756698,57,3643233,-1,400.0,3755333,3755355,126381,22,51,12,True,True,0.19861111111111115,-0.756698
4474,3628991,27,1,0.805525,57,3643233,-1,30.0,3668933,3668960,39942,27,52,10,True,True,0.01986075,-0.805525
4475,3641283,24,10,0.438719,57,3643233,-1,310.0,6977846,6977870,3336563,24,15,11,True,True,0.3069,-0.438719
4476,3641363,6696,4,0.192965,57,3643233,-1,136.0,8045006,8051702,4403643,6696,5,9,True,True,41.87364973333334,-0.19229765045140246
4477,3643034,67,1,0.68925,57,3643233,-1,50.0,6378091,6378158,2735057,67,25,11,True,True,0.06353833333333334,-0.68925
4478,3643821,17,8,0.358167,57,3646833,-1,304.0,5640606,5640623,1996785,17,34,10,True,True,0.09714404444444445,-0.358167
4479,3659990,2,4,0.134732,113,3668933,-1,120.0,5684806,5684808,2024816,2,34,11,True,True,0.005454666666666667,-0.134732
4480,3660044,204,25,0.898663,113,3668933,-1,425.0,5477106,5477310,1817062,204,37,11,True,True,2.4921433333333334,-0.898663
4481,3660260,7004,128,0.485302,113,3668933,-1,2176.0,6224117,6231121,2563857,7004,30,7,True,True,303.0776682666667,-0.45660534578006506
4482,3660679,5,16,0.4375,113,3668933,-1,368.0,6622515,6622520,2961836,5,24,8,True,True,0.057494888888888894,-0.4375
4483,3660746,5,1,0.294715,113,3668933,-1,13.0,7398368,7398373,3737622,5,13,11,True,True,0.0018263194444444444,-0.294715
4484,3660784,140,34,0.697038,113,3668933,-1,1360.0,6385291,6385431,2724507,140,27,9,True,True,2.618528888888889,-0.697038
4485,3660860,9450,32,0.189776,113,3668933,-1,1088.0,6475431,6484881,2814571,9450,27,0,True,True,267.5501978666667,-0.18256723542393655
4486,3661028,773,1,0.186627,113,3668933,-1,37.0,7446168,7446941,3785140,773,13,11,True,True,1.0124754,-0.186627
4487,3661037,3,2,0.347665,113,3668933,-1,30.0,4875075,4875078,1214038,3,47,11,True,True,0.00189,-0.347665
4488,3661057,9,16,0.732402,113,3668933,-1,192.0,5310684,5310693,1649627,9,44,11,True,True,0.0341568,-0.732402
4489,3661097,2714,1,0.275324,113,3668933,-1,42.0,6126717,6129431,2465620,2714,36,12,True,True,2.61192715,-0.27002306607771503
4490,3661187,11,16,0.83135,113,3668933,-1,96.0,8362071,8362082,4700884,11,2,0,True,True,0.04867573333333334,-0.83135
4491,3661202,4,6,0.914474,113,3668933,-1,210.0,4747475,4747479,1086273,4,53,8,True,True,0.019373666666666668,-0.914474
4492,3661241,8,1,0.55452,113,3668933,-1,27.0,3867642,3867650,206401,8,68,10,True,True,0.005545800000000001,-0.55452
4493,3661274,20842,1,0.068877,113,3668933,-1,13.0,6312291,6333133,2651017,20842,34,11,True,True,9.216490977777779,-0.06831602231643945
4494,3661337,35594,16,0.155025,113,3668933,-1,656.0,4072243,4107837,410906,35594,67,8,True,True,650.4259151555556,-0.15303917738762762
4495,3661440,101,8,0.295673,113,3668933,-1,368.0,8362071,8362172,4700631,101,3,2,True,True,1.7132383111111111,-0.295673
4496,3661501,63,1,0.263349,113,3668933,-1,42.0,7075430,7075493,3413929,63,19,1,True,True,0.062129550000000006,-0.263349
4497,3662111,8148,64,0.367113,113,3668933,-1,832.0,6933646,6941794,3271535,8148,22,10,True,True,245.12240248888887,-0.3347480442642235
4498,3662159,5579,4,0.00072,113,3668933,-1,136.0,4416515,4422094,754356,5579,61,9,True,True,14.551587844444446,-0.000686469064094315
4499,3662220,11570,1,0.638026,113,3668933,-1,10.0,4087543,4099113,425323,11570,69,7,True,True,3.0047614444444446,-0.6258526791753338
4500,3663788,609,1,0.379044,113,3668933,-1,5.0,4425515,4426124,761727,609,60,7,True,True,0.04520133333333333,-0.379044
4501,3663875,76,8,0.185534,113,3668933,-1,240.0,8060571,8060647,4396696,76,7,0,True,True,0.6837973333333334,-0.185534
4502,3663967,14665,10,0.01872,113,3668933,-1,460.0,7881610,7896275,4217643,14665,13,12,True,True,259.4137736111111,-0.018275946991969525
4503,3664153,27,2,0.856829,113,3668933,-1,40.0,5336384,5336411,1672231,27,52,8,True,True,0.027662999999999997,-0.856829
4504,3664169,5448,2,0.776017,113,3668933,-1,56.0,3903242,3908690,239073,5448,78,10,True,True,7.333849600000001,-0.7756576842450189
4505,3664201,8450,4,0.238787,113,3668933,-1,48.0,7658266,7666716,3994065,8450,14,11,True,True,14.859419733333333,-0.23720736077341742
4506,3664343,84,16,0.721004,113,3668933,-1,144.0,6519631,6519715,2855288,84,35,11,True,True,0.3225936,-0.7210039999999999
4507,3664361,91,1,0.658289,113,3668933,-1,18.0,4519115,4519206,854754,91,65,9,True,True,0.04907174999999999,-0.658289
4508,3664393,22,2,0.538957,113,3668933,-1,80.0,5965879,5965901,2301486,22,48,12,True,True,0.032095555555555565,-0.538957
4509,3664433,6,13,0.387491,113,3668933,-1,65.0,3908642,3908648,244209,6,82,7,True,True,0.009388166666666666,-0.387491
4510,3664610,111,4,0.52407,113,3668933,-1,188.0,6238517,6238628,2573907,111,43,9,True,True,0.3907533,-0.52407
4511,3664644,4,32,0.497549,113,3668933,-1,1600.0,3873042,3873046,208398,4,86,0,True,True,0.15294222222222223,-0.497549
4512,3664668,188,32,0.551468,113,3668933,-1,160.0,5385106,5385294,1720438,188,56,0,True,True,1.1360213333333335,-0.551468
4513,3664712,4,8,0.613039,113,3668933,-1,64.0,4354743,4354747,690031,4,73,10,True,True,0.005461333333333333,-0.613039
4514,3664784,6124,1,0.3226,113,3668933,-1,32.0,6471831,6477955,2807047,6124,37,12,True,True,5.3447256888888885,-0.30475608519984265
4515,3664816,16150,121,0.640904,113,3668933,-1,1815.0,5879479,5895629,2214663,16150,51,3,True,True,800.2793388333332,-0.6360981602231695
4516,3665011,232,32,0.110464,113,3668933,-1,992.0,7449429,7449661,3784418,232,17,6,True,True,9.848245333333333,-0.110464
4517,3665100,33,4,0.523201,113,3668933,-1,104.0,8037806,8037839,4372706,33,9,1,True,True,0.16848259999999998,-0.523201
4518,3665246,165,101,0.06668,113,3668933,-1,4242.0,4797975,4798140,1132729,165,68,11,True,True,17.7043405,-0.06668
4519,3665281,7,64,0.835193,113,3668933,-1,2880.0,5875879,5875886,2210598,7,54,7,True,True,0.730128,-0.835193
4520,3665449,6317,8,0.129774,113,3668933,-1,104.0,7663710,7670027,3998261,6317,15,1,True,True,24.06823004444444,-0.12810957859228594
4521,3665460,328,4,0.873493,113,3668933,-1,88.0,7938410,7938738,4272950,328,12,8,True,True,1.208359288888889,-0.873493
4522,3665924,9014,74,0.202079,113,3668933,-1,2220.0,6333891,6342905,2667967,9014,44,7,True,True,569.5064728333333,-0.20107589144378507
4523,3665959,15066,4,0.48537,113,3668933,-1,128.0,8354871,8369937,4688912,15066,5,10,True,True,89.85934080000001,-0.4851909974410679
4524,3665973,7608,3,0.098754,113,3668933,-1,15.0,4987185,4994793,1321212,7608,70,10,True,True,2.716002375,-0.09745473769489776
4525,3666177,10056,113,0.571012,113,3668933,-1,1921.0,5965879,5975935,2299702,10056,56,0,True,True,350.4920529166667,-0.5703398672691685
4526,3666436,7,1,0.8363,113,3668933,-1,10.0,5685706,5685713,2019270,7,62,6,True,True,0.0015909444444444443,-0.8363
4527,3667058,8,8,0.657921,113,3668933,-1,48.0,5974879,5974887,2307821,8,55,0,True,True,0.006881066666666667,-0.657921
4528,3667074,37,8,0.525821,113,3668933,-1,136.0,6018217,6018254,2351143,37,54,10,True,True,0.08652244444444446,-0.5258210000000001
4529,3668186,12,8,0.701314,113,3668933,-1,72.0,4612715,4612727,944529,12,83,1,True,True,0.017404799999999998,-0.701314
4530,3668196,39839,1,0.255939,113,3668933,-1,44.0,8325571,8365410,4657375,39839,6,10,True,True,65.340561,-0.25241549689015497
4531,3668426,38,4,0.366354,113,3668933,-1,24.0,5179085,5179123,1510659,38,75,6,True,True,0.025477733333333332,-0.366354
4532,3668615,13,64,0.605954,113,3668933,-1,640.0,3913142,3913155,244527,13,102,8,True,True,0.2061742222222222,-0.605954
4533,3668830,23991,4,0.070874,113,3668933,-1,92.0,8303471,8327462,4634641,23991,7,11,True,True,63.49919094444444,-0.06998650526152121
4534,3668847,12081,256,0.930211,113,3668933,-1,12288.0,6268091,6280172,2599244,12081,51,10,True,True,5886.616064,-0.9264444643623989
4535,3668865,5,1,0.208738,113,3668933,-1,33.0,7029246,7029251,3360381,5,30,7,True,True,0.00473825,-0.208738
4536,3669374,4541,184,0.491406,252,3755333,-1,4048.0,7144868,7149409,3475494,4541,29,3,True,True,514.1490962666667,-0.48434746012459895
4537,3669407,7819,4,0.889767,252,3755333,-1,96.0,6323091,6330910,2653684,7819,52,9,True,True,25.21902,-0.850608198748592
4538,3669434,2,4,0.079957,252,3755333,-1,112.0,6760315,6760317,3090881,2,39,7,True,True,0.006189244444444444,-0.079957
4539,3669546,5723,2,0.80102,252,3755333,-1,38.0,7141268,7146991,3471722,5723,30,0,True,True,6.253607011111111,-0.7767700451571093
4540,3669588,33704,64,0.0607,252,3755333,-1,1024.0,7123268,7156972,3453680,33704,31,1,True,True,1018.9183544888889,-0.058980252603576415
4541,3669597,10,1,0.55802,252,3755333,-1,26.0,4078543,4078553,408946,10,108,4,True,True,0.006544777777777778,-0.55802
4542,3670045,612,43,0.938244,252,3755333,-1,430.0,4330843,4331455,660798,612,100,10,True,True,3.375758,-0.938244
4543,3670118,3,16,0.415953,252,3755333,-1,96.0,7137668,7137671,3467550,3,31,9,True,True,0.0088256,-0.415953
4544,3670126,12,8,0.369069,252,3755333,-1,120.0,3845542,3845554,175416,12,120,12,True,True,0.027624000000000003,-0.369069
4545,3670158,26577,128,0.708434,252,3755333,-1,4352.0,5611306,5637883,1941148,26577,78,8,True,True,1697.4694933333335,-0.6709831151774984
4546,3670351,9,2,0.823643,252,3755333,-1,70.0,5385106,5385115,1714755,9,81,11,True,True,0.023793000000000005,-0.823643
4547,3670440,3747,1,0.265816,252,3755333,-1,30.0,4256443,4260190,586003,3747,107,10,True,True,1.8024264166666666,-0.2393540675333573
4548,3672786,28250,128,0.040653,252,3755333,-1,4224.0,5176385,5204635,1503599,28250,87,11,True,True,2593.5445653333336,-0.03872928539216447
4549,3672822,13457,128,0.070388,252,3755333,-1,3072.0,6618915,6632372,2946093,13457,47,8,True,True,1330.3913813333334,-0.07022685168407086
4550,3673201,21313,16,0.303905,252,3755333,-1,144.0,4094743,4116056,421542,21313,112,3,True,True,94.6358252,-0.29796562692632866
4551,3673565,89,1,0.944603,252,3755333,-1,12.0,5828979,5829068,2155414,89,74,9,True,True,0.039604999999999994,-0.944603
4552,3673625,16711,4,0.960587,252,3755333,-1,68.0,5340906,5357617,1667281,16711,84,6,True,True,28.462069044444448,-0.9379441166352399
4553,3673741,75,2,0.097119,252,3755333,-1,16.0,7536729,7536804,3862988,75,23,12,True,True,0.04204333333333333,-0.097119
4554,3673762,201,1,0.725172,252,3755333,-1,41.0,4234343,4234544,560581,201,113,12,True,True,0.137143975,-0.725172
4555,3673920,5,1,0.531661,252,3755333,-1,25.0,5974879,5974884,2300959,5,69,6,True,True,0.0022399305555555558,-0.531661
4556,3674946,25,1,0.18946,252,3755333,-1,24.0,8106571,8106596,4431625,25,10,11,True,True,0.026175,-0.18946
4557,3674980,12598,32,0.526192,252,3755333,-1,1440.0,4748375,4760973,1073395,12598,100,6,True,True,429.7631,-0.5107485886395561
4558,3675045,21116,45,0.248763,252,3755333,-1,1215.0,7940606,7961722,4265561,21116,15,1,True,True,1023.3308542499999,-0.23726936582495536
4559,3675284,288,3,0.625325,252,3755333,-1,105.0,4365096,4365384,689812,288,110,1,True,True,0.6493199999999999,-0.625325
4560,3675406,1649,5,0.178898,252,3755333,-1,220.0,7079030,7080679,3403624,1649,36,7,True,True,8.913303055555556,-0.178898
4561,3675425,101,1,0.749194,252,3755333,-1,6.0,3979442,3979543,304017,101,129,11,True,True,0.01573916666666667,-0.749194
4562,3675572,12,2,0.415185,252,3755333,-1,28.0,6326691,6326703,2651119,12,61,2,True,True,0.0105532,-0.415185
4563,3675590,8667,16,0.105514,252,3755333,-1,400.0,7267768,7276435,3592178,8667,30,10,True,True,70.00464777777778,-0.10451805058125718
4564,3675622,29,12,0.638624,252,3755333,-1,216.0,7155668,7155697,3480046,29,32,0,True,True,0.139983,-0.638624
4565,3675637,7754,128,0.357963,252,3755333,-1,1920.0,4605515,4613269,929878,7754,110,12,True,True,273.31284266666665,-0.3458435316593714
4566,3675654,189,32,0.458721,252,3755333,-1,320.0,6795646,6795835,3119992,189,47,8,True,True,1.5907919999999998,-0.458721
4567,3675688,10761,1,0.665242,252,3755333,-1,46.0,7887010,7897771,4211322,10761,19,7,True,True,19.255131694444444,-0.6594692499463856
4568,3675741,8744,4,0.882824,252,3755333,-1,196.0,5332784,5341528,1657043,8744,96,10,True,True,44.25802391111111,-0.878881295828249
4569,3675872,9308,1,0.166809,252,3755333,-1,44.0,4609115,4618423,933243,9308,113,8,True,True,7.983563988888888,-0.1661960623436303
4570,3675903,11829,72,0.180397,252,3755333,-1,2232.0,7558829,7570658,3882926,11829,26,10,True,True,1153.7428534,-0.17986168963431512
4571,3676012,238,1,0.401557,252,3755333,-1,35.0,7584529,7584767,3908517,238,25,1,True,True,0.32160741666666665,-0.401557
4572,3676024,33,8,0.337513,252,3755333,-1,360.0,8332771,8332804,4656747,33,6,9,True,True,0.375177,-0.337513
4573,3676082,23,5,0.158176,252,3755333,-1,70.0,6792046,6792069,3115964,23,52,10,True,True,0.04188683333333334,-0.158176
4574,3676130,45,1,0.998434,252,3755333,-1,50.0,6563915,6563960,2887785,45,61,11,True,True,0.0637125,-0.998434
4575,3676133,2356,2,0.443012,252,3755333,-1,18.0,5178185,5180541,1502052,2356,106,7,True,True,1.17084725,-0.4378264452189583
4576,3676184,230,8,0.352324,252,3755333,-1,128.0,6385431,6385661,2709247,230,65,1,True,True,0.40488177777777773,-0.352324
4577,3677867,53,45,0.315155,252,3755333,-1,1710.0,4356543,4356596,678676,53,128,7,True,True,1.938475,-0.315155
4578,3677893,32,1,0.991463,252,3755333,-1,33.0,3873042,3873074,195149,32,152,8,True,True,0.025235466666666668,-0.991463
4579,3677973,1043,1,0.324654,252,3755333,-1,43.0,4085743,4086786,407770,1043,141,4,True,True,1.1611100083333332,-0.3230993480379967
4580,3677995,13208,38,0.37172,252,3755333,-1,608.0,4743875,4757083,1065880,13208,118,12,True,True,195.77157848888885,-0.36962489505451035
4581,3678079,1889,4,0.764184,252,3755333,-1,168.0,8358471,8360360,4680392,1889,4,2,True,True,14.455342533333335,-0.7551556967644999
4582,3678090,14913,128,0.430588,252,3755333,-1,1792.0,6040317,6055230,2362227,14913,81,10,True,True,472.6384768,-0.4222354357607446
4583,3678108,13165,16,0.725868,252,3755333,-1,128.0,7242068,7255233,3563960,13165,37,0,True,True,37.77726897777778,-0.6845001452510288
4584,3678125,7,4,0.608413,252,3755333,-1,108.0,4635375,4635382,957250,7,123,8,True,True,0.012278699999999998,-0.608413
4585,3678176,6,37,0.563145,252,3755333,-1,1295.0,4751975,4751981,1073799,6,118,2,True,True,0.20558125,-0.563145
4586,3678377,8869,256,0.213928,252,3755333,-1,9472.0,8051702,8060571,4373325,8869,14,1,True,True,3585.288081066666,-0.20726621681564458
4587,3678440,12027,210,0.765708,252,3755333,-1,5250.0,8027006,8039033,4348566,12027,18,12,True,True,2878.7389166666667,-0.7303174320242809
4588,3679211,14,64,0.926147,252,3755333,-1,2176.0,7152068,7152082,3472857,14,41,3,True,True,0.836152177777778,-0.926147
4589,3679280,44,128,0.254089,252,3755333,-1,5632.0,4988985,4989029,1309705,44,115,7,True,True,5.497207466666667,-0.254089
4590,3679312,4,1,0.961652,252,3755333,-1,31.0,5996117,5996121,2316805,4,87,8,True,True,0.0027559000000000004,-0.961652
4591,3679372,7906,32,0.4475,252,3755333,-1,992.0,8450271,8458177,4770899,7906,0,12,True,True,338.6248984888889,-0.4423647160945807
4592,3680172,1984,32,0.397091,252,3755333,-1,1024.0,7073446,7075430,3393274,1984,50,11,True,True,53.29921706666667,-0.31242498890432024
4593,3680281,13,14,0.726313,252,3755333,-1,574.0,7141268,7141281,3460987,13,46,2,True,True,0.22620223888888885,-0.726313
4594,3680922,11742,86,0.982956,252,3755333,-1,602.0,4363796,4375538,682874,11742,141,0,True,True,166.9055769111111,-0.942681752189376
4595,3681024,1300,8,0.595763,252,3755333,-1,168.0,4363796,4365096,682772,1300,142,9,True,True,4.689533333333333,-0.595763
4596,3681070,19,1,0.517609,252,3755333,-1,28.0,4409296,4409315,728226,19,140,11,True,True,0.01787667777777778,-0.517609
4597,3681095,23,32,0.993412,252,3755333,-1,288.0,3869442,3869465,188347,23,171,7,True,True,0.1700712,-0.993412
4598,3681213,5,32,0.301842,252,3755333,-1,1408.0,6754915,6754920,3073702,5,65,11,True,True,0.18284444444444442,-0.301842
4599,3681391,13,8,0.300334,252,3755333,-1,264.0,4409315,4409328,727924,13,141,1,True,True,0.11532473333333333,-0.300334
4600,3681904,3459,4,0.221887,252,3755333,-1,156.0,5038585,5042044,1356681,3459,120,11,True,True,18.600462399999998,-0.22141254613567693
4601,3682096,13849,4,0.85572,252,3755333,-1,152.0,3759142,3772991,77046,13849,177,8,True,True,48.32990606666666,-0.8248469595740296
4602,3682167,19827,32,0.021701,252,3755333,-1,352.0,5124985,5144812,1442818,19827,120,12,True,True,200.80011208888888,-0.021222862377242403
4603,3682283,6,1,0.82194,252,3755333,-1,19.0,4990785,4990791,1308502,6,122,0,True,True,0.0028575999999999996,-0.82194
4604,3682525,22,32,0.689719,252,3755333,-1,1248.0,7401968,7401990,3719443,22,37,8,True,True,0.7304058666666666,-0.689719
4605,3682574,13,1,0.275957,252,3755333,-1,35.0,7027446,7027459,3344872,13,54,11,True,True,0.013066083333333332,-0.275957
4606,3682589,3,4,0.553663,252,3755333,-1,56.0,5432906,5432909,1750317,3,111,11,True,True,0.003342266666666667,-0.553663
4607,3683826,2914,1,0.556323,252,3755333,-1,29.0,5873179,5876093,2189353,2914,103,11,True,True,3.0058239,-0.5463796647566173
4608,3685104,2,1,0.925922,252,3755333,-1,14.0,3906842,3906844,221738,2,176,1,True,True,0.0006740222222222222,-0.925922
4609,3688341,561,1,0.154715,252,3755333,-1,38.0,7447968,7448529,3759627,561,36,7,True,True,0.79089115,-0.13413542132997305
4610,3688365,19295,64,0.037736,252,3755333,-1,2112.0,4065943,4085238,377578,19295,173,12,True,True,1053.1944896,-0.03732832600829613
4611,3688398,12603,8,0.355656,252,3755333,-1,128.0,3935242,3947845,246844,12603,175,10,True,True,44.88097742222223,-0.35379154723899225
4612,3688772,56,1,0.138408,252,3755333,-1,42.0,6710715,6710771,3021943,56,69,7,True,True,0.10201800000000001,-0.138408
4613,3688871,53,8,0.367083,252,3755333,-1,160.0,8030606,8030659,4341735,53,19,1,True,True,0.34115511111111113,-0.367083
4614,3688977,11,8,0.582156,252,3755333,-1,112.0,4103743,4103754,414766,11,166,3,True,True,0.040200844444444446,-0.582156
4615,3689104,7367,16,0.232994,252,3755333,-1,768.0,4823675,4831042,1134571,7367,134,8,True,True,122.58918400000002,-0.2203004137645753
4616,3689453,19,1,0.811074,252,3755333,-1,11.0,5773006,5773025,2083553,19,108,12,True,True,0.008196863888888888,-0.811074
4617,3690701,14513,16,0.091905,252,3755333,-1,592.0,7795210,7809723,4104509,14513,28,6,True,True,432.02701542222223,-0.08105169700091859
4618,3690792,149,32,0.399798,252,3755333,-1,1568.0,5266484,5266633,1575692,149,124,1,True,True,5.278785244444446,-0.399798
4619,3690846,16952,256,0.917882,252,3755333,-1,12800.0,4618423,4635375,927577,16952,148,1,True,True,4004.494968888889,-0.8857778442405406
4620,3690876,21615,64,0.734266,252,3755333,-1,896.0,5618506,5640121,1927630,21615,114,3,True,True,292.64678364444444,-0.7221259185487717
4621,3690903,30,8,0.723581,252,3755333,-1,160.0,3873942,3873972,183039,30,191,6,True,True,0.09387999999999999,-0.723581
4622,3691207,140,16,0.792904,252,3755333,-1,768.0,6222317,6222457,2531110,140,94,11,True,True,2.4012800000000003,-0.792904
4623,3691710,20607,32,0.172902,252,3755333,-1,1312.0,6178117,6198724,2486407,20607,95,9,True,True,660.5231236444445,-0.17065964067072303
4624,3691896,6844,35,0.825705,252,3755333,-1,1540.0,5563506,5570350,1871610,6844,119,12,True,True,276.7855774444444,-0.770160136326743
4625,3692532,17,8,0.689595,252,3755333,-1,256.0,5992517,5992534,2299985,17,100,1,True,True,0.08505742222222222,-0.689595
4626,3692654,1207,32,0.576232,252,3755333,-1,608.0,7155668,7156875,3463014,1207,46,2,True,True,16.197736444444445,-0.5691376332776023
4627,3692800,10,1,0.907656,252,3755333,-1,50.0,4965075,4965085,1272275,10,142,12,True,True,0.009363888888888889,-0.907656
4628,3692903,3,12,0.595231,252,3755333,-1,456.0,5132185,5132188,1439282,3,136,9,True,True,0.040143200000000004,-0.595231
4629,3693006,11,21,0.300393,252,3755333,-1,861.0,7661866,7661877,3968860,11,30,1,True,True,0.34374468333333336,-0.300393
4630,3699045,8653,32,0.730789,252,3755333,-1,928.0,4878675,4887328,1179630,8653,145,8,True,True,183.6004358222222,-0.7305397576155138
4631,3699066,22116,32,0.576284,252,3755333,-1,288.0,6863746,6885862,3164680,22116,65,11,True,True,252.91937759999996,-0.5745937143379302
4632,3699271,21,1,0.078477,252,3755333,-1,16.0,3755542,3755563,56271,21,208,1,True,True,0.007583333333333334,-0.078477
4633,3699282,111,18,0.055923,252,3755333,-1,612.0,7707910,7708021,4008628,111,29,11,True,True,1.4852577,-0.055923
4634,3699352,13,4,0.770902,252,3755333,-1,48.0,5388706,5388719,1689354,13,127,8,True,True,0.035287200000000005,-0.770902
4635,3699478,11,4,0.34793,252,3755333,-1,172.0,5996117,5996128,2296639,11,103,0,True,True,0.0420497,-0.34793
4636,3699527,13020,12,0.817142,252,3755333,-1,600.0,4068643,4081663,369116,13020,195,7,True,True,200.0833616666667,-0.8084122066366535
4637,3700163,6,11,0.416522,252,3755333,-1,187.0,3873942,3873948,173779,6,205,0,True,True,0.02194445,-0.416522
4638,3701086,44,32,0.867831,252,3755333,-1,1088.0,7663666,7663710,3962580,44,31,7,True,True,1.7374876444444447,-0.867831
4639,3701224,130,1,0.869787,252,3755333,-1,36.0,4100143,4100273,398919,130,187,6,True,True,0.13310699999999998,-0.869787
4640,3701346,187,32,0.226718,252,3755333,-1,928.0,3755355,3755542,54009,187,216,1,True,True,3.916611111111111,-0.22671799999999995
4641,3712058,24,36,0.652779,252,3755333,-1,216.0,7077230,7077254,3365172,24,58,7,True,True,0.1217232,-0.652779
4642,3712151,13959,64,0.602302,252,3755333,-1,704.0,6615315,6629274,2903164,13959,81,9,True,True,312.1897151999999,-0.5950768263486287
4643,3714914,7407,9,0.011434,252,3755333,-1,288.0,5340006,5347413,1625092,7407,135,1,True,True,54.4053744,-0.011411681961886548
4644,3715223,18,16,0.777419,252,3755333,-1,592.0,4994385,4994403,1279162,18,148,8,True,True,0.2492024,-0.777419
4645,3715324,18,16,0.382487,252,3755333,-1,800.0,5973079,5973097,2257755,18,113,9,True,True,0.25804000000000005,-0.382487
4646,3715542,5,8,0.304783,252,3755333,-1,136.0,4990785,4990790,1275243,5,151,7,True,True,0.017045333333333336,-0.304783
4647,3720730,18,16,0.041182,252,3755333,-1,304.0,4066843,4066861,346113,18,204,6,True,True,0.14838240000000003,-0.041182
4648,3720939,56,4,0.53993,252,3755333,-1,104.0,6817746,6817802,3096807,56,70,10,True,True,0.20945368888888888,-0.53993
4649,3721655,12,1,0.14958,252,3755333,-1,44.0,5340006,5340018,1618351,12,137,0,True,True,0.013500666666666666,-0.14958
4650,3723113,108,2,0.502402,252,3755333,-1,54.0,7794310,7794418,4071197,108,29,12,True,True,0.2047194,-0.502402
4651,3723509,38,1,0.220797,252,3755333,-1,43.0,7123230,7123268,3399721,38,58,11,True,True,0.055220122222222216,-0.220797
4652,3723658,819,1,0.05052,252,3755333,-1,22.0,8062371,8063190,4338713,819,14,7,True,True,0.6754748,-0.05052
4653,3723949,12732,20,0.731579,252,3755333,-1,920.0,5607706,5620438,1883757,12732,133,11,True,True,173.74698844444447,-0.7135878166312504
4654,3724018,394,4,0.392883,252,3755333,-1,32.0,4511915,4512309,787897,394,180,12,True,True,0.33516266666666666,-0.392883
4655,3733006,4,16,0.445616,252,3755333,-1,112.0,5685706,5685710,1952700,4,127,0,True,True,0.010182044444444443,-0.445616
4656,3733414,122,4,0.595132,252,3755333,-1,96.0,3979543,3979665,246129,122,214,1,True,True,0.3041866666666667,-0.595132
4657,3736777,71,3,0.504729,252,3755333,-1,114.0,5266385,5266456,1529608,71,149,12,True,True,0.1828794333333333,-0.504729
4658,3736867,291,2,0.222086,252,3755333,-1,94.0,6170917,6171208,2434050,291,107,11,True,True,0.6242790666666665,-0.222086
4659,3737473,40,1,0.289783,252,3755333,-1,29.0,4830875,4830915,1093402,40,167,9,True,True,0.021315,-0.289783
4660,3737586,14,4,0.394322,252,3755333,-1,200.0,6475431,6475445,2737845,14,90,8,True,True,0.07637000000000001,-0.394322
4661,3737606,16503,3,0.132189,252,3755333,-1,123.0,6981446,6997949,3243840,16503,67,8,True,True,71.70627076666668,-0.13066640081144495
4662,3737796,274,12,0.082545,252,3755333,-1,552.0,7934810,7935084,4197014,274,25,8,True,True,5.899932400000001,-0.082545
4663,3740770,18193,1,0.571441,252,3755333,-1,22.0,4332643,4350836,591873,18193,199,7,True,True,5.772461811111111,-0.5555996932127591
4664,3740870,2,4,0.049311,252,3755333,-1,60.0,7354168,7354170,3613298,2,48,12,True,True,0.003140333333333333,-0.049311
4665,3740946,4650,1,0.399191,252,3755333,-1,42.0,7130468,7135118,3389522,4650,60,9,True,True,6.3761630333333335,-0.39918680747704627
4666,3741105,22,1,0.085079,252,3755333,-1,42.0,5339984,5340006,1598879,22,150,8,True,True,0.02362616666666667,-0.08507900000000002
4667,3741132,20,4,0.501823,252,3755333,-1,116.0,7450329,7450349,3709197,20,42,6,True,True,0.09927666666666668,-0.501823
4668,3741765,21010,1,0.773825,252,3755333,-1,12.0,4074943,4095953,333178,21010,220,7,True,True,6.563237333333334,-0.7733267095240535
4669,3741794,1379,32,0.130375,252,3755333,-1,448.0,8259271,8260650,4517477,1379,11,12,True,True,25.211061866666668,-0.130375
4670,3741818,8052,16,0.134871,252,3755333,-1,144.0,7242068,7250120,3500250,8052,54,12,True,True,28.550646399999998,-0.12878803366226832
4671,3742130,11773,256,0.559296,252,3755333,-1,2560.0,5817206,5828979,2075076,11773,134,11,True,True,1224.4279893333335,-0.5581810783855191
4672,3742226,27737,2,0.487861,252,3755333,-1,30.0,7586329,7614066,3844103,27737,39,7,True,True,21.953978083333332,-0.47028819547303613
4673,3744910,24,1,0.652248,252,3755333,-1,47.0,6315891,6315915,2570981,24,108,1,True,True,0.03749973333333334,-0.652248
4674,3745166,37,4,0.196099,252,3755333,-1,152.0,6519715,6519752,2774549,37,96,1,True,True,0.14998895555555555,-0.196099
4675,3745225,5,16,0.615997,252,3755333,-1,800.0,4099243,4099248,354018,5,219,4,True,True,0.11376666666666667,-0.6159969999999999
8402,6658550,8,1,0.126368,1,6658550,-1,25.0,6659967,6659458,1417,8,0,6,True,True,0.006801666666666668,-0.126368
8403,6659967,7085,8,0.378801,1,6659967,-1,304.0,6746367,6753452,86400,7085,0,12,True,True,25.46706631111111,-0.3785400869165489
8404,6661077,2266,32,0.735422,171,6746367,-1,320.0,10209054,10211320,3547977,2266,0,8,True,True,18.90261866666667,-0.6820459143523057
8405,6662693,92,1,0.052865,171,6746367,-1,19.0,9973854,9973946,3311161,92,1,8,True,True,0.022670588888888888,-0.052865
8406,6663607,6,2,0.725419,171,6746367,-1,20.0,8208179,8208185,1544572,6,2,0,True,True,0.0014673333333333335,-0.725419
8407,6663928,2959,64,0.9745,171,6746367,-1,384.0,9295314,9298273,2631386,2959,2,1,True,True,28.273836799999998,-0.9745
8408,6664109,6,4,0.707502,171,6746367,-1,148.0,9324614,9324620,2660505,6,2,1,True,True,0.014634733333333334,-0.707502
8409,6667408,18,2,0.249112,171,6746367,-1,78.0,7530289,7530307,862881,18,5,9,True,True,0.0171483,-0.249112
8410,6667915,35,1,0.608703,171,6746367,-1,9.0,10552027,10552062,3884112,35,0,11,True,True,0.008113,-0.608703
8411,6669820,3,1,0.706787,171,6746367,-1,41.0,9900614,9900617,3230794,3,3,6,True,True,0.0030360500000000006,-0.706787
8412,6670131,6799,2,0.183105,171,6746367,-1,18.0,11131533,11138332,4461402,6799,0,2,True,True,1.5994598,-0.1827131877377464
8413,6670278,21978,2,0.986246,171,6746367,-1,50.0,6750867,6772845,80589,21978,9,8,True,True,13.844706250000002,-0.9562280388868308
8414,6670422,210,2,0.798469,171,6746367,-1,40.0,9915254,9915464,3244832,210,4,1,True,True,0.11648000000000001,-0.7984689999999999
8415,6670615,22390,152,0.502229,171,6746367,-1,5472.0,9290959,9313349,2620344,22390,8,8,True,True,2525.0633072,-0.4724978940697908
8416,6670823,31,18,0.275823,171,6746367,-1,270.0,8394679,8394710,1723856,31,9,11,True,True,0.10688025000000001,-0.275823
8417,6671262,315,2,0.427765,171,6746367,-1,58.0,10937992,10938307,4266730,315,1,11,True,True,0.5128287499999999,-0.4277649999999999
8418,6671303,2,60,0.941677,171,6746367,-1,1200.0,9902414,9902416,3231111,2,6,0,True,True,0.05924,-0.941677
8419,6671362,5,8,0.881388,171,6746367,-1,280.0,8578479,8578484,1907117,5,11,11,True,True,0.034086111111111116,-0.881388
8420,6671435,8,2,0.814023,171,6746367,-1,26.0,9807914,9807922,3136479,8,8,7,True,True,0.0038520444444444446,-0.814023
8421,6672239,38,16,0.305187,171,6746367,-1,208.0,9143939,9143977,2471700,38,12,0,True,True,0.06235377777777778,-0.305187
8422,6672376,65655,1,0.857921,171,6746367,-1,14.0,8204579,8270234,1532203,65655,16,0,True,True,12.583517488888889,-0.8568978611462009
8423,6672527,16,32,0.947455,171,6746367,-1,384.0,7741630,7741646,1069103,16,17,11,True,True,0.0991232,-0.947455
8424,6672602,19,2,0.406515,171,6746367,-1,78.0,9029139,9029158,2356537,19,13,8,True,True,0.02809213333333333,-0.406515
8425,6672621,10,1,0.312737,171,6746367,-1,42.0,8893274,8893284,2220653,10,14,7,True,True,0.004111333333333334,-0.312737
8426,6672835,18979,2,0.090141,171,6746367,-1,92.0,8534279,8553258,1861444,18979,16,9,True,True,38.87495036666667,-0.0837675776351266
8427,6673123,6401,32,0.079475,171,6746367,-1,1088.0,9191759,9198160,2518636,6401,12,1,True,True,85.74307680000001,-0.07925169418632742
8428,6673156,13820,1,0.729953,171,6746367,-1,27.0,10890192,10904012,4217036,13820,2,0,True,True,9.3695169,-0.726857984627277
8429,6673287,12,1,0.944867,171,6746367,-1,6.0,9032739,9032751,2359452,12,15,8,True,True,0.0010916,-0.944867
8430,6677934,4116,8,0.165113,171,6746367,-1,160.0,6846267,6850383,168333,4116,25,12,True,True,15.525414666666666,-0.158959915604363
8431,6677950,48,8,0.057412,171,6746367,-1,296.0,11472633,11472681,4794683,48,0,6,True,True,0.48820266666666673,-0.057412
8432,6684601,37,2,0.743409,171,6746367,-1,34.0,9587314,9587351,2902713,37,11,7,True,True,0.0164798,-0.743409
8433,6684784,14,16,0.55416,171,6746367,-1,384.0,10352254,10352268,3667470,14,5,11,True,True,0.1480192,-0.55416
8434,6685046,98,8,0.492851,171,6746367,-1,104.0,9904214,9904312,3219168,98,9,7,True,True,0.23801151111111105,-0.492851
8435,6685053,82,8,0.874353,171,6746367,-1,112.0,7947530,7947612,1262477,82,27,10,True,True,0.0937023111111111,-0.874353
8436,6685090,5649,32,0.962166,171,6746367,-1,256.0,7213367,7219016,528277,5649,30,7,True,True,44.93202417777778,-0.9323264066685182
8437,6685291,41,1,0.423984,171,6746367,-1,34.0,7557789,7557830,872498,41,29,6,True,True,0.04338825,-0.423984
8438,6685422,9165,8,0.508682,171,6746367,-1,264.0,8862076,8871241,2176654,9165,22,0,True,True,27.4572892,-0.4753187426344174
8439,6685437,42,16,0.730797,171,6746367,-1,128.0,8893430,8893472,2207993,42,21,2,True,True,0.05262506666666668,-0.730797
8440,6685575,14349,256,0.479656,171,6746367,-1,8704.0,8033930,8048279,1348355,14349,29,12,True,True,1063.9040156444446,-0.47559854838411886
8441,6685967,370,4,0.515011,171,6746367,-1,80.0,7065067,7065437,379100,370,35,12,True,True,0.6457733333333334,-0.5150109999999999
8442,6687864,3,1,0.997954,171,6746367,-1,42.0,7553289,7553292,865425,3,33,10,True,True,0.0031234,-0.997954
8443,6688959,12,4,0.888081,171,6746367,-1,44.0,7211567,7211579,522608,12,36,0,True,True,0.017299333333333333,-0.888081
8444,6688970,7565,16,0.697882,171,6746367,-1,752.0,10838427,10845992,4149457,7565,4,12,True,True,125.39022422222222,-0.680389417179148
8445,6688989,65,2,0.405471,171,6746367,-1,98.0,7478889,7478954,789900,65,36,0,True,True,0.0888615,-0.405471
8446,6689034,2,4,0.616287,171,6746367,-1,20.0,9963054,9963056,3274020,2,9,11,True,True,0.0006998888888888889,-0.616287
8447,6689145,10104,4,0.910886,171,6746367,-1,96.0,9907814,9917918,3218669,10104,11,8,True,True,18.5455824,-0.8788337480467345
8448,6690630,13444,15,0.745917,171,6746367,-1,225.0,8608495,8621939,1917865,13444,27,8,True,True,31.525549375,-0.7431347866135515
8449,6690784,12,2,0.71416,171,6746367,-1,22.0,8070379,8070391,1379595,12,33,10,True,True,0.004242333333333333,-0.71416
8450,6690805,12,4,0.702592,171,6746367,-1,136.0,7121867,7121879,431062,12,43,8,True,True,0.03142053333333334,-0.702592
8451,6690999,162,4,0.749668,171,6746367,-1,36.0,7216967,7217129,525968,162,41,8,True,True,0.1798362,-0.749668
8452,6691121,122,1,0.244226,171,6746367,-1,19.0,7359267,7359389,668146,122,41,8,True,True,0.10449672777777778,-0.244226
8453,6691182,1384,6,0.738983,171,6746367,-1,228.0,7874030,7875414,1182848,1384,36,7,True,True,3.1800629333333332,-0.738983
8454,6691260,20,2,0.950868,171,6746367,-1,62.0,11114433,11114453,4423173,20,2,8,True,True,0.03113088888888889,-0.9508680000000003
8455,6691976,2,1,0.823363,171,6746367,-1,21.0,7561430,7561432,869454,2,39,2,True,True,0.0015279833333333335,-0.823363
8456,6692023,180,4,0.880332,171,6746367,-1,92.0,7112867,7113047,420844,180,49,11,True,True,0.24541,-0.8803319999999998
8457,6692104,26055,32,0.528111,171,6746367,-1,256.0,10845992,10872047,4153888,26055,5,1,True,True,151.41090559999998,-0.5030909890522971
8458,6692240,2,32,0.609194,171,6746367,-1,1120.0,7611030,7611032,918790,2,40,7,True,True,0.035448,-0.609194
8459,6693041,7498,8,0.607374,171,6746367,-1,208.0,10062054,10069552,3369013,7498,10,7,True,True,34.39738524444444,-0.6067097716262023
8460,6693060,9,9,0.964647,171,6746367,-1,261.0,11446033,11446042,4752973,9,1,11,True,True,0.09367290000000002,-0.964647
8461,6693068,7871,1,0.674522,171,6746367,-1,35.0,7875830,7883701,1182762,7871,40,7,True,True,3.2870840138888893,-0.6667446744451033
8462,6693225,45,2,0.881931,171,6746367,-1,62.0,11236133,11236178,4542908,45,2,0,True,True,0.036533500000000003,-0.881931
8463,6693234,13127,128,0.523516,171,6746367,-1,4096.0,10741227,10754354,4047993,13127,9,10,True,True,1224.7123171555556,-0.5157418623063971
8464,6693334,20781,32,0.225069,171,6746367,-1,192.0,10218054,10238835,3524720,20781,12,9,True,True,159.69368799999998,-0.22284931854395676
8465,6693490,146,1,0.075122,171,6746367,-1,10.0,9562514,9562660,2869024,146,24,7,True,True,0.029277055555555553,-0.075122
8466,6693495,5968,2,0.839409,171,6746367,-1,24.0,10619227,10625195,3925732,5968,10,10,True,True,3.5041142000000005,-0.8310291755359142
8467,6693954,8839,2,0.513684,171,6746367,-1,52.0,9025539,9034378,2331585,8839,33,1,True,True,8.403240444444442,-0.5091212017187328
8468,6694487,18,2,0.952484,171,6746367,-1,30.0,9806114,9806132,3111627,18,24,0,True,True,0.010431,-0.952484
8469,6694554,650,1,0.422722,171,6746367,-1,27.0,10179754,10180404,3485200,650,15,7,True,True,0.14454375,-0.422722
8470,6694558,7636,16,0.379095,171,6746367,-1,480.0,9291859,9299495,2597301,7636,30,6,True,True,87.54499066666666,-0.37680747772094814
8471,6694656,49,1,0.373284,171,6746367,-1,41.0,9560714,9560763,2866058,49,28,0,True,True,0.04887450555555556,-0.373284
8472,6694767,7,1,0.113234,171,6746367,-1,50.0,11350433,11350440,4655666,7,2,7,True,True,0.0075697222222222225,-0.113234
8473,6694773,146,3,0.914045,171,6746367,-1,18.0,11210433,11210579,4515660,146,4,1,True,True,0.04493149999999999,-0.914045
8474,6694882,45,16,0.249765,171,6746367,-1,496.0,7557830,7557875,862948,45,57,1,True,True,0.69471,-0.249765
8475,6694978,6,8,0.53912,171,6746367,-1,352.0,7828030,7828036,1133052,6,54,12,True,True,0.06350666666666667,-0.53912
8476,6695010,8038,256,0.766414,171,6746367,-1,8192.0,10403654,10411692,3708644,8038,14,8,True,True,2303.467246933333,-0.7659767663602192
8477,6695053,16759,64,0.117865,171,6746367,-1,1088.0,6752667,6769426,57614,16759,72,7,True,True,228.8480432,-0.11699401454883203
8478,6695148,93,4,0.299178,171,6746367,-1,112.0,9970254,9970347,3275106,93,21,9,True,True,0.1613612,-0.299178
8479,6695180,58,128,0.293545,171,6746367,-1,3840.0,10842027,10842085,4146847,58,10,8,True,True,4.581226666666666,-0.293545
8480,6695199,6,1,0.213066,171,6746367,-1,50.0,11140533,11140539,4445334,6,5,8,True,True,0.0034358333333333337,-0.213066
8481,6695238,25,4,0.738026,171,6746367,-1,164.0,7478889,7478914,783651,25,67,11,True,True,0.057195,-0.738026
8482,6695298,20,64,0.568842,171,6746367,-1,448.0,8527079,8527099,1831781,20,50,10,True,True,0.2759928888888889,-0.568842
8483,6695334,12654,92,0.217463,171,6746367,-1,2024.0,8349579,8362233,1654245,12654,52,9,True,True,284.7511458,-0.21244705370133113
8484,6695375,8,32,0.30482,171,6746367,-1,800.0,10505292,10505300,3809917,8,16,0,True,True,0.2153422222222222,-0.3048199999999999
8485,6695418,8,2,0.933111,171,6746367,-1,58.0,8204579,8204587,1509161,8,56,12,True,True,0.005426222222222222,-0.933111
8486,6695567,7916,256,0.642974,171,6746367,-1,3072.0,8600579,8608495,1905012,7916,49,10,True,True,290.6177024,-0.6394450766643329
8487,6695643,41,8,0.825727,171,6746367,-1,352.0,8211779,8211820,1516136,41,55,8,True,True,0.1843287111111111,-0.825727
8488,6696117,662,4,0.035429,171,6746367,-1,184.0,9809714,9810376,3113597,662,31,7,True,True,2.3515210222222223,-0.03436515076393091
8489,6696123,68,1,0.463057,171,6746367,-1,7.0,7434689,7434757,738566,68,75,9,True,True,0.01409092222222222,-0.463057
8490,6696212,17714,8,0.617749,171,6746367,-1,256.0,9717914,9735628,3021702,17714,34,12,True,True,98.77041493333334,-0.5664053237543984
8491,6696220,9492,4,0.488266,171,6746367,-1,80.0,9326414,9335906,2630194,9492,38,7,True,True,11.546036,-0.44844249390594165
8492,6696273,189,4,0.355744,171,6746367,-1,24.0,10842027,10842216,4145754,189,11,0,True,True,0.093303,-0.355744
8493,6696284,286,16,0.61553,171,6746367,-1,320.0,8891376,8891662,2195092,286,51,7,True,True,0.9063022222222221,-0.61553
8494,6696298,22865,1,0.328552,171,6746367,-1,47.0,8255979,8278844,1559681,22865,60,11,True,True,9.695461452777778,-0.31788354543665276
8495,6696472,11783,4,0.353893,171,6746367,-1,172.0,9261659,9273442,2565187,11783,44,10,True,True,35.43914373333333,-0.33516083845042294
8496,6696604,20,4,0.005154,171,6746367,-1,80.0,9191739,9191759,2495135,20,46,11,True,True,0.019871111111111114,-0.005154
8497,6696658,25,8,0.890196,171,6746367,-1,312.0,8118179,8118204,1421521,25,67,7,True,True,0.09212666666666668,-0.890196
8498,6698389,10136,2,0.186158,171,6746367,-1,60.0,10890192,10900328,4191803,10136,10,11,True,True,14.759070666666666,-0.1858815782001132
8499,6698447,22,4,0.354532,171,6746367,-1,36.0,7209767,7209789,511320,22,89,9,True,True,0.0277816,-0.354532
8500,6698564,17,1,0.101338,171,6746367,-1,22.0,9899714,9899731,3201150,17,33,12,True,True,0.00952661111111111,-0.101338
8501,6698630,1956,1,0.492046,171,6746367,-1,30.0,8891474,8893430,2192844,1956,55,1,True,True,0.5762091666666667,-0.4879088886011181
8502,6699954,9735,1,0.084744,171,6746367,-1,24.0,10498092,10507827,3798138,9735,19,12,True,True,7.096365800000001,-0.08395492589625417
8503,6705235,25,1,0.514319,171,6746367,-1,42.0,6747267,6747292,42032,25,99,6,True,True,0.012317083333333333,-0.5143190000000001
8504,6705489,19,22,0.153711,171,6746367,-1,924.0,11334233,11334252,4628744,19,3,12,True,True,0.27109390000000005,-0.153711
8505,6705689,2302,8,0.123843,171,6746367,-1,232.0,9813314,9815616,3107625,2302,36,8,True,True,9.262598711111112,-0.10791885155321715
8506,6705986,4,1,0.487412,171,6746367,-1,49.0,10597127,10597131,3891141,4,18,11,True,True,0.005215233333333334,-0.487412
8507,6706134,41,16,0.15563,171,6746367,-1,112.0,11110792,11110833,4404658,41,9,12,True,True,0.12497893333333335,-0.15563000000000002
8508,6706223,14224,2,0.656633,171,6746367,-1,20.0,11136933,11151157,4430710,14224,7,7,True,True,3.125557388888889,-0.6335299248604911
8509,6706301,13442,8,0.226095,171,6746367,-1,288.0,11471733,11485175,4765432,13442,1,8,True,True,120.50101199999997,-0.21878908624237106
8510,6706308,37,1,0.395359,171,6746367,-1,46.0,9560714,9560751,2854406,37,48,12,True,True,0.04140587777777778,-0.395359
8511,6706394,30,8,0.299285,171,6746367,-1,56.0,8694895,8694925,1988501,30,66,12,True,True,0.03461733333333333,-0.299285
8512,6706686,147,32,0.428341,171,6746367,-1,1280.0,7872230,7872377,1165544,147,85,11,True,True,3.7130240000000003,-0.428341
8513,6706712,3,4,0.182182,171,6746367,-1,196.0,10719127,10719130,4012415,3,20,9,True,True,0.015172033333333335,-0.182182
8514,6706728,8,32,0.811544,171,6746367,-1,1152.0,10154054,10154062,3447326,8,31,11,True,True,0.0651008,-0.811544
8515,6706789,20,1,0.108695,171,6746367,-1,28.0,7607430,7607450,900641,20,91,7,True,True,0.009283555555555555,-0.108695
8516,6707123,32855,8,0.438572,171,6746367,-1,208.0,10845627,10878482,4138504,32855,16,3,True,True,154.16076057777778,-0.42830105260443013
8517,6707147,17258,8,0.839357,171,6746367,-1,160.0,11398233,11415491,4691086,17258,3,8,True,True,54.04479822222223,-0.8166889525128164
8518,6708435,4880,1,0.161834,171,6746367,-1,26.0,7556889,7561769,848454,4880,97,8,True,True,4.190864022222222,-0.15271675865048231
8519,6708487,62,4,0.353738,171,6746367,-1,188.0,11121633,11121695,4413146,62,11,9,True,True,0.24597397777777777,-0.353738
8520,6708512,324,4,0.43396,171,6746367,-1,200.0,9295314,9295638,2586802,324,56,0,True,True,1.6124399999999999,-0.43396
8521,6708732,57,1,0.359237,171,6746367,-1,42.0,7202567,7202624,493835,57,110,0,True,True,0.07737940000000001,-0.359237
8522,6708906,16,1,0.870514,171,6746367,-1,21.0,7355667,7355683,646761,16,106,8,True,True,0.008435466666666667,-0.870514
8523,6708965,55,8,0.198465,171,6746367,-1,320.0,11394633,11394688,4685668,55,4,11,True,True,0.5914088888888889,-0.198465
8524,6709526,98,16,0.189567,171,6746367,-1,576.0,10210854,10210952,3501328,98,33,7,True,True,1.5866592,-0.189567
8525,6709543,8202,2,0.040256,171,6746367,-1,88.0,11127033,11135235,4417490,8202,12,7,True,True,14.039071933333332,-0.03186212015607331
8526,6709545,284,16,0.394546,171,6746367,-1,448.0,7211567,7211851,502022,284,113,7,True,True,4.1686151111111105,-0.3945459999999999
8527,6710014,9997,1,0.743924,171,6746367,-1,6.0,8889576,8899573,2179562,9997,74,7,True,True,0.5894673166666666,-0.7429033911708364
8528,6710249,2100,8,0.900998,171,6746367,-1,96.0,8072179,8074279,1361930,2100,90,7,True,True,3.9838400000000007,-0.900998
8529,6710726,20,2,0.160313,171,6746367,-1,78.0,10355854,10355874,3645128,20,32,8,True,True,0.042800333333333336,-0.160313
8530,6710888,13426,42,0.198992,171,6746367,-1,924.0,7523089,7536515,812201,13426,108,11,True,True,167.18848556666669,-0.18807757171021694
8531,6710908,15363,1,0.479295,171,6746367,-1,42.0,9239559,9254922,2528651,15363,65,11,True,True,8.1540669,-0.4746810610983283
8532,6711020,7021,21,0.665243,171,6746367,-1,105.0,8350479,8357500,1639459,7021,85,6,True,True,7.311954999999999,-0.6458018339923264
8533,6711492,20210,4,0.2658,171,6746367,-1,68.0,9143939,9164149,2432447,20210,69,6,True,True,10.261509400000001,-0.25720121457322576
8534,6711790,2644,1,0.421095,171,6746367,-1,43.0,7151167,7153811,439377,2644,123,10,True,True,2.0844235666666666,-0.3708233018613518
8535,6711902,21375,256,0.550124,171,6746367,-1,4352.0,8418579,8439954,1706677,21375,85,10,True,True,2649.2773888,-0.5410303703474055
8536,6712080,73,4,0.79982,171,6746367,-1,124.0,6759867,6759940,47787,73,129,8,True,True,0.12107049999999998,-0.79982
8537,6712146,42,71,0.714321,171,6746367,-1,710.0,7352067,7352109,639921,42,118,6,True,True,0.7474879999999999,-0.714321
8538,6712201,95,1,0.324888,171,6746367,-1,5.0,9467114,9467209,2754913,95,58,11,True,True,0.007881041666666666,-0.324888
8539,6712467,6,16,0.764393,171,6746367,-1,688.0,7605630,7605636,893163,6,107,11,True,True,0.1015144,-0.764393
8540,6712772,33,1,0.881767,171,6746367,-1,38.0,6756267,6756300,43495,33,133,2,True,True,0.015535666666666666,-0.881767
8541,6712792,8619,16,0.501859,171,6746367,-1,560.0,10201854,10210473,3489062,8619,37,10,True,True,82.56119666666666,-0.3895147366589689
8542,6713969,3251,1,0.923561,171,6746367,-1,34.0,10752027,10755278,4038058,3251,24,9,True,True,2.5382325055555555,-0.9053604125085265
8543,6714465,81,5,0.843063,171,6746367,-1,110.0,9333614,9333695,2619149,81,61,9,True,True,0.1116225,-0.843063
8544,6714576,16,2,0.388849,171,6746367,-1,30.0,8904230,8904246,2189654,16,77,8,True,True,0.004653333333333333,-0.388849
8545,6715167,3,1,0.109733,171,6746367,-1,6.0,9023730,9023733,2308563,3,77,9,True,True,0.00035855,-0.109733
8546,6715187,24,26,0.10788,171,6746367,-1,624.0,7359389,7359413,644202,24,123,1,True,True,0.6751264,-0.10788
8547,6715308,98,8,0.021152,171,6746367,-1,304.0,8891376,8891474,2176068,98,82,0,True,True,0.29502355555555554,-0.021152
8548,6715781,6502,8,0.155542,171,6746367,-1,48.0,7351167,7357669,635386,6502,128,12,True,True,7.822265466666668,-0.15538981505832125
8549,6715792,68,1,0.500001,171,6746367,-1,12.0,7877630,7877698,1161838,68,106,7,True,True,0.008790133333333333,-0.500001
8550,6716171,15494,8,0.767385,171,6746367,-1,120.0,11468133,11483627,4751962,15494,2,10,True,True,59.72017066666666,-0.7414766562910157
8551,6716218,21849,2,0.236505,171,6746367,-1,58.0,9239559,9261408,2523341,21849,70,0,True,True,18.477801433333333,-0.2282067829515631
8552,6716224,39,8,0.67831,171,6746367,-1,352.0,7118267,7118306,402043,39,140,7,True,True,0.2080173333333333,-0.6783099999999999
8553,6716336,323,16,0.342141,171,6746367,-1,96.0,7609230,7609553,892894,323,115,7,True,True,0.5140437333333333,-0.342141
8554,6716745,436,9,0.976439,171,6746367,-1,126.0,9805214,9805650,3088469,436,56,12,True,True,1.0611804000000002,-0.976439
8555,6716958,10598,32,0.737432,171,6746367,-1,960.0,7403589,7414187,686631,10598,129,11,True,True,270.34079733333334,-0.6352527806204243
8556,6717398,25270,1,0.434329,171,6746367,-1,9.0,7202567,7227837,485169,25270,141,9,True,True,7.19957705,-0.4236225926780544
8557,6717678,379,4,0.289467,171,6746367,-1,72.0,7068667,7069046,350989,379,146,8,True,True,0.6016246,-0.2894669999999999
8558,6717855,52,3,0.485929,171,6746367,-1,132.0,10507827,10507879,3789972,52,31,2,True,True,0.23095453333333332,-0.48592899999999994
8559,6717865,4,16,0.7609,171,6746367,-1,592.0,9377814,9377818,2659949,4,64,11,True,True,0.05718062222222223,-0.7609
8560,6718881,47,64,0.247747,171,6746367,-1,384.0,8887776,8887823,2168895,47,90,10,True,True,0.17872533333333335,-0.247747
8561,6719183,5048,32,0.152496,171,6746367,-1,896.0,11206833,11211881,4487650,5048,10,11,True,True,81.03294328888889,-0.15243157286473752
8562,6719217,1317,9,0.51124,171,6746367,-1,171.0,8504979,8506296,1785762,1317,99,12,True,True,9.051444675,-0.51124
8563,6719376,16026,16,0.249467,171,6746367,-1,192.0,7561430,7577456,842054,16026,124,0,True,True,103.069488,-0.2445859076587422
8564,6719543,6,16,0.766728,171,6746367,-1,624.0,9147539,9147545,2427996,6,78,8,True,True,0.028267200000000003,-0.766728
8565,6719575,240,8,0.864167,171,6746367,-1,344.0,9915014,9915254,3195439,240,49,9,True,True,1.1448319999999998,-0.864167
8566,6719590,9,4,0.994257,171,6746367,-1,136.0,8803425,8803434,2083835,9,95,12,True,True,0.012348800000000002,-0.994257
8567,6719804,143,8,0.247354,171,6746367,-1,56.0,10400054,10400197,3680250,143,36,11,True,True,0.28261566666666665,-0.247354
8568,6719831,1,3,0.820609,171,6746367,-1,78.0,9422014,9422015,2702183,1,67,11,True,True,0.0009097833333333334,-0.820609
8569,6719897,12,4,0.198412,171,6746367,-1,160.0,9295302,9295314,2575405,12,74,1,True,True,0.047776,-0.198412
8570,6719987,93,8,0.706461,171,6746367,-1,264.0,6932667,6932760,212680,93,160,12,True,True,0.44248160000000003,-0.706461
8571,6720322,860,8,0.809952,171,6746367,-1,336.0,10177954,10178814,3457632,860,44,10,True,True,2.379906666666667,-0.809952
8572,6720698,28,32,0.701145,171,6746367,-1,1344.0,9422914,9422942,2702216,28,68,6,True,True,0.4389354666666667,-0.701145
8573,6720775,10084,1,0.502334,171,6746367,-1,14.0,8972330,8982414,2251555,10084,91,7,True,True,1.2933236555555556,-0.4978748345121627
8574,6724918,7775,1,0.181188,171,6746367,-1,31.0,10065654,10073429,3340736,7775,46,1,True,True,4.936905861111111,-0.17717740560595907
8575,6750100,26,3,0.992552,170,6750867,-1,78.0,7697430,7697456,947330,26,130,12,True,True,0.018516766666666667,-0.992552
8576,6753849,169,4,0.591196,169,6756267,-1,40.0,7239067,7239236,485218,169,152,10,True,True,0.18663233333333332,-0.5911960000000002
8577,6756623,10137,16,0.634477,176,6759867,-1,240.0,6934467,6944604,177844,10137,166,7,True,True,67.425086,-0.5855987240640846
8578,6756733,11913,1,0.229384,176,6759867,-1,30.0,11125233,11137146,4368500,11913,15,8,True,True,6.985202749999999,-0.21318702509218285
8579,6757768,2,4,0.132296,176,6759867,-1,164.0,11162633,11162635,4404865,2,11,10,True,True,0.0080032,-0.132296
8580,6759208,10,8,0.038366,176,6759867,-1,328.0,11024392,11024402,4265184,10,20,12,True,True,0.0824828888888889,-0.038366000000000004
8581,6759419,51,8,0.990399,176,6759867,-1,88.0,8862025,8862076,2102606,51,105,9,True,True,0.0421498,-0.990399
8582,6759463,20,32,0.929098,176,6759867,-1,1184.0,7531189,7531209,771726,20,145,6,True,True,0.33116808888888893,-0.8045550818197456
8583,6759475,9246,1,0.426303,176,6759867,-1,31.0,9287359,9296605,2527884,9246,83,8,True,True,7.081498002777778,-0.41895662827476443
8584,6759776,2755,1,0.616467,176,6759867,-1,37.0,9717914,9720669,2958138,2755,66,0,True,True,1.895881747222222,-0.5928792260781499
8585,6760116,14,16,0.090935,248,6846267,-1,144.0,8396479,8396493,1636363,14,117,7,True,True,0.076328,-0.090935
8586,6760143,10204,8,0.050955,248,6846267,-1,240.0,8717025,8727229,1956882,10204,109,10,True,True,22.912536,-0.047630168290709055
8587,6760202,8,30,0.407297,248,6846267,-1,690.0,7264767,7264775,504565,8,161,10,True,True,0.09095733333333332,-0.407297
8588,6760727,12352,4,0.306446,248,6846267,-1,152.0,11110833,11123185,4350106,12352,19,1,True,True,45.37246908888889,-0.2988976116158135
8589,6760798,17,4,0.63331,248,6846267,-1,156.0,8694925,8694942,1934127,17,111,1,True,True,0.05464593333333334,-0.63331
8590,6760809,91,32,0.231428,248,6846267,-1,1472.0,10205454,10205545,3444645,91,46,8,True,True,1.704167111111111,-0.231428
8591,6760837,5,8,0.336178,248,6846267,-1,272.0,11127933,11127938,4367096,5,15,6,True,True,0.03417377777777778,-0.336178
8592,6760951,309,32,0.479195,248,6846267,-1,288.0,8865676,8865985,2104725,309,109,2,True,True,0.9277415999999999,-0.479195
8593,6761259,15,1,0.509864,248,6846267,-1,21.0,8889576,8889591,2128317,15,107,0,True,True,0.0031193749999999998,-0.509864
8594,6761321,23,2,0.643873,248,6846267,-1,22.0,9143039,9143062,2381718,23,96,12,True,True,0.003991777777777777,-0.643873
8595,6761626,29,4,0.30429,248,6846267,-1,96.0,11239733,11239762,4478107,29,8,8,True,True,0.03291306666666667,-0.30429
8596,6761885,5,2,0.269246,248,6846267,-1,82.0,11337833,11337838,4575948,5,7,8,True,True,0.0072205555555555564,-0.269246
8597,6762086,24,1,0.280556,248,6846267,-1,10.0,11348633,11348657,4586547,24,7,9,True,True,0.005190666666666667,-0.280556
8598,6762107,17051,8,0.351025,248,6846267,-1,384.0,7925430,7942481,1163323,17051,142,11,True,True,71.87043413333332,-0.3247888989193793
8599,6762250,951,16,0.418074,248,6846267,-1,432.0,10621927,10622878,3859677,951,37,7,True,True,9.979794,-0.418074
8600,6762557,16076,1,0.319841,248,6846267,-1,15.0,7116467,7132543,353910,16076,185,8,True,True,5.791778708333333,-0.3014922605227398
8601,6762605,22,4,0.047556,248,6846267,-1,24.0,8342379,8342401,1579774,22,133,12,True,True,0.005472133333333335,-0.047556
8602,6762689,13406,8,0.040889,248,6846267,-1,56.0,10411692,10425098,3649003,13406,44,8,True,True,26.80740471111111,-0.040765285782124065
8603,6762751,645,1,0.052131,248,6846267,-1,24.0,10552927,10553572,3790176,645,40,6,True,True,0.398696,-0.052131
8604,6762947,4452,4,0.744755,248,6846267,-1,148.0,7425689,7430141,662742,4452,170,10,True,True,7.617757333333333,-0.7423890897130584
8605,6763239,643,2,0.211978,248,6846267,-1,60.0,10625527,10626170,3862288,643,37,8,True,True,0.9568911666666666,-0.211978
8606,6763259,6866,64,0.472058,248,6846267,-1,384.0,9321014,9327880,2557755,6866,89,10,True,True,42.7709248,-0.4509527191334676
8607,6763736,251,8,0.908482,248,6846267,-1,120.0,9195359,9195610,2431623,251,99,8,True,True,0.36905366666666667,-0.908482
8608,6764066,118,32,0.100762,248,6846267,-1,768.0,9918854,9918972,3154788,118,64,8,True,True,1.4019029333333335,-0.100762
8609,6764140,11607,7,0.18484,248,6846267,-1,63.0,7242667,7254274,478527,11607,182,8,True,True,10.501016225,-0.15559279793178005
8610,6792760,455,1,0.948328,248,6846267,-1,35.0,8208179,8208634,1415419,455,143,2,True,True,0.19472736111111114,-0.948328
8611,6792892,89,2,0.363581,248,6846267,-1,66.0,9470714,9470803,2677822,89,83,8,True,True,0.13815321666666666,-0.363581
8612,6792903,2,8,0.304357,248,6846267,-1,224.0,8970530,8970532,2177627,2,113,11,True,True,0.004325688888888888,-0.304357
8613,6792922,9391,8,0.096887,248,6846267,-1,296.0,11236133,11245524,4443211,9391,12,10,True,True,36.514923422222225,-0.09429478963669705
8614,6792964,41,4,0.013662,248,6846267,-1,136.0,11214033,11214074,4421069,41,13,8,True,True,0.09167873333333335,-0.013662
8615,6792988,13,8,0.551768,248,6846267,-1,184.0,7403589,7403602,610601,13,180,0,True,True,0.08972657777777776,-0.551768
8616,6793046,25,1,0.861974,248,6846267,-1,7.0,9298914,9298939,2505868,25,94,5,True,True,0.003404722222222222,-0.861974
8617,6793120,1,64,0.331212,248,6846267,-1,3200.0,11135133,11135134,4342013,1,19,1,True,True,0.04094222222222223,-0.331212
8618,6793359,12183,4,0.741292,248,6846267,-1,48.0,8116379,8128562,1323020,12183,153,11,True,True,7.6081592,-0.7325836042596424
8619,6793507,94,2,0.361385,248,6846267,-1,96.0,11246933,11247027,4453426,94,10,9,True,True,0.16175520000000002,-0.361385
8620,6793644,375,2,0.778808,248,6846267,-1,86.0,9585514,9585889,2791870,375,84,10,True,True,0.45060416666666664,-0.778808
8621,6793657,5,1,0.528862,248,6846267,-1,45.0,9806114,9806119,3012457,5,80,6,True,True,0.00434625,-0.528862
8622,6793690,13373,16,0.371592,248,6846267,-1,448.0,10505292,10518665,3711602,13373,49,2,True,True,200.21118008888888,-0.3711142046003828
8623,6794425,36,1,0.650248,248,6846267,-1,48.0,9563414,9563450,2768989,36,87,6,True,True,0.0346512,-0.650248
8624,6794611,16,8,0.210033,248,6846267,-1,296.0,10221654,10221670,3427043,16,56,8,True,True,0.16869368888888886,-0.210033
8625,6794650,8,1,0.384049,248,6846267,-1,34.0,11401833,11401841,4607183,8,4,8,True,True,0.005224666666666667,-0.384049
8626,6794882,6903,16,0.887194,248,6846267,-1,464.0,7881230,7888133,1086348,6903,166,2,True,True,45.484818000000004,-0.8560099620762956
8627,6794897,9,4,0.130485,248,6846267,-1,168.0,9025530,9025539,2230633,9,122,7,True,True,0.029383199999999998,-0.130485
8628,6795119,4,1,0.742587,248,6846267,-1,33.0,7195367,7195371,400248,4,209,11,True,True,0.005194933333333334,-0.742587
8629,6795199,30161,62,0.120354,248,6846267,-1,1984.0,9718814,9748975,2923615,30161,85,6,True,True,1477.478363022222,-0.1153233692655342
8630,6795317,113,1,0.586561,248,6846267,-1,41.0,10620127,10620240,3824810,113,44,6,True,True,0.11254329166666667,-0.586561
8631,6795662,23,4,0.912177,248,6846267,-1,148.0,9054839,9054862,2259177,23,121,10,True,True,0.0509749,-0.912177
8632,6795678,11543,4,0.654355,248,6846267,-1,116.0,9283759,9295302,2488081,11543,111,10,True,True,32.88566102222222,-0.6428254607312434
8633,6795730,72,16,0.190434,248,6846267,-1,192.0,8862076,8862148,2066346,72,141,1,True,True,0.1298304,-0.190434
8634,6795780,240,4,0.70466,248,6846267,-1,116.0,8854825,8855065,2059045,240,143,9,True,True,0.276312,-0.70466
8635,6796706,8,32,0.925501,248,6846267,-1,1536.0,7427489,7427497,630783,8,197,7,True,True,0.14400853333333333,-0.925501
8636,6797232,9963,1,0.07488,248,6846267,-1,30.0,10060254,10070217,3263022,9963,69,12,True,True,6.38686875,-0.07471047672518391
8637,6797280,18,2,0.546579,248,6846267,-1,84.0,9016530,9016548,2219250,18,129,11,True,True,0.020874000000000004,-0.546579
8638,6797293,62,8,0.342898,248,6846267,-1,168.0,10621927,10621989,3824634,62,43,0,True,True,0.253022,-0.342898
8639,6797647,13965,128,0.725351,248,6846267,-1,5248.0,10155854,10169819,3358207,13965,67,7,True,True,609.56176,-0.7251527791393749
8640,6797758,1656,1,0.989645,248,6846267,-1,41.0,11247833,11249489,4450075,1656,11,6,True,True,1.2170358000000001,-0.989645
8641,6797788,16,1,0.201999,248,6846267,-1,20.0,11341433,11341449,4543645,16,9,8,True,True,0.006826666666666667,-0.201999
8642,6797820,77,16,0.720769,248,6846267,-1,320.0,10893792,10893869,4095972,77,34,1,True,True,0.5931395555555555,-0.720769
8643,6797940,56,1,0.043811,248,6846267,-1,19.0,10711927,10711983,3913987,56,45,12,True,True,0.02577244444444444,-0.043811
8644,6801335,5109,64,0.191707,248,6846267,-1,1088.0,8926330,8931439,2124995,5109,138,10,True,True,43.39358346666667,-0.1915845490689722
8645,6801695,17432,1,0.550496,248,6846267,-1,39.0,10501692,10519124,3699997,17432,57,1,True,True,22.16889696666667,-0.550238718540488
8646,6801769,11,1,0.252526,248,6846267,-1,48.0,7129067,7129078,327298,11,228,9,True,True,0.017950533333333338,-0.252526
8647,6801804,22853,35,0.877075,248,6846267,-1,1365.0,10308054,10330907,3506250,22853,64,12,True,True,999.7361351249999,-0.8250215239798049
8648,6801841,23,32,0.853438,248,6846267,-1,480.0,9631514,9631537,2829673,23,98,11,True,True,0.173236,-0.853438
8649,6802457,5,2,0.906815,248,6846267,-1,80.0,8900630,8900635,2098173,5,143,9,True,True,0.003914444444444444,-0.906815
8650,6802703,23827,1,0.975126,248,6846267,-1,6.0,8048279,8072106,1245576,23827,183,9,True,True,3.1233266833333335,-0.9392519424672319
8651,6802844,5402,1,0.894913,248,6846267,-1,41.0,9474314,9479716,2671470,5402,105,8,True,True,8.542870244444446,-0.8636072275252517
8652,6808475,12039,1,0.448482,248,6846267,-1,12.0,9902414,9914453,3093939,12039,87,7,True,True,3.2884724,-0.4270170238647574
8653,6808515,225,16,0.717326,248,6846267,-1,224.0,10744827,10745052,3936312,225,43,8,True,True,1.1375,-0.717326
8654,6809122,42,1,0.910849,248,6846267,-1,47.0,8847625,8847667,2038503,42,160,11,True,True,0.017146383333333334,-0.910849
8655,6809142,3938,1,0.067708,248,6846267,-1,14.0,9056639,9060577,2247497,3938,135,7,True,True,0.8465564722222222,-0.06735907480056769
8656,6809863,679,1,0.419004,248,6846267,-1,18.0,6978667,6979346,168804,679,244,11,True,True,0.2551003,-0.419004
8657,6810153,9066,32,0.931332,248,6846267,-1,320.0,10109854,10118920,3299701,9066,76,11,True,True,70.92639111111112,-0.9221218972663192
6872,5320285,20178,32,0.782156,1,5320285,-1,352.0,5364485,5384663,44200,20178,0,11,True,True,249.68538417777776,-0.7731459210693249
6873,5320299,5629,1,0.947383,70,5364485,-1,18.0,9280278,9285907,3959979,5629,0,8,True,True,3.4460252499999995,-0.9419046048012151
6874,5320322,43,1,0.82361,70,5364485,-1,9.0,6121226,6121269,800904,43,1,0,True,True,0.0187523,-0.82361
6875,5320330,6210,64,0.041969,70,5364485,-1,1216.0,9878443,9884653,4558113,6210,0,6,True,True,287.7667479111111,-0.041773510465157176
6876,5320417,54,8,0.105411,70,5364485,-1,184.0,5761026,5761080,440609,54,3,2,True,True,0.49569599999999997,-0.105411
6877,5320442,4531,11,0.629926,70,5364485,-1,242.0,5546499,5551030,226057,4531,4,6,True,True,43.065764744444444,-0.6283287163703399
6878,5320811,78,1,0.870869,70,5364485,-1,34.0,6963071,6963149,1642260,78,2,11,True,True,0.09856600000000001,-0.870869
6879,5326366,3,16,0.910986,70,5364485,-1,736.0,8307463,8307466,2981097,3,2,0,True,True,0.09680240000000001,-0.9109859999999999
6880,5326406,82,2,0.157033,70,5364485,-1,82.0,9346578,9346660,4020172,82,1,10,True,True,0.2247683777777778,-0.157033
6881,5326414,738,1,0.292123,70,5364485,-1,6.0,7518601,7519339,2192187,738,4,7,True,True,0.1759269,-0.292123
6882,5326463,8,4,0.441518,70,5364485,-1,104.0,7796212,7796220,2469749,8,4,2,True,True,0.040955200000000004,-0.441518
6883,5326490,27824,32,0.505897,70,5364485,-1,1536.0,10283618,10311442,4957128,27824,0,1,True,True,1450.5675093333334,-0.4744379711953829
6884,5326642,8,1,0.732552,70,5364485,-1,24.0,7807020,7807028,2480378,8,5,0,True,True,0.010754133333333332,-0.732552
6885,5326650,12078,75,0.099294,70,5364485,-1,3300.0,5409594,5421672,82944,12078,12,1,True,True,1624.94574,-0.09756013579163499
6886,5326702,2168,1,0.647093,70,5364485,-1,32.0,9089475,9091643,3762773,2168,4,9,True,True,1.2615655111111113,-0.5197711201931045
6887,5326733,123,16,0.334608,70,5364485,-1,608.0,5946426,5946549,619693,123,11,12,True,True,3.6849815999999995,-0.334608
6888,5326785,41,64,0.137772,70,5364485,-1,3072.0,6034826,6034867,708041,41,11,11,True,True,5.6300544,-0.137772
6889,5326885,9,21,0.848595,70,5364485,-1,483.0,5409585,5409594,82700,9,16,11,True,True,0.1703541,-0.848595
6890,5327312,15,32,0.439108,70,5364485,-1,160.0,7962810,7962825,2635498,15,6,7,True,True,0.10912,-0.439108
6891,5329574,6132,123,0.41575,70,5364485,-1,2460.0,8702471,8708603,3372897,6132,5,9,True,True,464.73280650000004,-0.4072565500084693
6892,5329625,78,4,0.769033,70,5364485,-1,200.0,5411394,5411472,81769,78,17,7,True,True,0.6231333333333334,-0.769033
6893,5329685,3044,1,0.245316,70,5364485,-1,10.0,7810620,7813664,2480935,3044,8,3,True,True,0.8593292222222222,-0.24416028980470036
6894,5329717,4,1,0.809145,70,5364485,-1,44.0,9615696,9615700,4285979,4,2,12,True,True,0.008070088888888887,-0.809145
6895,5329743,52,16,0.34132,70,5364485,-1,208.0,8030923,8030975,2701180,52,8,1,True,True,0.5086524444444445,-0.34132
6896,5329758,22,16,0.505023,70,5364485,-1,464.0,5364485,5364507,34727,22,23,0,True,True,0.2449352888888889,-0.505023
6897,5329929,64,8,0.085234,70,5364485,-1,104.0,5756526,5756590,426597,64,19,1,True,True,0.31020657777777777,-0.085234
6898,5329953,19403,32,0.372436,70,5364485,-1,864.0,9505396,9524799,4175443,19403,3,8,True,True,465.35696399999995,-0.3569367656940003
6899,5329987,18,1,0.754845,70,5364485,-1,21.0,5414994,5415012,85007,18,22,0,True,True,0.0157122,-0.754845
6900,5330013,41,1,0.360643,70,5364485,-1,50.0,6300068,6300109,970055,41,16,8,True,True,0.06076541666666667,-0.36064300000000005
6901,5330215,11785,4,0.664995,70,5364485,-1,180.0,6874671,6886456,1544456,11785,16,12,True,True,85.83787399999999,-0.6561509342161977
6902,5330225,41,4,0.151611,70,5364485,-1,116.0,6121226,6121267,791001,41,19,12,True,True,0.23045462222222224,-0.151611
6903,5330796,12039,128,0.753507,70,5364485,-1,4864.0,7807020,7819059,2476224,12039,12,0,True,True,1825.6297642666666,-0.6443766524121761
6904,5331322,6,3,0.421722,70,5364485,-1,81.0,10174727,10174733,4843405,6,1,2,True,True,0.0189189,-0.421722
6905,5331339,5,2,0.228182,70,5364485,-1,94.0,8988475,8988480,3657136,5,8,0,True,True,0.012696527777777777,-0.22818200000000005
6906,5331402,7,1,0.801769,70,5364485,-1,34.0,5365385,5365392,33983,7,32,6,True,True,0.005710677777777778,-0.801769
6907,5331500,12101,32,0.413409,70,5364485,-1,1568.0,8318263,8330364,2986763,12101,10,7,True,True,648.0956819555556,-0.3689161853643116
6908,5331724,2922,1,0.409309,70,5364485,-1,37.0,6183429,6186351,851705,2922,22,8,True,True,3.741916991666667,-0.4071167125516482
6909,5332028,13055,64,0.458753,70,5364485,-1,2944.0,5594299,5607354,262271,13055,29,11,True,True,1439.310012088889,-0.4339787799897296
6910,5332161,81,32,0.85239,70,5364485,-1,512.0,5523499,5523580,191338,81,31,10,True,True,1.7524224,-0.85239
6911,5332646,86,1,0.794607,70,5364485,-1,30.0,5599699,5599785,267053,86,29,8,True,True,0.08526183333333333,-0.794607
6912,5332815,13,62,0.361774,70,5364485,-1,1364.0,8402971,8402984,3070156,13,10,8,True,True,0.5769303222222222,-0.361774
6913,5332881,34,4,0.029763,70,5364485,-1,184.0,5637107,5637141,304226,34,30,8,True,True,0.22040235555555554,-0.029763
6914,5333114,8162,1,0.145584,70,5364485,-1,11.0,6918871,6927033,1585757,8162,21,11,True,True,2.8532836138888884,-0.13881447149707027
6915,5333205,8,1,0.009949,70,5364485,-1,38.0,8399371,8399379,3066166,8,11,11,True,True,0.010119822222222222,-0.009949
6916,5333254,19,1,0.806247,70,5364485,-1,25.0,7494701,7494720,2161447,19,21,9,True,True,0.018725555555555554,-0.806247
6917,5335249,15,1,0.943643,70,5364485,-1,8.0,9637800,9637815,4302551,15,3,10,True,True,0.0035123333333333335,-0.943643
6918,5335270,6733,64,0.084778,70,5364485,-1,2688.0,7961010,7967743,2625740,6733,17,0,True,True,832.7064554666667,-0.08225155903375538
6919,5335279,3,32,0.314805,70,5364485,-1,1120.0,7110832,7110835,1775553,3,24,8,True,True,0.11167333333333335,-0.314805
6920,5340417,383,2,0.981945,70,5364485,-1,92.0,7458135,7458518,2117718,383,24,0,True,True,1.017831011111111,-0.981945
6921,5340511,14931,4,0.164325,70,5364485,-1,124.0,8307463,8322394,2966952,14931,15,12,True,True,85.66645434444445,-0.1638195872313127
6922,5340780,110,6,0.061468,70,5364485,-1,270.0,6187029,6187139,846249,110,31,8,True,True,1.0334775,-0.061468
6923,5340881,12,1,0.759192,70,5364485,-1,5.0,6744071,6744083,1403190,12,30,8,True,True,0.0026446666666666667,-0.759192
6924,5340988,39962,32,0.660176,70,5364485,-1,160.0,7386435,7426397,2045447,39962,26,9,True,True,200.0061897777778,-0.6561047959926459
6925,5344910,8897,8,0.641466,70,5364485,-1,128.0,7964610,7973507,2619700,8897,17,7,True,True,55.50475057777777,-0.6377840821024414
6926,5344928,82,2,0.902511,70,5364485,-1,72.0,7050432,7050514,1705504,82,29,6,True,True,0.2101168,-0.902511
6927,5345018,18384,32,0.05781,70,5364485,-1,992.0,8988475,9006859,3643457,18384,10,6,True,True,578.2715640888889,-0.05472708932336344
6928,5345307,137,1,0.631608,70,5364485,-1,29.0,8777154,8777291,3431847,137,11,10,True,True,0.07522213333333333,-0.631608
6929,5346560,21193,5,0.71337,70,5364485,-1,160.0,7085132,7106325,1738572,21193,31,7,True,True,104.03462400000001,-0.7099229486899438
6930,5346791,429,4,0.660362,70,5364485,-1,172.0,7792601,7793030,2445810,429,26,8,True,True,3.8203736999999998,-0.660362
6931,5347388,67,4,0.519778,70,5364485,-1,76.0,7162235,7162302,1814847,67,31,9,True,True,0.14462694444444443,-0.519778
6932,5347761,27299,2,0.295724,70,5364485,-1,74.0,7807020,7834319,2459259,27299,24,0,True,True,65.06256366666666,-0.27267248585374343
6933,5347929,6468,64,0.402003,70,5364485,-1,1408.0,8849754,8856222,3501825,6468,11,8,True,True,142.86105386666665,-0.3829246043175069
6934,5348178,7111,2,0.680871,70,5364485,-1,28.0,9082275,9089386,3734097,7111,9,11,True,True,5.591218888888888,-0.6354210329547089
6935,5348221,13489,128,0.55361,70,5364485,-1,640.0,5610499,5623988,262278,13489,52,4,True,True,319.17020622222225,-0.5416500381880525
6936,5348239,5,8,0.304323,70,5364485,-1,128.0,5501394,5501399,153155,5,57,12,True,True,0.028837333333333336,-0.304323
6937,5351461,8142,14,0.742698,70,5364485,-1,448.0,8221063,8229205,2869602,8142,20,1,True,True,173.56890257777775,-0.7424435810134006
6938,5351872,9,16,0.909231,70,5364485,-1,688.0,5768226,5768235,416354,9,50,8,True,True,0.2959776,-0.909231
6939,5352215,331,1,0.007902,70,5364485,-1,50.0,5606899,5607230,254684,331,55,8,True,True,0.6945483333333334,-0.007902
6940,5352494,6,38,0.279781,70,5364485,-1,1824.0,5596099,5596105,243605,6,57,7,True,True,0.37823680000000004,-0.279781
6941,5354007,20,4,0.527792,70,5364485,-1,28.0,5860026,5860046,506019,20,50,7,True,True,0.014776222222222222,-0.527792
6942,5354320,591,1,0.920451,70,5364485,-1,15.0,8117323,8117914,2763003,591,21,12,True,True,0.391512875,-0.920451
6943,5365988,59,1,0.700295,135,5409585,-1,30.0,6393668,6393727,1027680,59,44,12,True,True,0.07356808333333334,-0.700295
6944,5366909,14,8,0.446189,135,5409585,-1,88.0,9708643,9708657,4341734,14,3,8,True,True,0.07142862222222221,-0.446189
6945,5368060,28288,32,0.205134,135,5409585,-1,736.0,8607071,8635359,3239011,28288,16,0,True,True,988.8042301333334,-0.19982124286646075
6946,5368628,29,4,0.544425,135,5409585,-1,48.0,7584901,7584930,2216273,29,34,11,True,True,0.055003333333333335,-0.544425
6947,5368861,25820,32,0.788342,135,5409585,-1,1376.0,7057632,7083452,1688771,25820,42,8,True,True,1005.7541607111111,-0.7603443474126147
6948,5369672,15,16,0.652037,135,5409585,-1,800.0,8562871,8562886,3193199,15,17,9,True,True,0.6003333333333334,-0.652037
6949,5370616,1305,1,0.697471,135,5409585,-1,44.0,7699001,7700306,2328385,1305,35,11,True,True,1.3291134999999998,-0.697471
6950,5370641,67,16,0.887675,135,5409585,-1,624.0,8173223,8173290,2802582,67,24,6,True,True,1.6273764,-0.887675
6951,5370673,44,32,0.781563,135,5409585,-1,1120.0,8755054,8755098,3384381,44,15,6,True,True,1.3606755555555559,-0.7815629999999999
6952,5371268,13678,10,0.404506,135,5409585,-1,480.0,5752807,5766485,381539,13678,64,10,True,True,321.7261213333333,-0.40372414465071754
6953,5372935,449,1,0.197296,135,5409585,-1,13.0,7871010,7871459,2498075,449,31,8,True,True,0.23660928055555555,-0.197296
6954,5373410,98,64,0.301531,135,5409585,-1,2752.0,7819059,7819157,2445649,98,32,5,True,True,7.383677155555555,-0.301531
6955,5378120,396,13,0.03697,135,5409585,-1,91.0,10327818,10328214,4949698,396,0,11,True,True,1.0159148999999998,-0.03697
6956,5388412,6,1,0.334493,135,5409585,-1,34.0,10101227,10101233,4712815,6,3,11,True,True,0.008541366666666668,-0.334493
6957,5388565,8152,2,0.725099,135,5409585,-1,88.0,7819610,7827762,2431045,8152,34,2,True,True,23.902985333333334,-0.7023065475849743
6958,5389569,16113,2,0.740052,135,5409585,-1,92.0,6459968,6476081,1070399,16113,57,11,True,True,42.98832224444444,-0.7226196895342687
6959,5389584,10674,128,0.126006,135,5409585,-1,1152.0,9996753,10007427,4607169,10674,4,0,True,True,496.0654752,-0.11982841670351049
6960,5389601,1979,4,0.991924,135,5409585,-1,148.0,8987575,8989554,3597974,1979,16,1,True,True,7.818865077777778,-0.980228890681929
6961,5389650,26581,155,0.283928,135,5409585,-1,2790.0,7107232,7133813,1717582,26581,52,10,True,True,2774.0469737500002,-0.2794875450379276
6962,5391038,45,1,0.09282,135,5409585,-1,8.0,5501399,5501444,110361,45,82,1,True,True,0.016221000000000003,-0.09282000000000001
6963,5391101,5394,8,0.551786,135,5409585,-1,184.0,5545599,5550993,154498,5394,81,10,True,True,38.64286733333333,-0.5503425063087769
6964,5391112,6,4,0.521336,135,5409585,-1,188.0,9870343,9870349,4479231,6,6,8,True,True,0.03826426666666667,-0.521336
6965,5391518,27437,32,0.757046,135,5409585,-1,1344.0,9269478,9296915,3877960,27437,13,1,True,True,1096.2006197333333,-0.7556206577004871
6966,5391702,8,12,0.160027,135,5409585,-1,552.0,5611399,5611407,219697,8,77,6,True,True,0.17900746666666667,-0.160027
6967,5391780,16,1,0.027891,135,5409585,-1,13.0,9183075,9183091,3791295,16,14,12,True,True,0.005551288888888888,-0.027891
6968,5391840,32318,256,0.796599,135,5409585,-1,2304.0,9360978,9393296,3969138,32318,11,7,True,True,2098.3916927999994,-0.772247282339146
6969,5391868,7,1,0.592504,135,5409585,-1,17.0,9705036,9705043,4313168,7,8,1,True,True,0.00664251388888889,-0.592504
6970,5391915,8,16,0.24134,135,5409585,-1,768.0,9705043,9705051,4313128,8,8,1,True,True,0.34295466666666663,-0.24134
6971,5391923,81,1,0.774158,135,5409585,-1,37.0,7379235,7379316,1987312,81,56,12,True,True,0.06718275,-0.774158
6972,5392042,21,8,0.726509,135,5409585,-1,96.0,8987554,8987575,3595512,21,23,11,True,True,0.05446000000000001,-0.7265090000000001
6973,5394059,27,8,0.986955,135,5409585,-1,64.0,7054032,7054059,1659973,27,63,2,True,True,0.0639168,-0.986955
6974,5394249,11103,32,0.110442,135,5409585,-1,352.0,7653001,7664104,2258752,11103,52,10,True,True,88.46291226666666,-0.1104138233931225
6975,5394560,7298,14,0.059946,135,5409585,-1,574.0,9415396,9422694,4020836,7298,13,10,True,True,167.3058145111111,-0.05729687492413143
6976,5394817,14571,2,0.372979,135,5409585,-1,66.0,9884653,9899224,4489836,14571,5,0,True,True,36.8179196,-0.36669770841212623
6977,5394829,50,2,0.62699,135,5409585,-1,12.0,5633507,5633557,238678,50,87,10,True,True,0.02011,-0.62699
6978,5394850,119,1,0.354473,135,5409585,-1,15.0,5756407,5756526,361557,119,85,8,True,True,0.08319091666666666,-0.354473
6979,5394947,10210,61,0.047733,135,5409585,-1,2501.0,7155035,7165245,1760088,10210,62,11,True,True,741.1108744305557,-0.046712054317011885
6980,5395042,13069,128,0.650962,135,5409585,-1,2688.0,9501796,9514865,4106754,13069,14,12,True,True,1031.1602933333334,-0.6476284504648887
6981,5395051,13,1,0.12475,135,5409585,-1,39.0,8332164,8332177,2937113,13,35,7,True,True,0.0134186,-0.12475
6982,5404216,108,8,0.297961,135,5409585,-1,312.0,10283510,10283618,4879294,108,2,8,True,True,1.6054272,-0.297961
6983,5404231,12590,4,0.736859,135,5409585,-1,148.0,7807020,7819610,2402789,12590,52,0,True,True,58.03182366666666,-0.6180878347213393
6984,5404251,19571,32,0.453147,135,5409585,-1,1408.0,9096675,9116246,3692424,19571,22,0,True,True,698.6697578666666,-0.4476059266957753
6985,5404355,423,1,0.982951,135,5409585,-1,37.0,7630001,7630424,2225646,423,60,6,True,True,0.374971875,-0.9829510000000002
6986,5404531,3,32,0.805388,135,5409585,-1,416.0,6122126,6122129,717595,3,84,6,True,True,0.060472533333333335,-0.805388
6987,5404663,8273,256,0.989,135,5409585,-1,4864.0,7486428,7494701,2081765,8273,64,8,True,True,1618.5487473777778,-0.9855962126060298
6988,5404726,360,1,0.565597,135,5409585,-1,17.0,9866743,9867103,4462017,360,9,10,True,True,0.19048500000000002,-0.565597
6989,5404883,1167,32,0.894339,135,5409585,-1,1408.0,5550099,5551266,145216,1167,105,8,True,True,65.6167424,-0.890016821070367
6990,5405062,5649,1,0.627744,135,5409585,-1,47.0,6609871,6615520,1204809,5649,81,8,True,True,7.713947458333333,-0.6267953027435494
6991,5405093,38,1,0.533289,135,5409585,-1,27.0,9906753,9906791,4501660,38,6,10,True,True,0.04310625,-0.533289
6992,5405279,2611,6,0.595549,135,5409585,-1,264.0,6168129,6170740,762850,2611,88,11,True,True,32.510370200000004,-0.5800413926010713
6993,5405300,6178,1,0.350337,135,5409585,-1,50.0,7292835,7299013,1887535,6178,70,12,True,True,8.626913472222224,-0.34610868499814323
6994,5405341,13,32,0.284535,135,5409585,-1,1472.0,5414994,5415007,9653,13,116,2,True,True,0.7954197333333332,-0.284535
6995,5405392,6561,1,0.784789,135,5409585,-1,24.0,9094875,9101436,3689483,6561,25,7,True,True,3.5327676,-0.7246109145876238
6996,5405421,11,5,0.714854,135,5409585,-1,45.0,7792601,7792612,2387180,11,60,0,True,True,0.025628625,-0.714854
6997,5405739,13037,8,0.672434,135,5409585,-1,160.0,10171127,10184164,4765388,13037,4,8,True,True,79.96992222222222,-0.6716763627350968
6998,5405856,10708,4,0.714351,135,5409585,-1,128.0,8447171,8457879,3041315,10708,39,11,True,True,55.354271644444445,-0.6704391629359483
6999,5406099,4,4,0.519667,135,5409585,-1,88.0,7874610,7874614,2468511,4,53,8,True,True,0.013962666666666667,-0.519667
7000,5406479,9453,64,0.247633,135,5409585,-1,448.0,10009227,10018680,4602748,9453,6,7,True,True,261.81682613333334,-0.24532019463711227
7001,5406487,7846,2,0.327847,135,5409585,-1,86.0,5757426,5765272,350939,7846,104,6,True,True,32.71872962222222,-0.3249287974731827
7002,5406499,17137,16,0.582369,135,5409585,-1,176.0,8165123,8182260,2758624,17137,49,1,True,True,115.73284262222222,-0.5811044096824296
7003,5407008,60,32,0.822843,135,5409585,-1,832.0,7540701,7540761,2133693,60,71,10,True,True,1.8258239999999997,-0.822843
7004,5408337,30,1,0.361268,135,5409585,-1,8.0,9884653,9884683,4476316,30,10,2,True,True,0.009306666666666666,-0.361268
7005,5408442,13751,4,0.097988,135,5409585,-1,116.0,7206435,7220186,1797993,13751,80,10,True,True,51.50943427777778,-0.09674075566594599
7006,5408570,39,2,0.71164,135,5409585,-1,26.0,6210029,6210068,801459,39,97,10,True,True,0.03765883333333333,-0.71164
7007,5408757,11264,1,0.828438,135,5409585,-1,26.0,5990626,6001890,581869,11264,105,11,True,True,9.757283611111111,-0.7598152995950918
7008,5408765,62,16,0.081947,135,5409585,-1,752.0,8936154,8936216,3527389,62,35,12,True,True,1.0867277333333334,-0.081947
7009,5408895,18,14,0.062194,135,5409585,-1,532.0,8801054,8801072,3392159,18,37,7,True,True,0.1812258,-0.062194
7010,5409161,8,71,0.888509,135,5409585,-1,2201.0,7083332,7083340,1674171,8,88,8,True,True,0.3510350444444444,-0.888509
7011,5420634,14037,16,0.476253,197,5501394,-1,704.0,7458135,7472172,2037501,14037,79,11,True,True,388.9385573333333,-0.45576382243150476
7012,5422871,157,16,0.446164,197,5501394,-1,400.0,9754643,9754800,4331772,157,14,7,True,True,2.962415555555556,-0.446164
7013,5422941,8321,16,0.369294,197,5501394,-1,112.0,9877543,9885864,4454602,8321,12,9,True,True,35.32411306666667,-0.36826276700711574
7014,5477459,2,8,0.526256,197,5501394,-1,168.0,8607071,8607073,3129612,2,44,11,True,True,0.016612400000000003,-0.526256
7015,5477492,47,4,0.588239,197,5501394,-1,164.0,8693471,8693518,3215979,47,43,12,True,True,0.24149592222222227,-0.588239
7016,5477898,6728,1,0.518945,197,5501394,-1,7.0,6296468,6303196,818570,6728,105,12,True,True,1.610553311111111,-0.5176174548966769
7017,5477922,13,32,0.394782,197,5501394,-1,1536.0,8754154,8754167,3276232,13,42,1,True,True,0.5513386666666668,-0.394782
7018,5478470,419,8,0.263694,197,5501394,-1,296.0,9638700,9639119,4160230,419,19,6,True,True,3.6301135777777773,-0.263694
7019,5478503,40,16,0.498827,197,5501394,-1,96.0,8221023,8221063,2742520,40,57,11,True,True,0.18019200000000002,-0.498827
7020,5478704,24,15,0.423422,197,5501394,-1,735.0,8355171,8355195,2876467,24,52,6,True,True,0.7578829999999999,-0.423422
7021,5478751,62,2,0.44008,197,5501394,-1,54.0,6696271,6696333,1217520,62,105,12,True,True,0.1102143,-0.44008
7022,5479037,2589,2,0.931036,197,5501394,-1,36.0,8799254,8801843,3320217,2589,41,10,True,True,1.7638856999999997,-0.931036
7023,5479188,71,1,0.489541,197,5501394,-1,20.0,8469271,8469342,2990083,71,50,10,True,True,0.06099294444444444,-0.489541
7024,5479215,588,8,0.973272,197,5501394,-1,296.0,9844643,9845231,4365428,588,15,1,True,True,9.1824824,-0.973272
7025,5479876,5033,32,0.823812,197,5501394,-1,416.0,6187929,6192962,708053,5033,115,6,True,True,80.68386213333334,-0.8193296621224315
7026,5479895,11349,1,0.144346,197,5501394,-1,29.0,8309263,8320612,2829368,11349,58,7,True,True,15.28433947777778,-0.14301336222040276
7027,5480199,37,3,0.127124,197,5501394,-1,24.0,9355578,9355615,3875379,37,27,7,True,True,0.029992200000000004,-0.127124
7028,5480208,151,1,0.711151,197,5501394,-1,40.0,8176823,8176974,2696615,151,64,2,True,True,0.22795966666666667,-0.711151
7029,5480252,1035,2,0.129385,197,5501394,-1,30.0,8846154,8847189,3365902,1035,42,11,True,True,0.52414125,-0.12938500000000003
7030,5480313,14,32,0.704525,197,5501394,-1,608.0,5644307,5644321,163994,14,136,9,True,True,0.2783187555555555,-0.704525
7031,5480362,4,1,0.863272,197,5501394,-1,35.0,8172323,8172327,2691961,4,67,9,True,True,0.0054495,-0.863272
7032,5480469,3,4,0.118058,197,5501394,-1,200.0,9269475,9269478,3789006,3,31,12,True,True,0.014788333333333336,-0.118058
7033,5480759,566,16,0.212643,197,5501394,-1,608.0,9096675,9097241,3615916,566,34,7,True,True,7.423860711111111,-0.20446233352064996
7034,5485254,131,2,0.473356,197,5501394,-1,20.0,7702601,7702732,2217347,131,88,8,True,True,0.05921927777777777,-0.473356
7035,5485298,15703,245,0.746496,197,5501394,-1,1470.0,6546368,6562071,1061070,15703,118,0,True,True,649.3565954166667,-0.7226940169637783
7036,5485316,3332,8,0.94407,197,5501394,-1,128.0,9682900,9686232,4197584,3332,20,11,True,True,17.448725333333336,-0.9272758982445932
7037,5486882,13,5,0.369332,197,5501394,-1,180.0,8030910,8030923,2544028,13,74,10,True,True,0.110045,-0.369332
7038,5486925,10610,19,0.951822,197,5501394,-1,323.0,7184335,7194945,1697410,10610,105,10,True,True,137.76471734722222,-0.93834367476344
7039,5487043,7,26,0.6016,197,5501394,-1,1014.0,8354264,8354271,2867221,7,61,10,True,True,0.30495768333333334,-0.6016
7040,5487080,10179,3,0.40862,197,5501394,-1,108.0,9841043,9851222,4353963,10179,16,12,True,True,55.551754800000005,-0.4082699447528247
7041,5487115,84,1,0.120866,197,5501394,-1,18.0,8312863,8312947,2825748,84,65,8,True,True,0.06826679999999999,-0.120866
7042,5487163,45,6,0.571765,197,5501394,-1,204.0,8354271,8354316,2867108,45,62,1,True,True,0.3944085,-0.571765
7043,5487270,308,31,0.040282,197,5501394,-1,1395.0,10193510,10193818,4706240,308,3,9,True,True,12.686905,-0.040282
7044,5487342,177,4,0.153305,197,5501394,-1,28.0,9910353,9910530,4423011,177,9,8,True,True,0.22443796666666666,-0.15330500000000002
7045,5487359,26976,32,0.371467,197,5501394,-1,1344.0,7796220,7823196,2308861,26976,93,1,True,True,1468.3073664,-0.3494537712724112
7046,5487843,2,1,0.99102,197,5501394,-1,13.0,6740471,6740473,1252628,2,126,11,True,True,0.0012152833333333333,-0.99102
7047,5490421,5,1,0.30326,197,5501394,-1,17.0,7961010,7961015,2470589,5,84,12,True,True,0.0038646666666666673,-0.30326
7048,5490572,21,2,0.485926,197,5501394,-1,28.0,8754133,8754154,3263561,21,54,9,True,True,0.016235333333333334,-0.485926
7049,5490962,111,4,0.791204,197,5501394,-1,92.0,9015975,9016086,3525013,111,42,7,True,True,0.2701925,-0.791204
7050,5491084,157,4,0.14214,197,5501394,-1,120.0,9752843,9753000,4261759,157,20,11,True,True,0.8887246666666667,-0.14214
7051,5491425,61,1,0.589624,197,5501394,-1,11.0,7049471,7049532,1558046,61,126,12,True,True,0.02388014444444445,-0.589624
7052,5491435,11921,1,0.048651,197,5501394,-1,44.0,10167527,10179448,4676092,11921,6,11,True,True,19.212970822222218,-0.04776810956081243
7053,5491457,33,16,0.894253,197,5501394,-1,624.0,6788271,6788304,1296814,33,131,11,True,True,0.8997560000000001,-0.894253
7054,5491562,13,16,0.889057,197,5501394,-1,624.0,9014175,9014188,3522613,13,45,10,True,True,0.19139813333333333,-0.889057
7055,5491583,3979,4,0.215581,197,5501394,-1,132.0,6546368,6550347,1054785,3979,138,12,True,True,16.466045933333334,-0.2127287630264092
7056,5491672,6016,16,0.819125,197,5501394,-1,336.0,7807020,7813036,2315348,6016,99,9,True,True,70.06845813333334,-0.6322675807259489
7057,5491709,6190,14,0.488794,197,5501394,-1,350.0,8943354,8949544,3451645,6190,50,9,True,True,46.203781944444444,-0.4760832568771031
7058,5491949,14,16,0.122328,197,5501394,-1,192.0,9393296,9393310,3901347,14,32,7,True,True,0.052192,-0.122328
7059,5491967,22,5,0.348649,197,5501394,-1,110.0,9359178,9359200,3867211,22,34,8,True,True,0.07514772222222223,-0.348649
7060,5491982,9,32,0.870427,197,5501394,-1,832.0,6415768,6415777,923786,9,144,10,True,True,0.16500639999999997,-0.870427
7061,5492093,656,13,0.417575,197,5501394,-1,468.0,7516801,7517457,2024708,656,114,10,True,True,12.197598400000002,-0.417575
7062,5492111,86,6,0.573059,197,5501394,-1,150.0,5730707,5730793,238596,86,167,12,True,True,0.5708608333333334,-0.573059
7063,5492209,66,4,0.565764,197,5501394,-1,124.0,8008810,8008876,2516601,66,89,11,True,True,0.3921954666666667,-0.565764
7064,5492297,16,2,0.900287,197,5501394,-1,82.0,8330364,8330380,2838067,16,75,2,True,True,0.03159004444444445,-0.900287
7065,5492396,13696,10,0.781349,197,5501394,-1,260.0,5603299,5616995,110903,13696,176,2,True,True,142.69505827777778,-0.7699140114197159
7066,5492736,12909,32,0.475228,197,5501394,-1,416.0,5633507,5646416,140771,12909,172,0,True,True,184.27179679999998,-0.4663263835514263
7067,5492746,6972,4,0.720033,197,5501394,-1,96.0,6175329,6182301,682583,6972,155,9,True,True,21.680972800000003,-0.6885093255100478
7068,5492762,7019,8,0.60571,197,5501394,-1,336.0,5854626,5861645,361864,7019,164,12,True,True,61.167546533333336,-0.5485274563933257
7069,5492799,67,8,0.761951,197,5501394,-1,400.0,5764626,5764693,271827,67,166,2,True,True,1.2965244444444444,-0.761951
7070,5493423,5372,16,0.504764,197,5501394,-1,96.0,8161523,8166895,2668100,5372,87,11,True,True,17.9345152,-0.5047543033519051
7071,5493530,88,13,0.460936,197,5501394,-1,78.0,8992075,8992163,3498545,88,48,8,True,True,0.1732016,-0.460936
7072,5493769,13421,1,0.449929,197,5501394,-1,17.0,7792612,7806033,2298843,13421,109,1,True,True,12.1085118,-0.4376657499882919
7073,5493787,13,8,0.449075,197,5501394,-1,80.0,8316463,8316476,2822676,13,78,8,True,True,0.04794977777777777,-0.449075
7074,5493820,8,4,0.866346,197,5501394,-1,192.0,10053427,10053435,4559607,8,8,11,True,True,0.042679466666666666,-0.866346
7075,5498257,36,16,0.325216,197,5501394,-1,768.0,9705000,9705036,4206743,36,26,10,True,True,1.543296,-0.325216
7076,5498524,6193,16,0.799812,197,5501394,-1,272.0,7480235,7486428,1981711,6193,125,10,True,True,67.83949204444446,-0.7653472943684989
7077,5498578,7933,4,0.664502,197,5501394,-1,92.0,8695271,8703204,3196693,7933,66,7,True,True,22.743853855555557,-0.6501656647664676
7078,5503043,45,2,0.409628,232,5523499,-1,98.0,9353778,9353823,3850735,45,38,8,True,True,0.14894775000000002,-0.409628
7079,5503055,41,4,0.232822,232,5523499,-1,104.0,7654801,7654842,2151746,41,119,7,True,True,0.09720735555555554,-0.232822
7080,5503068,48,18,0.395397,232,5523499,-1,90.0,10279910,10279958,4776842,48,3,12,True,True,0.24044400000000002,-0.395397
7081,5503216,94,4,0.540994,232,5523499,-1,116.0,7845310,7845404,2342094,94,105,10,True,True,0.3599228666666667,-0.540994
7082,5503428,11,1,0.958079,232,5523499,-1,50.0,6210068,6210079,706640,11,163,1,True,True,0.02042638888888889,-0.958079
7083,5503584,37,1,0.890043,232,5523499,-1,6.0,7867410,7867447,2363826,37,105,10,True,True,0.009042183333333334,-0.890043
7084,5503596,4,1,0.735913,232,5523499,-1,5.0,7413935,7413939,1910339,4,134,7,True,True,0.0006707777777777777,-0.735913
7085,5503600,11,32,0.645917,232,5523499,-1,1280.0,7079732,7079743,1576132,11,146,10,True,True,0.2985742222222223,-0.645917
7086,5503641,4,4,0.865954,232,5523499,-1,72.0,6123929,6123933,620288,4,173,7,True,True,0.012398399999999999,-0.865954
7087,5503690,23431,64,0.707209,232,5523499,-1,704.0,7799820,7823251,2296130,23431,115,8,True,True,642.8923717333332,-0.6552275036898263
7088,5503736,280,16,0.571995,232,5523499,-1,528.0,9350178,9350458,3846442,280,40,8,True,True,4.781392,-0.571995
7089,5503803,35,16,0.796159,232,5523499,-1,256.0,7110835,7110870,1607032,35,144,1,True,True,0.2977955555555556,-0.7961590000000002
7090,5504030,35,2,0.707399,232,5523499,-1,44.0,9882043,9882078,4378013,35,16,2,True,True,0.05971777777777777,-0.707399
7091,5504142,9,2,0.561044,232,5523499,-1,42.0,8801954,8801963,3297812,9,63,6,True,True,0.00715365,-0.561044
7092,5504872,4,4,0.123782,232,5523499,-1,120.0,8555671,8555675,3050799,4,76,12,True,True,0.024068,-0.123782
7093,5505288,30625,128,0.559353,232,5523499,-1,6272.0,7630901,7661526,2125613,30625,129,6,True,True,4717.5158986666665,-0.5547169909003034
7094,5505382,7,2,0.192427,232,5523499,-1,32.0,9529296,9529303,4023914,7,33,10,True,True,0.0087752,-0.192427
7095,5505403,262,33,0.618704,232,5523499,-1,1023.0,8746671,8746933,3241268,262,71,11,True,True,8.203084633333333,-0.618704
7096,5505919,8727,128,0.576856,232,5523499,-1,4992.0,9093075,9101802,3587156,8727,51,8,True,True,962.8160256,-0.5385276019548015
7097,5506043,1264,1,0.052874,232,5523499,-1,16.0,7823210,7824474,2317167,1264,114,4,True,True,0.6904810666666666,-0.052874
7098,5506093,121,1,0.570244,232,5523499,-1,5.0,9507196,9507317,4001103,121,34,7,True,True,0.019301180555555558,-0.570244
7099,5507487,30,8,0.189396,232,5523499,-1,352.0,6122129,6122159,614642,30,186,1,True,True,0.5116906666666666,-0.189396
7100,5508181,351,2,0.475836,232,5523499,-1,78.0,6179829,6180180,671648,351,183,6,True,True,0.9121437000000001,-0.475836
7101,5508235,556,16,0.896864,232,5523499,-1,608.0,7629101,7629657,2120866,556,136,11,True,True,8.099066666666667,-0.896864
7102,5508271,117,32,0.120283,232,5523499,-1,896.0,9038075,9038192,3529804,117,55,10,True,True,2.1452704000000002,-0.120283
7103,5512274,9671,7,0.936182,232,5523499,-1,168.0,6307268,6316939,794994,9671,178,9,True,True,46.697023333333334,-0.9280663552340706
7104,5512317,6,1,0.179743,232,5523499,-1,13.0,8746933,8746939,3234616,6,74,1,True,True,0.0023872333333333335,-0.17974300000000004
7105,5512777,20,7,0.018974,232,5523499,-1,168.0,8329063,8329083,2816286,20,92,9,True,True,0.08090133333333335,-0.018974
7106,5513422,88,138,0.786757,232,5523499,-1,3864.0,10007427,10007515,4494005,88,11,0,True,True,11.589424000000001,-0.786757
7107,5513454,3,10,0.245287,232,5523499,-1,490.0,6606271,6606274,1092817,3,176,11,True,True,0.05565991666666667,-0.245287
7108,5513708,7,2,0.705618,232,5523499,-1,10.0,8746933,8746940,3233225,7,75,0,True,True,0.002142388888888889,-0.705618
7109,5517238,53,1,0.887656,232,5523499,-1,30.0,7390035,7390088,1872797,53,152,1,True,True,0.040474333333333334,-0.887656
7110,5519081,16744,4,0.444229,232,5523499,-1,76.0,5606899,5623643,87818,16744,219,0,True,True,48.334218433333334,-0.43549991966908935
7111,5519111,53,15,0.806921,232,5523499,-1,645.0,6562071,6562124,1042960,53,179,2,True,True,0.9160630416666666,-0.8069209999999998
7112,5519157,42120,185,0.606855,232,5523499,-1,5920.0,10053427,10095547,4534270,42120,9,0,True,True,8300.13345111111,-0.5908120161189292
7113,5519879,144,4,0.401798,232,5523499,-1,108.0,7789001,7789145,2269122,144,136,12,True,True,0.8143632,-0.401798
7114,5522376,10914,32,0.044984,232,5523499,-1,1152.0,5858226,5869140,335850,10914,207,1,True,True,376.35265919999995,-0.04261478034288604
7115,5524692,16121,8,0.861974,244,5545599,-1,248.0,10349918,10366039,4825226,16121,0,10,True,True,201.9367472888889,-0.812093456661972
7116,5525123,5,6,0.023263,244,5545599,-1,252.0,10123327,10123332,4598204,5,9,10,True,True,0.05232849999999999,-0.023263
7117,5525158,6,13,0.437017,244,5545599,-1,624.0,6178929,6178935,653771,6,198,8,True,True,0.12473760000000002,-0.43701699999999993
7118,5525495,6,60,0.414936,244,5545599,-1,1980.0,8321863,8321869,2796368,6,98,3,True,True,0.5522549999999999,-0.4149359999999999
7119,5526245,9346,256,0.859648,244,5545599,-1,9984.0,10184164,10193510,4657919,9346,6,2,True,True,2530.584576,-0.715026806024467
7120,5526393,11543,64,0.317382,244,5545599,-1,2432.0,5611407,5622950,85014,11543,226,1,True,True,1038.8656110222223,-0.3069889379090166
7121,5526548,25,1,0.257178,244,5545599,-1,41.0,9276678,9276703,3750130,25,51,9,True,True,0.030658888888888892,-0.257178
7122,5526694,11103,1,0.114645,244,5545599,-1,21.0,10057027,10068130,4530333,11103,12,8,True,True,7.071208783333335,-0.11406405964079616
7123,5526755,39,32,0.099334,244,5545599,-1,1120.0,7412135,7412174,1885380,39,160,10,True,True,1.345950666666667,-0.099334
7124,5526871,12087,32,0.168156,244,5545599,-1,1216.0,9996753,10008840,4469882,12087,18,12,True,True,581.7528122666666,-0.16033709648890543
7125,5526964,9,32,0.144034,244,5545599,-1,1472.0,9615700,9615709,4088736,9,39,1,True,True,0.6074576,-0.144034
7126,5529375,6075,128,0.255555,244,5545599,-1,4480.0,7049532,7055607,1520157,6075,180,1,True,True,988.7015040000001,-0.2549194694803213
7127,5529431,6,1,0.089629,244,5545599,-1,31.0,9324478,9324484,3795047,6,53,11,True,True,0.004977566666666667,-0.089629
1150,994133,154,1,0.052609,1,994133,-1,17.0,995033,995187,900,154,0,6,True,True,0.11040687777777777,-0.052609
1151,994202,6763,2,0.15741,4,995033,-1,26.0,4585642,4592405,3591440,6763,0,12,True,True,7.830079255555554,-0.147957447704662
1152,994284,10744,16,0.617838,4,995033,-1,224.0,2291115,2301859,1296831,10744,1,11,True,True,105.98443706666666,-0.5862856951001227
1153,994848,30,1,0.673969,4,995033,-1,27.0,2447866,2447896,1453018,30,1,6,True,True,0.0322605,-0.673969
1154,994925,4132,128,0.272103,4,995033,-1,1536.0,1039233,1043365,44308,4132,3,11,True,True,273.57099946666665,-0.26103882476792695
1155,995038,72,1,0.661939,9,1039233,-1,28.0,1075699,1075771,80661,72,3,8,True,True,0.05932080000000001,-0.661939
1156,995070,14346,1,0.485662,9,1039233,-1,33.0,1072099,1086445,77029,14346,4,7,True,True,13.438534358333333,-0.48440202837413365
1157,995191,16,40,0.442044,9,1039233,-1,520.0,1070299,1070315,75108,16,5,8,True,True,0.227136,-0.442044
1158,995919,234,8,0.273167,9,1039233,-1,280.0,1327099,1327333,331180,234,3,0,True,True,2.629172,-0.273167
1159,995960,21928,16,0.754943,9,1039233,-1,304.0,1097799,1119727,101839,21928,4,10,True,True,225.38096146666663,-0.7198359614636293
1160,995966,8966,256,0.113818,9,1039233,-1,7936.0,1061333,1070299,65367,8966,8,10,True,True,2321.607271822222,-0.10388842068860665
1161,1093171,1,5,0.429914,31,1097799,-1,250.0,3468282,3468283,2375111,1,1,11,True,True,0.008309027777777778,-0.429914
1162,1093221,15556,64,0.283246,31,1097799,-1,1280.0,4875242,4890798,3782021,15556,0,12,True,True,833.1872142222222,-0.27695286770905825
1163,1093281,10,1,0.678486,31,1097799,-1,25.0,1137899,1137909,44618,10,6,5,True,True,0.01059375,-0.678486
1164,1093299,23,1,0.486633,31,1097799,-1,10.0,2358718,2358741,1265419,23,4,6,True,True,0.009288166666666667,-0.486633
1165,1093712,4738,32,0.667133,31,1097799,-1,800.0,5209442,5214180,4115730,4738,0,10,True,True,59.70667111111112,-0.6395993772285674
1166,1093772,12,8,0.045417,31,1097799,-1,128.0,2796948,2796960,1703176,12,4,6,True,True,0.03307946666666667,-0.045417
1167,1093777,14,8,0.395263,31,1097799,-1,336.0,3374482,3374496,2280705,14,4,12,True,True,0.11703813333333332,-0.395263
1168,1093910,16958,1,0.599325,31,1097799,-1,42.0,1130699,1147657,36789,16958,11,1,True,True,29.11360421666667,-0.5990730531657288
1169,1093937,63,1,0.007687,31,1097799,-1,21.0,1825486,1825549,731549,63,9,12,True,True,0.043776600000000006,-0.007686999999999999
1170,1093970,6681,4,0.301419,31,1097799,-1,136.0,1127099,1133780,33129,6681,13,0,True,True,36.38454126666667,-0.30120846186112643
1171,1094413,13584,4,0.211234,31,1097799,-1,136.0,3687761,3701345,2593348,13584,3,8,True,True,75.77700926666667,-0.2049679114194979
1172,1094762,81,1,0.137235,31,1097799,-1,33.0,5660362,5660443,4565600,81,0,6,True,True,0.0687852,-0.137235
1173,1094806,4127,4,0.25552,31,1097799,-1,20.0,1603835,1607962,509029,4127,12,11,True,True,2.9391773333333333,-0.24549001193533518
1174,1094913,15538,1,0.328122,31,1097799,-1,6.0,1119899,1135437,24986,15538,17,10,True,True,3.64286705,-0.3258678612053601
1175,1095007,5,6,0.00773,31,1097799,-1,246.0,1134299,1134304,39292,5,15,8,True,True,0.04892325,-0.00773
1176,1095043,7568,1,0.747014,31,1097799,-1,33.0,1127099,1134667,32056,7568,18,0,True,True,9.997857283333335,-0.7458506873333267
1177,1095366,20494,2,0.175695,31,1097799,-1,22.0,1127099,1147593,31733,20494,19,9,True,True,18.337394105555553,-0.17568712217748172
1178,1095385,18,16,0.380207,31,1097799,-1,96.0,3950761,3950779,2855376,18,4,12,True,True,0.0697632,-0.380207
1179,1095413,34,4,0.703671,31,1097799,-1,156.0,3286282,3286316,2190869,34,8,10,True,True,0.16077013333333334,-0.703671
1180,1095456,22,2,0.500262,31,1097799,-1,90.0,3124582,3124604,2029126,22,9,6,True,True,0.068541,-0.500262
1181,1095651,10565,1,0.833354,31,1097799,-1,14.0,3288082,3298647,2192431,10565,8,7,True,True,5.197181966666667,-0.7949842320139863
1182,1095814,3,16,0.8062,31,1097799,-1,320.0,1185699,1185702,89885,3,18,11,True,True,0.04685333333333333,-0.8062
1183,1095861,25,1,0.072075,31,1097799,-1,47.0,5663962,5663987,4568101,25,0,8,True,True,0.033516874999999995,-0.072075
1184,1095977,15240,7,0.861764,31,1097799,-1,161.0,3129982,3145222,2034005,15240,11,7,True,True,95.25160353333334,-0.8304320868231769
1185,1095989,22,1,0.042302,31,1097799,-1,26.0,5267187,5267209,4171198,22,2,10,True,True,0.016279755555555553,-0.042302
1186,1096064,35,2,0.018742,31,1097799,-1,50.0,3595761,3595796,2499697,35,8,12,True,True,0.05801736111111111,-0.018742
1187,1097312,6379,2,0.921162,31,1097799,-1,14.0,4970842,4977221,3873530,6379,4,8,True,True,3.886075238888889,-0.8209893543977541
1188,1098703,9,1,0.86211,33,1119899,-1,31.0,3798061,3798070,2699358,9,8,0,True,True,0.010305175,-0.86211
1189,1102692,3,8,0.575759,33,1119899,-1,328.0,4674742,4674745,3572050,3,6,0,True,True,0.04536786666666667,-0.575759
1190,1102770,8,2,0.5734,33,1119899,-1,50.0,2898848,2898856,1796078,8,18,7,True,True,0.012314444444444446,-0.5734
1191,1126168,9182,1,0.709499,35,1127099,-1,29.0,4402042,4411224,3275874,9182,8,8,True,True,13.463424322222222,-0.6991655893769516
1192,1126543,12,1,0.417694,35,1127099,-1,46.0,5093742,5093754,3967199,12,4,10,True,True,0.017211666666666667,-0.417694
1193,1126627,8,2,0.115173,35,1127099,-1,24.0,4178142,4178150,3051515,8,10,12,True,True,0.0060464,-0.115173
1194,1127158,4722,32,0.020857,33,1130699,-1,512.0,1374899,1379621,247741,4722,28,7,True,True,58.28168248888889,-0.01749190238643127
1195,1135592,103,36,0.324768,34,1137899,-1,1296.0,5557548,5557651,4421956,103,2,11,True,True,5.1789635999999994,-0.324768
1196,1135907,12,1,0.801322,34,1137899,-1,21.0,5305489,5305501,4169582,12,3,9,True,True,0.0049763,-0.801322
1197,1137382,3744,8,0.618125,34,1137899,-1,232.0,1141499,1145243,4117,3744,33,2,True,True,36.19154437777778,-0.6152130970928295
1198,1139349,9081,1,0.832026,34,1141499,-1,41.0,5926332,5935413,4786983,9081,0,9,True,True,19.591705133333335,-0.8253677653416925
1199,1146845,26,1,0.91977,149,1185699,-1,35.0,3980061,3980087,2833216,26,14,9,True,True,0.020674694444444443,-0.91977
1200,1146985,279,1,0.08813,149,1185699,-1,13.0,2301918,2302197,1154933,279,29,1,True,True,0.17872042499999996,-0.08813
1201,1147010,5,23,0.844484,149,1185699,-1,460.0,4031300,4031305,2884290,5,14,11,True,True,0.050465833333333335,-0.844484
1202,1147066,593,16,0.243316,149,1185699,-1,800.0,4405642,4406235,3258576,593,12,1,True,True,25.15901333333333,-0.243316
1203,1147188,25840,32,0.588871,149,1185699,-1,1376.0,5845993,5871833,4698805,25840,1,1,True,True,1179.2049883555553,-0.5587836079376911
1204,1147611,3,10,0.523963,149,1185699,-1,190.0,2301915,2301918,1154304,3,33,7,True,True,0.02808675,-0.5239629999999998
1205,1148007,12000,2,0.395767,149,1185699,-1,26.0,1323499,1335499,175492,12000,39,11,True,True,11.172488816666666,-0.362876021447869
1206,1149858,6,8,0.310275,149,1185699,-1,344.0,5845987,5845993,4696129,6,2,8,True,True,0.08577066666666666,-0.310275
1207,1149895,19,1,0.339513,149,1185699,-1,26.0,4186242,4186261,3036347,19,16,9,True,True,0.017502694444444446,-0.339513
1208,1149959,40703,8,0.333069,149,1185699,-1,264.0,2354218,2394921,1204259,40703,34,6,True,True,379.52792606666674,-0.3164741974345602
1209,1150623,31,1,0.168133,149,1185699,-1,22.0,2935348,2935379,1784725,31,30,9,True,True,0.014806977777777775,-0.168133
1210,1150917,11999,8,0.510483,149,1185699,-1,296.0,2516866,2528865,1365949,11999,33,10,True,True,155.85027766666667,-0.5071502468575501
1211,1151265,945,1,0.114027,149,1185699,-1,48.0,5214842,5215787,4063577,945,8,8,True,True,0.7610399999999999,-0.114027
1212,1151881,41,4,0.509952,149,1185699,-1,140.0,5071642,5071683,3919761,41,11,12,True,True,0.17963011111111113,-0.509952
1213,1152096,5885,64,0.905923,149,1185699,-1,1664.0,3101548,3107433,1949452,5885,32,10,True,True,416.65601351111115,-0.8624434055636936
1214,1152326,16,4,0.349375,149,1185699,-1,40.0,3987100,3987116,2834774,16,21,6,True,True,0.015333333333333334,-0.349375
1215,1152376,78,1,0.727379,149,1185699,-1,10.0,2874948,2875026,1722572,78,36,8,True,True,0.02447466666666667,-0.727379
1216,1152625,2691,32,0.818949,149,1185699,-1,992.0,3263282,3265973,2110657,2691,31,7,True,True,93.75884968888889,-0.8037029123421685
1217,1154344,11288,256,0.815037,149,1185699,-1,6656.0,3864361,3875649,2710017,11288,24,10,True,True,2746.5006492444445,-0.7990520814686628
1218,1154580,39231,21,0.236269,149,1185699,-1,756.0,2292915,2332146,1138335,39231,46,7,True,True,1266.7389210000001,-0.2323410046592053
1219,1154754,47,4,0.146444,149,1185699,-1,76.0,5950379,5950426,4795625,47,0,7,True,True,0.1451025777777778,-0.146444
1220,1154807,20,1,0.197272,149,1185699,-1,6.0,3639961,3639981,2485154,20,28,11,True,True,0.0035640000000000003,-0.19727199999999998
1221,1155116,73,1,0.602399,149,1185699,-1,21.0,4353342,4353415,3198226,73,19,1,True,True,0.07779549166666667,-0.602399
1222,1156885,275,32,0.760215,149,1185699,-1,544.0,1916449,1916724,759564,275,51,2,True,True,4.961317777777778,-0.760215
1223,1156930,21,16,0.655509,149,1185699,-1,272.0,4499242,4499263,3342312,21,17,12,True,True,0.23565173333333336,-0.655509
1224,1157013,250,16,0.177146,149,1185699,-1,736.0,5313589,5313839,4156576,250,7,0,True,True,3.368939822222222,-0.16649662811692567
1225,1157242,3957,128,0.772848,149,1185699,-1,5760.0,4047542,4051499,2890300,3957,24,7,True,True,552.94256,-0.7623732871561286
1226,1157590,4,1,0.494117,149,1185699,-1,29.0,3842261,3842265,2684671,4,30,11,True,True,0.004638711111111111,-0.494117
1227,1157662,571,4,0.754446,149,1185699,-1,72.0,2357818,2358389,1200156,571,50,8,True,True,1.6176879999999998,-0.7351097039535739
1228,1157674,47,22,0.759877,149,1185699,-1,396.0,1272099,1272146,114425,47,62,12,True,True,0.6506445000000001,-0.759877
1229,1157686,12145,27,0.448905,149,1185699,-1,972.0,1275699,1287844,118013,12145,62,0,True,True,415.39501889999997,-0.4356912290050631
1230,1158062,1278,1,0.924154,149,1185699,-1,49.0,1920049,1921327,761987,1278,56,8,True,True,2.2453466000000004,-0.924154
1231,1158132,9455,1,0.564492,149,1185699,-1,29.0,4376342,4385797,3218210,9455,21,10,True,True,12.781884688888889,-0.5513207670441386
1232,1159630,20,4,0.635298,149,1185699,-1,116.0,3424082,3424102,2264452,20,37,11,True,True,0.068614,-0.635298
1233,1160181,12751,8,0.624522,149,1185699,-1,104.0,1629535,1642286,469354,12751,61,10,True,True,51.40368913333333,-0.6045134393330497
1234,1160206,1405,23,0.864247,149,1185699,-1,1035.0,2826248,2827653,1666042,1405,48,0,True,True,39.626268749999994,-0.864247
1235,1162444,17559,29,0.627217,149,1185699,-1,1276.0,5379889,5397448,4217445,17559,7,10,True,True,518.0563296333333,-0.6037763403522902
1236,1162633,10395,1,0.150957,149,1185699,-1,20.0,4963642,4974037,3801009,10395,16,11,True,True,10.780603888888889,-0.14626381434585695
1237,1162667,27183,1,0.068286,149,1185699,-1,37.0,5312689,5339872,4150022,27183,9,9,True,True,21.289593930555558,-0.06666979854631647
1238,1162881,1,1,0.442208,149,1185699,-1,20.0,2324018,2324019,1161137,1,58,10,True,True,0.000825,-0.442208
1239,1162899,378,16,0.30282,149,1185699,-1,240.0,5276189,5276567,4113290,378,11,7,True,True,2.2115519999999997,-0.30282
1240,1162909,8618,32,0.274674,149,1185699,-1,1408.0,5313589,5322207,4150680,8618,9,6,True,True,233.6400743111111,-0.24027201734488107
1241,1162924,907,61,0.056172,149,1185699,-1,1220.0,1376699,1377606,213775,907,70,7,True,True,26.618434444444446,-0.056172
1242,1162981,3,2,0.507337,149,1185699,-1,40.0,3376282,3376285,2213301,3,43,7,True,True,0.0029856666666666664,-0.507337
1243,1163064,15836,49,0.310408,149,1185699,-1,735.0,1371299,1387135,208235,15836,73,10,True,True,294.98295429166666,-0.2500500175916061
1244,1163448,240,4,0.451914,149,1185699,-1,188.0,5874932,5875172,4711484,240,2,2,True,True,1.010312,-0.451914
1245,1164035,54,2,0.05689,149,1185699,-1,16.0,5187342,5187396,4023307,54,17,8,True,True,0.013608,-0.05689
1246,1164071,1339,2,0.831697,149,1185699,-1,98.0,1559635,1560974,395564,1339,73,12,True,True,4.983155450000001,-0.831697
1247,1165297,130,1,0.076731,149,1185699,-1,29.0,5919132,5919262,4753835,130,2,11,True,True,0.17119988888888887,-0.076731
1248,1165977,107,16,0.86425,149,1185699,-1,480.0,3980087,3980194,2814110,107,36,1,True,True,1.1668706666666668,-0.86425
1249,1166085,343,1,0.855293,149,1185699,-1,21.0,1473235,1473578,307150,343,76,9,True,True,0.29584321666666674,-0.855293
1250,1166325,41,16,0.615008,149,1185699,-1,176.0,3264182,3264223,2097857,41,51,6,True,True,0.25825262222222223,-0.615008
1251,1166467,320,4,0.507068,149,1185699,-1,112.0,4985242,4985562,3818775,320,21,1,True,True,1.641472,-0.507068
1252,1166489,16048,16,0.462712,149,1185699,-1,640.0,2870448,2886496,1703959,16048,60,11,True,True,314.64251733333333,-0.45614490609375985
1253,1166504,6611,8,0.554316,149,1185699,-1,192.0,4788842,4795453,3622338,6611,25,8,True,True,46.71809066666666,-0.4902175430262307
1254,1166548,6845,8,0.791818,149,1185699,-1,168.0,5842387,5849232,4675839,6845,6,11,True,True,49.11353486666667,-0.7544834828209226
1255,1166563,8,5,0.895877,149,1185699,-1,100.0,4338942,4338950,3172379,8,34,12,True,True,0.039122222222222225,-0.895877
1256,1166965,13672,32,0.449734,149,1185699,-1,1152.0,2928148,2941820,1761183,13672,61,8,True,True,331.6182528,-0.42689987679761204
1257,1166983,17,1,0.809816,149,1185699,-1,8.0,3261482,3261499,2094499,17,57,12,True,True,0.005297955555555556,-0.809816
1258,1167043,5,2,0.651837,149,1185699,-1,34.0,5215787,5215792,4048744,5,17,1,True,True,0.0028522222222222226,-0.651837
1259,1167058,13082,32,0.321527,149,1185699,-1,1536.0,2158715,2171797,991657,13082,79,6,True,True,845.1221205333334,-0.3187170593964937
1260,1167100,21,32,0.475629,149,1185699,-1,448.0,4252542,4252563,3085442,21,36,10,True,True,0.3975402666666667,-0.475629
1261,1167121,2163,1,0.150861,149,1185699,-1,32.0,5950426,5952589,4783305,2163,0,1,True,True,2.7134320000000005,-0.1455880567169428
1262,1167209,4961,4,0.061874,149,1185699,-1,108.0,5097342,5102303,3930133,4961,22,8,True,True,17.5714302,-0.06008650362292356
1263,1167268,1093,1,0.103502,149,1185699,-1,39.0,3796261,3797354,2628993,1093,50,10,True,True,1.3586172166666666,-0.103502
1264,1167302,11886,27,0.899127,149,1185699,-1,756.0,2300115,2312001,1132813,11886,81,2,True,True,434.65287599999994,-0.8848474257113317
1265,1167605,8344,4,0.343438,149,1185699,-1,36.0,4674742,4683086,3507137,8344,30,0,True,True,11.8168756,-0.3091627905422166
1266,1167610,121,4,0.714316,149,1185699,-1,148.0,1349199,1349320,181589,121,96,10,True,True,0.39720938888888885,-0.714316
1267,1169111,2,8,0.504549,149,1185699,-1,288.0,5274387,5274389,4105276,2,17,9,True,True,0.0140416,-0.504549
1268,1169121,13195,173,0.172559,149,1185699,-1,7612.0,5798187,5811382,4629066,13195,8,10,True,True,2822.3334218444447,-0.14556113373973154
1269,1169177,61,8,0.247744,149,1185699,-1,352.0,2897048,2897109,1727871,61,72,10,True,True,0.5722288,-0.247744
1270,1169243,16,32,0.437758,149,1185699,-1,640.0,1630586,1630602,461343,16,92,1,True,True,0.31701333333333337,-0.437758
1271,1169296,5,16,0.439422,149,1185699,-1,752.0,3130882,3130887,1961586,5,66,6,True,True,0.15138177777777778,-0.439422
1272,1169303,8961,16,0.522748,149,1185699,-1,128.0,5687887,5696848,4518584,8961,9,7,True,True,28.359676800000003,-0.48185725843935556
1273,1169527,7861,44,0.158746,149,1185699,-1,2112.0,4981642,4989503,3812115,7861,29,8,True,True,793.7650042666668,-0.15827656729499526
1274,1169538,9,2,0.372852,149,1185699,-1,42.0,1825549,1825558,656011,9,94,1,True,True,0.0125076,-0.372852
1275,1169590,7460,1,0.282894,149,1185699,-1,24.0,2327618,2335078,1158028,7460,85,0,True,True,5.302076133333333,-0.26584243014434183
1276,1170047,76,4,0.408769,149,1185699,-1,24.0,2113615,2113691,943568,76,93,6,True,True,0.08500853333333333,-0.408769
1277,1170344,75,1,0.338367,149,1185699,-1,27.0,4718942,4719017,3548598,75,34,11,True,True,0.087204375,-0.338367
1278,1173850,14008,30,0.597886,149,1185699,-1,180.0,2940748,2954756,1766898,14008,73,1,True,True,74.08310599999999,-0.5805547991686867
1279,1174083,8200,16,0.789227,149,1185699,-1,720.0,4587442,4595642,3413359,8200,37,7,True,True,257.601188,-0.7476985401049028
1280,1174102,3921,77,0.647305,149,1185699,-1,2772.0,4674742,4678663,3500640,3921,37,6,True,True,503.50907529999995,-0.6454968704747851
1281,1174179,15452,16,0.065912,149,1185699,-1,720.0,5948579,5964031,4774400,15452,2,1,True,True,437.983996,-0.06553044982617375
1282,1174239,1532,1,0.094506,149,1185699,-1,25.0,5441648,5443180,4267409,1532,14,11,True,True,1.2520908333333336,-0.09450600000000003
1283,1174274,58,32,0.678379,149,1185699,-1,224.0,2492066,2492124,1317792,58,87,11,True,True,0.563528,-0.678379
1284,1174317,200,2,0.284147,149,1185699,-1,30.0,5245087,5245287,4070770,200,23,10,True,True,0.18963508333333334,-0.2671283484619516
1285,1174618,578,1,0.723734,149,1185699,-1,38.0,4091742,4092320,2917124,578,52,11,True,True,0.588696211111111,-0.723734
1286,1174663,23,35,0.656564,149,1185699,-1,1155.0,3175082,3175105,2000419,23,75,11,True,True,0.8209322916666668,-0.656564
1287,1174775,16600,4,0.906343,149,1185699,-1,176.0,2902448,2919048,1727673,16600,83,8,True,True,82.61973084444443,-0.8905575443517312
1288,1174799,9673,32,0.87328,149,1185699,-1,1248.0,3684161,3693834,2509362,9673,64,11,True,True,476.8975744,-0.8099691167543634
1289,1174889,6527,4,0.333362,149,1185699,-1,128.0,1652686,1659213,477797,6527,110,10,True,True,29.589525333333334,-0.3306890390068746
1290,1176555,56,1,0.58274,149,1185699,-1,48.0,1912849,1912905,736294,56,108,6,True,True,0.10955093333333332,-0.58274
1291,1176646,63,32,0.141428,149,1185699,-1,1024.0,3983687,3983750,2807041,63,56,2,True,True,1.4601216000000001,-0.141428
1292,1176692,460,40,0.349821,149,1185699,-1,1440.0,4974442,4974902,3797750,460,33,0,True,True,28.048959999999994,-0.349821
1293,1176978,311,1,0.967697,149,1185699,-1,24.0,2709648,2709959,1532670,311,93,0,True,True,0.16814733333333332,-0.967697
1294,1177613,2086,2,0.69848,149,1185699,-1,48.0,1378735,1380821,201122,2086,120,2,True,True,2.2183912000000006,-0.6433112944938102
1295,1177628,9,16,0.391958,149,1185699,-1,112.0,3424082,3424091,2246454,9,70,0,True,True,0.029811600000000004,-0.391958
1296,1177643,65,1,0.595041,149,1185699,-1,39.0,5513348,5513413,4335705,65,14,11,True,True,0.09064033333333332,-0.595041
1297,1178313,4026,32,0.938002,149,1185699,-1,992.0,4230442,4234468,3052129,4026,52,11,True,True,153.05316693333333,-0.9215458245614033
1298,1178624,16454,256,0.309582,149,1185699,-1,6400.0,2575448,2591902,1396824,16454,97,8,True,True,3605.4343822222218,-0.29470965850102576
1299,1178638,12363,256,0.376679,149,1185699,-1,6144.0,2026315,2038678,847677,12363,113,7,True,True,2720.5176831999997,-0.3559229005463854
1300,1178662,147,1,0.791662,149,1185699,-1,20.0,5948432,5948579,4769770,147,3,10,True,True,0.11942933333333335,-0.791662
1301,1178718,6469,32,0.813185,149,1185699,-1,1088.0,1279299,1285768,100581,6469,133,2,True,True,249.05999751111113,-0.786699923892129
1302,1183323,278,32,0.670116,149,1185699,-1,480.0,5245087,5245365,4061764,278,25,0,True,True,4.292873333333333,-0.6412413147997673
1303,1183672,116,1,0.828959,149,1185699,-1,37.0,3473682,3473798,2290010,116,73,7,True,True,0.14541534444444443,-0.828959
1304,1183685,13339,8,0.738775,149,1185699,-1,384.0,3972861,3986200,2789176,13339,64,10,True,True,116.6317568,-0.7192214498063535
1305,1183718,6208,8,0.685414,149,1185699,-1,136.0,5774287,5780495,4590569,6208,11,12,True,True,33.157863822222225,-0.6417477729512663
1306,1183767,10726,2,0.526393,149,1185699,-1,62.0,2564722,2575448,1380955,10726,103,1,True,True,27.01598367777778,-0.5000818480790442
1307,1183900,76,4,0.646025,149,1185699,-1,172.0,2112715,2112791,928815,76,119,12,True,True,0.6669261777777777,-0.646025
1308,1183938,4,8,0.423406,149,1185699,-1,304.0,4785242,4785246,3601304,4,42,11,True,True,0.0388816,-0.4234060000000001
1309,1184946,18041,8,0.361828,149,1185699,-1,256.0,2160515,2178556,975569,18041,118,0,True,True,190.4417102222222,-0.3594158446928509
1310,1185012,163,2,0.362598,149,1185699,-1,78.0,2796948,2797111,1611936,163,101,0,True,True,0.27381011666666666,-0.362598
1311,1185031,22,12,0.180263,149,1185699,-1,480.0,4978042,4978064,3793011,22,37,8,True,True,0.44067466666666666,-0.180263
1312,1185212,4,1,0.214193,149,1185699,-1,25.0,2446966,2446970,1261754,4,110,1,True,True,0.003982777777777778,-0.214193
1313,1185291,84,32,0.947668,149,1185699,-1,1408.0,3128182,3128266,1942891,84,91,8,True,True,5.2256512,-0.947668
1314,1185684,15,4,0.486271,149,1185699,-1,180.0,2988548,2988563,1802864,15,94,7,True,True,0.0692775,-0.486271
1315,1191642,84,1,0.226543,239,1272099,-1,32.0,2349718,2349802,1158076,84,116,10,True,True,0.07724266666666668,-0.226543
1316,1191737,2892,1,0.137565,239,1272099,-1,18.0,5558448,5561340,4366711,2892,15,6,True,True,1.8857285999999998,-0.137565
1317,1191778,247,3,0.077165,239,1272099,-1,84.0,4785242,4785489,3593464,247,44,0,True,True,0.6634173000000001,-0.077165
1318,1191811,5636,8,0.844428,239,1272099,-1,280.0,1373099,1378735,181288,5636,145,7,True,True,41.57951311111111,-0.7950696582642339
1319,1192077,4,1,0.101141,239,1272099,-1,45.0,4179042,4179046,2986965,4,61,6,True,True,0.0056685,-0.101141
1320,1192104,16915,256,0.770875,239,1272099,-1,5632.0,5397448,5414363,4205344,16915,19,7,True,True,2147.2356536888888,-0.7611288528027974
1321,1192299,3,8,0.83512,239,1272099,-1,248.0,2445118,2445121,1252819,3,117,12,True,True,0.02963186666666667,-0.83512
1322,1192348,269,64,0.883682,239,1272099,-1,2176.0,2493866,2494135,1301518,269,114,7,True,True,25.389295999999998,-0.883682
1323,1194337,3071,8,0.037747,239,1272099,-1,368.0,5663987,5667058,4469650,3071,13,1,True,True,31.942292666666663,-0.03740203544404779
1324,1194394,48,8,0.336764,239,1272099,-1,80.0,4033100,4033148,2838706,48,67,7,True,True,0.08866133333333334,-0.336764
1325,1194454,28023,1,0.766308,239,1272099,-1,40.0,2353318,2381341,1158864,28023,124,8,True,True,38.797171222222225,-0.7385386337884002
1326,1194499,48,16,0.131049,239,1272099,-1,576.0,2446918,2446966,1252419,48,120,7,True,True,1.1011584,-0.131049
1327,1194846,25,32,0.37672,239,1272099,-1,512.0,1630561,1630586,435715,25,146,1,True,True,0.39626666666666666,-0.37672
1328,1194889,6967,256,0.162247,239,1272099,-1,12544.0,3502394,3509361,2307505,6967,83,2,True,True,2550.553714488889,-0.1615096514904403
1329,1195374,67,16,0.831345,239,1272099,-1,704.0,2296515,2296582,1101141,67,133,2,True,True,1.9556376888888884,-0.831345
1330,1195475,6491,128,0.771098,239,1272099,-1,1664.0,2937148,2943639,1741673,6491,103,7,True,True,209.35370097777775,-0.6920317549952162
1331,1195492,4762,4,0.809044,239,1272099,-1,164.0,5183742,5188504,3988250,4762,35,12,True,True,12.3163344,-0.7847804651472781
1332,1195820,14,8,0.165539,239,1272099,-1,144.0,2924548,2924562,1728728,14,107,10,True,True,0.04080159999999999,-0.165539
1333,1195870,669,19,0.437673,239,1272099,-1,171.0,4354242,4354911,3158372,669,59,6,True,True,5.805431475,-0.437673
1334,1196468,8784,128,0.410859,239,1272099,-1,2048.0,2706048,2714832,1509580,8784,118,12,True,True,415.14680319999997,-0.3799118081660134
1335,1197052,6,8,0.676363,239,1272099,-1,240.0,2871348,2871354,1674296,6,113,6,True,True,0.048044,-0.676363
1336,1197189,7288,36,0.23753,239,1272099,-1,1440.0,5871332,5878620,4674143,7288,7,10,True,True,243.67291199999997,-0.2156335012877292
1337,1197554,19,2,0.444199,239,1272099,-1,12.0,2157815,2157834,960261,19,145,11,True,True,0.008174433333333333,-0.444199
1338,1197715,7726,184,0.284928,239,1272099,-1,4600.0,2494766,2502492,1297051,7726,124,6,True,True,1460.7957033333332,-0.2758771284844771
1339,1197805,30512,128,0.748537,239,1272099,-1,4864.0,3471882,3502394,2274077,30512,88,8,True,True,5012.720502044444,-0.741892734937059
1340,1197926,48,8,0.448928,239,1272099,-1,304.0,3477282,3477330,2279356,48,87,8,True,True,0.5353237333333333,-0.448928
1341,1198812,23,1,0.534011,239,1272099,-1,14.0,5776087,5776110,4577275,23,12,7,True,True,0.012189488888888891,-0.534011
1342,1198938,16,1,0.309468,239,1272099,-1,30.0,4741042,4741058,3542104,16,51,10,True,True,0.01831066666666667,-0.309468
1343,1198971,14212,2,0.808624,239,1272099,-1,24.0,2826248,2840460,1627277,14212,121,9,True,True,9.084356,-0.757802878808786
1344,1199693,30,8,0.469016,239,1272099,-1,136.0,1275699,1275729,76006,30,177,8,True,True,0.158202,-0.469016
1345,1199930,7380,1,0.835113,239,1272099,-1,28.0,3123682,3131062,1923752,7380,107,1,True,True,8.538222311111111,-0.820860728307401
1346,1202155,74,8,0.367841,239,1272099,-1,240.0,5222987,5223061,4020832,74,33,9,True,True,0.35973866666666665,-0.367841
1347,1202424,36,2,0.94713,239,1272099,-1,26.0,2990348,2990384,1787924,36,110,7,True,True,0.024016199999999998,-0.94713
1348,1202559,26,8,0.98444,239,1272099,-1,136.0,2942548,2942574,1739989,26,112,7,True,True,0.07586684444444444,-0.98444
1349,1202714,24,7,0.46168,239,1272099,-1,294.0,3774161,3774185,2571447,24,85,12,True,True,0.2411388,-0.46168
1350,1203627,197,1,0.281772,239,1272099,-1,37.0,3986200,3986397,2782573,197,76,2,True,True,0.17463229166666666,-0.281772
1351,1203673,4662,4,0.381872,239,1272099,-1,124.0,3468282,3472944,2264609,4662,95,0,True,True,19.41669086666667,-0.3802195424712047
1352,1203713,62,32,0.52746,239,1272099,-1,1600.0,5686087,5686149,4482374,62,15,10,True,True,2.6781244444444443,-0.52746
1353,1203772,135,2,0.966268,239,1272099,-1,100.0,1607435,1607570,403663,135,172,1,True,True,0.508725,-0.966268
1354,1203872,57,32,0.816891,239,1272099,-1,832.0,2246915,2246972,1043043,57,157,12,True,True,1.0078917333333335,-0.816891
1355,1203924,23275,43,0.801259,239,1272099,-1,1118.0,3079448,3102723,1875524,23275,114,6,True,True,1203.9487965555559,-0.796539961450828
1356,1205505,6,32,0.138399,239,1272099,-1,1536.0,5847793,5847799,4642288,6,8,7,True,True,0.402944,-0.138399
1357,1205783,9475,256,0.250003,239,1272099,-1,5888.0,4412842,4422317,3207059,9475,62,9,True,True,2762.2857052444447,-0.24812028010751522
1358,1206862,128,32,0.641179,239,1272099,-1,288.0,2010049,2010177,803187,128,167,8,True,True,1.3590528,-0.641179
1359,1223498,27,4,0.874117,239,1272099,-1,60.0,1466035,1466062,242537,27,181,6,True,True,0.064728,-0.874117
1360,1223641,226,1,0.554541,239,1272099,-1,13.0,2349718,2349944,1126077,226,151,0,True,True,0.08442669444444445,-0.554541
1361,1224041,21,1,0.10259,239,1272099,-1,49.0,5298289,5298310,4074248,21,30,10,True,True,0.025682125,-0.10259
1362,1225226,28,16,0.845892,239,1272099,-1,640.0,4342542,4342570,3117316,28,69,8,True,True,0.8165546666666667,-0.845892
1363,1225273,21,4,0.851166,239,1272099,-1,96.0,1465135,1465156,239862,21,185,12,True,True,0.09007040000000001,-0.851166
1364,1227915,12,32,0.285063,239,1272099,-1,1120.0,4919442,4919454,3691527,12,51,11,True,True,0.6723733333333334,-0.285063
1365,1228250,7654,8,0.763117,239,1272099,-1,176.0,5644848,5652502,4416598,7654,20,12,True,True,36.761030044444446,-0.7627518189374164
1366,1229002,48,16,0.272791,239,1272099,-1,224.0,4974442,4974490,3745440,48,50,8,True,True,0.4552874666666667,-0.272791
1367,1229105,220,16,0.905306,239,1272099,-1,368.0,4398442,4398662,3169337,220,69,10,True,True,4.143128,-0.905306
1368,1229713,20658,119,0.147349,239,1272099,-1,5712.0,2520466,2541124,1290753,20658,145,1,True,True,4418.432173866667,-0.14608990331029428
1369,1230193,7676,1,0.437473,239,1272099,-1,38.0,2327618,2335294,1097425,7676,161,2,True,True,8.630933877777778,-0.4120593685285558
1370,1230556,6,16,0.946413,239,1272099,-1,736.0,4967242,4967248,3736686,6,52,1,True,True,0.2509637333333333,-0.946413
1371,1230732,17,8,0.222038,239,1272099,-1,224.0,4040300,4040317,2809568,17,83,9,True,True,0.0831519111111111,-0.222038
1372,1230788,599,1,0.451128,239,1272099,-1,27.0,4091742,4092341,2860954,599,81,0,True,True,0.433481325,-0.451128
1373,1230842,9605,4,0.349585,239,1272099,-1,136.0,5465548,5475153,4234706,9605,24,7,True,True,34.499918622222225,-0.3490931985903638
1374,1235051,23287,128,0.02667,239,1272099,-1,1664.0,2619648,2642935,1384597,23287,147,11,True,True,1088.8193194666667,-0.024289914195499526
1375,1235300,14,8,0.053257,239,1272099,-1,304.0,5274389,5274403,4039089,14,34,1,True,True,0.10375182222222222,-0.053257
1376,1235392,17,2,0.502007,239,1272099,-1,12.0,4673842,4673859,3438450,17,66,12,True,True,0.009405533333333334,-0.502007
1377,1235511,454,1,0.235778,239,1272099,-1,43.0,4040317,4040771,2804806,454,87,1,True,True,0.42628456111111107,-0.235778
1378,1236012,295,4,0.994525,239,1272099,-1,104.0,2709648,2709943,1473636,295,149,1,True,True,0.6911522222222222,-0.994525
1379,1236187,17,4,0.374913,239,1272099,-1,160.0,5469148,5469165,4232961,17,24,8,True,True,0.07879688888888889,-0.374913
1380,1236211,51,4,0.028188,239,1272099,-1,104.0,4043942,4043993,2807731,51,88,1,True,True,0.11008746666666666,-0.028188
1381,1236861,297,4,0.930826,239,1272099,-1,148.0,3798061,3798358,2561200,297,103,7,True,True,1.6235637,-0.930826
1382,1236977,126,1,0.839176,239,1272099,-1,22.0,1630435,1630561,393458,126,197,6,True,True,0.0858165,-0.839176
1383,1237020,12617,1,0.649961,239,1272099,-1,23.0,1911949,1924566,674929,12617,192,12,True,True,10.503087488888887,-0.642639232808744
1384,1237041,19866,16,0.791381,239,1272099,-1,736.0,2006449,2026315,769408,19866,189,12,True,True,622.2712273777778,-0.7836949539382597
1385,1237455,182,16,0.1376,239,1272099,-1,608.0,3379882,3380064,2142427,182,118,8,True,True,2.875826488888889,-0.1376
1386,1237793,10471,1,0.286879,239,1272099,-1,14.0,4349742,4360213,3111949,10471,78,9,True,True,6.928598833333333,-0.2829731678652931
1387,1237852,53,16,0.829762,239,1272099,-1,336.0,1327099,1327152,89247,53,216,1,True,True,0.7145954666666667,-0.829762
1388,1237979,28,8,0.696072,239,1272099,-1,280.0,5849232,5849260,4611253,28,8,2,True,True,0.34278222222222227,-0.696072
1389,1238030,25,4,0.138793,239,1272099,-1,156.0,4043917,4043942,2805887,25,91,8,True,True,0.08094666666666667,-0.138793
1390,1240035,15281,128,0.705536,239,1272099,-1,2816.0,2992148,3007429,1752113,15281,137,7,True,True,1220.9687971555556,-0.695108264564672
1391,1240185,56,1,0.448601,239,1272099,-1,23.0,2564666,2564722,1324481,56,162,11,True,True,0.04929819999999999,-0.448601
1392,1240201,34,2,0.005251,239,1272099,-1,56.0,5211242,5211276,3971041,34,44,7,True,True,0.029189377777777775,-0.005250999999999999
1393,1240206,7860,256,0.079226,239,1272099,-1,12032.0,5652502,5660362,4412296,7860,21,6,True,True,2466.184334222222,-0.07915061311059551
1394,1240227,36,64,0.255924,239,1272099,-1,2240.0,4045742,4045778,2805515,36,92,7,True,True,1.6737280000000003,-0.255924
1395,1240251,222,10,0.834963,239,1272099,-1,320.0,1739086,1739308,498835,222,205,12,True,True,2.331296,-0.834963
1396,1242062,7846,3,0.548804,239,1272099,-1,78.0,3509361,3517207,2267299,7846,116,6,True,True,18.460532566666668,-0.5472036296953163
1397,1242109,31,1,0.727235,239,1272099,-1,36.0,2986748,2986779,1744639,31,144,11,True,True,0.0338551,-0.727235
1398,1242152,2651,8,0.527772,239,1272099,-1,136.0,2819048,2821699,1576896,2651,159,10,True,True,11.738451266666667,-0.527772
1399,1242232,9941,12,0.111187,239,1272099,-1,60.0,3595761,3605702,2353529,9941,115,0,True,True,19.1248955,-0.10219635337437985
1400,1242481,46,41,0.288102,239,1272099,-1,1558.0,5463748,5463794,4221267,46,28,10,True,True,1.8042419000000003,-0.288102
1401,1242829,8,1,0.301151,239,1272099,-1,32.0,2160515,2160523,917686,8,197,7,True,True,0.011445333333333332,-0.301151
1402,1242973,34,8,0.047749,239,1272099,-1,184.0,2796048,2796082,1553075,34,164,12,True,True,0.1347299111111111,-0.047749
1403,1243056,18345,1,0.419826,239,1272099,-1,33.0,5357789,5376134,4114733,18345,32,11,True,True,19.90901009166667,-0.4090668120358186
1404,1243104,34,30,0.793899,239,1272099,-1,1050.0,3123648,3123682,1880544,34,142,10,True,True,1.235815,-0.793899
1405,1243221,20017,4,0.457114,239,1272099,-1,136.0,3078548,3098565,1835327,20017,145,12,True,True,124.91290637777777,-0.4489989435945596
9512,7420904,105,2,0.730865,1,7420904,-1,10.0,7421140,7421009,236,105,0,0,True,True,0.028014583333333336,-0.730865
9513,7421140,3189,4,0.225831,1,7421140,-1,140.0,7447663,7427929,26523,3189,0,8,True,True,16.409980222222224,-0.21030702622815708
9514,7447663,476,16,0.263812,1,7447663,-1,800.0,7451263,7451739,3600,476,0,8,True,True,13.272995555555555,-0.26381199999999994
9515,7451106,21769,32,0.296234,1,7451263,-1,224.0,7454863,7476632,3757,21769,0,8,True,True,173.48093217777776,-0.29123020695852775
9516,7451300,22056,128,0.082794,7,7454863,-1,3968.0,7587544,7609600,136244,22056,0,12,True,True,2130.0930304000003,-0.08187866108813437
9517,7451557,281,1,0.558515,7,7454863,-1,20.0,7499063,7499344,47506,281,1,11,True,True,0.132351,-0.558515
9518,7451869,38,64,0.872872,7,7454863,-1,1920.0,8251292,8251330,799423,38,0,10,True,True,1.7739413333333331,-0.872872
9519,7453317,7620,1,0.659481,7,7454863,-1,42.0,9447603,9455223,1994286,7620,0,6,True,True,6.058770550000001,-0.5928711811910369
9520,7453877,29,2,0.735268,7,7454863,-1,90.0,9560703,9560732,2106826,29,0,8,True,True,0.057565,-0.735268
9521,7453926,1089,32,0.205891,7,7454863,-1,1600.0,8528012,8529101,1074086,1089,2,12,True,True,55.309626666666674,-0.1902054815373549
9522,7454242,9589,42,0.078017,7,7454863,-1,756.0,10009137,10018726,2554895,9589,0,8,True,True,131.49826410000003,-0.07785584054547284
9523,7455218,114,4,0.971765,126,7499063,-1,96.0,11338808,11338922,3883590,114,0,1,True,True,0.21419839999999998,-0.971765
9524,7457507,7217,1,0.060267,126,7499063,-1,18.0,8113292,8120509,655785,7217,6,11,True,True,3.2019358999999996,-0.059917888042105315
9525,7457873,11752,130,0.013128,126,7499063,-1,4030.0,11328008,11339760,3870135,11752,1,8,True,True,1133.5887593333332,-0.01247958212037228
9526,7458016,11,8,0.216135,126,7499063,-1,232.0,11665486,11665497,4207470,11,0,7,True,True,0.052847666666666675,-0.216135
9527,7458182,96,4,0.818511,126,7499063,-1,56.0,10347844,10347940,2889662,96,3,1,True,True,0.1956266666666667,-0.818511
9528,7458304,10277,71,0.187917,126,7499063,-1,1420.0,11452908,11463185,3994604,10277,1,0,True,True,455.6543491111111,-0.18606018647118244
9529,7458385,27,5,0.104535,126,7499063,-1,200.0,11799686,11799713,4341301,27,0,11,True,True,0.16029000000000002,-0.104535
9530,7458487,184,4,0.208661,126,7499063,-1,60.0,11848386,11848570,4389899,184,0,11,True,True,0.7409986666666667,-0.20866099999999999
9531,7458666,13,32,0.590523,126,7499063,-1,1216.0,10032137,10032150,2573471,13,7,10,True,True,0.2752348444444444,-0.590523
9532,7458715,1395,2,0.527645,126,7499063,-1,30.0,9533203,9534598,2074488,1395,10,8,True,True,1.2149287500000001,-0.527645
9533,7458727,46,1,0.858459,126,7499063,-1,27.0,7708644,7708690,249917,46,15,8,True,True,0.030746400000000004,-0.858459
9534,7458977,37320,8,0.760488,126,7499063,-1,400.0,11150108,11187428,3691131,37320,6,1,True,True,430.1420133333333,-0.7457948207952096
9535,7459029,14846,1,0.311825,126,7499063,-1,23.0,11324408,11339254,3865379,14846,6,2,True,True,8.1621595,-0.3109570645840807
9536,7459262,6908,16,0.454022,126,7499063,-1,224.0,10876120,10883028,3416858,6908,8,12,True,True,45.03665102222223,-0.4520412714049912
9537,7459573,3195,4,0.153999,126,7499063,-1,32.0,11641586,11644781,4182013,3195,3,1,True,True,2.296095466666667,-0.12435654882141431
9538,7459790,12,8,0.504511,126,7499063,-1,96.0,11755486,11755498,4295696,12,2,8,True,True,0.0244672,-0.504511
9539,7460179,8139,16,0.914125,126,7499063,-1,256.0,9370964,9379103,1910785,8139,17,11,True,True,55.408755911111115,-0.9131083279381885
9540,7460299,234,8,0.218785,126,7499063,-1,104.0,8251330,8251564,791031,234,19,1,True,True,0.5917028,-0.218785
9541,7460340,6157,1,0.363644,126,7499063,-1,30.0,11874086,11880243,4413746,6157,0,10,True,True,13.371161666666666,-0.3527323279519773
9542,7462757,1,1,0.975065,126,7499063,-1,22.0,8183192,8183193,720435,1,22,8,True,True,0.000552811111111111,-0.975065
9543,7462847,46,3,0.867859,126,7499063,-1,96.0,7589344,7589390,126497,46,25,6,True,True,0.10963946666666667,-0.867859
9544,7462894,755,4,0.513464,126,7499063,-1,48.0,10722665,10723420,3259771,755,12,1,True,True,0.8940206666666667,-0.513464
9545,7462915,17458,16,0.780021,126,7499063,-1,320.0,9693174,9710632,2230259,17458,16,7,True,True,123.06002488888889,-0.7568927184706276
9546,7463964,11,2,0.187953,126,7499063,-1,24.0,10334797,10334808,2870833,11,14,7,True,True,0.008879200000000002,-0.187953
9547,7464892,13,4,0.277838,126,7499063,-1,116.0,11080174,11080187,3615282,13,11,10,True,True,0.04878798888888889,-0.277838
9548,7465082,6755,128,0.164196,126,7499063,-1,2560.0,11553394,11560149,4088312,6755,6,12,True,True,563.14304,-0.16117813284042418
9549,7465329,22,2,0.307147,126,7499063,-1,90.0,11641564,11641586,4176235,22,6,11,True,True,0.055066000000000004,-0.307147
9550,7465376,7661,16,0.869831,126,7499063,-1,544.0,8254930,8262591,789554,7661,26,8,True,True,100.69129013333334,-0.865987376780428
9551,7465404,2698,32,0.648383,126,7499063,-1,512.0,10084899,10087597,2619495,2698,18,2,True,True,24.888147911111112,-0.6437276072687139
9552,7465458,15,6,0.14729,126,7499063,-1,300.0,7499344,7499359,33886,15,35,1,True,True,0.105975,-0.14729
9553,7465541,9,4,0.876196,126,7499063,-1,176.0,10723420,10723429,3257879,9,15,1,True,True,0.0390764,-0.876196
9554,7465580,45,4,0.745026,126,7499063,-1,180.0,11555194,11555239,4089614,45,7,7,True,True,0.28370249999999997,-0.7450259999999999
9555,7465625,700,1,0.240562,126,7499063,-1,11.0,9919137,9919837,2453512,700,23,7,True,True,0.27886833333333333,-0.240562
9556,7465675,13,1,0.894098,126,7499063,-1,43.0,9444903,9444916,1979228,13,28,7,True,True,0.015360077777777776,-0.894098
9557,7465724,4622,8,0.18703,126,7499063,-1,392.0,10087597,10092219,2621873,4622,20,0,True,True,33.14842595555555,-0.18472719897387332
9558,7465781,102,4,0.028586,126,7499063,-1,104.0,11452908,11453010,3987127,102,10,11,True,True,0.32566559999999994,-0.028586
9559,7465790,1354,8,0.661886,126,7499063,-1,184.0,10971520,10972874,3505730,1354,16,12,True,True,8.098422666666668,-0.6605409672782094
9560,7465971,63,32,0.452641,126,7499063,-1,1472.0,9794174,9794237,2328203,63,27,11,True,True,3.7609600000000003,-0.452641
9561,7466592,21,2,0.265579,126,7499063,-1,14.0,9524203,9524224,2057611,21,31,9,True,True,0.0088053,-0.265579
9562,7468178,56,2,0.926928,126,7499063,-1,100.0,10635344,10635400,3167166,56,20,10,True,True,0.2009466666666667,-0.926928
9563,7468182,484,16,0.084067,126,7499063,-1,80.0,11454810,11455294,3986628,484,9,7,True,True,1.1945111111111113,-0.08240489031168624
9564,7468203,10,8,0.431474,126,7499063,-1,272.0,8135392,8135402,667189,10,42,10,True,True,0.06814355555555557,-0.431474
9565,7468269,26,16,0.15062,126,7499063,-1,512.0,11386608,11386634,3918339,26,12,8,True,True,0.3634545777777778,-0.15062
9566,7468381,1733,4,0.50219,126,7499063,-1,128.0,7931290,7933023,462909,1733,45,11,True,True,4.703901155555556,-0.50219
9567,7468392,9270,256,0.507927,126,7499063,-1,11520.0,11565994,11575264,4097602,9270,7,8,True,True,3110.343168,-0.491822817650893
9568,7469489,16453,1,0.053157,126,7499063,-1,34.0,7982692,7999145,513203,16453,46,10,True,True,15.391531872222224,-0.05272892575981494
9569,7469646,52,2,0.272589,126,7499063,-1,20.0,8179592,8179644,709946,52,44,11,True,True,0.02822733333333333,-0.272589
9570,7469780,170,1,0.097813,126,7499063,-1,29.0,12063307,12063477,4593527,170,0,2,True,True,0.19629616666666666,-0.097813
9571,7469818,11436,128,0.648622,126,7499063,-1,6144.0,11575264,11586700,4105446,11436,8,6,True,True,2442.5798314666667,-0.6332914869018633
9572,7470263,126,2,0.732002,126,7499063,-1,16.0,7675744,7675870,205481,126,52,12,True,True,0.04897200000000001,-0.732002
9573,7470324,19,8,0.422588,126,7499063,-1,136.0,9278964,9278983,1808640,19,41,7,True,True,0.04053291111111112,-0.422588
9574,7470968,77,2,0.294006,126,7499063,-1,64.0,8561818,8561895,1090850,77,42,0,True,True,0.14763466666666666,-0.294006
9575,7471047,5,8,0.402692,126,7499063,-1,56.0,9432303,9432308,1961256,5,40,9,True,True,0.010737222222222224,-0.402692
9576,7471089,262,1,0.594049,126,7499063,-1,35.0,11239208,11239470,3768119,262,19,6,True,True,0.2074203055555556,-0.594049
9577,7471439,140,32,0.529563,126,7499063,-1,384.0,10159297,10159437,2687858,140,29,7,True,True,1.0175573333333334,-0.529563
9578,7471767,213,1,0.493616,126,7499063,-1,9.0,8439630,8439843,967863,213,47,6,True,True,0.058953074999999994,-0.493616
9579,7471808,102,11,0.433565,126,7499063,-1,209.0,11558794,11558896,4086986,102,10,8,True,True,0.6622199833333333,-0.433565
9580,7471834,10,4,0.681161,126,7499063,-1,124.0,8866118,8866128,1394284,10,46,11,True,True,0.026267333333333337,-0.681161
9581,7471849,155,1,0.646345,126,7499063,-1,5.0,11026974,11027129,3555125,155,23,6,True,True,0.02912277777777778,-0.646345
9582,7471908,27,1,0.958972,126,7499063,-1,16.0,11146474,11146501,3674566,27,22,10,True,True,0.0066527999999999995,-0.958972
9583,7471940,6347,32,0.21958,126,7499063,-1,832.0,11458894,11465241,3986954,6347,13,1,True,True,166.33544604444444,-0.21894273887931914
9584,7472063,7103,16,0.053138,126,7499063,-1,480.0,9372764,9379867,1900701,7103,47,6,True,True,89.88454266666666,-0.0523531447941271
9585,7472164,321,1,0.035688,126,7499063,-1,37.0,7960592,7960913,488428,321,62,1,True,True,0.3117052666666667,-0.035688
9586,7472257,9092,64,0.266178,126,7499063,-1,2112.0,7697844,7706936,225587,9092,65,10,True,True,544.4310549333334,-0.265392832482345
9587,7472310,34,4,0.065847,126,7499063,-1,76.0,11150074,11150108,3677764,34,23,8,True,True,0.03382886666666667,-0.065847
9588,7472367,260,2,0.101032,126,7499063,-1,52.0,11973286,11973546,4500919,260,1,8,True,True,0.5021177777777777,-0.101032
9589,7472391,7,1,0.226465,126,7499063,-1,6.0,11458894,11458901,3986503,7,14,0,True,True,0.0013085333333333333,-0.226465
9590,7472466,44,16,0.620221,126,7499063,-1,496.0,10591144,10591188,3118678,44,34,9,True,True,0.6306529777777778,-0.620221
9591,7472913,203,5,0.715823,126,7499063,-1,180.0,10879720,10879923,3406807,203,30,0,True,True,1.0427095,-0.715823
9592,7473068,4428,32,0.391908,126,7499063,-1,960.0,12059707,12064135,4586639,4428,1,1,True,True,170.45269333333334,-0.3661493428412119
9593,7473076,9633,85,0.101304,126,7499063,-1,2890.0,9691374,9701007,2218298,9633,47,12,True,True,656.0476530833333,-0.101174964536163
9594,7473095,5,32,0.733924,126,7499063,-1,1056.0,7588444,7588449,115349,5,75,6,True,True,0.12969733333333336,-0.733924
9595,7473646,211,1,0.879528,126,7499063,-1,5.0,9443103,9443314,1969457,211,53,9,True,True,0.028989055555555556,-0.879528
9596,7474035,16855,220,0.268267,126,7499063,-1,3080.0,9604974,9621829,2130939,16855,48,0,True,True,1551.1979816666665,-0.2604421792677366
9597,7474304,116,32,0.205705,126,7499063,-1,480.0,10883320,10883436,3409016,116,31,3,True,True,1.5434186666666665,-0.205705
9598,7475199,4,8,0.785728,126,7499063,-1,80.0,9582803,9582807,2107604,4,50,10,True,True,0.004107555555555556,-0.785728
9599,7475208,21,1,0.347633,126,7499063,-1,24.0,10722644,10722665,3247436,21,36,12,True,True,0.012433400000000002,-0.347633
9600,7475834,57,16,0.287993,126,7499063,-1,336.0,11466994,11467051,3991160,57,15,6,True,True,0.6078100000000001,-0.287993
9601,7477326,23,1,0.596313,126,7499063,-1,35.0,7501144,7501167,23818,23,83,7,True,True,0.018957750000000002,-0.596313
9602,7477372,2,32,0.733882,126,7499063,-1,416.0,10789720,10789722,3312348,2,35,10,True,True,0.02361031111111111,-0.733882
9603,7478388,75,4,0.094243,126,7499063,-1,144.0,11283408,11283483,3805020,75,25,11,True,True,0.27654,-0.094243
9604,7478403,4037,1,0.50324,126,7499063,-1,50.0,9517003,9521040,2038600,4037,58,8,True,True,5.742111527777778,-0.49965494533012533
9605,7478737,15613,25,0.700471,126,7499063,-1,925.0,11597364,11612977,4118627,15613,10,10,True,True,637.1621409027778,-0.6901196429961775
9606,7478932,12150,4,0.476758,126,7499063,-1,84.0,9246818,9258968,1767886,12150,67,11,True,True,22.85706686666667,-0.4746155576832158
9607,7479608,11987,1,0.305324,126,7499063,-1,42.0,11800586,11812573,4320978,11987,5,0,True,True,14.958257066666668,-0.30073830586324973
9608,7479731,23,16,0.906668,126,7499063,-1,576.0,10160197,10160220,2680466,23,46,6,True,True,0.2507552,-0.906668
9609,7480361,86,8,0.238619,126,7499063,-1,312.0,9915537,9915623,2435176,86,53,10,True,True,0.9467224,-0.238619
9610,7480435,12668,237,0.315112,126,7499063,-1,11376.0,9070218,9082886,1589783,12668,71,11,True,True,4033.1033863999996,-0.2828329755147144
9611,7480498,8452,1,0.069455,126,7499063,-1,36.0,11320808,11329260,3840310,8452,27,8,True,True,6.476773999999999,-0.058516233151119236
9612,7481026,93,3,0.187344,126,7499063,-1,123.0,8438730,8438823,957704,93,77,9,True,True,0.35178102499999997,-0.187344
9613,7481280,23947,247,0.899869,126,7499063,-1,5681.0,9251417,9275364,1770137,23947,71,1,True,True,2922.8149126222224,-0.8557421900547745
9614,7481294,9,8,0.141834,126,7499063,-1,80.0,11555194,11555203,4073900,9,15,0,True,True,0.025218,-0.14183399999999996
9615,7481416,4845,4,0.012735,126,7499063,-1,136.0,11879486,11884331,4398070,4845,3,8,True,True,50.302393288888894,-0.012345357803112437
9616,7481427,46,20,0.474601,126,7499063,-1,160.0,11562394,11562440,4080967,46,15,8,True,True,0.22619733333333336,-0.474601
9617,7481465,14246,16,0.334054,126,7499063,-1,752.0,11875886,11890132,4394421,14246,4,7,True,True,786.9008714666667,-0.32674256139078733
9618,7481557,48,7,0.177515,126,7499063,-1,77.0,11923686,11923734,4442129,48,3,11,True,True,0.14794266666666667,-0.177515
9619,7481724,5912,64,0.263832,126,7499063,-1,1600.0,12070507,12076419,4588783,5912,0,9,True,True,408.90828444444446,-0.24946785582521427
9620,7482405,12589,32,0.076977,126,7499063,-1,704.0,11969686,11982275,4487281,12589,4,7,True,True,341.36219822222216,-0.07339638634170235
9621,7482495,5781,4,0.679203,126,7499063,-1,124.0,10091197,10096978,2608702,5781,56,0,True,True,12.513399033333332,-0.6722388781626086
9622,7483729,367,1,0.85309,126,7499063,-1,44.0,11383008,11383375,3899279,367,31,10,True,True,0.42574925555555554,-0.8238026285642526
9623,7483771,6,1,0.594005,126,7499063,-1,30.0,8821918,8821924,1338147,6,84,12,True,True,0.0047495,-0.594005
9624,7483829,733,1,0.969542,126,7499063,-1,39.0,9248618,9249351,1764789,733,81,6,True,True,0.6015975333333333,-0.969542
9625,7484125,6337,128,0.583159,126,7499063,-1,4608.0,10351444,10357781,2867319,6337,53,8,True,True,1005.0870272,-0.574688916274278
9626,7485298,6441,64,0.488307,126,7499063,-1,576.0,11124374,11130815,3639076,6441,41,11,True,True,84.94786399999998,-0.487825903701822
9627,7485400,6086,16,0.24751,126,7499063,-1,160.0,11408708,11414794,3923308,6086,30,10,True,True,20.94276622222222,-0.24533234670596368
9628,7485441,42,4,0.109386,126,7499063,-1,108.0,9529603,9529645,2044162,42,74,8,True,True,0.1376928,-0.109386
9629,7485503,324,2,0.818926,126,7499063,-1,36.0,10396544,10396868,2911041,324,55,11,True,True,0.28192199999999995,-0.8115851675103348
9630,7485531,3,19,0.567267,126,7499063,-1,893.0,10338397,10338400,2852866,3,58,2,True,True,0.09448684166666667,-0.567267
9631,7485881,968,16,0.990413,126,7499063,-1,128.0,9882637,9883605,2396756,968,69,11,True,True,4.464674133333334,-0.990413
9632,7485930,30,16,0.835359,126,7499063,-1,656.0,11287008,11287038,3801078,30,37,8,True,True,0.529556,-0.835359
9633,7486024,1347,4,0.525269,126,7499063,-1,144.0,10346497,10347844,2860473,1347,59,3,True,True,7.058279999999999,-0.525269
9634,7486423,322,1,0.167305,126,7499063,-1,10.0,10352344,10352666,2865921,322,57,6,True,True,0.11525811111111112,-0.167305
9635,7486522,39,8,0.146583,126,7499063,-1,48.0,9380903,9380942,1894381,39,87,7,True,True,0.047949200000000004,-0.146583
9636,7486545,96,32,0.09391,126,7499063,-1,928.0,9742774,9742870,2256229,96,74,8,True,True,2.036650666666667,-0.09391
9637,7486552,12,1,0.304602,126,7499063,-1,16.0,9694974,9694986,2208422,12,75,7,True,True,0.0046304,-0.304602
9638,7486563,517,8,0.736186,126,7499063,-1,280.0,10767620,10768137,3281057,517,51,11,True,True,5.2238254444444445,-0.736186
9639,7486797,12091,64,0.452616,126,7499063,-1,896.0,8528012,8540103,1041215,12091,101,0,True,True,333.9567491555556,-0.43095872555963316
9640,7486842,462,1,0.734815,126,7499063,-1,23.0,10084437,10084899,2597595,462,69,0,True,True,0.19120896666666667,-0.734815
9641,7486887,589,32,0.989793,126,7499063,-1,320.0,8913918,8914507,1427031,589,99,1,True,True,5.143409777777777,-0.989793
9642,7486917,28843,4,0.25734,126,7499063,-1,140.0,11751886,11780729,4264969,28843,13,12,True,True,101.89408483333334,-0.2520828804563947
9643,7505496,7,2,0.486493,248,7587544,-1,44.0,10010037,10010044,2504541,7,72,6,True,True,0.005616722222222222,-0.486493
9644,7505618,77,1,0.364289,248,7587544,-1,29.0,7938490,7938567,432872,77,118,9,True,True,0.05235764722222222,-0.364289
9645,7505678,5,4,0.013561,248,7587544,-1,148.0,12059707,12059712,4554029,5,2,0,True,True,0.03224138888888889,-0.013561
9646,7505987,3,1,0.352626,248,7587544,-1,42.0,9604974,9604977,2098987,3,84,1,True,True,0.0028570500000000003,-0.352626
9647,7506481,10809,1,0.710157,248,7587544,-1,19.0,10879720,10890529,3373239,10809,51,8,True,True,5.84274911111111,-0.6765480455870913
9648,7507707,1443,16,0.891372,248,7587544,-1,768.0,11294208,11295651,3786501,1443,39,9,True,True,21.2748224,-0.891372
9649,7508060,599,16,0.774526,248,7587544,-1,592.0,8561818,8562417,1053758,599,109,0,True,True,10.623464666666665,-0.7745260000000003
9650,7508335,25,32,0.856956,248,7587544,-1,1120.0,10084437,10084462,2576102,25,74,6,True,True,0.5038444444444445,-0.856956
9651,7508355,439,16,0.902167,248,7587544,-1,624.0,9277164,9277603,1768809,439,102,7,True,True,4.430963333333334,-0.6740282245834219
9652,7508810,41,1,0.595744,248,7587544,-1,9.0,8229192,8229233,720382,41,119,10,True,True,0.010450899999999999,-0.5957439999999999
9653,7509792,1361,1,0.112761,248,7587544,-1,31.0,11851986,11853347,4342194,1361,10,8,True,True,3.2917183805555554,-0.112761
9654,7510285,49,1,0.685784,248,7587544,-1,9.0,9465603,9465652,1955318,49,95,9,True,True,0.010293675,-0.685784
9655,7511158,181,4,0.728216,248,7587544,-1,52.0,11236508,11236689,3725350,181,44,12,True,True,0.2057567777777778,-0.728216
9656,7511337,264,4,0.020727,248,7587544,-1,60.0,8528912,8529176,1017575,264,115,6,True,True,0.479864,-0.020727
9657,7511356,16631,256,0.978637,248,7587544,-1,5888.0,9003918,9020549,1492562,16631,110,12,True,True,1905.6752099555556,-0.9679847328147199
9658,7511475,10,1,0.856266,248,7587544,-1,49.0,8560018,8560028,1048543,10,116,7,True,True,0.015535722222222225,-0.8562659999999999
9659,7514110,15957,32,0.659367,248,7587544,-1,480.0,8735518,8751475,1221408,15957,114,12,True,True,183.37672133333334,-0.6545060841166994
9660,7514206,8830,6,0.141633,248,7587544,-1,138.0,11553394,11562224,4039188,8830,26,0,True,True,39.1574195,-0.139535213856959
9661,7515103,4,7,0.497832,248,7587544,-1,119.0,10091197,10091201,2576094,4,74,8,True,True,0.008868144444444443,-0.497832
9662,7515573,71,1,0.244368,248,7587544,-1,41.0,9604903,9604974,2089330,71,92,10,True,True,0.066006925,-0.244368
9663,7516063,225,8,0.741012,248,7587544,-1,184.0,11317208,11317433,3801145,225,41,6,True,True,0.9170099999999999,-0.741012
9664,7516430,12454,64,0.973291,248,7587544,-1,1024.0,10332997,10345451,2816567,12454,72,0,True,True,456.7538915555556,-0.9669591690937062
9665,7516582,11,1,0.35942,248,7587544,-1,48.0,10636244,10636255,3119662,11,63,6,True,True,0.018946400000000006,-0.35942
9666,7523724,10082,16,0.744365,248,7587544,-1,512.0,8431530,8441612,907806,10082,129,11,True,True,158.03550151111114,-0.7437598915711192
9667,7524970,12360,8,0.193842,248,7587544,-1,336.0,10342897,10355257,2817927,12360,71,2,True,True,149.3327164,-0.1937183333373183
9668,7525197,20221,4,0.954814,248,7587544,-1,104.0,7887090,7907311,361893,20221,143,8,True,True,46.92295544444444,-0.9136614168224196
9669,7525374,37,8,0.638734,248,7587544,-1,344.0,11800586,11800623,4275212,37,13,6,True,True,0.37780946666666665,-0.6387340000000001
9670,7526550,15363,1,0.965453,248,7587544,-1,45.0,9323164,9338527,1796614,15363,112,11,True,True,14.232596375,-0.9034500388363723
9671,7537641,10,8,0.877144,248,7587544,-1,216.0,11050874,11050884,3513233,10,53,7,True,True,0.058914,-0.877144
9672,7537765,8549,2,0.678802,248,7587544,-1,56.0,9509803,9518352,1972038,8549,105,10,True,True,13.652206555555557,-0.6763910767404449
9673,7537949,63,20,0.899221,248,7587544,-1,680.0,8207092,8207155,669143,63,139,7,True,True,0.46207700000000007,-0.899221
9674,7538406,43480,111,0.449269,248,7587544,-1,5439.0,11453010,11496490,3914604,43480,33,1,True,True,8262.431886916667,-0.4409905358820362
9675,7538432,144,8,0.958306,248,7587544,-1,168.0,10332997,10333141,2794565,144,78,12,True,True,0.8136576,-0.9583059999999999
9676,7541236,118,1,0.526907,248,7587544,-1,48.0,10583944,10584062,3042708,118,69,11,True,True,0.15232613333333334,-0.47248120909449104
9677,7541612,16086,8,0.265309,248,7587544,-1,144.0,9372764,9388850,1831152,16086,115,0,True,True,59.986879999999985,-0.26317217820282207
9678,7541791,407,4,0.679066,248,7587544,-1,24.0,9202618,9203025,1660827,407,124,12,True,True,0.3688505333333334,-0.679066
9679,7541852,19,58,0.887995,248,7587544,-1,1624.0,10246597,10246616,2704745,19,80,12,True,True,0.8224838222222223,-0.887995
9680,7542109,173,4,0.391026,248,7587544,-1,100.0,12114707,12114880,4572598,173,0,11,True,True,0.7322705555555556,-0.391026
9681,7542142,19,2,0.417294,248,7587544,-1,78.0,11024274,11024293,3482132,19,57,9,True,True,0.054578766666666674,-0.417294
9682,7542176,299,7,0.993944,248,7587544,-1,175.0,11238308,11238607,3696132,299,49,7,True,True,1.1438826388888887,-0.993944
9683,7542197,10425,8,0.309323,248,7587544,-1,400.0,9026018,9036443,1483821,10425,130,10,True,True,98.65011222222222,-0.3035928383030011
9684,7542226,15,8,0.0411,248,7587544,-1,376.0,11663686,11663701,4121460,15,19,10,True,True,0.11555733333333335,-0.0411
9685,7542506,5,1,0.520078,248,7587544,-1,30.0,10039337,10039342,2496831,5,93,9,True,True,0.00333375,-0.520078
9686,7542518,10317,1,0.343274,248,7587544,-1,42.0,11455294,11465611,3912776,10317,34,1,True,True,13.650162400000003,-0.3429279107184501
9687,7543012,8973,128,0.612367,248,7587544,-1,3968.0,10444344,10453317,2901332,8973,75,11,True,True,473.3690410666666,-0.6096001310470821
9688,7543040,8227,32,0.43346,248,7587544,-1,288.0,9275364,9283591,1732324,8227,129,6,True,True,42.4298048,-0.3991995249265099
9689,7543055,5167,1,0.455028,248,7587544,-1,18.0,9247718,9252885,1704663,5167,132,6,True,True,1.9570211,-0.4480501012884732
9690,7543071,9,4,0.968153,248,7587544,-1,148.0,8438730,8438739,895659,9,149,0,True,True,0.0409627,-0.968153
9691,7543195,2172,1,0.792341,248,7587544,-1,11.0,7960590,7962762,417395,2172,163,10,True,True,0.6270322666666667,-0.792341
9692,7554084,9942,4,0.288409,248,7587544,-1,148.0,9557103,9567045,2003019,9942,112,7,True,True,31.727561666666663,-0.2761182055983772
9693,7554231,35,32,0.96947,248,7587544,-1,1504.0,9379103,9379138,1824872,35,124,2,True,True,1.348315111111111,-0.96947
9694,7554406,43,32,0.498927,248,7587544,-1,1120.0,9917337,9917380,2362931,43,100,7,True,True,1.6992453333333335,-0.498927
9695,7554775,2,8,0.685527,248,7587544,-1,232.0,7960590,7960592,405815,2,166,0,True,True,0.012177422222222224,-0.685527
9696,7554832,53,16,0.466317,248,7587544,-1,656.0,8387330,8387383,832498,53,155,12,True,True,0.4866554222222222,-0.466317
9697,7554839,40,55,0.150228,248,7587544,-1,2530.0,9435903,9435943,1881064,40,123,8,True,True,2.834443333333333,-0.150228
9698,7554850,1522,14,0.966671,248,7587544,-1,406.0,11804186,11805708,4249336,1522,13,8,True,True,18.12492266666667,-0.9605190583626092
9699,7554855,11313,128,0.623795,248,7587544,-1,3968.0,10339297,10350610,2784442,11313,83,6,True,True,1649.0547601777778,-0.6235787028108242
9700,7554941,19250,16,0.66432,248,7587544,-1,416.0,9749974,9769224,2195033,19250,106,9,True,True,209.29468675555555,-0.6496112514895147
9701,7555000,46,8,0.303646,248,7587544,-1,288.0,9526003,9526049,1971003,46,119,7,True,True,0.38426560000000004,-0.30364599999999997
9702,7555030,5551,4,0.28826,248,7587544,-1,112.0,9446703,9452254,1891673,5551,125,7,True,True,12.202801022222221,-0.2835505779019645
9703,7555576,9,3,0.799785,248,7587544,-1,129.0,8300930,8300939,745354,9,162,0,True,True,0.017321475000000003,-0.799785
9704,7555625,8,12,0.015592,248,7587544,-1,360.0,9379103,9379111,1823478,8,131,0,True,True,0.07376799999999999,-0.015592
9705,7555664,5,1,0.040953,248,7587544,-1,18.0,10530744,10530749,2975080,5,76,12,True,True,0.0022489999999999997,-0.040953
9706,7555997,5,3,0.283017,248,7587544,-1,87.0,9371864,9371869,1815867,5,136,6,True,True,0.01178125,-0.28301699999999996
9707,7556017,9121,32,0.593072,248,7587544,-1,1088.0,11026074,11035195,3470057,9121,61,7,True,True,366.36975928888893,-0.5885812173068412
9708,7556166,31,8,0.053193,248,7587544,-1,112.0,10532544,10532575,2976378,31,77,7,True,True,0.08676142222222222,-0.053193
9709,7556438,21446,1,0.305822,248,7587544,-1,8.0,9889837,9911283,2333399,21446,107,9,True,True,8.424955244444446,-0.3032966480937174
9710,7556455,96,31,0.430323,248,7587544,-1,1147.0,9555303,9555399,1998848,96,121,10,True,True,2.627394666666667,-0.430323
9711,7556597,36,2,0.660253,248,7587544,-1,98.0,9838437,9838473,2281840,36,109,11,True,True,0.114366,-0.660253
9712,7556755,6,1,0.000642,248,7587544,-1,14.0,8528912,8528918,972157,6,162,0,True,True,0.0025447333333333336,-0.000642
9713,7556892,9528,32,0.251433,248,7587544,-1,1184.0,11967886,11977414,4410994,9528,7,11,True,True,433.32391146666663,-0.24331878447387173
9714,7556984,9,16,0.350218,248,7587544,-1,304.0,10400144,10400153,2843160,9,81,8,True,True,0.063878,-0.350218
9715,7558656,58,8,0.283266,248,7587544,-1,184.0,8554618,8554676,995962,58,164,8,True,True,0.28369733333333336,-0.283266
9716,7558728,21,2,0.859011,248,7587544,-1,66.0,12059686,12059707,4500958,21,5,12,True,True,0.06038725,-0.859011
9717,7558783,39,32,0.665326,248,7587544,-1,320.0,9376364,9376403,1817581,39,142,1,True,True,0.329784,-0.665326
9718,7558912,32,32,0.768885,248,7587544,-1,1280.0,10087597,10087629,2528685,32,100,1,True,True,0.7433102222222222,-0.768885
9719,7559187,7647,29,0.155037,248,7587544,-1,1073.0,11049074,11056721,3489887,7647,62,10,True,True,230.18429968888887,-0.15403328901654303
9720,7559722,9032,16,0.086003,248,7587544,-1,544.0,11316308,11325340,3756586,9032,50,10,True,True,91.67718897777779,-0.08207506762679284
9721,7559765,2,2,0.270669,248,7587544,-1,22.0,11017074,11017076,3457309,2,67,11,True,True,0.0018112111111111108,-0.270669
9722,7559900,26386,165,0.995914,248,7587544,-1,2805.0,10972874,10999260,3412974,26386,68,1,True,True,2833.509396666667,-0.9788017955334667
9723,7559976,9378,1,0.196727,248,7587544,-1,7.0,9072018,9081396,1512042,9378,161,7,True,True,1.84630005,-0.18629524358656066
9724,7560136,28,13,0.585225,248,7587544,-1,403.0,9794237,9794265,2234101,28,118,1,True,True,0.4576288888888889,-0.585225
9725,7560771,9,2,0.080718,248,7587544,-1,58.0,11058074,11058083,3497303,9,62,9,True,True,0.0145319,-0.080718
9726,7560886,251,8,0.218858,248,7587544,-1,88.0,8558218,8558469,997332,251,174,2,True,True,0.7003123111111111,-0.218858
9727,7561424,240,8,0.473178,248,7587544,-1,248.0,7797090,7797330,235666,240,202,11,True,True,1.404176,-0.473178
9728,7561428,10,2,0.354632,248,7587544,-1,68.0,9513403,9513413,1951975,10,138,8,True,True,0.01987677777777778,-0.354632
9729,7561500,8311,8,0.811709,248,7587544,-1,88.0,11335208,11343519,3773708,8311,46,9,True,True,15.05142882222222,-0.7633068457936869
9730,7561546,8018,128,0.637045,248,7587544,-1,5888.0,8910318,8918336,1348772,8018,170,11,True,True,1170.8778666666667,-0.6346206602527494
9731,7561575,499,8,0.422563,248,7587544,-1,184.0,11360908,11361407,3799333,499,45,10,True,True,1.8618244444444443,-0.422563
9732,7561780,114,32,0.966907,248,7587544,-1,960.0,10539744,10539858,2977964,114,86,9,True,True,2.879184,-0.966907
9733,7561869,11828,123,0.098139,248,7587544,-1,1968.0,9454803,9466631,1892934,11828,144,9,True,True,552.1617436,-0.09686419942287108
9734,7561916,15,16,0.261261,248,7587544,-1,192.0,9487703,9487718,1925787,15,143,10,True,True,0.06603200000000001,-0.261261
9735,7561944,37,1,0.302023,248,7587544,-1,29.0,8648218,8648255,1086274,37,178,12,True,True,0.018843072222222222,-0.302023
9736,7562063,148,64,0.310736,248,7587544,-1,2560.0,8256730,8256878,694667,148,194,7,True,True,9.310976,-0.310736
9737,7562097,26,32,0.563908,248,7587544,-1,256.0,10613244,10613270,3051147,26,84,10,True,True,0.16009528888888888,-0.563908
9738,7562119,700,13,0.678923,248,7587544,-1,195.0,9893437,9894137,2331318,700,120,8,True,True,8.243841666666667,-0.6789230000000002
9739,7562305,3,2,0.32248,248,7587544,-1,40.0,9425103,9425106,1862798,3,154,11,True,True,0.0045320000000000004,-0.32248
9740,7562431,6273,8,0.578167,248,7587544,-1,240.0,7705044,7711317,142613,6273,216,9,True,True,39.42402599999999,-0.5654147992959822
9741,7562440,4825,16,0.683321,248,7587544,-1,688.0,10157497,10162322,2595057,4825,106,11,True,True,66.26953217777778,-0.6460014194352377
9742,7562457,999,4,0.199507,248,7587544,-1,180.0,9250418,9251417,1687961,999,169,7,True,True,3.7842120000000006,-0.199507
9743,7562624,42,1,0.135691,248,7587544,-1,50.0,9739174,9739216,2176550,42,129,11,True,True,0.05017833333333333,-0.135691
9744,7562724,6792,128,0.554284,248,7587544,-1,4352.0,10591144,10597936,3028420,6792,85,0,True,True,897.6836551111112,-0.546231742323213
9745,7562749,15,1,0.301062,248,7587544,-1,15.0,10723420,10723435,3160671,15,79,0,True,True,0.005550625,-0.301062
9746,7562848,7025,2,0.085598,248,7587544,-1,66.0,10885120,10892145,3322272,7025,73,7,True,True,13.722888666666666,-0.082848841179051
9747,7562964,28,1,0.566665,248,7587544,-1,48.0,7752890,7752918,189926,28,221,11,True,True,0.0332192,-0.566665
9748,7562969,86,1,0.628319,248,7587544,-1,15.0,8561818,8561904,998849,86,190,7,True,True,0.03864625,-0.628319
9749,7562995,13964,16,0.545831,248,7587544,-1,784.0,9458403,9472367,1895408,13964,152,8,True,True,265.38639773333335,-0.5427047044466778
9750,7563194,10781,20,0.375966,248,7587544,-1,280.0,10005537,10016318,2442343,10781,121,12,True,True,55.175464555555564,-0.3747521370513407
9751,7563252,6624,2,0.875921,248,7587544,-1,80.0,10113297,10119921,2550045,6624,110,10,True,True,8.221000666666667,-0.8593671980852157
9752,7563313,139,8,0.436893,248,7587544,-1,240.0,7708690,7708829,145377,139,226,1,True,True,0.8258453333333333,-0.436893
9753,7564405,6,1,0.13861,248,7587544,-1,41.0,8205292,8205298,640887,6,213,10,True,True,0.0026533833333333336,-0.13861
9754,7564740,14547,1,0.441901,248,7587544,-1,19.0,8528918,8543465,964178,14547,197,1,True,True,8.58687039722222,-0.4287139610430107
9755,7564774,6,16,0.31326,248,7587544,-1,720.0,11462494,11462500,3897720,6,35,5,True,True,0.13790400000000003,-0.31326
9756,7564834,20618,32,0.93488,248,7587544,-1,448.0,8917518,8938136,1352684,20618,186,2,True,True,211.09690311111112,-0.9306542084984138
9757,7564875,32,4,0.712599,248,7587544,-1,160.0,8649118,8649150,1084243,32,192,6,True,True,0.08991288888888889,-0.712599
9758,7564880,13,8,0.468379,248,7587544,-1,104.0,8441612,8441625,876732,13,205,2,True,True,0.04157775555555555,-0.468379
9759,7565888,11,2,0.427669,248,7587544,-1,96.0,11466094,11466105,3900206,11,35,8,True,True,0.03351333333333334,-0.427669
9760,7565897,69,2,0.420506,248,7587544,-1,74.0,8069092,8069161,503195,69,224,12,True,True,0.15734989999999996,-0.4205059999999999
9761,7565911,20256,128,0.410259,248,7587544,-1,1280.0,8300930,8321186,735019,20256,213,11,True,True,411.92290844444443,-0.39257215377006105
9762,7566277,4590,1,0.027673,248,7587544,-1,25.0,9326764,9331354,1760487,4590,173,8,True,True,2.2245283333333337,-0.02499175258413472
9763,7566559,28,32,0.558909,248,7587544,-1,448.0,9116218,9116246,1549659,28,184,11,True,True,0.41614720000000005,-0.558909
9764,7566576,2,32,0.957492,248,7587544,-1,576.0,10083537,10083539,2516961,2,120,11,True,True,0.0203456,-0.957492
9765,7566639,79,4,0.420919,248,7587544,-1,52.0,7883490,7883569,316851,79,236,12,True,True,0.08916642222222221,-0.420919
9766,7566742,64,5,0.755856,248,7587544,-1,45.0,8551018,8551082,984276,64,204,10,True,True,0.07830399999999998,-0.755856
9767,7566922,8560,8,0.615209,248,7587544,-1,256.0,8551018,8559578,984096,8560,204,0,True,True,61.77216568888889,-0.5981642159329948
7477,5838914,19466,16,0.616028,1,5838914,-1,464.0,5842514,5861980,3600,19466,0,8,True,True,428.53039902222224,-0.5847014416861066
7478,5839417,118,8,0.189102,9,5842514,-1,312.0,5893914,5894032,54497,118,0,11,True,True,1.6289034666666666,-0.189102
7479,5839583,4,2,0.535468,9,5842514,-1,38.0,5896015,5896019,56432,4,0,1,True,True,0.006725155555555556,-0.535468
7480,5839618,2272,4,0.789588,9,5842514,-1,116.0,10827982,10830254,4988364,2272,0,11,True,True,19.78850057777778,-0.7744652145587437
7481,5839644,34,8,0.327681,9,5842514,-1,104.0,10925182,10925216,5085538,34,0,12,True,True,0.24501533333333333,-0.32768100000000006
7482,5839700,19967,1,0.053259,9,5842514,-1,18.0,7154023,7173990,1314323,19967,2,6,True,True,9.1747505,-0.05289874198694078
7483,5839896,20,1,0.795612,9,5842514,-1,48.0,7459201,7459221,1619305,20,2,8,True,True,0.033626666666666666,-0.7956119999999998
7484,5840012,82,4,0.872851,9,5842514,-1,132.0,5849714,5849796,9702,82,6,8,True,True,0.4612828,-0.872851
7485,5840100,18,1,0.851503,9,5842514,-1,12.0,7616200,7616218,1776100,18,2,10,True,True,0.007812600000000001,-0.851503
7486,5840188,107,1,0.968384,9,5842514,-1,30.0,5846114,5846221,5926,107,8,1,True,True,0.11510525,-0.968384
7487,5870614,11551,32,0.885834,24,5893914,-1,672.0,7804596,7816147,1933982,11551,2,12,True,True,213.0509154666667,-0.8637480390302238
7488,5880600,3,16,0.209238,24,5893914,-1,688.0,7710996,7710999,1830396,3,3,2,True,True,0.06978613333333333,-0.209238
7489,5880962,15,2,0.081408,24,5893914,-1,80.0,8948363,8948378,3067401,15,2,10,True,True,0.042679999999999996,-0.081408
7490,5881100,68,4,0.470667,24,5893914,-1,52.0,10248171,10248239,4367071,68,2,10,True,True,0.0891956,-0.470667
7491,5881385,2,8,0.663502,24,5893914,-1,248.0,7183601,7183603,1302216,2,8,10,True,True,0.018237644444444447,-0.663502
7492,5881622,112,17,0.064873,24,5893914,-1,629.0,6050515,6050627,168893,112,10,0,True,True,2.4236068888888886,-0.064873
7493,5883158,1641,1,0.508614,24,5893914,-1,35.0,7059312,7060953,1176154,1641,10,1,True,True,1.5284724583333336,-0.502601742332739
7494,5883784,6,1,0.751308,24,5893914,-1,15.0,6225129,6225135,341345,6,11,12,True,True,0.007839,-0.751308
7495,5885585,1201,64,0.645072,24,5893914,-1,1472.0,5894814,5896015,9229,1201,14,6,True,True,78.2185144888889,-0.645072
7496,5887426,17,64,0.509159,24,5893914,-1,3136.0,7279201,7279218,1391775,17,8,9,True,True,1.3798922666666669,-0.509159
7497,5888353,2940,16,0.498588,24,5893914,-1,240.0,7826696,7829636,1938343,2940,4,10,True,True,23.806159999999995,-0.498588
7498,5888516,102,4,0.464267,24,5893914,-1,200.0,7956096,7956198,2067580,102,4,9,True,True,0.8280700000000001,-0.464267
7499,5889002,20,8,0.321823,24,5893914,-1,104.0,6709515,6709535,820513,20,14,8,True,True,0.09208044444444444,-0.321823
7500,5889054,7028,1,0.373879,24,5893914,-1,44.0,7014915,7021943,1125861,7028,14,12,True,True,7.9372077888888874,-0.3735287994464788
7501,5890305,1107,1,0.69451,24,5893914,-1,31.0,6436429,6437536,546124,1107,16,10,True,True,0.9179641638888889,-0.6567826518869104
7502,5890888,78,1,0.71565,24,5893914,-1,39.0,7850596,7850674,1959708,78,5,10,True,True,0.19462885000000002,-0.71565
7503,5890994,2,64,0.494792,24,5893914,-1,832.0,6228729,6228731,337735,2,18,8,True,True,0.12075093333333334,-0.494792
7504,5891319,21,4,0.268335,24,5893914,-1,104.0,6584615,6584636,693296,21,17,9,True,True,0.11845166666666668,-0.26833500000000005
7505,5894446,38,1,0.400946,24,5894814,-1,26.0,6568136,6568174,673690,38,18,12,True,True,0.04997907777777778,-0.400946
7506,5895769,6344,1,0.921185,25,5896015,-1,40.0,5897815,5904159,2046,6344,23,7,True,True,10.579526555555555,-0.9190073415835125
7507,5895801,14,16,0.583983,25,5896015,-1,80.0,5942015,5942029,46214,14,23,11,True,True,0.038254222222222224,-0.583983
7508,5896365,6,16,0.036604,26,5897815,-1,656.0,11261696,11261702,5365331,6,0,12,True,True,0.13631680000000004,-0.036604000000000005
7509,5897788,87,45,0.219526,26,5897815,-1,2070.0,8900563,8900650,3002775,87,5,9,True,True,9.988992,-0.21952600000000005
7510,5897835,22,1,0.203,63,5942015,-1,21.0,9066081,9066103,3168246,22,4,8,True,True,0.02170501666666667,-0.20299999999999999
7511,5903646,2,16,0.863168,63,5942015,-1,160.0,7131023,7131025,1227377,2,17,1,True,True,0.009709333333333334,-0.863168
7512,5903692,5511,16,0.3959,63,5942015,-1,560.0,9121509,9127020,3217817,5511,4,2,True,True,118.48645200000001,-0.3937592114993445
7513,5903830,14,1,0.305999,63,5942015,-1,12.0,7718196,7718210,1814366,14,12,9,True,True,0.0060886,-0.305999
7514,5903854,21512,256,0.888709,63,5942015,-1,7168.0,7485594,7507106,1581740,21512,15,7,True,True,7537.819062044445,-0.8456458554292979
7515,5903891,13741,32,0.57137,63,5942015,-1,1408.0,7272001,7285742,1368110,13741,18,11,True,True,490.2408192,-0.5675556091132824
7516,5903910,6463,1,0.935499,63,5942015,-1,34.0,9858948,9865411,3955038,6463,4,1,True,True,14.952821844444447,-0.9204624292336828
7517,5904073,7,16,0.374107,63,5942015,-1,352.0,10482735,10482742,4578662,7,3,12,True,True,0.09527466666666665,-0.374107
7518,5904109,192,32,0.550552,63,5942015,-1,480.0,8889763,8889955,2985654,192,10,2,True,True,5.018112,-0.550552
7519,5904173,54,29,0.13433,63,5942015,-1,1276.0,9623722,9623776,3719549,54,6,11,True,True,2.7171144000000003,-0.13433
7520,5904231,20,8,0.084028,63,5942015,-1,256.0,9651236,9651256,3747005,20,6,10,True,True,0.18042311111111112,-0.084028
7521,5904299,7667,1,0.444505,63,5942015,-1,39.0,11317596,11325263,5413297,7667,0,6,True,True,24.729574675000002,-0.44282357670559425
7522,5904344,7,4,0.351575,63,5942015,-1,116.0,8014696,8014703,2110352,7,14,10,True,True,0.04111652222222222,-0.351575
7523,5904545,13,64,0.583962,63,5942015,-1,2176.0,6797915,6797928,893370,13,31,11,True,True,0.7653475555555556,-0.583962
7524,5905986,11287,128,0.465253,63,5942015,-1,3584.0,5964115,5975402,58129,11287,39,10,True,True,1693.1467392000002,-0.4600351062688783
7525,5906035,4050,67,0.621126,63,5942015,-1,804.0,9695436,9699486,3789401,4050,7,11,True,True,227.87114060000005,-0.5735834881913894
7526,5906485,4656,2,0.426102,63,5942015,-1,28.0,9446922,9451578,3540437,4656,10,7,True,True,4.8174042,-0.4223653606833888
7527,5906664,83,37,0.467551,63,5942015,-1,851.0,9094909,9094992,3188245,83,12,7,True,True,4.007049330555556,-0.467551
7528,5906719,25,1,0.408953,63,5942015,-1,28.0,10215271,10215296,4308552,25,6,10,True,True,0.018114444444444443,-0.408953
7529,5906995,65,8,0.804504,63,5942015,-1,200.0,6577415,6577480,670420,65,38,1,True,True,0.5435444444444445,-0.804504
7530,5907080,18,4,0.31702,63,5942015,-1,52.0,9906748,9906766,3999668,18,7,8,True,True,0.03774159999999999,-0.31702
7531,5907182,677,2,0.382371,63,5942015,-1,54.0,6481736,6482413,574554,677,41,11,True,True,1.8851742,-0.382371
7532,5907513,29749,128,0.179566,63,5942015,-1,1024.0,10360271,10390020,4452758,29749,5,7,True,True,1478.9119374222223,-0.17562711034321712
7533,5908228,324,8,0.23379,63,5942015,-1,272.0,8395340,8395664,2487112,324,20,11,True,True,3.0095712000000003,-0.23379000000000005
7534,5922727,807,2,0.645355,63,5942015,-1,88.0,10193171,10193978,4270444,807,8,12,True,True,2.2233925999999995,-0.645355
7535,5922836,12,1,0.359093,63,5942015,-1,36.0,7850596,7850608,1927760,12,24,0,True,True,0.027639600000000004,-0.35909300000000005
7536,5922893,56,8,0.082419,63,5942015,-1,64.0,6414329,6414385,491436,56,47,10,True,True,0.16111075555555557,-0.082419
7537,5923043,9440,30,0.842603,63,5942015,-1,1200.0,9254809,9264249,3331766,9440,15,11,True,True,416.74154,-0.8159555596463325
7538,5923741,6610,32,0.512791,63,5942015,-1,512.0,10374671,10381281,4450930,6610,5,9,True,True,252.1992519111111,-0.496858635150116
7539,5924008,267,32,0.643654,63,5942015,-1,160.0,8645263,8645530,2721255,267,23,9,True,True,1.6713013333333335,-0.643654
7540,5924145,828,2,0.785873,63,5942015,-1,36.0,6928515,6929343,1004370,828,43,12,True,True,0.7390728,-0.785873
7541,5937302,20,8,0.926606,63,5942015,-1,288.0,9344109,9344129,3406807,20,16,11,True,True,0.23919999999999997,-0.926606
7542,5937343,15455,1,0.098409,63,5942015,-1,31.0,10556282,10571737,4618939,15455,4,8,True,True,16.59834024722222,-0.0966019353871104
7543,5937364,22032,1,0.071349,63,5942015,-1,26.0,8893363,8915395,2955999,22032,24,2,True,True,37.12573229444445,-0.07040630555673998
7544,5937459,60,16,0.038281,63,5942015,-1,544.0,9491122,9491182,3553663,60,16,11,True,True,2.654176,-0.038281
7545,5938122,17491,128,0.200307,63,5942015,-1,4480.0,6392229,6409720,454107,17491,56,10,True,True,5124.311633777778,-0.19975763514827322
7546,5939596,10,1,0.196646,63,5942015,-1,45.0,9388319,9388329,3448723,10,18,1,True,True,0.01796,-0.196646
7547,5940046,5,9,0.329241,63,5942015,-1,126.0,8647063,8647068,2707017,5,28,7,True,True,0.024647,-0.329241
7548,5943944,43,16,0.302716,89,5964115,-1,80.0,7572000,7572043,1628056,43,40,1,True,True,0.1181448888888889,-0.30271599999999993
7549,5944054,4569,8,0.815565,89,5964115,-1,64.0,9421219,9425788,3477165,4569,18,10,True,True,12.890206044444444,-0.8155100796025727
7550,5944985,16221,32,0.683539,89,5964115,-1,704.0,7365601,7381822,1420616,16221,44,12,True,True,469.7053816888888,-0.6835287921844988
7551,5945227,20,1,0.274465,89,5964115,-1,43.0,6136915,6136935,191688,20,64,12,True,True,0.07085205555555554,-0.274465
7552,5945250,9156,1,0.705643,89,5964115,-1,13.0,8171140,8180296,2225890,9156,32,11,True,True,4.091945433333334,-0.6602839886073095
7553,5949338,6946,1,0.997996,89,5964115,-1,48.0,7851496,7858442,1902158,6946,35,6,True,True,19.7699656,-0.9487852410030674
7554,5949610,9251,4,0.998405,89,5964115,-1,132.0,9627322,9636573,3677712,9251,15,8,True,True,56.2365837,-0.9922966361642399
7555,5950566,59,4,0.752383,89,5964115,-1,80.0,9080509,9080568,3129943,59,25,1,True,True,0.4321028888888889,-0.752383
7556,5950742,7103,32,0.739821,89,5964115,-1,704.0,6050515,6057618,99773,7103,70,12,True,True,178.77165777777776,-0.7379379600223566
7557,5950940,1359,8,0.912383,89,5964115,-1,88.0,6276529,6277888,325589,1359,66,0,True,True,3.5459028,-0.9123829999999999
7558,5951016,40,8,0.008534,89,5964115,-1,320.0,9629136,9629176,3678120,40,15,1,True,True,0.5867733333333334,-0.008534
7559,5951084,22235,2,0.299474,89,5964115,-1,10.0,10711182,10733417,4760098,22235,4,1,True,True,17.427849944444443,-0.2952077054560459
7560,5951247,6,1,0.822309,89,5964115,-1,15.0,6276529,6276535,325282,6,69,8,True,True,0.0026685,-0.822309
7561,5951296,6,78,0.783128,89,5964115,-1,2964.0,8343940,8343946,2392644,6,36,12,True,True,0.401622,-0.783128
7562,5951655,140,1,0.403811,89,5964115,-1,8.0,10367471,10367611,4415816,140,8,2,True,True,0.04439866666666667,-0.403811
7563,5951854,12,1,0.405758,89,5964115,-1,39.0,7948896,7948908,1997042,12,41,11,True,True,0.019535100000000003,-0.4057580000000001
7564,5951926,14,1,0.579954,89,5964115,-1,26.0,6136915,6136929,184989,14,75,0,True,True,0.02998854444444444,-0.579954
7565,5951995,14,28,0.655309,89,5964115,-1,700.0,9629122,9629136,3677127,14,18,7,True,True,0.44924833333333325,-0.655309
7566,5952001,11284,16,0.472004,89,5964115,-1,128.0,8040540,8051824,2088539,11284,40,10,True,True,85.74738773333334,-0.46595502958072504
7567,5952197,8289,16,0.512647,89,5964115,-1,768.0,7059312,7067601,1107115,8289,61,0,True,True,192.1037184,-0.47033530519192374
7568,5953161,12067,16,0.761161,89,5964115,-1,576.0,9089509,9101576,3136348,12067,29,7,True,True,409.01664639999996,-0.6960070632129234
7569,5955024,20,4,0.149281,89,5964115,-1,132.0,9299909,9299929,3344885,20,26,11,True,True,0.13992000000000004,-0.149281
7570,5955318,15,1,0.397505,89,5964115,-1,33.0,7992596,7992611,2037278,15,44,8,True,True,0.016190625,-0.397505
7571,5955467,16,16,0.226926,89,5964115,-1,784.0,10783782,10783798,4828315,16,4,1,True,True,1.0141824,-0.226926
7572,5955906,27,1,0.749137,89,5964115,-1,46.0,9832336,9832363,3876430,27,16,12,True,True,0.09788340000000001,-0.7491369999999999
7573,5956088,10745,1,0.474438,89,5964115,-1,20.0,10000348,10011093,4044260,10745,14,6,True,True,7.125699222222222,-0.4688639141120865
7574,5961665,86,1,0.515825,89,5964115,-1,18.0,10666782,10666868,4705117,86,6,10,True,True,0.0789685,-0.5024134800157875
7575,5969778,334,8,0.785975,111,6050515,-1,296.0,6437536,6437870,467758,334,78,1,True,True,2.5679924,-0.785975
7576,5970831,20,1,0.757621,111,6050515,-1,33.0,9996748,9996768,4025917,20,16,8,True,True,0.02468766666666667,-0.757621
7577,5972158,9422,1,0.72251,111,6050515,-1,5.0,11272496,11281918,5300338,9422,1,9,True,True,1.768528888888889,-0.7205493853018622
7578,5972911,50,1,0.461401,111,6050515,-1,11.0,6136929,6136979,164018,50,88,1,True,True,0.0453123611111111,-0.461401
7579,5972972,7561,17,0.791915,111,6050515,-1,527.0,9696336,9703897,3723364,7561,21,6,True,True,260.5579873666667,-0.7326418587732572
7580,5973042,2995,5,0.313075,111,6050515,-1,60.0,7103512,7106507,1130470,2995,71,11,True,True,7.6192468333333325,-0.30502048879949595
7581,5973569,43036,2,0.187847,111,6050515,-1,34.0,9579522,9622558,3605953,43036,28,11,True,True,125.241125,-0.17846756879462755
7582,5975531,24,16,0.770131,111,6050515,-1,480.0,7040615,7040639,1065084,24,75,8,True,True,0.16131199999999998,-0.770131
7583,5993285,22793,128,0.697941,111,6050515,-1,1408.0,7462801,7485594,1469516,22793,65,8,True,True,1422.7248287999996,-0.6979395283911091
7584,5995698,2,8,0.209585,111,6050515,-1,280.0,7901096,7901098,1905398,2,55,11,True,True,0.03226066666666667,-0.209585
7585,5995748,7,4,0.449972,111,6050515,-1,180.0,9087709,9087716,3091961,7,39,8,True,True,0.09336599999999999,-0.449972
7586,5995800,686,1,0.558447,111,6050515,-1,14.0,7455601,7456287,1459801,686,69,12,True,True,0.38738801111111115,-0.558447
7587,5995817,602,1,0.3747,111,6050515,-1,30.0,10644682,10645284,4648865,602,8,11,True,True,1.3961686666666666,-0.3520637259551214
7588,5995826,170,4,0.577508,111,6050515,-1,28.0,8257540,8257710,2261714,170,51,12,True,True,0.15555944444444444,-0.577508
7589,5997313,37,6,0.128346,111,6050515,-1,174.0,11131096,11131133,5133783,37,3,9,True,True,0.6460175333333333,-0.128346
7590,5997397,69,8,0.943354,111,6050515,-1,264.0,7594100,7594169,1596703,69,68,10,True,True,0.7163442,-0.943354
7591,5997607,47,16,0.009681,111,6050515,-1,688.0,10508435,10508482,4510828,47,11,8,True,True,1.4230534666666665,-0.009681
7592,6010433,2573,2,0.810401,111,6050515,-1,80.0,8886163,8888736,2875730,2573,49,0,True,True,9.901082888888888,-0.7159043598403608
7593,6010526,2,4,0.834299,111,6050515,-1,144.0,11316696,11316698,5306170,2,1,11,True,True,0.022626399999999998,-0.834299
7594,6010551,78,1,0.339822,111,6050515,-1,25.0,8612363,8612441,2601812,78,53,12,True,True,0.06905166666666668,-0.339822
7595,6010570,6486,32,0.419147,111,6050515,-1,192.0,9210609,9217095,3200039,6486,40,6,True,True,59.78992960000001,-0.41284587221056557
7596,6010615,23,1,0.685763,111,6050515,-1,8.0,9093109,9093132,3082494,23,43,2,True,True,0.012076533333333334,-0.685763
7597,6011833,103,8,0.403369,111,6050515,-1,224.0,8351140,8351243,2339307,103,57,9,True,True,0.6333904888888889,-0.403369
7598,6084405,10,1,0.778643,227,6136915,-1,47.0,6591815,6591825,507410,10,95,8,True,True,0.020716555555555557,-0.778643
7599,6084716,8396,8,0.537604,227,6136915,-1,168.0,7702600,7710996,1617884,8396,74,12,True,True,46.94597226666667,-0.5370137672317928
7600,6085683,12,4,0.32608,227,6136915,-1,120.0,10757182,10757194,4671499,12,8,11,True,True,0.1051,-0.32608
7601,6085768,291,64,0.02324,227,6136915,-1,2944.0,7709800,7710091,1624032,291,75,9,True,True,28.96611413333333,-0.023239999999999997
7602,6085843,31,32,0.785358,227,6136915,-1,256.0,7153123,7153154,1067280,31,89,10,True,True,0.19654826666666667,-0.785358
7603,6085865,8087,26,0.922144,227,6136915,-1,858.0,7227801,7235888,1141936,8087,87,11,True,True,140.76379221666667,-0.8301610810887634
7604,6093970,4,2,0.153691,227,6136915,-1,22.0,9835936,9835940,3741966,4,25,8,True,True,0.006524955555555555,-0.153691
7605,6094137,1277,1,0.952638,227,6136915,-1,17.0,9698136,9699413,3603999,1277,27,7,True,True,1.625735452777778,-0.9286815062672172
7606,6094181,836,16,0.330251,227,6136915,-1,432.0,10393635,10394471,4299454,836,15,8,True,True,10.3189152,-0.330251
7607,6094592,4818,1,0.629839,227,6136915,-1,8.0,8638063,8642881,2543471,4818,59,0,True,True,1.4725859999999997,-0.6275511680066116
7608,6094727,8,8,0.603003,227,6136915,-1,120.0,7853296,7853304,1758569,8,72,7,True,True,0.058216000000000004,-0.603003
7609,6094907,18787,2,0.607837,227,6136915,-1,84.0,10783782,10802569,4688875,18787,7,0,True,True,118.07361043333334,-0.5991296317859923
7610,6094978,10,4,0.866945,227,6136915,-1,116.0,8992563,8992573,2897585,10,53,11,True,True,0.05699788888888888,-0.866945
7611,6095254,11,44,0.980172,227,6136915,-1,528.0,8841963,8841974,2746709,11,59,12,True,True,0.20015013333333337,-0.980172
7612,6095273,34,1,0.204205,227,6136915,-1,8.0,6370129,6370163,274856,34,117,9,True,True,0.013117955555555555,-0.204205
7613,6095276,750,8,0.390636,227,6136915,-1,120.0,7037015,7037765,941739,750,104,10,True,True,1.2945000000000002,-0.390636
7614,6095281,697,1,0.534491,227,6136915,-1,33.0,7058615,7059312,963334,697,103,9,True,True,0.57770845,-0.534491
7615,6095288,87,1,0.188339,227,6136915,-1,36.0,7978196,7978283,1882908,87,72,10,True,True,0.13574609999999998,-0.188339
7616,6095300,5354,8,0.108638,227,6136915,-1,208.0,10336371,10341725,4241071,5354,20,7,True,True,30.500148755555557,-0.10697712314210646
7617,6095363,19008,8,0.569515,227,6136915,-1,312.0,11317596,11336604,5222233,19008,0,0,True,True,514.721012,-0.5605228451816101
7618,6095534,31,4,0.451535,227,6136915,-1,80.0,9445122,9445153,3349588,31,42,7,True,True,0.09299311111111112,-0.451535
7619,6095582,113,2,0.894744,227,6136915,-1,62.0,7044215,7044328,948633,113,108,8,True,True,0.0987651388888889,-0.894744
7620,6095896,137,32,0.093242,227,6136915,-1,320.0,9395519,9395656,3299623,137,44,9,True,True,1.9223840000000003,-0.093242
7621,6095972,9,2,0.104313,227,6136915,-1,96.0,10390035,10390044,4294063,9,18,1,True,True,0.030316799999999998,-0.10431300000000003
7622,6095994,6961,17,0.552907,227,6136915,-1,833.0,10099571,10106532,4003577,6961,26,1,True,True,147.859270125,-0.5315525519613628
7623,6096053,39045,8,0.032059,227,6136915,-1,80.0,7161501,7200546,1065448,39045,104,1,True,True,86.69888800000001,-0.031736506590501035
7624,6096103,12315,4,0.689025,227,6136915,-1,132.0,7157623,7169938,1061520,12315,105,1,True,True,40.694494133333336,-0.6843654072555875
7625,6096127,23680,2,0.488613,227,6136915,-1,66.0,9117909,9141589,3021782,23680,53,6,True,True,58.88769425000001,-0.48007922503917533
7626,6096190,11,1,0.186692,227,6136915,-1,30.0,10947282,10947293,4851092,11,6,10,True,True,0.021625083333333333,-0.186692
7627,6096215,699,18,0.069491,227,6136915,-1,666.0,11123896,11124595,5027681,699,6,1,True,True,48.719010000000004,-0.06838320639029283
7628,6096769,50,1,0.962995,227,6136915,-1,9.0,10838782,10838832,4742013,50,9,2,True,True,0.031545,-0.962995
7629,6096778,13995,36,0.283818,227,6136915,-1,972.0,10831582,10845577,4734804,13995,10,8,True,True,953.7737391000001,-0.27486199087043867
7630,6096933,51,1,0.233039,227,6136915,-1,17.0,10508482,10508533,4411549,51,19,1,True,True,0.038155225,-0.233039
7631,6096961,72,4,0.65957,227,6136915,-1,68.0,6588215,6588287,491254,72,127,8,True,True,0.2303704,-0.65957
7632,6097020,8852,128,0.069979,227,6136915,-1,5504.0,10381281,10390133,4284261,8852,24,6,True,True,2149.119879822222,-0.05598716015720121
7633,6097126,33,8,0.057453,227,6136915,-1,56.0,10948182,10948215,4851056,33,7,6,True,True,0.12064873333333333,-0.057453
7634,6097130,279,4,0.518532,227,6136915,-1,132.0,6577136,6577415,480006,279,132,9,True,True,1.488169466666667,-0.501138893081761
7635,6097184,6985,8,0.171826,227,6136915,-1,240.0,6138729,6145714,41545,6985,144,7,True,True,137.09503333333333,-0.17063023409811917
7636,6097211,410,4,0.859707,227,6136915,-1,160.0,7129212,7129622,1032001,410,117,7,True,True,1.9904133333333336,-0.859707
7637,6097271,3,8,0.410861,227,6136915,-1,80.0,9036763,9036766,2939492,3,67,11,True,True,0.008773333333333333,-0.410861
7638,6097277,278,2,0.157035,227,6136915,-1,34.0,7161223,7161501,1063946,278,114,8,True,True,0.23146897777777775,-0.157035
7639,6097332,23,4,0.110744,227,6136915,-1,20.0,8525940,8525963,2428608,23,79,11,True,True,0.016045055555555555,-0.110744
7640,6097351,23,32,0.536453,227,6136915,-1,704.0,10099548,10099571,4002197,23,34,9,True,True,0.4618768,-0.5364529999999998
7641,6098046,203,8,0.478251,227,6136915,-1,200.0,9903148,9903351,3805102,203,38,0,True,True,1.7743327777777782,-0.478251
7642,6098145,19,1,0.068763,227,6136915,-1,26.0,10600482,10600501,4502337,19,19,0,True,True,0.04321127777777778,-0.068763
7643,6098202,1062,2,0.955097,227,6136915,-1,20.0,7058615,7059677,960413,1062,127,0,True,True,0.5362713888888889,-0.8954313244003307
7644,6098431,6,1,0.865699,227,6136915,-1,49.0,10835182,10835188,4736751,6,11,1,True,True,0.021960166666666666,-0.865699
7645,6098546,4961,16,0.129932,227,6136915,-1,480.0,6569936,6574897,471390,4961,142,7,True,True,86.681668,-0.10128893475651955
7646,6098955,14,1,0.205677,227,6136915,-1,28.0,11123882,11123896,5024927,14,7,11,True,True,0.04168811111111111,-0.205677
7647,6100368,8,26,0.432201,227,6136915,-1,442.0,8014696,8014704,1914328,8,91,0,True,True,0.17904928888888888,-0.432201
7648,6100373,624,1,0.709672,227,6136915,-1,39.0,9745936,9746560,3645563,624,45,1,True,True,1.2517492,-0.709672
7649,6100434,3,2,0.47478,227,6136915,-1,32.0,9998548,9998551,3898114,3,39,0,True,True,0.003158133333333334,-0.47478
7650,6100512,20254,16,0.603709,227,6136915,-1,736.0,7856896,7877150,1756384,20254,100,2,True,True,1202.3052097777775,-0.579776256516737
7651,6100987,28,2,0.939154,227,6136915,-1,14.0,9080481,9080509,2979494,28,73,9,True,True,0.03588651111111111,-0.939154
7652,6101020,9091,128,0.587492,227,6136915,-1,2816.0,8755563,8764654,2654543,9091,83,12,True,True,788.1915790222221,-0.5606395671145651
7653,6101026,128,16,0.502475,227,6136915,-1,800.0,8525963,8526091,2424937,128,88,1,True,True,3.5717688888888888,-0.502475
7654,6101073,7,1,0.684836,227,6136915,-1,29.0,10600482,10600489,4499409,7,22,11,True,True,0.01775686111111111,-0.684836
7655,6106453,89,16,0.275441,227,6136915,-1,576.0,7369201,7369290,1262748,89,122,1,True,True,2.3386351999999997,-0.275441
7656,6106775,9486,8,0.007443,227,6136915,-1,328.0,11321196,11330682,5214421,9486,0,2,True,True,271.29614173333334,-0.007307934829953494
7657,6106898,10,16,0.142692,227,6136915,-1,672.0,9535322,9535332,3428424,10,58,11,True,True,0.28619733333333336,-0.142692
7658,6107010,66,32,0.06397,227,6136915,-1,1568.0,10504835,10504901,4397825,66,27,10,True,True,2.952570133333333,-0.06397
7659,6107212,15,1,0.399237,227,6136915,-1,21.0,10390020,10390035,4282808,15,31,6,True,True,0.011052999999999999,-0.399237
7660,6107349,5513,1,0.807566,227,6136915,-1,41.0,9117009,9122522,3009660,5513,73,10,True,True,8.745385075000002,-0.7944104048963171
7661,6107760,42,4,0.525857,227,6136915,-1,100.0,8638063,8638105,2530303,42,93,10,True,True,0.15811833333333336,-0.525857
7662,6107783,6,4,0.910303,227,6136915,-1,36.0,7571994,7572000,1464211,6,124,12,True,True,0.0074184,-0.910303
7663,6108059,58,1,0.879239,227,6136915,-1,48.0,10092348,10092406,3984289,58,42,11,True,True,0.08738666666666667,-0.879239
7664,6108112,537,1,0.460205,227,6136915,-1,38.0,9903148,9903685,3795036,537,48,11,True,True,0.880879688888889,-0.45457024537850615
7665,6108162,11,4,0.576133,227,6136915,-1,200.0,7131012,7131023,1022850,11,143,7,True,True,0.06675166666666668,-0.576133
7666,6108299,73,1,0.737291,227,6136915,-1,32.0,6272929,6273002,164630,73,172,11,True,True,0.0801183111111111,-0.7372909999999999
7667,6109439,8251,8,0.287912,227,6136915,-1,344.0,11078782,11087033,4969343,8251,9,11,True,True,213.3098181111111,-0.2856226780758285
7668,6110021,745,2,0.880994,227,6136915,-1,70.0,8018440,8019185,1908419,745,106,1,True,True,2.5470929166666667,-0.880994
7669,6110292,24,16,0.456307,227,6136915,-1,144.0,10396335,10396359,4286043,24,30,6,True,True,0.0987456,-0.456307
7670,6110560,683,2,0.700317,227,6136915,-1,82.0,6680215,6680898,569655,683,160,11,True,True,2.0037702222222222,-0.700317
7671,6110618,475,1,0.711648,227,6136915,-1,50.0,8926263,8926738,2815645,475,88,10,True,True,0.8900972222222222,-0.711648
7672,6111648,10744,4,0.297449,227,6136915,-1,104.0,10334571,10345315,4222923,10744,39,12,True,True,31.165744711111106,-0.28509311947605137
7673,6111677,29494,4,0.613028,227,6136915,-1,180.0,6702315,6731809,590638,29494,162,10,True,True,243.49013950000003,-0.6126327352417544
7674,6112290,396,7,0.809985,227,6136915,-1,63.0,10218871,10219267,4106581,396,41,7,True,True,0.6760908000000001,-0.809985
7675,6112402,206,1,0.175126,227,6136915,-1,42.0,7828496,7828702,1716094,206,123,7,True,True,0.2919088666666667,-0.175126
7676,6112602,13650,14,0.249135,227,6136915,-1,126.0,6636015,6649665,523413,13650,166,11,True,True,63.803402250000005,-0.24449476083966964
7677,6112924,20785,193,0.899965,227,6136915,-1,7334.0,10552682,10573467,4439758,20785,26,11,True,True,5839.878507194443,-0.8617939138935027
7678,6116203,5,8,0.733244,227,6136915,-1,160.0,9073281,9073286,2957078,5,87,9,True,True,0.048220000000000006,-0.7332440000000001
7679,6116352,1695,8,0.457828,227,6136915,-1,400.0,10217071,10218766,4100719,1695,43,7,True,True,18.373800000000003,-0.457828
7680,6116390,8,4,0.910833,227,6136915,-1,96.0,9255709,9255717,3139319,8,77,6,True,True,0.028420266666666666,-0.910833
7681,6116853,16547,64,0.183444,227,6136915,-1,2048.0,9858040,9874587,3741187,16547,56,10,True,True,2145.8951111111114,-0.18079448796754957
7682,6117029,5,2,0.568615,227,6136915,-1,90.0,7127412,7127417,1010383,5,157,10,True,True,0.01395375,-0.568615
7683,6118255,11693,41,0.393551,227,6136915,-1,1230.0,6362929,6374622,244674,11693,186,12,True,True,676.9477609999999,-0.37700711083425925
7684,6118441,9726,24,0.945687,227,6136915,-1,312.0,10358471,10368197,4240030,9726,39,10,True,True,123.07043666666668,-0.9309173602739788
7685,6118880,394,1,0.239695,227,6136915,-1,19.0,10003948,10004342,3885068,394,50,8,True,True,0.2598057888888889,-0.239695
7686,6118914,18,1,0.87054,227,6136915,-1,21.0,9040363,9040381,2921449,18,94,8,True,True,0.0153174,-0.87054
7687,6118928,95,1,0.273776,227,6136915,-1,12.0,11175296,11175391,5056368,95,6,11,True,True,0.08309016666666666,-0.273776
7688,6119064,23817,2,0.628083,227,6136915,-1,10.0,6842115,6865932,723051,23817,172,11,True,True,7.8529167499999994,-0.6065484480966193
7689,6119108,9,4,0.29189,227,6136915,-1,152.0,11265296,11265305,5146188,9,5,8,True,True,0.0473024,-0.29189
7690,6123749,14,4,0.916296,227,6136915,-1,92.0,9040381,9040395,2916632,14,96,1,True,True,0.05219262222222222,-0.916296
7691,6123915,18,4,0.698044,227,6136915,-1,196.0,10363871,10363889,4239956,18,40,1,True,True,0.1404928,-0.698044
7692,6124059,81,1,0.722409,227,6136915,-1,45.0,7988996,7989077,1864937,81,126,9,True,True,0.087186375,-0.722409
7693,6124598,92,2,0.217255,227,6136915,-1,36.0,11034582,11034674,4909984,92,12,12,True,True,0.29472200000000004,-0.21725500000000006
7694,6124770,8,1,0.493488,227,6136915,-1,36.0,9858940,9858948,3734170,8,62,6,True,True,0.0198344,-0.4934880000000001
7695,6125092,2,5,0.99239,227,6136915,-1,115.0,7051415,7051417,926323,2,173,9,True,True,0.003526027777777778,-0.99239
7696,6125214,4,4,0.552824,227,6136915,-1,140.0,7981796,7981800,1856582,4,129,8,True,True,0.01561,-0.552824
7697,6125511,10193,16,0.995316,227,6136915,-1,672.0,9998548,10008741,3873037,10193,57,7,True,True,229.3849338666667,-0.9923658857456659
7698,6125774,15531,128,0.076534,227,6136915,-1,3328.0,10712982,10728513,4587208,15531,23,7,True,True,4316.649320533334,-0.07613268737998373
7699,6126004,10,16,0.105225,227,6136915,-1,240.0,9388309,9388319,3262305,10,85,11,True,True,0.09578666666666667,-0.105225
7700,6126999,20414,256,0.766539,227,6136915,-1,9728.0,9835940,9856354,3708941,20414,66,1,True,True,13423.153885866666,-0.7601608534586949
7701,6127255,15208,4,0.326013,227,6136915,-1,192.0,10780182,10795390,4652927,15208,22,6,True,True,227.98223893333335,-0.32132335661305
7702,6127551,151,16,0.450936,227,6136915,-1,96.0,7904696,7904847,1777145,151,138,8,True,True,0.6133821333333335,-0.450936
7703,6128779,3,1,0.252767,227,6136915,-1,26.0,9443322,9443325,3314543,3,84,1,True,True,0.0029247833333333334,-0.252767
7704,6128835,200,32,0.506065,227,6136915,-1,1184.0,10710982,10711182,4582147,200,26,11,True,True,18.56446222222222,-0.506065
7705,6128855,154,2,0.462167,227,6136915,-1,66.0,8481740,8481894,2352885,154,125,12,True,True,0.3352426,-0.46216699999999994
7706,6129010,26,32,0.073195,227,6136915,-1,288.0,9399119,9399145,3270109,26,87,8,True,True,0.332384,-0.073195
7707,6130829,3,5,0.694486,227,6136915,-1,35.0,9443319,9443322,3312490,3,86,10,True,True,0.003937208333333334,-0.694486
7708,6132809,32539,37,0.749736,227,6136915,-1,1591.0,10106771,10139310,3973962,32539,54,9,True,True,1491.2520914805555,-0.7400529087246883
7709,6133298,352,1,0.381156,227,6136915,-1,34.0,9062481,9062833,2929183,352,109,10,True,True,0.5207409777777778,-0.381156
7710,6133568,34,106,0.745957,227,6136915,-1,4028.0,6753715,6753749,620147,34,195,11,True,True,5.425581733333333,-0.745957
7711,6133731,53,4,0.855773,227,6136915,-1,32.0,8904163,8904216,2770432,53,116,3,True,True,0.10135013333333333,-0.855773
7712,6133928,6435,4,0.396674,227,6136915,-1,140.0,9084109,9090544,2950181,6435,105,8,True,True,67.21753072222222,-0.3892809844134987
7713,6134348,3,8,0.010737,227,6136915,-1,336.0,10779282,10779285,4644934,3,23,10,True,True,0.08354080000000001,-0.010737
7714,6134461,109,4,0.114683,227,6136915,-1,140.0,9209709,9209818,3075248,109,99,7,True,True,0.7099291111111111,-0.114683
7715,6134542,144,8,0.917137,227,6136915,-1,152.0,8018296,8018440,1883754,144,141,8,True,True,1.0690464000000002,-0.917137
7716,6157938,30,8,0.32711,240,6225129,-1,264.0,6705915,6705945,547977,30,202,8,True,True,0.31347800000000003,-0.32711
7717,6158059,72,1,0.748676,240,6225129,-1,50.0,8126940,8127012,1968881,72,139,12,True,True,0.32358,-0.748676
7718,6158070,1194,32,0.484759,240,6225129,-1,448.0,8948363,8949557,2790293,1194,117,0,True,True,19.0250368,-0.484759
7719,6158142,61,8,0.068237,240,6225129,-1,224.0,10048148,10048209,3890006,61,59,11,True,True,0.4994951111111111,-0.068237
7720,6166540,36,1,0.548429,240,6225129,-1,25.0,10395435,10395471,4228895,36,39,7,True,True,0.025715000000000002,-0.548429
7721,6166801,8740,64,0.242294,240,6225129,-1,384.0,9742336,9751076,3575535,8740,76,11,True,True,183.28952320000002,-0.23683349936404624
7722,6167111,15477,8,0.950018,240,6225129,-1,64.0,8886163,8901640,2719052,15477,128,11,True,True,53.972928177777774,-0.9392695325893311
7723,6167127,12518,64,0.140256,240,6225129,-1,832.0,11079682,11092200,4912555,12518,11,6,True,True,693.2078492444443,-0.1299151106425526
7724,6167151,6896,1,0.820427,240,6225129,-1,22.0,8615963,8622859,2448812,6896,136,8,True,True,6.493898766666666,-0.7601444888425193
7725,6167179,4606,42,0.841563,240,6225129,-1,630.0,7059312,7063918,892133,4606,197,0,True,True,80.47367650000001,-0.7404346534315804
7726,6167293,35,32,0.170589,240,6225129,-1,1152.0,8669163,8669198,2501870,35,132,10,True,True,1.386,-0.170589
7727,6167321,2351,32,0.018066,240,6225129,-1,576.0,9999448,10001799,3832127,2351,64,6,True,True,45.5891872,-0.017524665688003233
7728,6167402,3,64,0.100515,240,6225129,-1,448.0,7105312,7105315,937910,3,197,7,True,True,0.05692960000000001,-0.100515
7729,6168363,50,16,0.294145,240,6225129,-1,512.0,9993148,9993198,3824785,50,68,12,True,True,1.116942222222222,-0.294145
7730,6170285,6,15,0.534654,240,6225129,-1,615.0,9207909,9207915,3037624,6,106,12,True,True,0.14921950000000003,-0.534654
7731,6170812,28303,8,0.39085,240,6225129,-1,200.0,10222471,10250774,4051659,28303,53,8,True,True,133.24516944444446,-0.3735792781510388
7732,6170820,852,1,0.077585,240,6225129,-1,46.0,10226071,10226923,4055251,852,53,8,True,True,1.0819169333333332,-0.077585
7714,6134461,109,4,0.114683,1,6134461,-1,140.0,6156561,6156670,22100,109,0,10,True,True,0.5641961111111111,-0.114683
7715,6134542,144,8,0.917137,1,6156561,-1,152.0,6163761,6163905,29219,144,0,9,True,True,0.8453632,-0.917137
7716,6157938,30,8,0.32711,4,6163761,-1,264.0,8449337,8449367,2291399,30,0,0,True,True,0.7197960000000001,-0.32711
7717,6158059,72,1,0.748676,4,6163761,-1,50.0,9340931,9341003,3182872,72,0,0,True,True,0.12913,-0.748676
7718,6158070,1194,32,0.484759,4,6163761,-1,448.0,9340931,9342125,3182861,1194,1,11,True,True,19.35048515555556,-0.4520932875145686
7719,6158142,61,8,0.068237,4,6163761,-1,224.0,6167361,6167422,9219,61,3,8,True,True,0.5742675555555556,-0.068237
7720,6166540,36,1,0.548429,11,6167361,-1,25.0,8141474,8141510,1974934,36,3,10,True,True,0.0267575,-0.548429
7721,6166801,8740,64,0.242294,11,6167361,-1,384.0,10559762,10568502,4392961,8740,0,1,True,True,155.10225493333334,-0.23917987944878805
7722,6167111,15477,8,0.950018,11,6167361,-1,64.0,8743503,8758980,2576392,15477,3,12,True,True,34.600435733333335,-0.9041024115943318
7723,6167127,12518,64,0.140256,11,6167361,-1,832.0,8093674,8106192,1926547,12518,6,8,True,True,518.6192497777778,-0.1367986510535182
7724,6167151,6896,1,0.820427,11,6167361,-1,22.0,9570231,9577127,3403080,6896,1,12,True,True,7.250035955555555,-0.7928081786914627
7725,6167179,4606,42,0.841563,11,6167361,-1,630.0,6174561,6179167,7382,4606,8,9,True,True,122.72442525000001,-0.837416306219557
7726,6167293,35,32,0.170589,11,6167361,-1,1152.0,6291161,6291196,123868,35,8,7,True,True,1.681344,-0.170589
7727,6167321,2351,32,0.018066,11,6167361,-1,576.0,9161921,9164272,2994600,2351,4,11,True,True,49.18710399999999,-0.018016553132920988
7728,6167402,3,64,0.100515,21,6174561,-1,448.0,6260961,6260964,93559,3,10,12,True,True,0.052281600000000004,-0.100515
7729,6168363,50,16,0.294145,21,6174561,-1,512.0,6645125,6645175,476762,50,9,11,True,True,0.8875377777777778,-0.294145
7730,6170285,6,15,0.534654,21,6174561,-1,615.0,11072869,11072875,4902584,6,0,12,True,True,0.10366850000000001,-0.534654
7731,6170812,28303,8,0.39085,21,6174561,-1,200.0,6265461,6293764,94649,28303,12,6,True,True,226.79838444444448,-0.3869873657424516
7732,6170820,852,1,0.077585,21,6174561,-1,46.0,10963171,10964023,4792351,852,1,8,True,True,1.3504909999999999,-0.077585
7733,6171254,11,32,0.763589,21,6174561,-1,1216.0,7686353,7686364,1515099,11,11,9,True,True,0.4828364444444444,-0.763589
7734,6171266,6290,1,0.677383,21,6174561,-1,30.0,9269227,9275517,3097961,6290,6,6,True,True,6.677104583333334,-0.6772196648565006
7735,6171277,10237,3,0.153496,21,6174561,-1,63.0,8401537,8411774,2230260,10237,10,9,True,True,23.977324,-0.14684333212675646
7736,6171329,8,10,0.358087,21,6174561,-1,360.0,7754464,7754472,1583135,8,13,10,True,True,0.108968,-0.358087
7737,6171796,29,4,0.216672,21,6174561,-1,128.0,10955971,10956000,4784175,29,2,6,True,True,0.27285262222222223,-0.216672
7738,6171947,8514,128,0.034445,21,6174561,-1,1408.0,11076469,11084983,4904522,8514,0,8,True,True,351.64141368888886,-0.02883827984935482
7739,6180587,10886,2,0.675044,163,6260961,-1,16.0,7058104,7068990,877517,10886,17,9,True,True,9.0333664,-0.6737606737643114
7740,6180626,47,1,0.216166,163,6260961,-1,50.0,11142769,11142816,4962143,47,0,10,True,True,0.0746125,-0.216166
7741,6180674,58,1,0.696742,163,6260961,-1,44.0,7232704,7232762,1052030,58,18,7,True,True,0.1027038222222222,-0.696742
7742,6180804,34,2,0.836501,163,6260961,-1,48.0,6646025,6646059,465221,34,20,6,True,True,0.05798586666666667,-0.836501
7743,6180922,3,1,0.811512,163,6260961,-1,11.0,7497353,7497356,1316431,3,18,12,True,True,0.0009098833333333334,-0.811512
7744,6181531,14512,1,0.641012,163,6260961,-1,50.0,7000302,7014814,818771,14512,21,7,True,True,22.084334166666665,-0.6131208687114243
7745,6181893,34,4,0.71641,163,6260961,-1,136.0,7243504,7243538,1061611,34,19,8,True,True,0.1959676888888889,-0.71641
7746,6181980,11445,16,0.89701,163,6260961,-1,160.0,9294927,9306372,3112947,11445,9,10,True,True,64.36741866666667,-0.8964337822535409
7747,6182070,10698,256,0.390618,163,6260961,-1,11520.0,10966771,10977469,4784701,10698,3,8,True,True,3766.648416,-0.3801204407809765
7748,6182223,59,2,0.308324,163,6260961,-1,40.0,9483831,9483890,3301608,59,8,8,True,True,0.1965027777777778,-0.308324
7749,6182229,14021,8,0.052415,163,6260961,-1,368.0,6692025,6706046,509796,14021,26,6,True,True,432.98520893333335,-0.051918227833214675
7750,6182245,6,7,0.004666,163,6260961,-1,126.0,6600925,6600931,418680,6,29,12,True,True,0.0195384,-0.004666
7751,6182363,11,15,0.77241,163,6260961,-1,165.0,8296937,8296948,2114574,11,17,0,True,True,0.06737179166666668,-0.77241
7752,6182386,12,2,0.767114,163,6260961,-1,18.0,6267261,6267273,84875,12,32,7,True,True,0.0079632,-0.767114
7753,6182528,13,32,0.928821,163,6260961,-1,640.0,9348131,9348144,3165603,13,9,9,True,True,0.32360177777777777,-0.928821
7754,6182662,527,8,0.374645,163,6260961,-1,208.0,9072621,9073148,2889959,527,15,6,True,True,4.011336622222222,-0.374645
7755,6182694,1989,2,0.23854,163,6260961,-1,62.0,10552370,10554359,4369676,1989,7,11,True,True,5.84287535,-0.23854
7756,6182782,38,2,0.091386,163,6260961,-1,56.0,10649671,10649709,4466889,38,6,10,True,True,0.08483035555555556,-0.091386
7757,6182850,21,4,0.421683,163,6260961,-1,132.0,8865821,8865842,2682971,21,18,11,True,True,0.07989520000000001,-0.421683
7758,6182870,18,2,0.989291,163,6260961,-1,28.0,10093237,10093255,3910367,18,9,11,True,True,0.0469378,-0.989291
7759,6182876,16473,21,0.337117,163,6260961,-1,336.0,10493770,10510243,4310894,16473,9,11,True,True,318.12637266666667,-0.32214709739596414
7760,6183019,13368,6,0.192152,163,6260961,-1,120.0,6514525,6527893,331506,13368,38,8,True,True,58.63908666666666,-0.18280614190373862
7761,6183053,24,4,0.668949,163,6260961,-1,184.0,10977469,10977493,4794416,24,3,0,True,True,0.12039733333333334,-0.668949
7762,6184878,28,1,0.220568,163,6260961,-1,41.0,8774603,8774631,2589725,28,22,8,True,True,0.04450732222222222,-0.220568
7763,6186030,10651,4,0.882286,163,6260961,-1,136.0,7804064,7814715,1618034,10651,29,7,True,True,27.589083533333337,-0.7836393650969337
7764,6186037,134,4,0.796924,163,6260961,-1,168.0,9218727,9218861,3032690,134,19,2,True,True,0.8685254666666665,-0.796924
7765,6186291,7,1,0.830451,163,6260961,-1,43.0,7050904,7050911,864613,7,37,11,True,True,0.015664541666666663,-0.830451
7766,6186296,4,1,0.167883,163,6260961,-1,7.0,9296731,9296735,3110435,4,17,1,True,True,0.0010018555555555556,-0.167883
7767,6186359,9079,16,0.167047,163,6260961,-1,208.0,6835002,6844081,648643,9079,40,2,True,True,69.48195626666666,-0.16482678717219826
7768,6186610,2,64,0.41568,163,6260961,-1,2560.0,9660231,9660233,3473621,2,12,12,True,True,0.3970417777777778,-0.41568
7769,6186646,12762,5,0.107684,163,6260961,-1,60.0,8350137,8362899,2163491,12762,29,8,True,True,35.89784099999999,-0.10629068514501142
7770,6186691,94,4,0.327141,163,6260961,-1,188.0,10180537,10180631,3993846,94,11,6,True,True,1.7681326888888889,-0.327141
7771,6186720,10727,1,0.562054,163,6260961,-1,48.0,10585671,10596398,4398951,10727,8,8,True,True,16.8043336,-0.5562379051464923
7772,6186760,4,16,0.189548,163,6260961,-1,592.0,10239137,10239141,4052377,4,12,8,True,True,0.19993813333333332,-0.189548
7773,6187354,35732,16,0.207119,163,6260961,-1,368.0,8747103,8782835,2559749,35732,29,8,True,True,463.8675655111111,-0.2018927644668117
7774,6187374,16088,32,0.541703,163,6260961,-1,448.0,9246227,9262315,3058853,16088,24,10,True,True,260.7564088888889,-0.540551914726268
7775,6187428,7,4,0.938923,163,6260961,-1,68.0,7756264,7756271,1568836,7,39,7,True,True,0.018009988888888894,-0.938923
7776,6187452,40,4,0.120804,163,6260961,-1,80.0,10399970,10400010,4212518,40,12,6,True,True,0.2226577777777778,-0.12080400000000002
7777,6187476,230,32,0.21378,163,6260961,-1,1280.0,10620371,10620601,4432895,230,8,1,True,True,9.184462222222221,-0.21378
7778,6187562,4,1,0.356576,163,6260961,-1,44.0,8956021,8956025,2768459,4,30,11,True,True,0.005337199999999999,-0.356576
7779,6187628,5482,64,0.173622,163,6260961,-1,2112.0,8821621,8827103,2633993,5482,32,7,True,True,384.3452682666667,-0.17355981206359683
7780,6187688,7780,16,0.402139,163,6260961,-1,320.0,6510925,6518705,323237,7780,58,12,True,True,76.30444888888888,-0.39087093947287505
7781,6196956,48,8,0.31624,163,6260961,-1,40.0,7006693,7006741,809737,48,51,0,True,True,0.05652266666666667,-0.31623999999999997
7782,6197065,8715,64,0.389187,163,6260961,-1,2624.0,6954302,6963017,757237,8715,53,7,True,True,1267.6074887111113,-0.3509212874373348
7783,6197309,20587,32,0.458776,163,6260961,-1,256.0,9835031,9855618,3637722,20587,17,0,True,True,195.0539107555556,-0.4479475123846456
7784,6197333,132,8,0.066016,163,6260961,-1,304.0,7679153,7679285,1481820,132,47,12,True,True,1.6997552,-0.066016
7785,6197371,40,8,0.815085,163,6260961,-1,248.0,9214227,9214267,3016856,40,29,11,True,True,0.3734604444444445,-0.815085
7786,6197433,8,4,0.649945,163,6260961,-1,72.0,10959571,10959579,4762138,8,6,8,True,True,0.0264736,-0.649945
7787,6198518,5,2,0.36898,163,6260961,-1,20.0,6833625,6833630,635107,5,59,8,True,True,0.003726944444444444,-0.36898
7788,6198545,6037,1,0.067331,163,6260961,-1,45.0,7891374,7897411,1692829,6037,45,0,True,True,7.255704124999999,-0.06675773049475585
7789,6198567,13942,3,0.218561,163,6260961,-1,111.0,8910021,8923963,2711454,13942,34,11,True,True,36.10515993333333,-0.21807023783671456
7790,6199325,12,4,0.301534,163,6260961,-1,132.0,9215127,9215139,3015802,12,30,0,True,True,0.05963320000000001,-0.301534
7791,6199601,9528,16,0.598869,163,6260961,-1,752.0,8115774,8125302,1916173,9528,46,10,True,True,249.41040053333333,-0.5854563606794649
7792,6199623,16060,128,0.983102,163,6260961,-1,3328.0,9268327,9284387,3068704,16060,28,10,True,True,1991.8386083555556,-0.9829719381957145
7793,6200106,14,3,0.101814,163,6260961,-1,78.0,6693825,6693839,493719,14,65,7,True,True,0.09568649999999998,-0.101814
7794,6200395,17,19,0.536182,163,6260961,-1,855.0,7688164,7688181,1487769,17,53,7,True,True,0.524673125,-0.536182
7795,6201790,98,3,0.990531,163,6260961,-1,138.0,10955971,10956069,4754181,98,7,0,True,True,0.9940891333333334,-0.990531
7796,6201992,13,32,0.850465,163,6260961,-1,1088.0,10235537,10235550,4033545,13,17,0,True,True,0.8703274666666667,-0.8504649999999999
7797,6202188,15248,8,0.171459,163,6260961,-1,224.0,11143669,11158917,4941481,15248,0,6,True,True,108.1908912,-0.17085875372219295
7798,6202259,119,4,0.959035,163,6260961,-1,68.0,9272827,9272946,3070568,119,30,2,True,True,0.2880752,-0.959035
7799,6202348,13269,32,0.599867,163,6260961,-1,1120.0,10191337,10204606,3988989,13269,19,2,True,True,697.6253760000001,-0.49286329610430346
7800,6202504,4977,8,0.981416,163,6260961,-1,344.0,6830025,6835002,627521,4977,71,11,True,True,66.05983359999999,-0.9715723704561846
7801,6202738,9543,16,0.696315,163,6260961,-1,224.0,10213437,10222980,4010699,9543,19,0,True,True,75.22899066666668,-0.6934197950979792
7802,6202784,3,4,0.677901,163,6260961,-1,112.0,8818803,8818806,2616019,3,45,11,True,True,0.011029200000000001,-0.677901
7803,6202795,12009,1,0.972367,163,6260961,-1,35.0,8607467,8619476,2404672,12009,49,10,True,True,24.721383263888892,-0.9658412673624454
7804,6202868,670,1,0.693721,163,6260961,-1,24.0,10422070,10422740,4219202,670,16,0,True,True,1.0864273333333332,-0.693721
7805,6203049,269,8,0.332047,163,6260961,-1,216.0,7890464,7890733,1687415,269,59,12,True,True,1.5005357999999998,-0.332047
7806,6203171,1197,3,0.635353,163,6260961,-1,126.0,7236304,7237501,1033133,1197,68,8,True,True,6.2046495,-0.635353
7807,6204006,19249,128,0.883967,163,6260961,-1,4864.0,6842202,6861451,638196,19249,75,9,True,True,3073.3528533333333,-0.8598713475595137
7808,6204286,8237,4,0.317967,163,6260961,-1,68.0,7891374,7899611,1687088,8237,59,1,True,True,15.959485533333336,-0.28310592378103455
7809,6204343,16776,1,0.851554,163,6260961,-1,30.0,10616771,10633547,4412428,16776,12,8,True,True,17.624655916666665,-0.8429080062204124
7810,6206461,119,16,0.48213,163,6260961,-1,784.0,7006704,7006823,800243,119,74,1,True,True,2.746530577777778,-0.48213
7811,6207230,21,4,0.335105,163,6260961,-1,64.0,6950702,6950723,743472,21,78,10,True,True,0.08211093333333334,-0.335105
7812,6207482,681,8,0.608533,163,6260961,-1,96.0,9952731,9953412,3745249,681,25,11,True,True,2.5536592000000002,-0.608533
7813,6207629,10100,64,0.585037,163,6260961,-1,1792.0,7979574,7989674,1771945,10100,60,12,True,True,1098.6731093333333,-0.5129894518367054
7814,6207858,109,32,0.382371,163,6260961,-1,1376.0,11147269,11147378,4939411,109,0,8,True,True,4.883229066666666,-0.3823710000000001
7815,6207901,27,32,0.640592,163,6260961,-1,1312.0,9458131,9458158,3250230,27,31,0,True,True,1.6144488,-0.640592
7816,6208349,196,1,0.232425,163,6260961,-1,13.0,6646925,6647121,438576,196,89,6,True,True,0.09053185555555554,-0.232425
7817,6210331,11382,10,0.587469,163,6260961,-1,470.0,8771003,8782385,2560672,11382,52,10,True,True,206.72376730555555,-0.5837951357161024
7818,6210539,12,2,0.988381,163,6260961,-1,94.0,7239904,7239916,1029365,12,75,2,True,True,0.04841626666666668,-0.9883809999999998
7819,6210662,20824,32,0.232606,163,6260961,-1,1376.0,10422070,10442894,4211408,20824,19,10,True,True,1884.3954213333332,-0.23214124046713733
7820,6210840,189,3,0.616349,163,6260961,-1,114.0,6950702,6950891,739862,189,85,0,True,True,1.3163409,-0.616349
7821,6210850,9410,4,0.896779,163,6260961,-1,88.0,6738025,6747435,527175,9410,91,11,True,True,46.19558533333333,-0.8065554451071969
7822,6211134,23,4,0.308849,163,6260961,-1,84.0,8911821,8911844,2700687,23,48,7,True,True,0.04682953333333334,-0.308849
7823,6211443,21,5,0.737913,163,6260961,-1,95.0,10182337,10182358,3970894,21,25,7,True,True,0.19674025,-0.737913
7824,6212544,5,2,0.757246,163,6260961,-1,96.0,8819821,8819826,2607277,5,53,1,True,True,0.015756000000000003,-0.757246
7825,6214784,7,16,0.619766,163,6260961,-1,560.0,8119374,8119381,1904590,7,65,0,True,True,0.14091311111111113,-0.619766
7826,6214847,161,4,0.059923,163,6260961,-1,84.0,6337964,6338125,123117,161,104,11,True,True,0.36743956666666666,-0.059923
7827,6219088,11,1,0.374524,163,6260961,-1,41.0,9573831,9573842,3354743,11,31,1,True,True,0.020491686111111112,-0.374524
7828,6223783,10,4,0.296615,163,6260961,-1,136.0,9381031,9381041,3157248,10,35,8,True,True,0.04750555555555556,-0.29661499999999996
7829,6224187,10232,4,0.151671,163,6260961,-1,152.0,10556159,10566391,4331972,10232,16,7,True,True,74.35903333333333,-0.15039937638334172
7830,6225090,18531,100,0.204385,163,6260961,-1,3900.0,10235537,10254068,4010447,18531,24,10,True,True,5346.9078,-0.19577680223815788
7831,6225413,11946,113,0.037907,163,6260961,-1,2599.0,10986469,10998415,4761056,11946,5,7,True,True,878.331725125,-0.03218003617229451
7832,6226281,9339,64,0.923409,163,6260961,-1,2432.0,10184137,10193476,3957856,9339,28,7,True,True,1799.7717269333334,-0.8116976397472107
7833,6226847,91,1,0.598075,163,6260961,-1,42.0,7003002,7003093,776155,91,93,6,True,True,0.1268904,-0.598075
7834,6232781,8,8,0.945876,163,6260961,-1,192.0,9071721,9071729,2838940,8,54,12,True,True,0.05449386666666667,-0.9458760000000003
7835,6234484,38,64,0.739256,163,6260961,-1,2368.0,10049037,10049075,3814553,38,32,1,True,True,3.726837333333333,-0.739256
7836,6234645,5418,32,0.32869,163,6260961,-1,416.0,8142437,8147855,1907792,5418,72,1,True,True,70.96452595555556,-0.311445101116142
7837,6234774,319,4,0.278126,163,6260961,-1,108.0,8657103,8657422,2422329,319,67,11,True,True,1.0828455000000001,-0.278126
7838,6235408,28813,1,0.643602,163,6260961,-1,19.0,7232704,7261517,997296,28813,92,0,True,True,22.506615458333332,-0.6412329375051165
7839,6237416,7,8,0.760494,163,6260961,-1,168.0,10049030,10049037,3811614,7,33,11,True,True,0.048706,-0.760494
7840,6237461,1018,1,0.520873,163,6260961,-1,17.0,7287704,7288722,1050243,1018,90,11,True,True,0.7401199333333335,-0.520873
7841,6237706,12201,1,0.977568,163,6260961,-1,29.0,8449367,8461568,2211661,12201,70,1,True,True,29.476857794444445,-0.9699516791385632
7842,6237799,10444,14,0.648046,163,6260961,-1,378.0,6338125,6348569,100326,10444,119,1,True,True,115.0181928,-0.6317072241413076
7843,6237848,14170,2,0.288455,163,6260961,-1,92.0,9879231,9893401,3641383,14170,35,11,True,True,71.07038307777778,-0.28536125229075815
7844,6239963,212,2,0.023693,163,6260961,-1,66.0,10559759,10559971,4319796,212,17,0,True,True,0.6869683333333333,-0.023693
7845,6240057,14,1,0.846935,163,6260961,-1,45.0,9953412,9953426,3713355,14,35,1,True,True,0.024608500000000002,-0.846935
7846,6240278,19618,2,0.33127,163,6260961,-1,44.0,8979921,8999539,2739643,19618,60,10,True,True,27.190079033333333,-0.3249536355624774
7847,6241516,23,1,0.242249,163,6260961,-1,5.0,7592753,7592776,1351237,23,94,9,True,True,0.0029794583333333335,-0.242249
7848,6242557,54,4,0.539312,163,6260961,-1,72.0,10179637,10179691,3937080,54,32,12,True,True,0.38900519999999994,-0.539312
7849,6242604,9233,64,0.906632,163,6260961,-1,832.0,10329170,10338403,4086566,9233,24,1,True,True,424.2852200888889,-0.9055976694109017
7850,6242942,14832,119,0.665006,163,6260961,-1,4879.0,6741625,6756457,498683,14832,117,8,True,True,3307.4158637138885,-0.6116146501833957
7851,6244121,9,64,0.248338,163,6260961,-1,2944.0,6928602,6928611,684481,9,113,12,True,True,0.6353152,-0.248338
7852,6244172,10,8,0.68735,163,6260961,-1,104.0,9982730,9982740,3738558,10,37,1,True,True,0.04386488888888889,-0.68735
7853,6244213,24,1,0.719502,163,6260961,-1,12.0,8585367,8585391,2341154,24,77,7,True,True,0.007240000000000001,-0.719502
7854,6244275,3,8,0.608063,163,6260961,-1,48.0,8119374,8119377,1875099,3,85,0,True,True,0.0051764,-0.608063
7855,6244781,5455,114,0.381486,163,6260961,-1,3192.0,9979112,9984567,3734331,5455,38,1,True,True,714.3376002,-0.3667217521330442
7856,6245020,28567,1,0.321637,163,6260961,-1,6.0,8535767,8564334,2290747,28567,79,12,True,True,6.297474766666667,-0.3204909153143518
7857,6245128,3,2,0.442361,163,6260961,-1,68.0,9386431,9386434,3141303,3,48,7,True,True,0.007161533333333334,-0.442361
7858,6246233,8,3,0.006043,163,6260961,-1,33.0,8983521,8983529,2737288,8,65,8,True,True,0.008961333333333333,-0.006043
7859,6246872,28,2,0.869867,163,6260961,-1,10.0,9116821,9116849,2869949,28,63,11,True,True,0.009277333333333334,-0.869867
7860,6247440,6376,4,0.069985,163,6260961,-1,104.0,10004830,10011206,3757390,6376,37,10,True,True,26.270498222222223,-0.06974024743390754
7861,6247495,18,17,0.192465,163,6260961,-1,510.0,9982712,9982730,3735217,18,39,8,True,True,0.38719200000000004,-0.192465
7862,6249536,43,4,0.634367,163,6260961,-1,196.0,10955071,10955114,4705535,43,12,12,True,True,0.6195048222222224,-0.634367
7863,6249682,63,16,0.141532,163,6260961,-1,592.0,8142374,8142437,1892692,63,92,6,True,True,1.1088308000000002,-0.141532
7864,6249698,7093,1,0.20422,163,6260961,-1,14.0,9704431,9711524,3454733,7093,46,11,True,True,3.7137058000000005,-0.20087621169955686
7865,6249760,22807,32,0.091759,163,6260961,-1,1184.0,8748903,8771710,2499143,22807,81,7,True,True,900.8867908444444,-0.08992826029481157
7866,6249915,15444,16,0.592631,163,6260961,-1,624.0,8583567,8599011,2333652,15444,87,11,True,True,424.68427039999995,-0.5632659580114002
7867,6249937,23254,64,0.831221,163,6260961,-1,1472.0,10329137,10352391,4079200,23254,26,0,True,True,2408.611254222222,-0.8074508558374138
7868,6250937,20830,2,0.931813,163,6260961,-1,26.0,8405137,8425967,2154200,20830,92,8,True,True,26.683446761111107,-0.892719851825942
7869,6250948,49,2,0.23631,163,6260961,-1,88.0,10559762,10559811,4308814,49,17,0,True,True,0.21170722222222219,-0.23631
7870,6251161,27,1,0.078165,163,6260961,-1,41.0,6264561,6264588,13400,27,151,8,True,True,0.0408114,-0.078165
7871,6251172,7,26,0.724989,163,6260961,-1,1248.0,7003093,7003100,751921,7,126,1,True,True,0.29003519999999994,-0.724989
7872,6251927,99,4,0.311463,163,6260961,-1,180.0,9220527,9220626,2968600,99,65,7,True,True,0.6971579999999999,-0.311463
7873,6251990,5,1,0.721674,163,6260961,-1,16.0,6952502,6952507,700512,5,131,7,True,True,0.005404888888888889,-0.721674
7874,6252113,2,4,0.244925,163,6260961,-1,44.0,7758064,7758066,1505951,2,110,7,True,True,0.003235711111111111,-0.244925
7875,6256781,23843,84,0.176436,163,6260961,-1,3612.0,9355331,9379174,3098550,23843,56,1,True,True,2947.674598866666,-0.17172437432415394
7876,6256847,10440,1,0.248969,163,6260961,-1,28.0,9748631,9759071,3491784,10440,48,11,True,True,14.09986612222222,-0.24639365719841488
7877,6256880,29,1,0.285353,163,6260961,-1,14.0,10559971,10560000,4303091,29,17,2,True,True,0.019933472222222224,-0.285353
7878,6260604,7213,16,0.448271,163,6260961,-1,304.0,11120669,11127882,4860065,7213,3,11,True,True,189.76116240000002,-0.444284890618199
7879,6260611,2338,4,0.635604,163,6260961,-1,160.0,6998502,7000840,737891,2338,135,11,True,True,13.668467555555557,-0.635604
7880,6260754,18,16,0.271861,163,6260961,-1,320.0,7686364,7686382,1425610,18,118,1,True,True,0.20792,-0.271861
7881,6260898,10,4,0.781289,163,6260961,-1,44.0,7891364,7891374,1630466,10,112,6,True,True,0.011485222222222221,-0.781289
7882,6261066,16,1,0.080016,188,6264561,-1,7.0,9170027,9170043,2908961,16,73,1,True,True,0.004374533333333334,-0.080016
7883,6261074,10,1,0.972555,188,6264561,-1,6.0,7732364,7732374,1471290,10,119,11,True,True,0.0014983333333333335,-0.972555
7884,6261097,13,2,0.398244,188,6264561,-1,44.0,7585553,7585566,1324456,13,125,12,True,True,0.015261277777777775,-0.398244
7885,6261328,12317,1,0.167766,188,6264561,-1,20.0,10611371,10623688,4350043,12317,17,8,True,True,8.36572638888889,-0.16043343201287322
7886,6261346,12203,4,0.441376,188,6264561,-1,100.0,10693871,10706074,4432525,12203,14,11,True,True,33.89616305555556,-0.4334303270425104
7887,6261501,36,4,0.505293,188,6264561,-1,172.0,8612867,8612903,2351366,36,95,2,True,True,0.3641412,-0.505293
7888,6261542,10,32,0.734928,188,6264561,-1,1152.0,10868671,10868681,4607129,10,14,12,True,True,0.4845439999999999,-0.734928
7889,6261575,49,8,0.760324,188,6264561,-1,56.0,8609267,8609316,2347692,49,97,7,True,True,0.1557601111111111,-0.760324
7890,6261599,12716,8,0.819604,188,6264561,-1,360.0,9982712,9995428,3721113,12716,47,0,True,True,194.26921199999998,-0.7896278070542331
7891,6261631,6,1,0.793559,188,6264561,-1,26.0,6293764,6293770,32133,6,168,2,True,True,0.006426766666666667,-0.793559
7892,6262442,10208,1,0.019811,188,6264561,-1,33.0,10242737,10252945,3980295,10208,33,2,True,True,24.255496925,-0.01793112162874192
7893,6262462,277,4,0.381419,188,6264561,-1,124.0,9458131,9458408,3195669,277,62,10,True,True,1.5654101,-0.381419
7894,6262642,15546,8,0.854042,188,6264561,-1,392.0,7688164,7703710,1425522,15546,128,0,True,True,205.33869222222222,-0.836457128980529
7895,6262648,29052,128,0.758858,188,6264561,-1,1408.0,8612903,8641955,2350255,29052,99,1,True,True,2112.2588647111115,-0.737402632377491
7896,6262662,82,32,0.921532,188,6264561,-1,1440.0,8295137,8295219,2032475,82,112,12,True,True,4.383064,-0.921532
7897,6262673,18,1,0.595183,188,6264561,-1,34.0,10613171,10613189,4350498,18,19,7,True,True,0.021770200000000003,-0.595183
7898,6262684,4772,32,0.152799,188,6264561,-1,896.0,8296937,8301709,2034253,4772,113,7,True,True,153.96856533333332,-0.14933005522561052
7899,6262698,15738,128,0.726648,188,6264561,-1,4608.0,10447770,10463508,4185072,15738,29,10,True,True,3810.5773824000003,-0.7209415688789335
7900,6262737,401,2,0.257292,188,6264561,-1,30.0,7003093,7003494,740356,401,151,0,True,True,0.399396,-0.257292
7901,6263014,52,8,0.463651,188,6264561,-1,104.0,8539367,8539419,2276353,52,107,1,True,True,0.2284128888888889,-0.463651
7902,6263982,24,1,0.453603,188,6264561,-1,30.0,10738071,10738095,4474089,24,15,11,True,True,0.026652,-0.453603
7903,6264048,132,8,0.375147,188,6264561,-1,80.0,7388853,7388985,1124805,132,143,8,True,True,0.3676933333333333,-0.3751470000000001
7904,6264128,24339,1,0.606025,188,6264561,-1,27.0,6424525,6448864,160397,24339,178,12,True,True,35.130376350000006,-0.5979710670873067
7905,6264153,4789,16,0.07194,188,6264561,-1,480.0,10508170,10512959,4244017,4789,29,9,True,True,146.39162666666667,-0.06943428143318965
7906,6264206,6395,4,0.136656,188,6264561,-1,68.0,10500970,10507365,4236764,6395,30,2,True,True,24.45595161111111,-0.13517179291827916
7907,6264222,10100,1,0.469258,188,6264561,-1,15.0,10582071,10592171,4317849,10100,23,10,True,True,4.906521083333333,-0.46240305611568666
7908,6264833,3,16,0.154724,191,6265461,-1,384.0,10559759,10559762,4294926,3,28,2,True,True,0.056560000000000006,-0.154724
7909,6264838,6470,8,0.189626,191,6265461,-1,72.0,10399070,10405540,4134232,6470,38,11,True,True,36.55215,-0.18473518732133792
7910,6265259,27,1,0.012834,191,6265461,-1,18.0,10213437,10213464,3948178,27,46,10,True,True,0.018123749999999998,-0.012834
7911,6265407,245,2,0.5007,191,6265461,-1,60.0,7893174,7893419,1627767,245,132,7,True,True,0.3837108333333333,-0.5007
7912,6265505,6010,176,0.725345,193,6267261,-1,6512.0,8119374,8125384,1853869,6010,129,1,True,True,1310.4003899555555,-0.7053998913324342
7913,6265684,16444,36,0.491454,193,6267261,-1,576.0,6289361,6305805,23677,16444,191,10,True,True,384.1053408,-0.49047273922589585
7914,6266486,10,32,0.925691,193,6267261,-1,1312.0,10497370,10497380,4230884,10,33,1,True,True,0.7704355555555557,-0.9256909999999999
7915,6293965,6405,256,0.940285,244,6337964,-1,2304.0,8001674,8008079,1707709,6405,133,10,True,True,836.2342719999999,-0.9346868908981703
7916,6294014,47,2,0.970493,244,6337964,-1,32.0,6691125,6691172,397111,47,182,11,True,True,0.12689164444444445,-0.970493
7917,6294183,8744,2,0.373145,244,6337964,-1,36.0,9224127,9232871,2929944,8744,85,8,True,True,11.8971883,-0.3721619692839661
7918,6294238,76,1,0.489551,244,6337964,-1,13.0,10607771,10607847,4313533,76,22,10,True,True,0.035315511111111114,-0.489551
7919,6294258,12626,1,0.641049,244,6337964,-1,17.0,6842202,6854828,547944,12626,176,0,True,True,7.250326505555556,-0.6199272103404093
7920,6294397,5647,43,0.588309,244,6337964,-1,645.0,9480231,9485878,3185834,5647,72,10,True,True,270.3889217083333,-0.5843118918715275
7921,6294565,28479,256,0.408788,244,6337964,-1,6144.0,7360374,7388853,1065809,28479,157,0,True,True,4928.946432,-0.39707149663027436
7922,6294966,67,8,0.038827,244,6337964,-1,248.0,7802264,7802331,1507298,67,144,11,True,True,0.41526153333333327,-0.038827
7923,6295829,7814,32,0.921603,244,6337964,-1,224.0,9436031,9443845,3140202,7814,75,11,True,True,59.0565416,-0.9105097184574071
7924,6298965,26663,64,0.384826,244,6337964,-1,768.0,10554359,10581022,4255394,26663,31,1,True,True,856.2514112,-0.37147085922213346
7925,6299872,10537,4,0.565609,244,6337964,-1,40.0,10425670,10436207,4125798,10537,38,2,True,True,27.16268677777778,-0.5642805512790995
7926,6300302,13,1,0.194228,244,6337964,-1,40.0,10984669,10984682,4684367,13,7,9,True,True,0.014249444444444445,-0.19422799999999998
7927,6300322,11,4,0.436298,244,6337964,-1,164.0,10977469,10977480,4677147,11,9,1,True,True,0.049184055555555564,-0.436298
7928,6300898,46,1,0.255258,244,6337964,-1,18.0,10187737,10187783,3886839,46,54,8,True,True,0.0751226,-0.255258
7929,6300934,906,1,0.913086,244,6337964,-1,6.0,9169121,9170027,2868187,906,99,9,True,True,0.21290438333333334,-0.8876291343255847
7930,6302260,33,1,0.722245,244,6337964,-1,50.0,10329137,10329170,4026877,33,47,12,True,True,0.09168958333333335,-0.722245
7931,6302530,24,5,0.509608,244,6337964,-1,205.0,10449570,10449594,4147040,24,39,7,True,True,0.27791166666666667,-0.509608
7932,6303072,4,32,0.488622,244,6337964,-1,864.0,7144504,7144508,841432,4,174,12,True,True,0.17482560000000003,-0.488622
7933,6303104,118,16,0.688489,244,6337964,-1,720.0,8819703,8819821,2516599,118,114,6,True,True,2.7888120000000005,-0.688489
7934,6303782,4,2,0.696455,244,6337964,-1,100.0,9296727,9296731,2992945,4,90,7,True,True,0.014312222222222223,-0.696455
7935,6303857,21992,1,0.650906,244,6337964,-1,12.0,7002102,7024094,698245,21992,184,7,True,True,7.350163533333333,-0.6401913513915735
7936,6304128,4,2,0.926519,244,6337964,-1,66.0,9377431,9377435,3073303,4,85,10,True,True,0.0086614,-0.9265189999999998
7937,6304268,3,4,0.735664,244,6337964,-1,56.0,9391831,9391834,3087563,3,83,8,True,True,0.0062174000000000005,-0.735664
7938,6304793,55,4,0.242353,244,6337964,-1,172.0,8045874,8045929,1741081,55,149,11,True,True,0.36134572222222217,-0.242353
7939,6305356,7261,1,0.034508,244,6337964,-1,24.0,10354870,10362131,4049514,7261,46,8,True,True,9.788605133333334,-0.03282033397612491
7940,6306232,11,4,0.813126,244,6337964,-1,108.0,7006693,7006704,700461,11,185,3,True,True,0.0349734,-0.813126
7941,6306483,18483,16,0.630953,244,6337964,-1,272.0,9835031,9853514,3528548,18483,74,12,True,True,182.2739471111111,-0.6002621730262863
7942,6307347,18643,1,0.676426,244,6337964,-1,24.0,8346537,8365180,2039190,18643,140,11,True,True,21.19553446666667,-0.6698563648746204
7943,6312530,12644,19,0.697471,244,6337964,-1,950.0,8394337,8406981,2081807,12644,139,11,True,True,368.6763536111111,-0.6480460251134359
7944,6312649,6370,4,0.645334,244,6337964,-1,72.0,7354004,7360374,1041355,6370,177,10,True,True,10.5487136,-0.623470713470944
7945,6312732,16236,8,0.261331,244,6337964,-1,192.0,9886431,9902667,3573699,16236,72,9,True,True,167.31254080000002,-0.25761193524906884
7946,6320189,19481,1,0.455471,244,6337964,-1,6.0,6785825,6805306,465636,19481,207,11,True,True,8.441721983333334,-0.4474574196451344
7947,6322813,10286,1,0.681066,244,6337964,-1,29.0,9975512,9985798,3652699,10286,70,10,True,True,12.353151105555556,-0.6526450409305595
7948,6322961,88,1,0.254288,244,6337964,-1,48.0,9384631,9384719,3061670,88,89,8,True,True,0.14735893333333336,-0.254288
7949,6324202,102,16,0.602149,244,6337964,-1,672.0,8186637,8186739,1862435,102,148,11,True,True,2.6726448000000005,-0.602149
7950,6324844,9561,1,0.951778,244,6337964,-1,40.0,7410953,7420514,1086109,9561,179,10,True,True,14.030892222222223,-0.9437506358832939
7951,6325444,11804,128,0.841516,244,6337964,-1,3072.0,8957821,8969625,2632377,11804,116,7,True,True,1187.6166229333332,-0.8290656136994654
7952,6325959,19,4,0.012337,244,6337964,-1,52.0,10627571,10627590,4301612,19,20,9,True,True,0.03579304444444444,-0.012337
7953,6325980,159,1,0.770972,244,6337964,-1,23.0,8302337,8302496,1976357,159,147,7,True,True,0.09232909166666665,-0.770972
7954,6326647,10527,1,0.644397,244,6337964,-1,6.0,7230904,7241431,904257,10527,192,12,True,True,2.5835516666666667,-0.6356557255247224
7955,6326677,9368,16,0.916883,244,6337964,-1,384.0,10351270,10360638,4024593,9368,48,10,True,True,244.83198720000001,-0.8449166254138666
7956,6327300,4292,32,0.397667,244,6337964,-1,1152.0,8449337,8453629,2122037,4292,143,11,True,True,440.4035936,-0.3963346669129696
7957,6327484,176,8,0.58616,244,6337964,-1,376.0,9908531,9908707,3581047,176,75,10,True,True,2.738032,-0.58616
7958,6327837,11,1,0.900996,244,6337964,-1,12.0,7357604,7357615,1029767,11,188,8,True,True,0.0030173000000000005,-0.9009960000000002
7959,6331957,33,10,0.518537,244,6337964,-1,430.0,9117721,9117754,2785764,33,114,6,True,True,0.47016199999999997,-0.5185370000000001
7960,6332001,17,128,0.188823,244,6337964,-1,1664.0,8090074,8090091,1758073,17,164,11,True,True,1.3938126222222222,-0.188823
7961,6332054,26653,1,0.422945,244,6337964,-1,36.0,9215127,9241780,2883073,26653,110,6,True,True,36.00859689999999,-0.42002536817111336
7962,6332099,123,2,0.82975,244,6337964,-1,76.0,10782271,10782394,4450172,123,17,11,True,True,0.23533589999999996,-0.82975
7963,6332200,1273,16,0.252871,244,6337964,-1,240.0,8985321,8986594,2653121,1273,120,7,True,True,10.250763999999998,-0.24994641414124144
7964,6332235,9,16,0.30222,244,6337964,-1,480.0,7331904,7331913,999669,9,195,11,True,True,0.171144,-0.30222
7965,6332293,18787,128,0.967683,244,6337964,-1,6272.0,9388231,9407018,3055938,18787,92,7,True,True,4957.151300266667,-0.9564367961931778
7966,6332822,138,1,0.658486,244,6337964,-1,23.0,8300537,8300675,1967715,138,156,8,True,True,0.11429044999999999,-0.658486
7967,6333000,21997,128,0.382789,244,6337964,-1,3712.0,8208737,8230734,1875737,21997,160,10,True,True,2588.359668977778,-0.38250342325879416
7968,6333005,11747,64,0.307979,244,6337964,-1,896.0,9351731,9363478,3018726,11747,98,8,True,True,362.42960071111116,-0.29638809703858715
7969,6333011,11207,19,0.411609,244,6337964,-1,760.0,7499153,7510360,1166142,11207,193,7,True,True,194.694729,-0.40859835911580317
1472,1293277,13,1,0.496203,1,1293277,-1,37.0,1294554,1293290,1277,13,0,0,True,True,0.019052944444444442,-0.496203
1473,1294554,6774,64,0.497523,1,1294554,-1,1984.0,1296354,1303128,1800,6774,0,7,True,True,469.189216,-0.49172036842415406
1474,1294669,12239,3,0.92431,3,1296354,-1,120.0,1299954,1312193,5285,12239,0,8,True,True,41.002544666666665,-0.9152335007010282
1475,1294737,112,2,0.519276,3,1296354,-1,44.0,4637413,4637525,3342676,112,0,9,True,True,0.052743288888888885,-0.519276
1476,1295058,292,16,0.801148,3,1296354,-1,656.0,1344154,1344446,49096,292,1,11,True,True,9.083289422222222,-0.801148
1477,1296674,31905,16,0.727081,6,1299954,-1,480.0,1842354,1874259,545680,31905,1,6,True,True,449.502744,-0.6865516721642576
1478,1298004,12956,1,0.078927,6,1299954,-1,34.0,5793164,5806120,4495160,12956,0,8,True,True,6.30494148888889,-0.0742869873877671
1479,1299053,5794,178,0.602453,6,1299954,-1,4450.0,3860523,3866317,2561470,5794,2,9,True,True,258.4538491666667,-0.5952961644972901
1480,1299172,10160,8,0.822341,6,1299954,-1,384.0,1528854,1539014,229682,10160,4,1,True,True,40.026316800000004,-0.7728476703214003
1481,1300217,5981,128,0.545474,96,1344154,-1,3200.0,4077523,4083504,2777306,5981,2,11,True,True,1204.19304,-0.5288530506484241
1482,1300293,11,1,0.321211,96,1344154,-1,13.0,6698273,6698284,5397980,11,0,11,True,True,0.002090977777777778,-0.321211
1483,1300678,4,9,0.080069,96,1344154,-1,333.0,2766804,2766808,1466126,4,5,7,True,True,0.0318126,-0.080069
1484,1300931,8,4,0.660919,96,1344154,-1,132.0,3800752,3800760,2499821,8,5,7,True,True,0.0421784,-0.660919
1485,1301041,7580,2,0.306496,96,1344154,-1,78.0,5516227,5523807,4215186,7580,2,11,True,True,5.916689783333332,-0.2401979490483895
1486,1305566,17109,1,0.602622,96,1344154,-1,37.0,3671552,3688661,2365986,17109,7,12,True,True,4.242828027777778,-0.5908099148880869
1487,1305714,670,1,0.426116,96,1344154,-1,31.0,2388302,2388972,1082588,670,9,0,True,True,0.44932433333333327,-0.426116
1488,1306220,46393,55,0.689765,96,1344154,-1,1045.0,5643883,5690276,4337663,46393,2,10,True,True,950.1676665555553,-0.6565273023761232
1489,1306545,14816,1,0.351547,96,1344154,-1,15.0,5793164,5807980,4486619,14816,1,0,True,True,3.4130401666666663,-0.3079895775111601
1490,1309878,42,2,0.042355,96,1344154,-1,60.0,5541027,5541069,4231149,42,4,6,True,True,0.040495,-0.042355
1491,1310397,16,8,0.870037,96,1344154,-1,384.0,5124116,5124132,3813719,16,6,12,True,True,0.11137706666666668,-0.870037
1492,1312556,496,64,0.352559,96,1344154,-1,2880.0,6405696,6406192,5093140,496,1,1,True,True,13.483263999999998,-0.352559
1493,1313082,51,43,0.998151,96,1344154,-1,1376.0,4750113,4750164,3437031,51,8,9,True,True,3.1590895999999997,-0.998151
1494,1313539,32,2,0.274555,96,1344154,-1,70.0,3220679,3220711,1907140,32,14,11,True,True,0.07945155555555555,-0.274555
1495,1313662,8755,32,0.980027,96,1344154,-1,1248.0,5883164,5891919,4569502,8755,2,12,True,True,352.21630773333334,-0.9614608184459846
1496,1314069,13,10,0.947904,96,1344154,-1,50.0,4626613,4626626,3312544,13,11,11,True,True,0.006541527777777777,-0.947904
1497,1315723,46,8,0.075041,96,1344154,-1,136.0,4280413,4280459,2964690,46,12,9,True,True,0.1102793777777778,-0.075041
1498,1316219,12086,8,0.637513,96,1344154,-1,144.0,3307079,3319165,1990860,12086,17,12,True,True,20.947506,-0.5850867712068614
1499,1316353,12827,25,0.363311,96,1344154,-1,675.0,3385095,3397922,2068742,12827,17,10,True,True,226.07966625000003,-0.3601094095011194
1500,1319043,143,2,0.801096,96,1344154,-1,24.0,1666654,1666797,347611,143,23,11,True,True,0.16192366666666666,-0.801096
1501,1320593,9,2,0.679411,96,1344154,-1,70.0,6317264,6317273,4996671,9,2,11,True,True,0.0050697500000000005,-0.6794109999999999
1502,1320865,90,8,0.952789,96,1344154,-1,360.0,1536054,1536144,215189,90,25,3,True,True,0.29645999999999995,-0.952789
1503,1322450,37,1,0.142779,96,1344154,-1,45.0,5234616,5234653,3912166,37,9,11,True,True,0.03144075,-0.142779
1504,1322616,57,1,0.607573,96,1344154,-1,9.0,3768752,3768809,2446136,57,18,3,True,True,0.005045925,-0.607573
1505,1323015,12743,2,0.781312,96,1344154,-1,18.0,1388354,1401097,65339,12743,29,11,True,True,10.153834349999999,-0.718091378344052
1506,1323031,8047,37,0.034799,96,1344154,-1,888.0,4719913,4727960,3396882,8047,12,8,True,True,101.73795033333333,-0.033887763096992284
1507,1323428,727,4,0.067233,96,1344154,-1,112.0,4709113,4709840,3385685,727,13,7,True,True,2.2479809333333334,-0.06723300000000001
1508,1323517,392,1,0.778515,96,1344154,-1,37.0,1388354,1388746,64837,392,31,0,True,True,0.806704422222222,-0.778515
1509,1323542,13448,128,0.366328,96,1344154,-1,2176.0,1390154,1403602,66612,13448,31,7,True,True,1191.537682488889,-0.3584602524982808
1510,1323995,46337,4,0.382854,96,1344154,-1,112.0,1434354,1480691,110359,46337,31,11,True,True,164.33853240000002,-0.367220732508242
1511,1324200,44,28,0.567245,96,1344154,-1,924.0,2415904,2415948,1091704,44,26,10,True,True,1.7286705333333334,-0.567245
1512,1327945,7659,16,0.605095,96,1344154,-1,368.0,1525254,1532913,197309,7659,32,8,True,True,31.789934533333337,-0.561044519704177
1513,1327951,5,16,0.679062,96,1344154,-1,528.0,5024704,5024709,3696753,5,11,2,True,True,0.08703200000000001,-0.6790619999999999
1514,1328512,20621,179,0.948824,96,1344154,-1,5012.0,3816070,3836691,2487558,20621,20,1,True,True,4656.498979222222,-0.9451379600314948
1515,1328728,11,2,0.372013,96,1344154,-1,70.0,6653173,6653184,5324445,11,1,6,True,True,0.013402277777777779,-0.372013
1516,1328802,12,1,0.763084,96,1344154,-1,21.0,5282453,5282465,3953651,12,10,11,True,True,0.012306700000000002,-0.763084
1517,1328814,5,1,0.573922,96,1344154,-1,11.0,2761404,2761409,1432590,5,30,11,True,True,0.0017219583333333332,-0.573922
1518,1330137,7732,1,0.52946,96,1344154,-1,15.0,2296502,2304234,966365,7732,33,7,True,True,1.7241783333333331,-0.48868648626319466
1519,1330153,7,16,0.398034,96,1344154,-1,208.0,3035972,3035979,1705819,7,29,9,True,True,0.06619542222222222,-0.398034
1520,1330385,43,2,0.649561,96,1344154,-1,34.0,1344154,1344197,13769,43,44,0,True,True,0.06932722777777779,-0.649561
1521,1330698,7,8,0.249612,96,1344154,-1,80.0,6519873,6519880,5189175,7,2,6,True,True,0.010115777777777779,-0.249612
1522,1331059,8744,128,0.113449,96,1344154,-1,2432.0,4880604,4889348,3549545,8744,15,8,True,True,561.716608,-0.11308463255869756
1523,1331092,33237,13,0.735675,96,1344154,-1,507.0,2984572,3017809,1653480,33237,32,1,True,True,268.696822225,-0.6945110889982958
1524,1331191,443,16,0.499044,96,1344154,-1,144.0,5906164,5906607,4574973,443,5,6,True,True,1.7479008,-0.499044
1525,1331228,4,2,0.386987,96,1344154,-1,46.0,1622454,1622458,291226,4,41,12,True,True,0.0036064,-0.386987
1526,1331306,21,32,0.561673,96,1344154,-1,288.0,4862604,4862625,3531298,21,17,12,True,True,0.1584408,-0.5616729999999999
1527,1331604,25,1,0.261777,96,1344154,-1,12.0,4877004,4877029,3545400,25,17,9,True,True,0.011253333333333332,-0.261777
1528,1331611,39,1,0.26029,96,1344154,-1,36.0,5551827,5551866,4220216,39,10,1,True,True,0.024648,-0.26029
1529,1331759,8757,200,0.446273,96,1344154,-1,4200.0,5789564,5798321,4457805,8757,9,1,True,True,310.93931166666664,-0.434904430722113
1530,1331776,17,8,0.996365,96,1344154,-1,112.0,4221323,4221340,2889547,17,27,10,True,True,0.022334977777777775,-0.996365
1531,1331818,3,28,0.285577,96,1344154,-1,364.0,2390204,2390207,1058386,3,42,1,True,True,0.0236236,-0.285577
1532,1331990,15,2,0.916479,96,1344154,-1,26.0,2493004,2493019,1161014,15,41,8,True,True,0.006420916666666667,-0.916479
1533,1332252,26,8,0.4912,96,1344154,-1,136.0,2489404,2489430,1157152,26,42,11,True,True,0.06668306666666667,-0.4912
1534,1333108,18,4,0.122637,96,1344154,-1,132.0,4869804,4869822,3536696,18,20,9,True,True,0.0665412,-0.122637
1535,1333163,16498,128,0.852826,96,1344154,-1,640.0,6786674,6803172,5453511,16498,0,11,True,True,186.41149155555556,-0.8430297539614972
1536,1333242,867,1,0.452043,96,1344154,-1,23.0,3480495,3481362,2147253,867,36,8,True,True,0.59708345,-0.44818870301221375
1537,1333786,19,32,0.898679,96,1344154,-1,608.0,5789545,5789564,4455759,19,11,11,True,True,0.0979032,-0.8986790000000002
1538,1333912,5033,84,0.445111,96,1344154,-1,1932.0,6383564,6388597,5049652,5033,5,10,True,True,88.655294,-0.4435724234550206
1539,1334006,872,8,0.087791,96,1344154,-1,248.0,4387513,4388385,3053507,872,30,6,True,True,2.453304177777778,-0.087791
1540,1334127,58,12,0.681929,96,1344154,-1,180.0,5168316,5168374,3834189,58,19,11,True,True,0.10144199999999999,-0.681929
1541,1334696,29,3,0.845521,96,1344154,-1,117.0,6228864,6228893,4894168,29,7,6,True,True,0.057878925000000005,-0.845521
1542,1334724,2511,8,0.319588,96,1344154,-1,120.0,4663113,4665624,3328389,2511,30,8,True,True,7.037151999999998,-0.18965023687216107
1543,1334768,8,36,0.347425,96,1344154,-1,1728.0,6430573,6430581,5095805,8,4,0,True,True,0.2434176,-0.347425
1544,1337018,21038,1,0.064939,96,1344154,-1,5.0,5234653,5255691,3897635,21038,20,1,True,True,2.199925875,-0.06451291409400552
1545,1337084,10203,16,0.542171,96,1344154,-1,672.0,3793552,3803755,2456468,10203,42,7,True,True,257.6117842666667,-0.5300052551811216
1546,1337224,459,3,0.891332,96,1344154,-1,78.0,6226164,6226623,4888940,459,9,10,True,True,0.59819175,-0.891332
1547,1337255,11,16,0.851362,96,1344154,-1,704.0,3810519,3810530,2473264,11,42,9,True,True,0.23302986666666664,-0.851362
1548,1337380,8,1,0.711809,96,1344154,-1,28.0,3362995,3363003,2025615,8,49,6,True,True,0.001369511111111111,-0.711809
1549,1337421,5291,16,0.927324,96,1344154,-1,480.0,5467853,5473144,4130432,5291,20,7,True,True,60.63459066666667,-0.784937335048977
1550,1337520,59,16,0.6377,96,1344154,-1,80.0,4289413,4289472,2951893,59,38,7,True,True,0.07405155555555555,-0.6377
1551,1337540,58,8,0.793696,96,1344154,-1,344.0,2300102,2300160,962562,58,63,0,True,True,0.29761733333333334,-0.793696
1552,1337563,8260,2,0.508756,96,1344154,-1,62.0,3471495,3479755,2133932,8260,50,12,True,True,15.306441166666666,-0.5087183939453671
1553,1337577,18561,16,0.121362,96,1344154,-1,336.0,4753204,4771765,3415627,18561,31,2,True,True,243.57999306666665,-0.11791450483054432
1554,1337629,12183,8,0.20098,96,1344154,-1,376.0,6418873,6431056,5081244,12183,5,8,True,True,84.12726042222222,-0.1928686685522471
1555,1337691,25,1,0.138877,96,1344154,-1,30.0,6608073,6608098,5270382,25,3,7,True,True,0.00988125,-0.138877
1556,1337703,119,8,0.790373,96,1344154,-1,360.0,4228523,4228642,2890820,119,43,9,True,True,0.53074,-0.790373
1557,1337729,7,16,0.026284,96,1344154,-1,112.0,5190416,5190423,3852687,7,26,10,True,True,0.014007466666666666,-0.026284
1558,1338585,19622,32,0.554021,96,1344154,-1,800.0,2515104,2534726,1176519,19622,64,10,True,True,343.62581777777774,-0.5137671364391125
1559,1338629,64,1,0.368911,96,1344154,-1,28.0,6025664,6025728,4687035,64,12,11,True,True,0.061664711111111103,-0.36891100000000004
1560,1338983,182,16,0.803662,96,1344154,-1,288.0,5538327,5538509,4199344,182,22,10,True,True,1.2351248,-0.8036620000000002
1561,1339153,4,71,0.551647,96,1344154,-1,3408.0,4287613,4287617,2948460,4,45,9,True,True,0.21387093333333332,-0.551647
1562,1340956,9,8,0.611948,96,1344154,-1,184.0,6426073,6426082,5085117,9,6,9,True,True,0.037720000000000004,-0.611948
1563,1341428,4,8,0.086215,96,1344154,-1,400.0,4084723,4084727,2743295,4,50,8,True,True,0.09512444444444446,-0.086215
1564,1343396,18753,128,0.309291,96,1344154,-1,4608.0,3841770,3860523,2498374,18753,53,8,True,True,2268.0896256,-0.29795155688554953
1565,1343404,59,1,0.999595,96,1344154,-1,38.0,4753098,4753157,3409694,59,38,2,True,True,0.10247185555555556,-0.999595
1566,1343558,25529,16,0.71887,96,1344154,-1,288.0,4142423,4167952,2798865,25529,51,6,True,True,510.1368264000001,-0.6936410821547364
1567,1343568,19,32,0.525696,96,1344154,-1,1408.0,5540127,5540146,4196559,19,23,7,True,True,0.6303811555555555,-0.525696
1568,1343589,9,4,0.769165,96,1344154,-1,152.0,3351279,3351288,2007690,9,67,11,True,True,0.008173800000000002,-0.769165
1569,1343888,11393,1,0.823339,96,1344154,-1,25.0,2897404,2908797,1553516,11393,72,11,True,True,3.7939912500000004,-0.7544747373291838
1570,1344060,19979,128,0.073751,96,1344154,-1,3840.0,6474773,6494752,5130713,19979,5,11,True,True,1317.3793173333333,-0.06939329848211218
1571,1344137,5,32,0.97238,96,1344154,-1,1344.0,3489752,3489757,2145615,5,64,1,True,True,0.17654933333333334,-0.97238
1572,1344253,122,32,0.642339,114,1388354,-1,1152.0,4386613,4386735,3042360,122,48,8,True,True,1.5943936,-0.642339
1573,1363780,12229,38,0.449974,114,1388354,-1,1672.0,2765004,2777233,1401224,12229,77,8,True,True,433.5214407333333,-0.44644830815716874
1574,1364676,40,1,0.680109,114,1388354,-1,6.0,5656245,5656285,4291569,40,21,2,True,True,0.006192,-0.680109
1575,1364795,22,16,0.344515,114,1388354,-1,352.0,3476895,3476917,2112100,22,68,7,True,True,0.2314165333333333,-0.344515
1576,1366877,6679,32,0.87796,114,1388354,-1,1344.0,5551883,5558562,4185006,6679,23,2,True,True,123.16074026666668,-0.5719200041672524
1577,1367148,7834,13,0.780263,114,1388354,-1,260.0,3812413,3820247,2445265,7834,62,7,True,True,76.74431194444445,-0.6914325591917108
1578,1367189,10,8,0.639794,114,1388354,-1,64.0,4186623,4186633,2819434,10,56,11,True,True,0.048394666666666676,-0.639794
1579,1367258,28,1,0.181963,114,1388354,-1,5.0,5745345,5745373,4378087,28,21,7,True,True,0.0009648333333333333,-0.181963
1580,1367279,4,19,0.966265,114,1388354,-1,513.0,1797254,1797258,429975,4,94,0,True,True,0.0594795,-0.966265
1581,1367491,70,1,0.432618,114,1388354,-1,25.0,3585152,3585222,2217661,70,70,9,True,True,0.017325,-0.432618
1582,1369153,7330,4,0.910712,114,1388354,-1,24.0,3810613,3817943,2441460,7330,65,1,True,True,6.151243066666667,-0.8717012699754322
1583,1371674,29978,16,0.055413,114,1388354,-1,720.0,4707313,4737291,3335639,29978,47,11,True,True,372.92540399999996,-0.05081393464652586
1584,1371746,7570,32,0.124161,114,1388354,-1,832.0,6825272,6832842,5453526,7570,0,10,True,True,77.57692337777776,-0.09316635349743962
1585,1371766,22985,1,0.153015,114,1388354,-1,36.0,1532454,1555439,160688,22985,102,2,True,True,9.107000099999999,-0.1466671269931451
1586,1374454,11567,32,0.164657,114,1388354,-1,1120.0,3791752,3803319,2417298,11567,71,6,True,True,490.2439764444445,-0.1634581482942086
1587,1376090,11,17,0.322661,114,1388354,-1,85.0,4141523,4141534,2765433,11,61,7,True,True,0.08149304166666668,-0.322661
1588,1381788,16620,8,0.709332,114,1388354,-1,104.0,2123654,2140274,741866,16620,99,12,True,True,15.537368888888889,-0.6751604685295007
1589,1384832,10899,256,0.346023,114,1388354,-1,8960.0,6803172,6814071,5418340,10899,1,7,True,True,1396.824352,-0.3157168185591734
1590,1385180,25,3,0.940904,114,1388354,-1,111.0,2388302,2388327,1003122,25,98,12,True,True,0.060032499999999996,-0.940904
1591,1385597,192,1,0.894926,114,1388354,-1,44.0,2294702,2294894,909105,192,101,0,True,True,0.13810133333333333,-0.894926
1592,1389857,6,1,0.845934,114,1390154,-1,13.0,2853204,2853210,1463347,6,89,12,True,True,0.0024795333333333335,-0.845934
1593,1389978,10134,32,0.250605,114,1390154,-1,1472.0,1797254,1807388,407276,10134,106,12,True,True,562.7735598222222,-0.19744299924339423
1594,1390228,10712,64,0.635057,159,1434354,-1,1600.0,3803319,3814031,2413091,10712,71,3,True,True,540.0106577777779,-0.5892204434949274
1595,1405595,74,1,0.550841,159,1434354,-1,9.0,5368853,5368927,3963258,74,33,12,True,True,0.016226349999999997,-0.550841
1596,1405663,4790,256,0.12517,159,1434354,-1,10496.0,3484962,3489752,2079299,4790,80,8,True,True,1370.375020088889,-0.1249572423016587
1597,1406002,106,32,0.302825,159,1434354,-1,1184.0,4753098,4753204,3347096,106,46,0,True,True,5.736230044444444,-0.302825
1598,1406116,50,4,0.533478,159,1434354,-1,152.0,4582413,4582463,3176297,50,55,12,True,True,0.08102444444444444,-0.5334779999999999
1599,1406373,15161,64,0.502573,159,1434354,-1,3072.0,4409613,4424774,3003240,15161,56,10,True,True,1499.6468138666664,-0.45156944480030764
1600,1406442,14079,1,0.168636,159,1434354,-1,44.0,4192023,4206102,2785581,14079,64,8,True,True,11.4751263,-0.13176594560218913
1601,1406530,1,8,0.941607,159,1434354,-1,344.0,6742473,6742474,5335943,1,3,11,True,True,0.005764866666666666,-0.941607
1602,1406645,12,16,0.154194,159,1434354,-1,656.0,5796764,5796776,4390119,12,20,3,True,True,0.07226933333333334,-0.154194
1603,1407095,154,32,0.658733,159,1434354,-1,1600.0,3481362,3481516,2074267,154,87,1,True,True,7.44128,-0.6587330000000001
1604,1407146,4350,4,0.720633,159,1434354,-1,156.0,4716313,4720663,3309167,4350,52,9,True,True,9.5172883,-0.5708756919659146
1605,1408195,10170,128,0.605139,159,1434354,-1,5376.0,6430573,6440743,5022378,10170,10,6,True,True,752.4193002666668,-0.5750292276201873
1606,1408412,53,9,0.84253,159,1434354,-1,162.0,3035979,3036032,1627567,53,98,1,True,True,0.39035295,-0.84253
1607,1408478,13,16,0.563618,159,1434354,-1,720.0,5462453,5462466,4053975,13,36,9,True,True,0.28654599999999997,-0.563618
1608,1408524,16770,21,0.825236,159,1434354,-1,987.0,3132279,3149049,1723755,16770,99,6,True,True,422.56521475,-0.8170276690324842
1609,1408588,818,16,0.028373,159,1434354,-1,144.0,6273064,6273882,4864476,818,16,11,True,True,0.9868352,-0.028373
1610,1408763,78,1,0.045462,159,1434354,-1,14.0,3475095,3475173,2066332,78,94,8,True,True,0.032632600000000005,-0.045462
1611,1408861,22648,16,0.641454,159,1434354,-1,208.0,5234616,5257264,3825755,22648,41,0,True,True,100.07834026666667,-0.6181822474023828
1612,1409391,32,2,0.576771,159,1434354,-1,88.0,6405664,6405696,4996273,32,14,10,True,True,0.026579911111111104,-0.576771
1613,1409433,50,1,0.65113,159,1434354,-1,47.0,4199223,4199273,2789790,50,72,9,True,True,0.02716208333333333,-0.65113
1614,1419280,17420,1,0.766959,159,1434354,-1,21.0,4081123,4098543,2661843,17420,78,1,True,True,23.029157025000004,-0.7472321239659344
1615,1419841,10,1,0.416587,159,1434354,-1,30.0,1520754,1520764,100913,10,134,12,True,True,0.004104999999999999,-0.416587
1616,1419867,10276,128,0.638991,159,1434354,-1,6400.0,6204064,6214340,4784197,10276,20,11,True,True,585.5222044444444,-0.5585906164663349
1617,1419942,13212,32,0.498038,159,1434354,-1,192.0,4924804,4938016,3504862,13212,49,11,True,True,81.78164480000001,-0.4979702705855657
1618,1419965,3682,32,0.627164,159,1434354,-1,1568.0,3354895,3358577,1934930,3682,104,1,True,True,35.62952026666667,-0.5961855178944332
1619,1420003,3,32,0.289672,159,1434354,-1,288.0,6873072,6873075,5453069,3,0,11,True,True,0.010356,-0.289672
1620,1420167,12298,141,0.95665,159,1434354,-1,1692.0,3757952,3770250,2337785,12298,94,12,True,True,253.85279979999999,-0.8358001184342142
1621,1420244,56,2,0.482945,159,1434354,-1,42.0,5551827,5551883,4131583,56,34,0,True,True,0.04129066666666667,-0.482945
1622,1420284,9835,8,0.804688,159,1434354,-1,352.0,4775304,4785139,3355020,9835,56,10,True,True,84.83601964444443,-0.7260534357098957
1623,1420302,31,1,0.684991,159,1434354,-1,50.0,2438004,2438035,1017702,31,124,10,True,True,0.06189666666666666,-0.684991
1624,1420306,8332,256,0.297434,159,1434354,-1,2560.0,2286370,2294702,866064,8332,132,1,True,True,389.2658488888889,-0.29634634218300143
1625,1420347,34,16,0.072973,159,1434354,-1,272.0,2393804,2393838,973457,34,126,8,True,True,0.22292817777777782,-0.072973
1626,1424591,1809,1,0.059913,159,1434354,-1,22.0,6159864,6161673,4735273,1809,22,11,True,True,0.68308845,-0.059913
1627,1424612,768,1,0.439605,159,1434354,-1,31.0,2983804,2984572,1559192,768,117,12,True,True,0.5790479666666668,-0.4215857992966184
1628,1426672,18,24,0.484251,159,1434354,-1,456.0,5021104,5021122,3594432,18,52,6,True,True,0.23139720000000003,-0.484251
1629,1427179,524,8,0.204023,159,1434354,-1,312.0,5651083,5651607,4223904,524,33,1,True,True,7.386478666666667,-0.204023
1630,1432315,7,1,0.60666,159,1434354,-1,6.0,4496013,4496020,3063698,7,72,12,True,True,0.0007998666666666666,-0.60666
1631,1432369,8,4,0.312582,159,1434354,-1,72.0,3797152,3797160,2364783,8,97,1,True,True,0.020859199999999998,-0.312582
1632,1432443,52,16,0.718363,159,1434354,-1,304.0,5469653,5469705,4037210,52,42,7,True,True,0.3536161777777777,-0.718363
1633,1432465,5,2,0.7342,159,1434354,-1,62.0,6426073,6426078,4993608,5,12,0,True,True,0.007061111111111112,-0.7342
1634,1432472,7933,197,0.860777,159,1434354,-1,2758.0,2300102,2308035,867630,7933,139,8,True,True,335.68594791666663,-0.8329884290148262
1635,1432563,40,1,0.975374,159,1434354,-1,23.0,6115664,6115704,4683101,40,24,8,True,True,0.012706222222222223,-0.9753740000000002
1636,1432902,16297,1,0.130766,159,1434354,-1,31.0,5026916,5043213,3594014,16297,55,2,True,True,17.003941663888888,-0.13000747880145624
1637,1433882,10,1,0.37054,159,1434354,-1,17.0,1950854,1950864,516972,10,146,10,True,True,0.0019516944444444447,-0.37054
1638,1434306,672,2,0.561651,159,1434354,-1,64.0,2213781,2214453,779475,672,145,1,True,True,0.5054138666666665,-0.5065257291707904
1639,1434340,258,2,0.319116,159,1434354,-1,14.0,6959472,6959730,5525132,258,0,12,True,True,0.11040680000000003,-0.319116
1640,1434383,83,41,0.466473,198,1520754,-1,287.0,3810530,3810613,2376147,83,99,1,True,True,0.7168135916666666,-0.46647299999999997
1641,1434752,30097,16,0.267472,198,1520754,-1,528.0,6518973,6549070,5084221,30097,10,11,True,True,236.41889626666668,-0.25670024416368686
1642,1435236,54,1,0.247919,198,1520754,-1,19.0,5472027,5472081,4036791,54,46,2,True,True,0.03175185,-0.247919
1643,1435263,34,1,0.096812,198,1520754,-1,32.0,5124116,5124150,3688853,34,57,0,True,True,0.019723022222222223,-0.096812
1644,1435411,15,32,0.290212,198,1520754,-1,1056.0,5037716,5037731,3602305,15,59,9,True,True,0.627704,-0.290212
1645,1435621,33,32,0.38415,198,1520754,-1,1056.0,5907964,5907997,4472343,33,28,7,True,True,0.8792344000000001,-0.38415
1646,1435683,2,2,0.615377,198,1520754,-1,56.0,1841454,1841456,405771,2,156,11,True,True,0.004399422222222222,-0.615377
1647,1435706,6918,1,0.24827,198,1520754,-1,27.0,3028772,3035690,1593066,6918,131,11,True,True,7.06870875,-0.2247075896925629
1648,1435860,98,2,0.865308,198,1520754,-1,46.0,3671552,3671650,2235692,98,113,0,True,True,0.03247012222222222,-0.8653080000000002
1649,1435902,860,5,0.1597,198,1520754,-1,70.0,4630213,4631073,3194311,860,80,8,True,True,0.5551777777777779,-0.1597
1650,1435919,238,4,0.327436,198,1520754,-1,92.0,5599683,5599921,4163764,238,40,8,True,True,0.33257591111111107,-0.327436
1651,1436041,8762,16,0.577687,198,1520754,-1,464.0,5647483,5656245,4211442,8762,39,1,True,True,174.16462848888892,-0.5672118734168317
1652,1436063,18,4,0.312715,198,1520754,-1,32.0,4776204,4776222,3340141,18,71,6,True,True,0.014675200000000001,-0.312715
1653,1436085,79,1,0.763121,198,1520754,-1,50.0,3362095,3362174,1926010,79,129,9,True,True,0.024885,-0.763121
1654,1436093,26,28,0.498266,198,1520754,-1,448.0,1710854,1710880,274761,26,166,11,True,True,0.4864334222222222,-0.498266
1655,1438443,13,1,0.514725,198,1520754,-1,44.0,4139723,4139736,2701280,13,100,11,True,True,0.04394707777777777,-0.514725
1656,1439228,3,2,0.49876,198,1520754,-1,48.0,5937264,5937267,4498036,3,28,9,True,True,0.004774800000000001,-0.49876
1657,1440078,14813,8,0.30854,198,1520754,-1,192.0,5466053,5480866,4025975,14813,53,2,True,True,76.86906826666666,-0.28926087012695506
1658,1440364,46,2,0.023176,198,1520754,-1,18.0,3124179,3124225,1683815,46,138,12,True,True,0.0389804,-0.023176
1659,1440682,10185,1,0.945233,198,1520754,-1,17.0,4742913,4753098,3302231,10185,79,6,True,True,6.144554233333334,-0.825978999806832
1660,1440832,120,64,0.505444,198,1520754,-1,2816.0,2489404,2489524,1048572,120,152,0,True,True,6.372608,-0.505444
1661,1441739,12,1,0.966687,198,1520754,-1,34.0,2300102,2300114,858363,12,160,0,True,True,0.006086000000000001,-0.966687
1662,1441788,212,1,0.215144,198,1520754,-1,41.0,7045872,7046084,5604084,212,0,12,True,True,0.11246482222222222,-0.215144
1663,1442362,3461,128,0.352895,198,1520754,-1,3200.0,6227964,6231425,4785602,3461,24,7,True,True,188.88413333333332,-0.35281968562883764
1664,1442591,40,1,0.05054,198,1520754,-1,45.0,6742474,6742514,5299883,40,6,1,True,True,0.030165,-0.05054
1665,1442660,76316,128,0.494894,198,1520754,-1,768.0,2210054,2286370,767394,76316,170,12,True,True,772.4295552000001,-0.47882309984763227
1666,1450502,450,32,0.882339,198,1520754,-1,192.0,3577952,3578402,2127450,450,127,7,True,True,0.9498613333333333,-0.8820616517133956
1667,1450575,102,2,0.65426,198,1520754,-1,58.0,2390102,2390204,939527,102,162,7,True,True,0.12798279999999998,-0.65426
1668,1451480,778,32,0.470587,198,1520754,-1,1472.0,4742013,4742791,3290533,778,83,10,True,True,26.84895288888889,-0.470587
1669,1451527,12814,32,0.536691,198,1520754,-1,896.0,4095523,4108337,2643996,12814,108,8,True,True,706.1113820444444,-0.5043463671269311
1670,1451581,96,4,0.847172,198,1520754,-1,28.0,3176479,3176575,1724898,96,144,11,True,True,0.025625600000000002,-0.847172
1671,1451844,30,16,0.430928,198,1520754,-1,176.0,1521654,1521684,69810,30,189,6,True,True,0.07224799999999999,-0.430928
1672,1451875,16774,1,0.882456,198,1520754,-1,50.0,5455253,5472027,4003378,16774,58,12,True,True,22.27030027777778,-0.7959320678342333
1673,1452049,27,1,0.727508,198,1520754,-1,23.0,4273213,4273240,2821164,27,101,1,True,True,0.011742074999999998,-0.727508
1674,1452085,57,1,0.763857,198,1520754,-1,33.0,3816013,3816070,2363928,57,117,8,True,True,0.06962312500000001,-0.763857
1675,1452408,18768,1,0.365937,198,1520754,-1,29.0,2544404,2563172,1091996,18768,160,9,True,True,8.678867700000001,-0.3605045005265854
1676,1452615,52,16,0.400582,198,1520754,-1,272.0,2445204,2445256,992589,52,165,9,True,True,0.45543680000000003,-0.400582
1677,1454614,8,1,0.570282,198,1520754,-1,47.0,4383013,4383021,2928399,8,98,9,True,True,0.004048266666666666,-0.570282
1678,1454636,39,1,0.194655,198,1520754,-1,20.0,5030516,5030555,3575880,39,69,8,True,True,0.0242775,-0.194655
1679,1456872,6712,86,0.553223,198,1520754,-1,3096.0,5020204,5026916,3563332,6712,73,8,True,True,625.1889368000001,-0.5412209956219808
1680,1596460,10681,32,0.073532,240,1622454,-1,1152.0,3798952,3809633,2202492,10681,127,7,True,True,416.68057919999995,-0.07073409682766757
1681,1596869,64,32,0.504256,240,1622454,-1,1600.0,3576152,3576216,1979283,64,137,12,True,True,1.1261155555555558,-0.504256
1682,1597436,24,10,0.764404,240,1622454,-1,250.0,4033323,4033347,2435887,24,117,12,True,True,0.12138333333333334,-0.764404
1683,1597484,939,2,0.279721,240,1622454,-1,32.0,5124116,5125055,3526632,939,66,0,True,True,0.5447034666666666,-0.279721
1684,1597521,994,8,0.989091,240,1622454,-1,336.0,3131379,3132373,1533858,994,156,9,True,True,12.957584266666666,-0.9092116857036652
1685,1597734,3,42,0.680399,240,1622454,-1,1050.0,5905264,5905267,4307530,3,34,10,True,True,0.08631000000000001,-0.680399
1686,1597776,122,1,0.118811,240,1622454,-1,23.0,5238253,5238375,3640477,122,62,8,True,True,0.05156804444444445,-0.118811
1687,1597818,384,8,0.975083,240,1622454,-1,304.0,2717204,2717588,1119386,384,170,12,True,True,3.4573312,-0.975083
1688,1597823,17302,18,0.393904,240,1622454,-1,306.0,5743545,5760847,4145722,17302,42,12,True,True,57.4261292,-0.3811980039750731
1689,1598531,28,1,0.794897,240,1622454,-1,33.0,4091923,4091951,2493392,28,118,9,True,True,0.0561099,-0.794897
1690,1598542,127,51,0.339085,240,1622454,-1,2091.0,2213654,2213781,615112,127,193,8,True,True,3.4603552416666665,-0.339085
1691,1598584,14,3,0.938949,240,1622454,-1,120.0,2630804,2630818,1032220,14,173,12,True,True,0.02262866666666667,-0.938949
1692,1598620,11847,3,0.754965,240,1622454,-1,48.0,6429673,6441520,4831053,11847,16,8,True,True,7.838823066666667,-0.7522906530500453
1693,1598714,12681,256,0.199058,240,1622454,-1,3584.0,6406192,6418873,4807478,12681,20,1,True,True,403.66782151111113,-0.17131356963309743
1694,1598776,6557,2,0.509123,240,1622454,-1,36.0,6606273,6612830,5007497,6557,11,12,True,True,2.5276161,-0.4993979022663823
1695,1598819,490,37,0.500078,240,1622454,-1,1628.0,4272723,4273213,2673904,490,112,10,True,True,14.572322966666665,-0.48312866578462155
1696,1598835,37,32,0.045303,240,1622454,-1,1568.0,3037779,3037816,1438944,37,166,7,True,True,2.637632977777778,-0.045303
1697,1603039,14883,16,0.137036,240,1622454,-1,272.0,3765152,3780035,2162113,14883,142,2,True,True,38.744983333333344,-0.1320479597067896
1698,1603587,160,1,0.333041,240,1622454,-1,17.0,4930204,4930364,3326617,160,81,8,True,True,0.10499955555555557,-0.333041
1699,1603891,46,32,0.473744,240,1622454,-1,1504.0,5930064,5930110,4326173,46,35,10,True,True,1.2395466666666666,-0.473744
1700,1604086,27,64,0.456989,240,1622454,-1,2048.0,5981464,5981491,4377378,27,34,11,True,True,1.58208,-0.456989
1701,1605702,50,4,0.606261,240,1622454,-1,32.0,1841454,1841504,235752,50,208,0,True,True,0.06284888888888888,-0.606261
1702,1605723,93,1,0.515506,240,1622454,-1,28.0,6828872,6828965,5223149,93,3,8,True,True,0.028159366666666664,-0.515506
1703,1605946,11059,128,0.327966,240,1622454,-1,3200.0,3791752,3802811,2185806,11059,144,0,True,True,1343.137288888889,-0.32547655567620765
1704,1606006,11257,64,0.613068,240,1622454,-1,1216.0,3761552,3772809,2155546,11257,148,1,True,True,138.98386844444445,-0.512311841975557
1705,1606043,41,1,0.162502,240,1622454,-1,7.0,4659513,4659554,3053470,41,103,10,True,True,0.003725419444444444,-0.162502
1706,1606213,16,2,0.990616,240,1622454,-1,96.0,1928754,1928770,322541,16,211,12,True,True,0.017570133333333335,-0.990616
1707,1606308,359,2,0.739319,240,1622454,-1,96.0,4926604,4926963,3320296,359,85,7,True,True,1.2860816000000002,-0.739319
1708,1606337,1891,8,0.299234,240,1622454,-1,240.0,6361464,6363355,4755127,1891,26,11,True,True,4.494276666666666,-0.299234
1709,1606500,13621,1,0.336373,240,1622454,-1,38.0,6654073,6667694,5047573,13621,10,6,True,True,7.4018528,-0.32562450273668364
1710,1606528,59,2,0.828289,240,1622454,-1,50.0,3790852,3790911,2184324,59,150,10,True,True,0.11440263888888892,-0.828289
1711,1606786,19333,64,0.53234,240,1622454,-1,2048.0,5596083,5615416,3989297,19333,56,11,True,True,625.8737436444444,-0.4988202775426327
1712,1606809,112,64,0.70874,240,1622454,-1,768.0,5621783,5621895,4014974,112,55,10,True,True,2.610824533333333,-0.70874
1713,1608097,518,2,0.299791,240,1622454,-1,34.0,6652273,6652791,5044176,518,12,11,True,True,0.23727277777777783,-0.299791
1714,1608200,15423,32,0.815749,240,1622454,-1,1248.0,4375813,4391236,2767613,15423,119,12,True,True,214.16632986666667,-0.8037964684184457
1715,1608220,15378,1,0.368358,240,1622454,-1,22.0,3838170,3853548,2229950,15378,141,10,True,True,12.0355741,-0.35906035170527
1716,1608688,1992,1,0.673806,240,1622454,-1,21.0,5657145,5659137,4048457,1992,52,6,True,True,1.0792656,-0.673806
1717,1608889,7265,8,0.979898,240,1622454,-1,272.0,5548227,5555492,3939338,7265,63,9,True,True,35.76764942222222,-0.9333313477571524
1718,1611130,6,4,0.583702,240,1622454,-1,172.0,5016604,5016610,3405474,6,91,12,True,True,0.0237618,-0.5837019999999998
1719,1611158,29,32,0.796755,240,1622454,-1,864.0,4250623,4250652,2639465,29,128,10,True,True,0.5341104,-0.796755
1720,1611488,390,32,0.725324,240,1622454,-1,800.0,2037254,2037644,425766,390,223,12,True,True,6.044826666666667,-0.4255543266487215
1721,1611548,15,8,0.688044,240,1622454,-1,160.0,4188423,4188438,2576875,15,133,7,True,True,0.14317333333333332,-0.688044
1722,1618229,16,1,0.026647,240,1622454,-1,19.0,3354879,3354895,1736650,16,181,8,True,True,0.001976,-0.026647
1723,1618309,13,2,0.47459,240,1622454,-1,60.0,5654683,5654696,4036374,13,54,2,True,True,0.03521916666666667,-0.47459
1724,1618347,25525,16,0.967071,240,1622454,-1,480.0,3946923,3972448,2328576,25525,145,12,True,True,571.0991093333333,-0.9596134859981791
1725,1618857,5,13,0.782904,240,1622454,-1,130.0,6112064,6112069,4493207,5,37,12,True,True,0.010176111111111111,-0.782904
1726,1618870,2,8,0.776162,240,1622454,-1,208.0,2537204,2537206,918334,2,206,10,True,True,0.006816622222222222,-0.776162
1727,1618883,135,32,0.577634,240,1622454,-1,1344.0,2301902,2302037,683019,135,219,7,True,True,2.6520479999999997,-0.577634
4529,3668186,12,8,0.701314,1,3668186,-1,72.0,3669986,3669998,1800,12,0,7,True,True,0.016183200000000002,-0.701314
4530,3668196,39839,1,0.255939,12,3669986,-1,44.0,9429015,9468854,5760819,39839,0,1,True,True,67.48953114444444,-0.24950439885879144
4531,3668426,38,4,0.366354,12,3669986,-1,24.0,5488306,5488344,1819880,38,1,10,True,True,0.03537546666666666,-0.366354
4532,3668615,13,64,0.605954,12,3669986,-1,640.0,3761986,3761999,93371,13,2,11,True,True,0.1165031111111111,-0.605954
4533,3668830,23991,4,0.070874,12,3669986,-1,92.0,5489206,5513197,1820376,23991,1,6,True,True,78.29262227777777,-0.06859467111110566
4534,3668847,12081,256,0.930211,12,3669986,-1,12288.0,8480506,8492587,4811659,12081,1,12,True,True,10097.866410666666,-0.9104762270632453
4535,3668865,5,1,0.208738,12,3669986,-1,33.0,5267706,5267711,1598841,5,4,12,True,True,0.005344166666666667,-0.208738
4536,3669374,4541,184,0.491406,12,3669986,-1,4048.0,9217585,9222126,5548211,4541,1,12,True,True,882.5288242222223,-0.4778317531938055
4537,3669407,7819,4,0.889767,12,3669986,-1,96.0,3714186,3722005,44779,7819,7,11,True,True,17.9708544,-0.8860947482595831
4538,3669434,2,4,0.079957,12,3669986,-1,112.0,4810266,4810268,1140832,2,6,9,True,True,0.011972799999999999,-0.079957
4539,3669546,5723,2,0.80102,12,3669986,-1,38.0,4398581,4404304,729035,5723,7,12,True,True,6.588181177777778,-0.7419219997239781
4540,3669588,33704,64,0.0607,12,3669986,-1,1024.0,7193566,7227270,3523978,33704,3,0,True,True,1149.6823068444446,-0.05988810826117463
4541,3669597,10,1,0.55802,12,3669986,-1,26.0,5608506,5608516,1938909,10,4,8,True,True,0.012258277777777776,-0.55802
4542,3670045,612,43,0.938244,112,3714186,-1,430.0,9314985,9315597,5644940,612,1,10,True,True,12.247905000000001,-0.938244
4543,3670118,3,16,0.415953,112,3714186,-1,96.0,8900356,8900359,5230238,3,3,11,True,True,0.021075200000000002,-0.415953
4544,3670126,12,8,0.369069,112,3714186,-1,120.0,7514478,7514490,3844352,12,5,11,True,True,0.10534000000000002,-0.369069
4545,3670158,26577,128,0.708434,112,3714186,-1,4352.0,9485815,9512392,5815657,26577,0,11,True,True,5629.776576000001,-0.6960022783478993
4546,3670351,9,2,0.823643,112,3714186,-1,70.0,8386897,8386906,4716546,9,6,8,True,True,0.028014000000000008,-0.823643
4547,3670440,3747,1,0.265816,112,3714186,-1,30.0,6163375,6167122,2492935,3747,9,8,True,True,4.207334749999999,-0.2655509120293973
4548,3672786,28250,128,0.040653,112,3714186,-1,4224.0,8622956,8651206,4950170,28250,5,2,True,True,11161.461555200001,-0.04031760074704245
4549,3672822,13457,128,0.070388,112,3714186,-1,3072.0,8856156,8869613,5183334,13457,5,12,True,True,1529.1606442666666,-0.06948291471169488
4550,3673201,21313,16,0.303905,112,3714186,-1,144.0,5514906,5536219,1841705,21313,13,8,True,True,107.90522999999997,-0.29980178545273195
4551,3673565,89,1,0.944603,112,3714186,-1,12.0,5652706,5652795,1979141,89,12,11,True,True,0.0367214,-0.944603
4552,3673625,16711,4,0.960587,112,3714186,-1,68.0,4486981,4503692,813356,16711,19,11,True,True,53.955768088888895,-0.9587548184665946
4553,3673741,75,2,0.097119,112,3714186,-1,16.0,8624756,8624831,4951015,75,6,7,True,True,0.11835666666666667,-0.097119
4554,3673762,201,1,0.725172,112,3714186,-1,41.0,7562623,7562824,3888861,201,10,8,True,True,0.558121725,-0.725172
4555,3673920,5,1,0.531661,112,3714186,-1,25.0,8626556,8626561,4952636,5,6,6,True,True,0.012322916666666666,-0.531661
4556,3674946,25,1,0.18946,112,3714186,-1,24.0,6499175,6499200,2824229,25,14,12,True,True,0.03992,-0.18946
4557,3674980,12598,32,0.526192,112,3714186,-1,1440.0,6683139,6695737,3008159,12598,14,1,True,True,813.46308,-0.5073007950922646
4558,3675045,21116,45,0.248763,112,3714186,-1,1215.0,6018375,6039491,2343330,21116,17,11,True,True,1385.8027695,-0.2440449064924002
4559,3675284,288,3,0.625325,112,3714186,-1,105.0,7649086,7649374,3973802,288,11,1,True,True,1.9292279999999997,-0.625325
4560,3675406,1649,5,0.178898,112,3714186,-1,220.0,7327766,7329415,3652360,1649,14,11,True,True,32.16548561111111,-0.178898
4561,3675425,101,1,0.749194,112,3714186,-1,6.0,4677886,4677987,1002461,101,27,12,True,True,0.02459855,-0.749194
4562,3675572,12,2,0.415185,112,3714186,-1,28.0,9131185,9131197,5455613,12,4,1,True,True,0.018606933333333336,-0.415185
4563,3675590,8667,16,0.105514,112,3714186,-1,400.0,6163375,6172042,2487785,8667,19,0,True,True,128.81235444444445,-0.10498782706359595
4564,3675622,29,12,0.638624,112,3714186,-1,216.0,6988766,6988795,3313144,29,17,11,True,True,0.1981686,-0.638624
4565,3675637,7754,128,0.357963,112,3714186,-1,1920.0,6684039,6691793,3008402,7754,18,6,True,True,655.8053706666667,-0.32420457188254875
4566,3675654,189,32,0.458721,112,3714186,-1,320.0,4442781,4442970,767127,189,33,0,True,True,2.177784,-0.458721
4567,3675688,10761,1,0.665242,112,3714186,-1,46.0,8769756,8780517,5094068,10761,7,7,True,True,16.255386083333335,-0.5047639416801641
4568,3675741,8744,4,0.882824,112,3714186,-1,196.0,6846466,6855210,3170725,8744,19,8,True,True,47.95870753333334,-0.8635052086310447
4569,3675872,9308,1,0.166809,112,3714186,-1,44.0,9425415,9434723,5749543,9308,2,8,True,True,17.980838211111113,-0.16371487394277956
4570,3675903,11829,72,0.180397,112,3714186,-1,2232.0,7376466,7388295,3700563,11829,17,6,True,True,1185.1674294,-0.1714824077179878
4571,3676012,238,1,0.401557,112,3714186,-1,35.0,6174175,6174413,2498163,238,25,6,True,True,0.32056616666666665,-0.401557
4572,3676024,33,8,0.337513,112,3714186,-1,360.0,4214941,4214974,538917,33,40,8,True,True,0.664323,-0.337513
4573,3676082,23,5,0.158176,112,3714186,-1,70.0,6687639,6687662,3011557,23,22,8,True,True,0.06341611111111113,-0.158176
4574,3676130,45,1,0.998434,112,3714186,-1,50.0,4591486,4591531,915356,45,38,9,True,True,0.21283125000000003,-0.998434
4575,3676133,2356,2,0.443012,112,3714186,-1,18.0,9315597,9317953,5639464,2356,3,2,True,True,1.9058273,-0.42776900280513275
4576,3676184,230,8,0.352324,112,3714186,-1,128.0,4894906,4895136,1218722,230,37,2,True,True,1.0887075555555554,-0.352324
4577,3677867,53,45,0.315155,112,3714186,-1,1710.0,3925641,3925694,247774,53,45,7,True,True,1.99662925,-0.3151550000000001
4578,3677893,32,1,0.991463,112,3714186,-1,33.0,5376206,5376238,1698313,32,36,12,True,True,0.03862906666666666,-0.991463
4579,3677973,1043,1,0.324654,112,3714186,-1,43.0,9441615,9442658,5763642,1043,1,7,True,True,1.390568161111111,-0.324654
4580,3677995,13208,38,0.37172,112,3714186,-1,608.0,8677956,8691164,4999961,13208,11,1,True,True,460.0865504,-0.33131283675747186
4581,3678079,1889,4,0.764184,112,3714186,-1,168.0,6842866,6844755,3164787,1889,25,7,True,True,8.635550933333336,-0.7640324713996689
4582,3678090,14913,128,0.430588,112,3714186,-1,1792.0,5144806,5159719,1466716,14913,41,8,True,True,697.7136568888889,-0.4107586207961739
4583,3678108,13165,16,0.725868,112,3714186,-1,128.0,9539015,9552180,5860907,13165,0,11,True,True,50.097319111111105,-0.7164990660032743
4584,3678125,7,4,0.608413,112,3714186,-1,108.0,5974175,5974182,2296050,7,35,0,True,True,0.030340799999999994,-0.608413
4585,3678176,6,37,0.563145,112,3714186,-1,1295.0,8285086,8285092,4606910,6,18,0,True,True,0.3314984166666667,-0.563145
4586,3678377,8869,256,0.213928,112,3714186,-1,9472.0,5827306,5836175,2148929,8869,37,12,True,True,3355.0457834666668,-0.20978283064818834
4587,3678440,12027,210,0.765708,112,3714186,-1,5250.0,6735439,6747466,3056999,12027,28,11,True,True,2108.6856583333333,-0.7593347082828015
4588,3679211,14,64,0.926147,112,3714186,-1,2176.0,8764356,8764370,5085145,14,12,12,True,True,1.0438151111111111,-0.926147
4589,3679280,44,128,0.254089,112,3714186,-1,5632.0,9322797,9322841,5643517,44,5,8,True,True,10.45887431111111,-0.254089
4590,3679312,4,1,0.961652,112,3714186,-1,31.0,9292885,9292889,5613573,4,8,8,True,True,0.0057870111111111115,-0.961652
4591,3679372,7906,32,0.4475,112,3714186,-1,992.0,9085956,9093862,5406584,7906,11,10,True,True,571.5996586666666,-0.434524462433788
4592,3680172,1984,32,0.397091,112,3714186,-1,1024.0,4218541,4220525,538369,1984,58,8,True,True,111.2425216,-0.37254181168660594
4593,3680281,13,14,0.726313,112,3714186,-1,574.0,6661036,6661049,2980755,13,36,11,True,True,0.5465085888888889,-0.726313
4594,3680922,11742,86,0.982956,112,3714186,-1,602.0,6521275,6533017,2840353,11742,37,10,True,True,305.91088188888887,-0.9453032008192306
4595,3681024,1300,8,0.595763,112,3714186,-1,168.0,4225741,4227041,544717,1300,60,0,True,True,11.980022133333332,-0.5665641355160496
4596,3681070,19,1,0.517609,112,3714186,-1,28.0,6691239,6691258,3010169,19,33,4,True,True,0.024735044444444444,-0.517609
4597,3681095,23,32,0.993412,112,3714186,-1,288.0,4584256,4584279,903161,23,58,8,True,True,0.5439959999999999,-0.993412
4598,3681213,5,32,0.301842,112,3714186,-1,1408.0,9032756,9032761,5351543,5,12,12,True,True,0.2682631111111111,-0.301842
4599,3681391,13,8,0.300334,112,3714186,-1,264.0,5152006,5152019,1470615,13,54,9,True,True,0.08586673333333333,-0.300334
4600,3681904,3459,4,0.221887,112,3714186,-1,156.0,7693286,7696745,4011382,3459,24,11,True,True,37.8906931,-0.221887
4601,3682096,13849,4,0.85572,112,3714186,-1,152.0,7283566,7297415,3601470,13849,30,8,True,True,68.8621598,-0.8451146203434188
4602,3682167,19827,32,0.021701,112,3714186,-1,352.0,9421815,9441642,5739648,19827,5,8,True,True,274.97753946666666,-0.021498697360496376
4603,3682283,6,1,0.82194,112,3714186,-1,19.0,5880375,5880381,2198092,6,49,11,True,True,0.003966883333333333,-0.82194
4604,3682525,22,32,0.689719,112,3714186,-1,1248.0,3815341,3815363,132816,22,72,2,True,True,1.0213632,-0.689719
4605,3682574,13,1,0.275957,112,3714186,-1,35.0,9063856,9063869,5381282,13,13,7,True,True,0.038673736111111114,-0.275957
4606,3682589,3,4,0.553663,112,3714186,-1,56.0,6173275,6173278,2490686,3,46,6,True,True,0.0062916000000000005,-0.553663
4607,3683826,2914,1,0.556323,112,3714186,-1,29.0,3717786,3720700,33960,2914,76,8,True,True,2.017777466666667,-0.5529674371711544
4608,3685104,2,1,0.925922,112,3714186,-1,14.0,4573381,4573383,888277,2,67,12,True,True,0.0016979666666666667,-0.925922
4609,3688341,561,1,0.154715,112,3714186,-1,38.0,9494815,9495376,5806474,561,1,2,True,True,0.9788515,-0.154715
4610,3688365,19295,64,0.037736,112,3714186,-1,2112.0,8132386,8151681,4444021,19295,27,9,True,True,2423.4969909333336,-0.03618697414040986
4611,3688398,12603,8,0.355656,112,3714186,-1,128.0,7107166,7119769,3418768,12603,36,6,True,True,51.85785137777778,-0.35006020259803006
4612,3688772,56,1,0.138408,112,3714186,-1,42.0,6159775,6159831,2471003,56,52,11,True,True,0.09482479999999999,-0.138408
4613,3688871,53,8,0.367083,112,3714186,-1,160.0,5462606,5462659,1773735,53,62,12,True,True,0.2754586666666667,-0.367083
4614,3688977,11,8,0.582156,112,3714186,-1,112.0,6409175,6409186,2720198,11,48,8,True,True,0.11653693333333333,-0.582156
4615,3689104,7367,16,0.232994,112,3714186,-1,768.0,6616836,6624203,2927732,7367,46,10,True,True,242.76811093333333,-0.23294278423692616
4616,3689453,19,1,0.811074,112,3714186,-1,11.0,7019866,7019885,3330413,19,37,9,True,True,0.007591344444444443,-0.811074
4617,3690701,14513,16,0.091905,112,3714186,-1,592.0,7559023,7573536,3868322,14513,31,1,True,True,580.6914384,-0.09007013114510518
4618,3690792,149,32,0.399798,112,3714186,-1,1568.0,6172375,6172524,2481583,149,54,7,True,True,8.749518400000001,-0.399798
4619,3690846,16952,256,0.917882,112,3714186,-1,12800.0,4793314,4810266,1102468,16952,74,1,True,True,8099.497244444445,-0.8091875132587206
4620,3690876,21615,64,0.734266,112,3714186,-1,896.0,4854806,4876421,1163930,21615,73,1,True,True,1405.5185610666667,-0.7168723662605873
4621,3690903,30,8,0.723581,112,3714186,-1,160.0,6594736,6594766,2903833,30,49,1,True,True,0.27113333333333334,-0.723581
4622,3691207,140,16,0.792904,112,3714186,-1,768.0,9221185,9221325,5529978,140,11,8,True,True,5.437226666666667,-0.792904
4623,3691710,20607,32,0.172902,112,3714186,-1,1312.0,8371594,8392201,4679884,20607,27,1,True,True,1272.8539434666666,-0.16954603909448634
4624,3691896,6844,35,0.825705,112,3714186,-1,1540.0,7470278,7477122,3778382,6844,35,11,True,True,746.6465416666667,-0.8240607099219265
4625,3692532,17,8,0.689595,112,3714186,-1,256.0,4981306,4981323,1288774,17,76,12,True,True,0.14593706666666667,-0.689595
4626,3692654,1207,32,0.576232,112,3714186,-1,608.0,8371486,8372693,4678832,1207,28,0,True,True,40.1602696,-0.5762320000000001
4627,3692800,10,1,0.907656,112,3714186,-1,50.0,5047606,5047616,1354806,10,77,10,True,True,0.017084722222222223,-0.907656
4628,3692903,3,12,0.595231,112,3714186,-1,456.0,5907875,5907878,2214972,3,65,10,True,True,0.0676552,-0.595231
4629,3693006,11,21,0.300393,112,3714186,-1,861.0,9039956,9039967,5346950,11,16,9,True,True,0.8024041666666667,-0.300393
4630,3699045,8653,32,0.730789,112,3714186,-1,928.0,8622956,8631609,4923911,8653,25,0,True,True,786.3110318222223,-0.7287539848559261
4631,3699066,22116,32,0.576284,112,3714186,-1,288.0,8625656,8647772,4926590,22116,24,6,True,True,595.5248544,-0.5761387622054575
4632,3699271,21,1,0.078477,112,3714186,-1,16.0,5601306,5601327,1902035,21,73,12,True,True,0.01492026666666667,-0.078477
4633,3699282,111,18,0.055923,112,3714186,-1,612.0,9439815,9439926,5740533,111,4,0,True,True,2.1062694000000004,-0.055923
4634,3699352,13,4,0.770902,112,3714186,-1,48.0,7835586,7835599,4136234,13,35,8,True,True,0.061614800000000004,-0.770902
4635,3699478,11,4,0.34793,112,3714186,-1,172.0,7375566,7375577,3676088,11,43,11,True,True,0.11587448888888889,-0.34793
4636,3699527,13020,12,0.817142,112,3714186,-1,600.0,5181306,5194326,1481779,13020,83,2,True,True,257.28745,-0.8125932455933399
4637,3700163,6,11,0.416522,112,3714186,-1,187.0,4210441,4210447,510278,6,102,12,True,True,0.0346324,-0.416522
4638,3701086,44,32,0.867831,112,3714186,-1,1088.0,4442781,4442825,741695,44,98,11,True,True,1.7237909333333334,-0.867831
4639,3701224,130,1,0.869787,112,3714186,-1,36.0,9245085,9245215,5543861,130,12,10,True,True,0.26977599999999996,-0.869787
4640,3701346,187,32,0.226718,112,3714186,-1,928.0,7902786,7902973,4201440,187,36,11,True,True,12.826720622222222,-0.226718
4641,3712058,24,36,0.652779,112,3714186,-1,216.0,8619206,8619230,4907148,24,30,6,True,True,0.5035104,-0.652779
4642,3712151,13959,64,0.602302,112,3714186,-1,704.0,3806186,3820145,94035,13959,109,11,True,True,382.6775802666666,-0.5919137439588436
4643,3714914,7407,9,0.011434,115,3717786,-1,288.0,9062056,9069463,5347142,7407,18,10,True,True,177.4732344,-0.01134860977426038
4644,3715223,18,16,0.777419,115,3717786,-1,592.0,8378797,8378815,4663574,18,34,1,True,True,0.4687752,-0.777419
4645,3715324,18,16,0.382487,115,3717786,-1,800.0,9491215,9491233,5775891,18,2,2,True,True,0.6480800000000001,-0.382487
4646,3715542,5,8,0.304783,115,3717786,-1,136.0,6218375,6218380,2502833,5,69,11,True,True,0.051015111111111115,-0.304783
4647,3720730,18,16,0.041182,172,3761986,-1,304.0,9328197,9328215,5607467,18,9,8,True,True,0.2657416,-0.041182
4648,3720939,56,4,0.53993,172,3761986,-1,104.0,8767956,8768012,5047017,56,26,8,True,True,0.18983004444444443,-0.53993
4649,3721655,12,1,0.14958,172,3761986,-1,44.0,6546975,6546987,2825320,12,68,10,True,True,0.0428868,-0.14958
4650,3723113,108,2,0.502402,172,3761986,-1,54.0,8371486,8371594,4648373,108,40,12,True,True,0.31915619999999995,-0.502402
4651,3723509,38,1,0.220797,172,3761986,-1,43.0,6683136,6683174,2959627,38,66,10,True,True,0.0852993388888889,-0.220797
4652,3723658,819,1,0.05052,172,3761986,-1,22.0,9130156,9130975,5406498,819,18,11,True,True,0.9977968,-0.05052
4653,3723949,12732,20,0.731579,172,3761986,-1,920.0,4884106,4896838,1160157,12732,102,9,True,True,453.19771933333334,-0.7060793137389022
4654,3724018,394,4,0.392883,172,3761986,-1,32.0,4580656,4581050,856638,394,109,1,True,True,0.8213061333333332,-0.392883
4655,3733006,4,16,0.445616,172,3761986,-1,112.0,9421815,9421819,5688809,4,8,0,True,True,0.019245333333333333,-0.445616
4656,3733414,122,4,0.595132,172,3761986,-1,96.0,7012666,7012788,3279252,122,60,7,True,True,0.3844464000000001,-0.595132
4657,3736777,71,3,0.504729,172,3761986,-1,114.0,9331815,9331886,5595038,71,10,2,True,True,0.43109543333333333,-0.504729
4658,3736867,291,2,0.222086,172,3761986,-1,94.0,4685086,4685377,948219,291,109,9,True,True,1.1553265833333333,-0.222086
4659,3737473,40,1,0.289783,172,3761986,-1,29.0,4692286,4692326,954813,40,109,9,True,True,0.04748911111111111,-0.289783
4660,3737586,14,4,0.394322,172,3761986,-1,200.0,9314985,9314999,5577399,14,14,0,True,True,0.1303166666666667,-0.394322
4661,3737606,16503,3,0.132189,172,3761986,-1,123.0,8566906,8583409,4829300,16503,39,12,True,True,149.43609001666667,-0.12073541475810977
4662,3737796,274,12,0.082545,172,3761986,-1,552.0,8902156,8902430,5164360,274,27,7,True,True,11.067992533333335,-0.082545
4663,3740770,18193,1,0.571441,172,3761986,-1,22.0,5025506,5043699,1284736,18193,106,11,True,True,13.59188483888889,-0.5512251768534043
4664,3740870,2,4,0.049311,172,3761986,-1,60.0,6850966,6850968,3110096,2,66,6,True,True,0.0033813333333333334,-0.049311
4665,3740946,4650,1,0.399191,172,3761986,-1,42.0,8618306,8622956,4877360,4650,40,11,True,True,19.0293397,-0.3957195416393389
4666,3741105,22,1,0.085079,172,3761986,-1,42.0,8016686,8016708,4275581,22,50,7,True,True,0.06763423333333334,-0.085079
4667,3741132,20,4,0.501823,172,3761986,-1,116.0,5885775,5885795,2144643,20,94,8,True,True,0.09957311111111111,-0.501823
4668,3741765,21010,1,0.773825,172,3761986,-1,12.0,6944566,6965576,3202801,21010,68,12,True,True,5.767146,-0.7692503858580685
4669,3741794,1379,32,0.130375,172,3761986,-1,448.0,4079841,4081220,338047,1379,133,9,True,True,26.422620622222222,-0.130375
4670,3741818,8052,16,0.134871,172,3761986,-1,144.0,7331366,7339418,3589548,8052,61,8,True,True,82.4115664,-0.1320784131402139
4671,3742130,11773,256,0.559296,172,3761986,-1,2560.0,5054806,5066579,1312676,11773,111,9,True,True,698.76544,-0.5507410589150307
4672,3742226,27737,2,0.487861,172,3761986,-1,30.0,6569075,6596812,2826849,27737,82,10,True,True,52.28560591666666,-0.47846340496328965
4673,3744910,24,1,0.652248,172,3761986,-1,47.0,5740906,5740930,1995996,24,100,7,True,True,0.0446124,-0.652248
4674,3745166,37,4,0.196099,172,3761986,-1,152.0,4677886,4677923,932720,37,124,0,True,True,0.22828753333333332,-0.196099
4675,3745225,5,16,0.615997,172,3761986,-1,800.0,6858166,6858171,3112941,5,70,9,True,True,0.12347777777777777,-0.615997
4676,3745556,5180,2,0.735668,172,3761986,-1,42.0,5952075,5957255,2206519,5180,97,0,True,True,8.469924166666669,-0.7292388880274826
4677,3745892,345,7,0.246246,172,3761986,-1,91.0,7558678,7559023,3812786,345,57,11,True,True,2.2007895000000004,-0.246246
4678,3745926,7556,18,0.071644,172,3761986,-1,774.0,3807986,3815542,62060,7556,144,7,True,True,229.4100267,-0.07090531570229426
4679,3746126,1346,1,0.776772,172,3761986,-1,38.0,6025575,6026921,2279449,1346,96,1,True,True,2.5620742111111108,-0.7721007050416043
4680,3746157,12869,5,0.323412,172,3761986,-1,25.0,3969841,3982710,223684,12869,143,11,True,True,8.416901249999999,-0.3121816726336681
4681,3746241,9785,64,0.924138,172,3761986,-1,2816.0,9324597,9334382,5578356,9785,12,7,True,True,1371.3198556444445,-0.919597064404696
4682,3746249,7103,1,0.089595,172,3761986,-1,10.0,8946356,8953459,5200107,7103,28,11,True,True,4.5192173888888885,-0.08945141035233455
4683,3755003,82,3,0.671748,172,3761986,-1,39.0,6111975,6112057,2356972,82,98,12,True,True,0.12953676666666666,-0.671748
4684,3755163,75,16,0.423541,172,3761986,-1,688.0,4576981,4577056,821818,75,136,8,True,True,2.974883333333333,-0.423541
4685,3755216,149,15,0.348308,172,3761986,-1,75.0,6313775,6313924,2558559,149,91,9,True,True,1.0343083333333334,-0.348308
4686,3755303,664,1,0.320738,172,3761986,-1,49.0,7924886,7925550,4169583,664,53,10,True,True,2.1311080000000002,-0.3207380000000001
4687,3755563,12,7,0.593877,172,3761986,-1,154.0,7380066,7380078,3624503,12,63,8,True,True,0.07541379999999999,-0.593877
4688,3755616,5197,2,0.024207,172,3761986,-1,72.0,9289285,9294482,5533669,5197,18,11,True,True,17.0782064,-0.024039030605706467
4689,3755685,162,1,0.304819,172,3761986,-1,12.0,9319197,9319359,5563512,162,14,8,True,True,0.0841158,-0.304819
4690,3755779,25,4,0.987652,172,3761986,-1,44.0,6524875,6524900,2769096,25,92,8,True,True,0.04881555555555554,-0.987652
4691,3755886,133,1,0.616221,172,3761986,-1,39.0,8011286,8011419,4255400,133,55,12,True,True,0.24789537500000003,-0.616221
4692,3756006,65,1,0.990159,172,3761986,-1,18.0,7106266,7106331,3350260,65,74,12,True,True,0.05377449999999999,-0.990159
4693,3756031,311,16,0.44221,172,3761986,-1,800.0,3901741,3902052,145710,311,157,12,True,True,9.413624444444444,-0.44221
4694,3756055,4751,128,0.145818,172,3761986,-1,1792.0,7381878,7386629,3625823,4751,66,7,True,True,410.2171584,-0.14172890735122828
4695,3756222,13626,35,0.044878,172,3761986,-1,315.0,8154486,8168112,4398264,13626,53,10,True,True,193.25602800000001,-0.044818838022236095
4696,3756261,33,32,0.818172,172,3761986,-1,1408.0,5952075,5952108,2195814,33,113,11,True,True,1.8446207999999997,-0.818172
4697,3756506,69,2,0.199685,172,3761986,-1,88.0,9540815,9540884,5784309,69,0,7,True,True,0.1804733333333333,-0.199685
4698,3756759,40,8,0.373821,172,3761986,-1,312.0,4312141,4312181,555382,40,154,12,True,True,0.480584,-0.373821
4699,3756843,17162,1,0.757734,172,3761986,-1,14.0,5174106,5191268,1417263,17162,130,10,True,True,7.804161944444444,-0.7394053023536925
4700,3756862,6542,32,0.852764,172,3761986,-1,160.0,9328215,9334757,5571353,6542,12,1,True,True,53.5060768888889,-0.8522492538992703
4701,3756895,3,1,0.112372,172,3761986,-1,40.0,8378794,8378797,4621899,3,51,9,True,True,0.005279000000000001,-0.112372
4702,3756915,8,32,0.054538,172,3761986,-1,1472.0,6850066,6850074,3093151,8,86,3,True,True,0.32514844444444446,-0.054538
4703,3757054,179,8,0.948941,172,3761986,-1,360.0,6319175,6319354,2562121,179,104,8,True,True,6.4024719999999995,-0.948941
4704,3757085,210,1,0.92673,172,3761986,-1,18.0,9130975,9131185,5373890,210,26,1,True,True,0.20932800000000001,-0.92673
4705,3762278,398,1,0.868752,251,3806186,-1,5.0,6315575,6315973,2553297,398,106,7,True,True,0.18456144444444444,-0.868752
4706,3762315,1072,16,0.820134,251,3806186,-1,384.0,7858586,7859658,4096271,1072,63,10,True,True,37.79251626666667,-0.8198071922492696
4707,3762596,873,2,0.013733,251,3806186,-1,32.0,7279966,7280839,3517370,873,79,12,True,True,0.9396584,-0.013733
4708,3762738,3561,13,0.693795,251,3806186,-1,182.0,6591175,6594736,2828437,3561,101,10,True,True,36.84940602777777,-0.661899842591918
4709,3763357,38,8,0.111278,251,3806186,-1,224.0,5177706,5177744,1414349,38,139,1,True,True,0.27623804444444444,-0.11127799999999997
4710,3763829,30,16,0.450062,251,3806186,-1,800.0,9432615,9432645,5668786,30,7,1,True,True,0.7888666666666667,-0.450062
4711,3763901,3,1,0.022748,251,3806186,-1,35.0,6683136,6683139,2919235,3,98,0,True,True,0.005481291666666667,-0.022748
4712,3764374,127,1,0.20901,251,3806186,-1,45.0,6170575,6170702,2406201,127,117,9,True,True,0.21402675,-0.20901
4713,3764568,25,1,0.538005,251,3806186,-1,45.0,6841066,6841091,3076498,25,93,9,True,True,0.030603125,-0.5380049999999998
4714,3765006,404,1,0.203801,251,3806186,-1,8.0,7380078,7380482,3615072,404,74,1,True,True,0.13189253333333334,-0.20380100000000007
4715,3765081,180,8,0.523266,251,3806186,-1,368.0,7010866,7011046,3245785,180,87,10,True,True,2.174328,-0.523266
4716,3765135,8,64,0.258658,251,3806186,-1,2432.0,5739106,5739114,1973971,8,135,12,True,True,0.7694848,-0.258658
4717,3765185,10,13,0.483026,251,3806186,-1,364.0,8125186,8125196,4360001,10,60,10,True,True,0.200473,-0.483026
4718,3766817,15506,16,0.729924,251,3806186,-1,192.0,5289806,5305312,1522989,15506,145,10,True,True,96.77116693333332,-0.7247999471167444
4719,3767495,22743,32,0.141347,251,3806186,-1,256.0,6842866,6865609,3075371,22743,95,0,True,True,171.76140160000003,-0.13629773022314
4720,3767621,8118,85,0.698755,251,3806186,-1,2805.0,8240886,8249004,4473265,8118,58,12,True,True,911.9181225000001,-0.6937031569488145
4721,3767629,340,11,0.018389,251,3806186,-1,66.0,4854466,4854806,1086837,340,161,11,True,True,1.7253866666666668,-0.018389
4722,3767677,4,1,0.583005,251,3806186,-1,33.0,8630156,8630160,4862479,4,42,2,True,True,0.012692533333333334,-0.583005
4723,3767719,4,16,0.663528,251,3806186,-1,384.0,4887706,4887710,1119987,4,160,2,True,True,0.062050133333333334,-0.663528
4724,3767753,19427,32,0.043482,251,3806186,-1,1312.0,8769756,8789183,5002003,19427,38,0,True,True,1300.0532195555556,-0.03811044998103948
4725,3770600,21,4,0.17032,251,3806186,-1,24.0,6115575,6115596,2344975,21,129,8,True,True,0.022100400000000003,-0.17032
4726,3770711,12818,8,0.284014,251,3806186,-1,64.0,4876906,4889724,1106195,12818,164,10,True,True,37.48034524444444,-0.2543923789930394
4727,3770842,8241,4,0.789188,251,3806186,-1,140.0,4891306,4899547,1120464,8241,162,3,True,True,40.42376333333334,-0.7415108398776964
4728,3771034,6679,3,0.617965,251,3806186,-1,102.0,3923841,3930520,152807,6679,191,10,True,True,14.7777141,-0.6164896909362868
4729,3771114,4923,32,0.053085,251,3806186,-1,800.0,5974175,5979098,2203061,4923,134,10,True,True,150.30923555555555,-0.051561426220981164
4730,3773534,8,2,0.654758,251,3806186,-1,72.0,3815186,3815194,41652,8,195,2,True,True,0.021427199999999997,-0.654758
4731,3773691,23,2,0.008334,251,3806186,-1,20.0,9487615,9487638,5713924,23,4,7,True,True,0.02074855555555556,-0.008334
4732,3775251,3,3,0.388645,251,3806186,-1,42.0,9222985,9222988,5447734,3,25,7,True,True,0.006371750000000001,-0.388645
4733,3775256,74203,8,0.27131,251,3806186,-1,80.0,8379697,8453900,4604441,74203,56,6,True,True,250.04464688888885,-0.2627987852344489
4734,3775461,22,8,0.852083,251,3806186,-1,224.0,6306575,6306597,2531114,22,124,7,True,True,0.45181546666666667,-0.852083
4735,3775465,484,16,0.6601,251,3806186,-1,784.0,7836486,7836970,4061021,484,72,6,True,True,37.468117866666674,-0.6601
4736,3775529,23,11,0.864282,251,3806186,-1,330.0,7193566,7193589,3418037,23,91,12,True,True,0.3272976666666667,-0.864282
4737,3775548,21509,8,0.019078,251,3806186,-1,64.0,4577056,4598565,801508,21509,184,1,True,True,110.72824622222221,-0.018514855763184963
4738,3775801,117,16,0.86741,251,3806186,-1,624.0,8103086,8103203,4327285,117,67,12,True,True,5.6583228,-0.86741
4739,3775807,8667,128,0.649411,251,3806186,-1,5760.0,4050541,4059208,274734,8667,198,9,True,True,2035.357536,-0.6493695752654455
4740,3775814,295,1,0.231169,251,3806186,-1,6.0,6304775,6305070,2528961,295,128,12,True,True,0.16227950000000002,-0.231169
4741,3775877,598,8,0.380701,251,3806186,-1,280.0,8394106,8394704,4618229,598,55,9,True,True,7.487358666666666,-0.380701
4742,3775944,10,16,0.976612,251,3806186,-1,752.0,6405575,6405585,2629631,10,125,12,True,True,0.7138151111111112,-0.976612
4743,3780875,22841,128,0.099604,251,3806186,-1,2688.0,6841066,6863907,3060191,22841,107,0,True,True,1780.1794901333333,-0.09839323121943294
4744,3780907,14592,1,0.315456,251,3806186,-1,47.0,8625656,8640248,4844749,14592,47,0,True,True,65.10575986666666,-0.31536505631206746
4745,3780940,7,32,0.866773,251,3806186,-1,480.0,4584279,4584286,803339,7,188,1,True,True,0.27593999999999996,-0.866773
4746,3780982,152,8,0.531561,251,3806186,-1,248.0,8386906,8387058,4605924,152,57,1,True,True,1.6762154666666669,-0.531561
4747,3781726,10507,128,0.186417,251,3806186,-1,768.0,4124041,4134548,342315,10507,204,11,True,True,498.7369109333333,-0.1675375696876673
4748,3781779,44,1,0.500651,251,3806186,-1,35.0,5604906,5604950,1823127,44,158,8,True,True,0.07018550000000001,-0.500651
4749,3782028,63,7,0.457986,251,3806186,-1,350.0,7649023,7649086,3866995,63,80,12,True,True,1.40672875,-0.457986
4750,3782175,100,16,0.92635,251,3806186,-1,656.0,4036141,4036241,253966,100,209,11,True,True,1.7123422222222222,-0.92635
4751,3782239,4,45,0.021488,251,3806186,-1,675.0,7831986,7831990,4049747,4,78,6,True,True,0.2602875,-0.021488
4752,3782343,24,4,0.247392,251,3806186,-1,128.0,9062056,9062080,5279713,24,33,0,True,True,0.2611114666666667,-0.247392
4753,3782371,14628,1,0.529415,251,3806186,-1,45.0,4778686,4793314,996315,14628,188,12,True,True,27.748779499999998,-0.5234968576901434
4754,3782770,17,1,0.33357,251,3806186,-1,42.0,7426078,7426095,3643308,17,88,11,True,True,0.05355396666666667,-0.33357
4755,3782813,3755,4,0.3934,251,3806186,-1,116.0,3811586,3815341,28773,3755,220,8,True,True,16.58153428888889,-0.3649301235665501
4756,3782901,7,4,0.157005,251,3806186,-1,192.0,8285086,8285093,4502185,7,67,11,True,True,0.05734026666666667,-0.157005
4757,3784680,5380,32,0.34678,251,3806186,-1,992.0,6683136,6688516,2898456,5380,122,0,True,True,236.4532081777778,-0.32032940544785954
4758,3784760,79,2,0.351913,251,3806186,-1,34.0,5952075,5952154,2167315,79,155,0,True,True,0.1066342,-0.351913
4759,3786043,6140,12,0.625231,251,3806186,-1,372.0,5141206,5147346,1355163,6140,179,12,True,True,60.6173876,-0.6245739525818027
4760,3786103,4836,2,0.236205,251,3806186,-1,50.0,3991941,3996777,205838,4836,218,10,True,True,5.831523750000001,-0.23439339742976165
4761,3786136,12503,32,0.978244,251,3806186,-1,320.0,9439815,9452318,5653679,12503,8,9,True,True,150.76783822222222,-0.9553255568058213
4762,3786949,7853,25,0.501251,251,3806186,-1,1200.0,4584286,4592139,797337,7853,200,1,True,True,808.0125899999998,-0.488049373506763
4763,3787888,41,1,0.811893,251,3806186,-1,22.0,8383297,8383338,4595409,41,61,2,True,True,0.041221400000000005,-0.811893
4764,3787929,5991,4,0.625792,251,3806186,-1,64.0,7831086,7837077,4043157,5991,83,9,True,True,37.483606933333334,-0.6254847654607464
4765,3788206,36,16,0.878677,251,3806186,-1,720.0,5466206,5466242,1678000,36,173,8,True,True,0.850608,-0.878677
4766,3793189,15235,1,0.890402,251,3806186,-1,22.0,7737486,7752721,3944297,15235,84,11,True,True,28.922186516666663,-0.8815879449839323
4767,3793296,24,32,0.814859,251,3806186,-1,1568.0,4072641,4072665,279345,24,222,10,True,True,1.6311381333333332,-0.814859
4768,3793755,43,8,0.029466,251,3806186,-1,232.0,8622806,8622849,4829051,43,54,2,True,True,0.9839384222222223,-0.029466
4769,3794963,722,4,0.554939,251,3806186,-1,144.0,4312181,4312903,517218,722,216,1,True,True,4.0157472,-0.5450585938567435
4770,3795019,219,1,0.280194,251,3806186,-1,15.0,7823886,7824105,4028867,219,85,12,True,True,0.31017700000000004,-0.280194
4771,3795036,1550,1,0.151708,251,3806186,-1,6.0,6833866,6835416,3038830,1550,122,12,True,True,0.2895658333333334,-0.151708
4772,3795334,47,8,0.897175,251,3806186,-1,88.0,8014886,8014933,4219552,47,77,8,True,True,0.30274371111111115,-0.897175
4773,3795560,19937,23,0.656932,251,3806186,-1,943.0,4225741,4245678,430181,19937,222,9,True,True,967.9127738527777,-0.6359698752180597
4774,3795585,72,64,0.087795,251,3806186,-1,2880.0,8574106,8574178,4778521,72,57,9,True,True,16.89696,-0.087795
4775,3795959,6636,4,0.382207,251,3806186,-1,144.0,5836175,5842811,2040216,6636,169,0,True,True,37.1345492,-0.3784965977080114
4776,3796892,6712,4,0.960606,251,3806186,-1,80.0,6412775,6419487,2615883,6712,142,8,True,True,39.97450777777778,-0.885763111801814
4777,3797073,6565,5,0.612448,251,3806186,-1,150.0,4043341,4049906,246268,6565,233,9,True,True,40.991975000000004,-0.6110992188830024
4778,3797479,5880,31,0.625525,251,3806186,-1,682.0,5511306,5517186,1713827,5880,179,10,True,True,143.03076773333333,-0.6188216713182585
4779,3797575,40203,16,0.227428,251,3806186,-1,256.0,4211341,4251544,413766,40203,229,6,True,True,531.715538488889,-0.22737120927024473
4780,3798522,3,3,0.240361,251,3806186,-1,93.0,9418215,9418218,5619693,3,14,12,True,True,0.011704825,-0.240361
4781,3798552,43,1,0.152749,251,3806186,-1,42.0,5882175,5882218,2083623,43,170,7,True,True,0.06284378333333335,-0.152749
4782,3799182,12567,128,0.970537,251,3806186,-1,6272.0,6747466,6760033,2948284,12567,126,9,True,True,2761.1382051555556,-0.9679324625005137
4783,3799324,9878,1,0.909735,251,3806186,-1,49.0,6021975,6031853,2222651,9878,163,1,True,True,25.458582508333336,-0.8613534948143364
4784,3799843,8419,64,0.329285,251,3806186,-1,1600.0,8674356,8682775,4874513,8419,48,11,True,True,883.7249955555556,-0.29650403436746087
3774,2907987,14250,1,0.700882,1,2907987,-1,40.0,2908151,2922237,164,14250,0,0,True,True,17.464241,-0.6328940970167573
3775,2908151,9396,2,0.072589,1,2908151,-1,88.0,2952351,2961747,44200,9396,0,11,True,True,14.102175999999996,-0.0712316375239811
3776,2911601,7,16,0.928048,20,2952351,-1,112.0,4405346,4405353,1493745,7,0,8,True,True,0.037364133333333334,-0.928048
3777,2911671,19274,1,0.106136,20,2952351,-1,29.0,5046180,5065454,2134509,19274,0,6,True,True,5.776770033333333,-0.08491799002336653
3778,2911700,18,20,0.786892,20,2952351,-1,940.0,4275483,4275501,1363783,18,2,10,True,True,0.178271,-0.786892
3779,2911760,8450,1,0.301351,20,2952351,-1,28.0,6459947,6468397,3548187,8450,0,6,True,True,3.264395322222222,-0.27546966284315705
3780,2914905,17422,33,0.086505,20,2952351,-1,264.0,6657752,6675174,3742847,17422,0,11,True,True,45.363037866666666,-0.08393751593610775
3781,2915106,14,1,0.765274,20,2952351,-1,11.0,3038751,3038765,123645,14,5,12,True,True,0.003102672222222222,-0.765274
3782,2915277,18716,128,0.437676,20,2952351,-1,3328.0,6925420,6944136,4010143,18716,0,0,True,True,943.3049969777776,-0.4211631361310417
3783,2915536,5,8,0.395113,20,2952351,-1,168.0,4594903,4594908,1679367,5,4,10,True,True,0.046519666666666674,-0.395113
3784,2916128,12127,2,0.660723,20,2952351,-1,50.0,5827444,5839571,2911316,12127,3,11,True,True,5.559238888888888,-0.4715045195100585
3785,2916370,2,16,0.473988,20,2952351,-1,80.0,3411005,3411007,494635,2,8,12,True,True,0.0019315555555555557,-0.473988
3786,2916683,5,1,0.533468,20,2952351,-1,15.0,3040554,3040559,123871,5,9,0,True,True,0.0015110416666666666,-0.533468
3787,2921047,3,1,0.136381,20,2952351,-1,34.0,3565205,3565208,644158,3,8,10,True,True,0.0012758500000000002,-0.136381
3788,2921059,7959,32,0.390993,20,2952351,-1,768.0,6367047,6375006,3445988,7959,3,9,True,True,239.09647360000002,-0.38886812685943134
3789,2921234,330,8,0.797485,20,2952351,-1,144.0,4029753,4030083,1108519,330,9,9,True,True,0.4357319999999999,-0.797485
3790,2921365,13007,16,0.545724,20,2952351,-1,208.0,3280405,3293412,359040,13007,12,0,True,True,75.76756893333334,-0.5294159862155369
3791,2921446,78,16,0.960134,20,2952351,-1,192.0,5375974,5376052,2454528,78,5,9,True,True,0.17904640000000002,-0.960134
3792,2922343,10,16,0.144076,20,2952351,-1,512.0,6694252,6694262,3771909,10,1,10,True,True,0.03795911111111112,-0.144076
3793,2922366,529,2,0.677289,20,2952351,-1,10.0,5140899,5141428,2218533,529,7,0,True,True,0.06774138888888889,-0.677289
3794,2928592,5647,2,0.914169,20,2952351,-1,22.0,3920653,3926300,992061,5647,13,1,True,True,2.9505569499999997,-0.882265747420596
3795,2944405,473,1,0.795017,20,2952351,-1,35.0,5260274,5260747,2315869,473,7,11,True,True,0.42928034722222225,-0.795017
3796,2961339,17,8,0.729325,44,3038751,-1,200.0,7257624,7257641,4296285,17,0,12,True,True,0.08791833333333333,-0.729325
3797,2961560,20,32,0.373131,44,3038751,-1,1216.0,6883669,6883689,3922109,20,2,8,True,True,0.4020231111111111,-0.37313099999999993
3798,2961635,16139,4,0.949465,44,3038751,-1,20.0,3040559,3056698,78924,16139,20,1,True,True,5.057045277777777,-0.7919581524800284
3799,2962058,6,2,0.553524,44,3038751,-1,64.0,5282374,5282380,2320316,6,9,10,True,True,0.008838400000000001,-0.553524
3800,2962145,51,11,0.55507,44,3038751,-1,77.0,3084759,3084810,122614,51,21,11,True,True,0.19258662499999998,-0.55507
3801,2962163,751,16,0.123235,44,3038751,-1,416.0,7459561,7460312,4497398,751,0,10,True,True,4.365145777777777,-0.123235
3802,2963700,1749,1,0.00503,44,3038751,-1,11.0,6912969,6914718,3949269,1749,3,10,True,True,0.3759621249999999,-0.00503
3803,2964106,1,8,0.596655,44,3038751,-1,176.0,5849544,5849545,2885438,1,9,10,True,True,0.004632711111111111,-0.596655
3804,2964339,17,3,0.537152,44,3038751,-1,69.0,4570800,4570817,1606461,17,17,8,True,True,0.07168985000000001,-0.537152
3805,2964729,13132,56,0.946979,44,3038751,-1,448.0,3040554,3053686,75825,13132,28,1,True,True,90.64526613333334,-0.8484886604011985
3806,2964774,9175,20,0.304691,44,3038751,-1,740.0,6968220,6977395,4003446,9175,2,10,True,True,151.7617077777778,-0.2875570375470014
3807,2964873,338,32,0.748297,44,3038751,-1,544.0,4784326,4784664,1819453,338,17,11,True,True,1.952739377777778,-0.7381105631362169
3808,2965028,10775,16,0.903546,44,3038751,-1,96.0,6929020,6939795,3963992,10775,3,2,True,True,15.451348,-0.8817204995388351
3809,2966203,5734,7,0.343852,44,3038751,-1,294.0,6052956,6058690,3086753,5734,11,1,True,True,76.13669816666666,-0.3438019943735758
3810,2966671,7,4,0.412654,44,3038751,-1,52.0,6938020,6938027,3971349,7,3,9,True,True,0.0050727444444444445,-0.412654
3811,2969763,1412,32,0.645932,44,3038751,-1,256.0,3220875,3222287,251112,1412,30,8,True,True,14.681448533333334,-0.6390121445259461
3812,2970284,1812,19,0.512553,44,3038751,-1,190.0,4740126,4741938,1769842,1812,21,11,True,True,7.90362,-0.48712005125291685
3813,2970596,7173,2,0.160954,44,3038751,-1,30.0,3535905,3543078,565309,7173,29,11,True,True,6.367235499999999,-0.15565073413948569
3814,2971170,3,32,0.220788,44,3038751,-1,1088.0,5143474,5143477,2172304,3,18,2,True,True,0.041797333333333346,-0.220788
3815,2971241,3,1,0.834748,44,3038751,-1,37.0,3040551,3040554,69310,3,38,7,True,True,0.002236341666666667,-0.834748
3816,2971336,7275,2,0.194326,44,3038751,-1,54.0,4253383,4260658,1282047,7275,27,11,True,True,7.463563499999999,-0.16775572815028986
3817,2972083,34,46,0.181358,44,3038751,-1,1978.0,4117383,4117417,1145300,34,28,6,True,True,0.7005416666666666,-0.181358
3818,3033384,13,4,0.79966,44,3038751,-1,24.0,3171275,3171288,137891,13,36,1,True,True,0.0074516,-0.79966
3819,3036042,28,16,0.852251,44,3038751,-1,432.0,4453572,4453600,1417530,28,25,1,True,True,0.3234336,-0.852251
3820,3036207,8369,2,0.851388,44,3038751,-1,82.0,4009053,4017422,972846,8369,31,11,True,True,3.6610095833333336,-0.7883952548246564
3821,3038912,116,8,0.93237,46,3040551,-1,392.0,3171159,3171275,132247,116,39,12,True,True,1.0860229333333336,-0.93237
3822,3038993,36,4,0.994313,46,3040551,-1,192.0,3764353,3764389,725360,36,33,11,True,True,0.043545600000000004,-0.994313
3823,3040549,21,16,0.461265,46,3040551,-1,336.0,6568447,6568468,3527898,21,10,12,True,True,0.11887400000000002,-0.461265
3824,3041375,20,8,0.549665,82,3084759,-1,368.0,6923620,6923640,3882245,20,6,2,True,True,0.13295022222222225,-0.549665
3825,3041510,8394,32,0.290653,82,3084759,-1,576.0,6569347,6577741,3527837,8394,11,6,True,True,98.6688048,-0.2807805640709677
3826,3042985,748,1,0.067363,82,3084759,-1,29.0,3642305,3643053,599320,748,37,10,True,True,0.20613425555555556,-0.067363
3827,3044963,18059,128,0.098202,82,3084759,-1,4096.0,5045280,5063339,2000317,18059,24,1,True,True,723.9755889777778,-0.0935245949251493
3828,3045113,16,128,0.725589,82,3084759,-1,3968.0,6030844,6030860,2985731,16,16,8,True,True,1.5954887111111111,-0.725589
3829,3045224,60,4,0.48719,82,3084759,-1,44.0,3618405,3618465,573181,60,40,7,True,True,0.08906333333333333,-0.48719
3830,3045578,8846,9,0.330851,82,3084759,-1,99.0,5782215,5791061,2736637,8846,19,2,True,True,11.3494073,-0.3092913742773527
3831,3045763,297,1,0.128215,82,3084759,-1,43.0,6122856,6123153,3077093,297,15,10,True,True,0.175494825,-0.12821500000000002
3832,3046090,5,1,0.655473,82,3084759,-1,20.0,4475200,4475205,1429110,5,32,3,True,True,0.006691944444444445,-0.655473
3833,3046231,21291,1,0.100045,82,3084759,-1,32.0,4993880,5015171,1947649,21291,28,11,True,True,14.642140177777778,-0.09666263784050379
3834,3046353,13320,1,0.619516,82,3084759,-1,20.0,7080320,7093640,4033967,13320,2,10,True,True,4.603935555555556,-0.6152497572479659
3835,3046421,243,16,0.900119,82,3084759,-1,368.0,5462074,5462317,2415653,243,22,7,True,True,3.0394224000000003,-0.9001190000000002
3836,3046471,28,8,0.317786,82,3084759,-1,264.0,3221775,3221803,175304,28,51,6,True,True,0.3034826666666667,-0.317786
3837,3046776,105,2,0.450646,82,3084759,-1,12.0,5368774,5368879,2321998,105,24,12,True,True,0.022365,-0.450646
3838,3051388,6907,40,0.616342,82,3084759,-1,480.0,6912969,6919876,3861581,6907,8,0,True,True,75.21693466666666,-0.6118039142048255
3839,3076161,6213,28,0.305675,82,3084759,-1,280.0,4519400,4525613,1443239,6213,37,11,True,True,56.90374977777779,-0.27623330702520327
3840,3076310,9327,256,0.58417,82,3084759,-1,9984.0,7323924,7333251,4247614,9327,1,11,True,True,1043.6859264,-0.5246016684111616
3841,3076349,116,1,0.565552,82,3084759,-1,29.0,4949680,4949796,1873331,116,34,12,True,True,0.08137142222222223,-0.565552
3842,3076398,1137,16,0.364493,82,3084759,-1,784.0,3720153,3721290,643755,1137,50,10,True,True,8.396568133333334,-0.364493
3843,3076422,11420,11,0.316333,82,3084759,-1,99.0,5937944,5949364,2861522,11420,21,10,True,True,24.853045800000004,-0.28281508001737143
3844,3078387,151,1,0.428307,82,3084759,-1,20.0,5893744,5893895,2815357,151,22,10,True,True,0.03970461111111111,-0.428307
3845,3078425,648,2,0.004832,82,3084759,-1,76.0,6183407,6184055,3104982,648,18,11,True,True,0.439128,-0.004832
3846,3078695,7,16,0.246175,82,3084759,-1,224.0,4997480,4997487,1918785,7,36,1,True,True,0.030188355555555556,-0.246175
3847,3078713,5,32,0.221526,82,3084759,-1,1536.0,6971820,6971825,3893107,5,4,8,True,True,0.148352,-0.221526
3848,3078777,9,1,0.739816,82,3084759,-1,24.0,3491705,3491714,412928,9,60,9,True,True,0.0042276,-0.739816
3849,3078809,68,32,0.436124,82,3084759,-1,640.0,5189474,5189542,2110665,68,33,11,True,True,1.153400888888889,-0.436124
3850,3078843,30,1,0.84011,82,3084759,-1,6.0,5774115,5774145,2695272,30,28,11,True,True,0.0043855,-0.84011
3851,3078987,14413,2,0.134306,82,3084759,-1,68.0,5442274,5456687,2363287,14413,30,11,True,True,30.15060556666667,-0.12564464948665038
3852,3079000,49,1,0.732973,82,3084759,-1,13.0,6793669,6793718,3714669,49,13,8,True,True,0.0054534277777777765,-0.7329729999999999
3853,3079028,18,2,0.877886,82,3084759,-1,36.0,5915844,5915862,2836816,18,25,10,True,True,0.0064008,-0.877886
3854,3079202,45,8,0.462848,82,3084759,-1,384.0,6923476,6923521,3844274,45,10,0,True,True,0.31214400000000003,-0.462848
3855,3079221,11740,130,0.358742,82,3084759,-1,1040.0,7466761,7478501,4387540,11740,0,9,True,True,224.47564244444445,-0.3168637013169534
3856,3079456,9793,128,0.305472,82,3084759,-1,1280.0,5777715,5787508,2698259,9793,32,8,True,True,169.64064000000002,-0.23052312055973898
3857,3079657,6,2,0.551672,82,3084759,-1,96.0,4651726,4651732,1572069,6,50,10,True,True,0.0122784,-0.5516720000000002
3858,3079762,52,32,0.17577,82,3084759,-1,416.0,4460800,4460852,1381038,52,55,9,True,True,1.4858780444444444,-0.17577
3859,3079785,16,1,0.606628,82,3084759,-1,39.0,7437461,7437477,4357676,16,2,1,True,True,0.015180533333333333,-0.606628
3860,3079804,24,32,0.841793,82,3084759,-1,1120.0,6916569,6916593,3836765,24,13,2,True,True,0.696192,-0.841793
3861,3079891,14948,1,0.858714,82,3084759,-1,31.0,3462405,3477353,382514,14948,73,9,True,True,17.57585386111111,-0.8571021548570699
3862,3084371,19121,4,0.140002,82,3084759,-1,168.0,3668753,3687874,584382,19121,68,8,True,True,37.16264953333334,-0.13981668737273917
3863,3084438,7516,16,0.538618,82,3084759,-1,688.0,4787926,4795442,1703488,7516,50,8,True,True,63.51630524444444,-0.5065492412243985
3864,3085236,6,1,0.263235,161,3171159,-1,14.0,6880069,6880075,3794833,6,17,12,True,True,0.0017248000000000003,-0.263235
3865,3085260,127,1,0.886336,161,3171159,-1,15.0,5213374,5213501,2128114,127,43,10,True,True,0.03420533333333333,-0.886336
3866,3115127,186,2,0.076462,161,3171159,-1,38.0,4570817,4571003,1455690,186,57,1,True,True,0.43197260000000004,-0.076462
3867,3116699,37,1,0.0754,161,3171159,-1,40.0,3455205,3455242,338506,37,79,11,True,True,0.057280111111111115,-0.0754
3868,3117087,32,1,0.01863,161,3171159,-1,43.0,3217275,3217307,100188,32,84,11,True,True,0.03511093333333333,-0.01863
3869,3117246,44,1,0.507178,161,3171159,-1,50.0,3665153,3665197,547907,44,73,10,True,True,0.022391111111111115,-0.507178
3870,3117543,16767,8,0.031194,161,3171159,-1,160.0,7415356,7432123,4297813,16767,3,6,True,True,64.60639866666666,-0.031000952610905446
3871,3117657,16541,16,0.58189,161,3171159,-1,608.0,5783244,5799785,2665587,16541,35,1,True,True,153.53284062222224,-0.570452431510197
3872,3117832,9,4,0.405134,161,3171159,-1,192.0,6482047,6482056,3364215,9,24,10,True,True,0.0200064,-0.405134
3873,3117984,70,2,0.590036,161,3171159,-1,44.0,6359847,6359917,3241863,70,27,1,True,True,0.1306091111111111,-0.590036
3874,3119439,12175,8,0.906304,161,3171159,-1,80.0,4384171,4396346,1264732,12175,68,1,True,True,30.657903333333334,-0.7580080930188824
3875,3119671,13017,256,0.551594,161,3171159,-1,6912.0,6780652,6793669,3660981,13017,20,12,True,True,826.6824576,-0.5447979781960973
3876,3121027,22596,101,0.543469,161,3171159,-1,4040.0,4449953,4472549,1328926,22596,68,8,True,True,4488.1205033333335,-0.49054080289564145
3877,3121239,24557,16,0.998728,161,3171159,-1,336.0,4523000,4547557,1401761,24557,64,8,True,True,406.70781760000006,-0.8816163547860528
3878,3121554,144,1,0.472104,161,3171159,-1,19.0,6923476,6923620,3801922,144,14,1,True,True,0.0494228,-0.472104
3879,3124725,9503,1,0.775197,161,3171159,-1,46.0,6027244,6036747,2902519,9503,34,0,True,True,11.583879083333333,-0.7684960467745062
3880,3124877,70,16,0.365819,161,3171159,-1,464.0,6668552,6668622,3543675,70,23,9,True,True,0.2974626666666667,-0.365819
3881,3125037,15,1,0.223307,161,3171159,-1,25.0,3173075,3173090,48038,15,97,7,True,True,0.007997916666666667,-0.223307
3882,3125139,15384,4,0.772145,161,3171159,-1,140.0,4629626,4645010,1504487,15384,64,9,True,True,27.141131111111115,-0.7670515952621221
3883,3125742,295,4,0.733227,161,3171159,-1,104.0,3872853,3873148,747111,295,82,12,True,True,0.9738343333333334,-0.733227
3884,3125821,5,32,0.290999,161,3171159,-1,512.0,4571003,4571008,1445182,5,66,1,True,True,0.1564586666666667,-0.290999
3885,3126121,9,1,0.464701,161,3171159,-1,38.0,4029753,4029762,903632,9,80,0,True,True,0.00313595,-0.464701
3886,3127312,16009,4,0.510412,161,3171159,-1,120.0,6356207,6372216,3228895,16009,31,12,True,True,72.24117433333333,-0.48026045064564943
3887,3127546,188,2,0.396785,161,3171159,-1,34.0,4383983,4384171,1256437,188,78,10,True,True,0.19937713333333337,-0.396785
3888,3128217,30,4,0.502167,161,3171159,-1,28.0,3234375,3234405,106158,30,100,9,True,True,0.031434666666666666,-0.502167
3889,3128359,23189,256,0.662678,161,3171159,-1,6656.0,5540715,5563904,2412356,23189,46,8,True,True,2900.7518776888887,-0.649500825207286
3890,3128551,4,32,0.847982,161,3171159,-1,576.0,7170320,7170324,4041769,4,6,1,True,True,0.0546752,-0.847982
3891,3128842,15010,1,0.80654,161,3171159,-1,32.0,7390224,7405234,4261382,15010,4,10,True,True,16.086655288888892,-0.7601378196795604
3892,3129140,11442,1,0.614036,161,3171159,-1,47.0,5445874,5457316,2316734,11442,50,8,True,True,15.793598261111113,-0.5911681796557345
3893,3129548,51,3,0.165844,161,3171159,-1,27.0,4837580,4837631,1708032,51,65,8,True,True,0.055099125,-0.165844
3894,3130495,1041,8,0.514137,161,3171159,-1,88.0,4464400,4465441,1333905,1041,78,8,True,True,6.275402466666667,-0.5141369999999998
3895,3130726,102,2,0.44622,161,3171159,-1,16.0,6455447,6455549,3324721,102,31,11,True,True,0.03207333333333333,-0.44622
3896,3133786,7064,16,0.179145,161,3171159,-1,240.0,4993880,5000944,1860094,7064,64,0,True,True,31.073434666666664,-0.134834078352295
3897,3138149,8107,8,0.948712,161,3171159,-1,136.0,4468000,4476107,1329851,8107,80,7,True,True,70.86798953333333,-0.9218160412311434
3898,3138585,45,4,0.659413,161,3171159,-1,156.0,5090380,5090425,1951795,45,61,11,True,True,0.22248416666666668,-0.6378580745607836
3899,3141174,50,1,0.967736,161,3171159,-1,38.0,3224475,3224525,83301,50,111,6,True,True,0.07389416666666665,-0.967736
3900,3141629,7049,1,0.73592,161,3171159,-1,43.0,7170324,7177373,4028695,7049,7,1,True,True,6.898365777777777,-0.6886997718217961
3901,3141729,9477,2,0.483503,161,3171159,-1,10.0,3543105,3552582,401376,9477,105,9,True,True,2.070638416666667,-0.4754849190028872
3902,3141837,630,1,0.358796,161,3171159,-1,46.0,3227175,3227805,85338,630,113,6,True,True,1.100757,-0.358796
3903,3141844,9584,128,0.218819,161,3171159,-1,3968.0,7171224,7180808,4029380,9584,7,6,True,True,821.3051050666667,-0.218102559642205
3904,3141861,17134,3,0.487642,161,3171159,-1,93.0,4471600,4488734,1329739,17134,83,2,True,True,102.84503218333333,-0.48633877610613074
3905,3141872,22292,32,0.062861,161,3171159,-1,1088.0,4412553,4434845,1270681,22292,89,9,True,True,755.8733150222223,-0.05999082748139997
3906,3142446,49,71,0.369435,161,3171159,-1,781.0,3223575,3223624,81129,49,118,7,True,True,1.4883451916666663,-0.369435
3907,3142634,5,1,0.042808,161,3171159,-1,26.0,6613547,6613552,3470913,5,29,11,True,True,0.0010082222222222222,-0.042808
3908,3142888,15142,1,0.206774,161,3171159,-1,46.0,5118799,5133941,1975911,15142,64,8,True,True,9.470926966666667,-0.17437049749614797
3909,3143000,19,21,0.907726,161,3171159,-1,231.0,4399946,4399965,1256946,19,93,8,True,True,0.20115030833333336,-0.907726
3910,3143277,10,1,0.361251,161,3171159,-1,28.0,3964853,3964863,821576,10,102,11,True,True,0.004102000000000001,-0.361251
3911,3143287,19,2,0.469674,161,3171159,-1,80.0,5115180,5115199,1971893,19,65,7,True,True,0.04196466666666667,-0.469674
3912,3143655,266,16,0.454643,161,3171159,-1,128.0,4030083,4030349,886428,266,100,2,True,True,0.31220124444444447,-0.454643
3913,3143818,18,119,0.046437,161,3171159,-1,2618.0,7368124,7368142,4224306,18,5,11,True,True,1.3629308,-0.046437
3914,3145238,13,8,0.98059,161,3171159,-1,168.0,4618803,4618816,1473565,13,80,10,True,True,0.023757066666666667,-0.98059
3915,3145257,67,1,0.324071,161,3171159,-1,41.0,3643053,3643120,497796,67,113,1,True,True,0.026104130555555556,-0.324071
3916,3145276,11371,64,0.703736,161,3171159,-1,1280.0,4859680,4871051,1714404,11371,74,10,True,True,228.15805866666668,-0.6838915513258408
3917,3145286,124,6,0.521373,161,3171159,-1,138.0,4594903,4595027,1449617,124,82,0,True,True,0.9476720666666667,-0.521373
3918,3145601,23651,128,0.829647,161,3171159,-1,1152.0,3587305,3610956,441704,23651,118,10,True,True,1092.6979647999997,-0.7625800306235732
3919,3145641,4022,1,0.834872,161,3171159,-1,19.0,5145274,5149296,1999633,4022,63,7,True,True,1.9322079555555556,-0.7392234180152116
3920,3145833,13,32,0.263316,161,3171159,-1,1248.0,3690853,3690866,545020,13,114,10,True,True,0.1942824,-0.263316
3921,3145957,16943,4,0.54435,161,3171159,-1,28.0,4405353,4422296,1259396,16943,98,1,True,True,17.250416944444442,-0.4845037623241699
3922,3145988,5980,1,0.17385,161,3171159,-1,49.0,4207383,4213363,1061395,5980,105,12,True,True,8.840835616666666,-0.15755292965260786
3923,3154183,25685,64,0.653675,161,3171159,-1,960.0,5216074,5241759,2061891,25685,61,6,True,True,793.3647306666666,-0.5399743869783592
3924,3154227,15680,1,0.365297,161,3171159,-1,43.0,4466200,4481880,1311973,15680,94,7,True,True,44.085702222222224,-0.35872229328427035
3925,3154964,3,64,0.653337,161,3171159,-1,384.0,6052944,6052947,2897980,3,42,10,True,True,0.052048000000000004,-0.653337
3926,3154982,17819,1,0.835469,161,3171159,-1,16.0,4116483,4134302,961501,17819,110,12,True,True,3.2338481777777774,-0.8350949714463546
3927,3155084,46368,4,0.516663,161,3171159,-1,128.0,7166720,7213088,4011636,46368,11,12,True,True,110.49330915555554,-0.4948856536658502
3928,3155158,50,2,0.376329,161,3171159,-1,22.0,3616605,3616655,461447,50,127,9,True,True,0.040201944444444436,-0.376329
3929,3155276,17218,16,0.907242,161,3171159,-1,160.0,6919876,6937094,3764600,17218,21,2,True,True,44.92984533333333,-0.9008961509518297
3930,3155303,8295,1,0.516372,161,3171159,-1,45.0,6880069,6888364,3724766,8295,26,0,True,True,6.578601,-0.5062749198248906
3931,3155323,13,6,0.352898,161,3171159,-1,246.0,5531074,5531087,2375751,13,58,6,True,True,0.06483056666666667,-0.352898
3932,3155807,14557,16,0.867719,161,3171159,-1,240.0,5191274,5205831,2035467,14557,68,7,True,True,58.93145533333333,-0.8220659361139581
3933,3155869,18,4,0.486862,161,3171159,-1,184.0,6459047,6459065,3303178,18,38,8,True,True,0.0565156,-0.48686200000000013
3934,3155965,191,8,0.48211,161,3171159,-1,104.0,5629115,5629306,2473150,191,58,11,True,True,0.31749293333333334,-0.48211
3935,3156106,9,1,0.604211,161,3171159,-1,18.0,6027244,6027253,2871138,9,49,11,True,True,0.004009499999999999,-0.604211
3936,3156253,9884,23,0.501837,161,3171159,-1,667.0,5982144,5992028,2825891,9884,50,11,True,True,66.78295997777778,-0.4789819571510779
3937,3156525,23,32,0.138968,161,3171159,-1,640.0,4622403,4622426,1465878,23,93,8,True,True,0.1726737777777778,-0.138968
3938,3156593,11878,64,0.165606,161,3171159,-1,1792.0,6269807,6281685,3113214,11878,43,12,True,True,685.4974983111111,-0.16185162177523413
3939,3156607,13568,16,0.077088,161,3171159,-1,352.0,3698053,3711621,541446,13568,131,9,True,True,76.22140533333334,-0.07636264717328003
3940,3156819,25737,128,0.643477,161,3171159,-1,5120.0,4396346,4422083,1239527,25737,115,2,True,True,5212.695950222223,-0.6159281375985827
3941,3156879,8983,2,0.211517,161,3171159,-1,42.0,4622426,4631409,1465547,8983,94,1,True,True,4.5060332333333335,-0.20921770463369468
3942,3156951,13,8,0.186906,161,3171159,-1,176.0,6661352,6661365,3504401,13,32,1,True,True,0.023680799999999995,-0.186906
3943,3158636,83,3,0.362223,161,3171159,-1,51.0,3278605,3278688,119969,83,151,11,True,True,0.12515569999999998,-0.362223
3944,3171252,8,7,0.717303,161,3171275,-1,140.0,4863280,4863288,1692028,8,88,8,True,True,0.017223111111111113,-0.717303
3945,3172221,502,64,0.11833,165,3173075,-1,3008.0,5398074,5398576,2225853,502,68,10,True,True,16.59339804444445,-0.11833
3946,3172267,19,1,0.230346,165,3173075,-1,15.0,4453553,4453572,1281286,19,114,1,True,True,0.007620583333333333,-0.230346
3947,3172413,40,8,0.811173,165,3173075,-1,40.0,4833980,4834020,1661567,40,92,11,True,True,0.06806666666666668,-0.811173
3948,3172710,24,128,0.720256,165,3173075,-1,5376.0,3324605,3324629,151895,24,154,11,True,True,2.7922944000000003,-0.720256
3949,3172807,24672,16,0.481517,165,3173075,-1,128.0,6945220,6969892,3772413,24672,15,9,True,True,57.547003733333334,-0.45449076989493614
3950,3173805,31,1,0.478815,186,3217275,-1,30.0,5871644,5871675,2697839,31,57,0,True,True,0.020803583333333334,-0.478815
3951,3174689,1629,2,0.210704,186,3217275,-1,14.0,5528374,5530003,2353685,1629,67,10,True,True,0.42552105555555564,-0.19392926734049765
3952,3174838,26,4,0.161246,186,3217275,-1,156.0,6890869,6890895,3716031,26,26,8,True,True,0.055995333333333334,-0.161246
3953,3175208,2575,4,0.833365,186,3217275,-1,168.0,5140899,5143474,1965691,2575,84,10,True,True,5.5396833333333335,-0.8333649999999999
3954,3175685,734,1,0.022446,186,3217275,-1,44.0,4789780,4790514,1614095,734,98,1,True,True,0.36638017777777776,-0.022446
3955,3175739,8,9,0.043144,186,3217275,-1,108.0,5729915,5729923,2554176,8,65,9,True,True,0.0089664,-0.043144
3956,3213193,40,32,0.573487,186,3217275,-1,1344.0,6359807,6359847,3146614,40,45,8,True,True,2.279722666666667,-0.573487
3957,3213292,7,32,0.161129,186,3217275,-1,480.0,6130056,6130063,2916764,7,49,9,True,True,0.06789066666666665,-0.161129
3958,3213707,12027,8,0.62954,186,3217275,-1,320.0,3917053,3929080,703346,12027,144,11,True,True,90.80426311111111,-0.6004319103675615
3959,3214079,7848,16,0.039191,186,3217275,-1,288.0,4567200,4575048,1353121,7848,115,11,True,True,140.1390528,-0.03895963591275922
3960,3214664,8,4,0.572269,186,3217275,-1,116.0,5506274,5506282,2291610,8,72,11,True,True,0.022671555555555556,-0.572269
3961,3215048,5,1,0.055912,186,3217275,-1,19.0,7437456,7437461,4222408,5,3,10,True,True,0.0023111388888888886,-0.055912
3962,3215258,6398,32,0.25826,186,3217275,-1,960.0,6887269,6893667,3672011,6398,28,2,True,True,86.331104,-0.2575734168474507
3963,3215295,3413,2,0.180038,186,3217275,-1,96.0,5636315,5639728,2421020,3413,70,9,True,True,4.997347733333333,-0.14541779976013694
3964,3215375,4547,22,0.958238,186,3217275,-1,176.0,4417053,4421600,1201678,4547,131,6,True,True,33.82958675555555,-0.9574853991695054
3965,3215389,12527,8,0.599358,186,3217275,-1,240.0,5140899,5153426,1925510,12527,90,0,True,True,75.934244,-0.5076696619694396
3966,3215507,23,8,0.563605,186,3217275,-1,112.0,5215174,5215197,1999667,23,85,7,True,True,0.04625351111111112,-0.563605
3967,3216620,813,1,0.01862,186,3217275,-1,47.0,4012653,4013466,796033,813,149,8,True,True,0.19604365833333331,-0.01862
3968,3216752,5278,1,0.719547,186,3217275,-1,11.0,5115199,5120477,1898447,5278,95,1,True,True,1.1365437416666666,-0.5508723592105523
3969,3216902,6,8,0.661745,186,3217275,-1,216.0,4837580,4837586,1620678,6,106,0,True,True,0.05185800000000001,-0.661745
3970,3216985,24,32,0.283455,186,3217275,-1,352.0,4361883,4361907,1144898,24,143,12,True,True,0.40482346666666663,-0.28345500000000007
3971,3217098,6,1,0.085749,186,3217275,-1,24.0,6930820,6930826,3713722,6,18,7,True,True,0.0021564,-0.085749
3972,3218348,9722,16,0.449203,191,3220875,-1,496.0,5041680,5051402,1823332,9722,101,11,True,True,42.68473768888889,-0.42798735108219493
3973,3218367,3,5,0.992776,191,3220875,-1,175.0,3484505,3484508,266138,3,175,10,True,True,0.010393541666666667,-0.992776
3974,3218489,203,4,0.867302,191,3220875,-1,176.0,7058220,7058423,3839731,203,14,12,True,True,0.6218656888888888,-0.867302
3975,3218788,14762,64,0.170567,191,3220875,-1,1920.0,3226275,3241037,7487,14762,185,7,True,True,1053.4103733333334,-0.16997888080026768
3976,3218960,20,4,0.830364,191,3220875,-1,184.0,4209183,4209203,990223,20,149,7,True,True,0.1056977777777778,-0.830364
3977,3219242,5551,4,0.600839,191,3220875,-1,116.0,6133656,6139207,2914414,5551,53,8,True,True,5.911839144444445,-0.600546763880559
3978,3223294,128,6,0.794616,190,3223575,-1,246.0,4446353,4446481,1223059,128,139,10,True,True,0.4229888,-0.794616
3979,3225540,754,2,0.820453,189,3226275,-1,26.0,4401746,4402500,1176206,754,144,7,True,True,0.8984622111111111,-0.820453
3980,3226332,13412,1,0.181884,197,3227175,-1,37.0,4453600,4467012,1227268,13412,136,1,True,True,26.21504801111111,-0.17579107074148453
3981,3226397,15893,32,0.659649,197,3227175,-1,1536.0,6100756,6116649,2874359,15893,56,11,True,True,434.22031786666673,-0.5846438050856123
3982,3226436,332,2,0.264521,197,3227175,-1,18.0,7412324,7412656,4185888,332,5,10,True,True,0.13242199999999998,-0.24668512625672198
3983,3226743,4441,256,0.724187,197,3227175,-1,6400.0,3786453,3790894,559710,4441,168,10,True,True,709.0221155555555,-0.7240897224141825
3984,3226844,722,25,0.342671,197,3227175,-1,1100.0,3280405,3281127,53561,722,190,7,True,True,28.677238333333335,-0.342671
3985,3226926,8998,128,0.45347,197,3227175,-1,2048.0,4572803,4581801,1345877,8998,126,7,True,True,1222.0080526222223,-0.44613134170748514
3986,3227019,1061,1,0.590596,197,3227175,-1,10.0,4022553,4023614,795534,1061,163,7,True,True,0.10568738888888889,-0.590596
3987,3227040,6,1,0.229814,197,3227175,-1,46.0,6139207,6139213,2912167,6,54,2,True,True,0.0018898333333333332,-0.229814
3988,3227155,17147,13,0.385462,197,3227175,-1,299.0,5453074,5470221,2225919,17147,83,8,True,True,152.32846857222225,-0.3723303735870058
3989,3227187,12,1,0.10857,225,3234375,-1,31.0,4740126,4740138,1512939,12,120,0,True,True,0.0082336,-0.10857
3990,3227201,2,8,0.202349,225,3234375,-1,232.0,5871644,5871646,2644443,2,69,10,True,True,0.010379422222222223,-0.202349
3991,3227619,4377,16,0.859592,225,3234375,-1,448.0,5460274,5464651,2232655,4377,84,9,True,True,66.2925984,-0.8588497120789085
3992,3227639,42,4,0.50436,225,3234375,-1,128.0,4424253,4424295,1196614,42,149,9,True,True,0.20870826666666667,-0.50436
3993,3227955,27,8,0.419795,225,3234375,-1,184.0,5113380,5113407,1885425,27,106,10,True,True,0.1371582,-0.419795
3994,3228020,9,1,0.149561,225,3234375,-1,41.0,7412656,7412665,4184636,9,5,1,True,True,0.00800115,-0.149561
3995,3228272,12686,117,0.096299,225,3234375,-1,4329.0,5983044,5995730,2754772,12686,65,6,True,True,544.8843998,-0.08678852947918503
3996,3228293,20,32,0.475869,225,3234375,-1,1280.0,4387771,4387791,1159478,20,160,8,True,True,0.61824,-0.475869
3997,3228695,243,1,0.614748,225,3234375,-1,5.0,5636315,5636558,2407620,243,79,0,True,True,0.011225249999999999,-0.614748
3998,3230542,15,32,0.039037,225,3234375,-1,1280.0,6946120,6946135,3715578,15,19,6,True,True,0.27312,-0.039037
3999,3230614,9,8,0.783868,225,3234375,-1,248.0,6052947,6052956,2822333,9,62,1,True,True,0.100843,-0.783868
4000,3230652,178,18,0.503329,225,3234375,-1,126.0,6569347,6569525,3338695,178,44,0,True,True,0.3778495,-0.503329
4001,3230740,8,16,0.117516,225,3234375,-1,624.0,7488861,7488869,4258121,8,0,10,True,True,0.17111466666666666,-0.11751599999999998
4002,3230930,8191,8,0.482241,225,3234375,-1,56.0,4695926,4704117,1464996,8191,132,11,True,True,4.8849787777777784,-0.46364512105622135
4003,3230950,15,4,0.130329,225,3234375,-1,120.0,6137256,6137271,2906306,15,59,8,True,True,0.018815000000000002,-0.130329
4004,3230965,13,16,0.603475,225,3234375,-1,496.0,7414456,7414469,4183491,13,6,7,True,True,0.1398141333333333,-0.603475
4005,3232271,10541,85,0.827522,225,3234375,-1,1275.0,5530174,5540715,2297903,10541,90,7,True,True,300.98701166666666,-0.8246183312348422
4006,3233206,180,32,0.896969,225,3234375,-1,1376.0,3234405,3234585,1199,180,213,1,True,True,9.268736,-0.896969
4007,3233353,17432,1,0.77487,225,3234375,-1,24.0,4416153,4433585,1182800,17432,163,8,True,True,13.364674466666667,-0.6964951118710248
4008,3233362,25,32,0.649232,225,3234375,-1,1408.0,5091280,5091305,1857918,25,117,6,True,True,1.085431111111111,-0.649232
4009,3233466,312,1,0.522044,225,3234375,-1,29.0,5449474,5449786,2216008,312,96,8,True,True,0.2712389333333334,-0.522044
4010,3233513,5867,64,0.370377,225,3234375,-1,2304.0,6672152,6678019,3438639,5867,42,2,True,True,114.4155136,-0.3296721170758093
4011,3233675,21233,1,0.043438,225,3234375,-1,48.0,6613552,6634785,3379877,21233,46,1,True,True,14.887400133333333,-0.04341846556955679
4012,3233900,15,16,0.529817,225,3234375,-1,144.0,3620205,3620220,386305,15,203,7,True,True,0.07286999999999999,-0.5298169999999999
4013,3233915,129,11,0.229486,225,3234375,-1,484.0,5783115,5783244,2549200,129,83,6,True,True,0.8468749666666666,-0.229486
4014,3234031,323,1,0.8023,225,3234375,-1,32.0,4394971,4395294,1160940,323,175,9,True,True,0.4489269333333334,-0.8023
4015,3234059,24779,2,0.789556,225,3234375,-1,48.0,5584915,5609694,2350856,24779,91,11,True,True,20.815238533333336,-0.7033361508535826
4016,3234226,6230,8,0.381236,225,3234375,-1,344.0,4596703,4602933,1362477,6230,147,7,True,True,35.24213302222222,-0.1654286809568793
4017,3234243,12,4,0.589048,225,3234375,-1,140.0,4120983,4120995,886740,12,186,8,True,True,0.02237666666666667,-0.589048
4018,3234606,47,1,0.741394,235,3278605,-1,20.0,3609405,3609452,374799,47,211,10,True,True,0.04428444444444445,-0.741394
4019,3237061,2,16,0.761539,235,3278605,-1,368.0,5722715,5722717,2485654,2,88,12,True,True,0.014713866666666665,-0.761539
4020,3237080,18897,16,0.696708,235,3278605,-1,688.0,7279724,7298621,4042644,18897,12,10,True,True,156.67480573333333,-0.695707476604456
4021,3237244,9,32,0.097717,235,3278605,-1,1440.0,6056556,6056565,2819312,9,68,8,True,True,0.58518,-0.097717
4022,3237380,132,16,0.133883,235,3278605,-1,496.0,6925420,6925552,3688040,132,28,7,True,True,1.1826789333333334,-0.133883
4023,3237475,10306,32,0.477141,235,3278605,-1,1568.0,4837580,4847886,1600105,10306,137,0,True,True,558.9408657777778,-0.4272023668931483
4024,3237506,11946,16,0.232513,235,3278605,-1,416.0,5778615,5790561,2541109,11946,88,6,True,True,65.7495072,-0.21759821726085798
4025,3237550,36,53,0.859053,235,3278605,-1,265.0,5141799,5141835,1904249,36,120,6,True,True,0.12216500000000001,-0.859053
4026,3237567,54,4,0.283267,235,3278605,-1,116.0,4789726,4789780,1552159,54,144,7,True,True,0.0710616,-0.283267
4027,3237605,3,1,0.876766,235,3278605,-1,16.0,6411247,6411250,3173642,3,57,11,True,True,0.0011236,-0.876766
4028,3237639,57,1,0.408647,235,3278605,-1,40.0,4013553,4013610,775914,57,202,6,True,True,0.011697666666666667,-0.408647
4029,3237648,9,8,0.189021,235,3278605,-1,80.0,4020753,4020762,783105,9,202,9,True,True,0.004086,-0.189021
9049,7067964,113,2,0.771941,1,7067964,-1,46.0,7090064,7090177,22100,113,0,10,True,True,0.13000775555555558,-0.771941
9050,7067978,16,16,0.257944,21,7090064,-1,240.0,10153430,10153446,3085452,16,0,9,True,True,0.038794666666666665,-0.257944
9051,7068000,5846,32,0.473261,21,7090064,-1,832.0,12081947,12087793,5013947,5846,0,0,True,True,276.38053155555554,-0.47104949506711546
9052,7072488,40,16,0.256026,21,7090064,-1,288.0,9813868,9813908,2741380,40,2,6,True,True,1.0622399999999999,-0.256026
9053,7072656,13729,98,0.876658,21,7090064,-1,980.0,7654164,7667893,581508,13729,3,7,True,True,407.16688016666666,-0.8758553680673358
9054,7073592,28,4,0.650292,21,7090064,-1,32.0,10209326,10209354,3135734,28,1,1,True,True,0.020013155555555554,-0.650292
9055,7073635,11342,32,0.140447,21,7090064,-1,704.0,9305884,9317226,2232249,11342,4,1,True,True,456.14007217777777,-0.12977454062413446
9056,7073725,13964,1,0.123966,21,7090064,-1,47.0,12284947,12298911,5211222,13964,0,8,True,True,16.234900191666668,-0.11681104289974627
9057,7073777,19272,1,0.568733,21,7090064,-1,43.0,8611567,8630839,1537790,19272,6,11,True,True,36.27960106944444,-0.5576568117845249
9058,7074702,11235,77,0.039593,21,7090064,-1,2926.0,12442627,12453862,5367925,11235,0,12,True,True,409.5220253055556,-0.03456899980574663
9059,7074723,299,11,0.859003,21,7090064,-1,242.0,9809368,9809667,2734645,299,6,12,True,True,2.8898981222222218,-0.859003
9060,7074773,12,1,0.400939,21,7090064,-1,36.0,7091864,7091876,17091,12,10,7,True,True,0.010804800000000002,-0.400939
9061,7074936,384,1,0.857001,21,7090064,-1,26.0,9393784,9394168,2318848,384,7,10,True,True,0.5502570666666666,-0.857001
9062,7075408,4299,84,0.91714,21,7090064,-1,672.0,8567367,8571666,1491959,4299,10,9,True,True,54.502924,-0.906954880657446
9063,7075631,4,32,0.128984,21,7090064,-1,1056.0,9875177,9875181,2799546,4,5,2,True,True,0.12569919999999998,-0.128984
9064,7077889,9841,1,0.366732,21,7090064,-1,39.0,11488576,11498417,4410687,9841,3,8,True,True,10.571113475,-0.33270733178032535
9065,7078039,10,3,0.844836,21,7090064,-1,66.0,7181864,7181874,103825,10,14,12,True,True,0.014454000000000003,-0.844836
9066,7084626,842,32,0.952045,21,7090064,-1,1088.0,7095464,7096306,10838,842,15,8,True,True,26.509748622222226,-0.9262244423065491
9067,7086232,13575,8,0.373683,21,7090064,-1,296.0,7847924,7861499,761692,13575,13,10,True,True,168.59180486666665,-0.370690833973677
9068,7086472,105,1,0.682201,21,7090064,-1,23.0,8560167,8560272,1473695,105,13,1,True,True,0.046549125,-0.682201
9069,7086917,641,1,0.505942,21,7090064,-1,29.0,7727724,7728365,640807,641,15,7,True,True,0.19182815277777776,-0.505942
9070,7089332,130,2,0.262827,21,7090064,-1,56.0,11891147,11891277,4801815,130,3,12,True,True,0.22238377777777776,-0.262827
9071,7093090,2160,2,0.875536,20,7095464,-1,10.0,8180524,8182684,1087434,2160,15,11,True,True,0.8272200000000001,-0.875536
9072,7106775,4,1,0.682556,170,7181864,-1,12.0,11492176,11492180,4385401,4,4,8,True,True,0.0016205333333333333,-0.682556
9073,7107032,28,1,0.620614,170,7181864,-1,8.0,8936964,8936992,1829932,28,13,11,True,True,0.008273688888888889,-0.620614
9074,7107248,22,9,0.643867,170,7181864,-1,171.0,11986547,11986569,4879299,22,3,12,True,True,0.04918815000000001,-0.643867
9075,7107275,19759,32,0.741043,170,7181864,-1,576.0,11231476,11251235,4124201,19759,7,11,True,True,287.7883248,-0.738005073505414
9076,7109502,7380,8,0.244817,170,7181864,-1,256.0,8092124,8099504,982622,7380,20,10,True,True,81.69689884444445,-0.22783280780911183
9077,7109724,215,1,0.821235,170,7181864,-1,15.0,12081947,12082162,4972223,215,3,12,True,True,0.18968375,-0.821235
9078,7111029,2112,5,0.007943,170,7181864,-1,120.0,10775126,10777238,3664097,2112,9,10,True,True,10.447360000000002,-0.007943
9079,7112093,69,16,0.85306,170,7181864,-1,336.0,7341764,7341833,229671,69,26,10,True,True,0.41132279999999993,-0.85306
9080,7112485,34284,1,0.290661,170,7181864,-1,11.0,9858068,9892352,2745583,34284,13,11,True,True,12.254314966666668,-0.287342808916686
9081,7112504,34188,128,0.158206,170,7181864,-1,3200.0,12547027,12581215,5434523,34188,0,1,True,True,1125.9202222222225,-0.1565057080206004
9082,7112573,555,8,0.39928,170,7181864,-1,328.0,9357284,9357839,2244711,555,18,8,True,True,3.6104600000000007,-0.39928
9083,7112578,194,2,0.072979,170,7181864,-1,20.0,10922273,10922467,3809695,194,10,7,True,True,0.1833608333333333,-0.07065681596453822
9084,7113672,7824,128,0.388223,170,7181864,-1,5760.0,12312027,12319851,5198355,7824,2,1,True,True,660.037824,-0.38805333869242853
9085,7113827,11316,37,0.462279,170,7181864,-1,1221.0,10146230,10157546,3032403,11316,15,8,True,True,168.21709538333334,-0.44675735214829493
9086,7114504,1157,32,0.093503,170,7181864,-1,864.0,10201893,10203050,3087389,1157,14,3,True,True,36.0564672,-0.07856393164491068
9087,7114587,17747,32,0.465878,170,7181864,-1,1088.0,10273326,10291073,3158739,17747,13,0,True,True,1045.4070364444447,-0.45480683929410143
9088,7114913,86,1,0.642484,170,7181864,-1,42.0,8758364,8758450,1643451,86,26,6,True,True,0.1695432666666667,-0.642484
9089,7114996,9,32,0.900127,170,7181864,-1,384.0,10924267,10924276,3809271,9,11,7,True,True,0.1531488,-0.900127
9090,7115168,217,4,0.464853,170,7181864,-1,152.0,10199843,10200060,3084675,217,17,1,True,True,1.4159298222222223,-0.46485299999999996
9091,7117993,60,4,0.085823,170,7181864,-1,72.0,7676264,7676324,558271,60,36,10,True,True,0.116004,-0.085823
9092,7118079,105,1,0.731778,170,7181864,-1,30.0,7319664,7319769,201585,105,39,12,True,True,0.13731375,-0.731778
9093,7118118,1402,1,0.91746,170,7181864,-1,39.0,8558765,8560167,1440647,1402,32,8,True,True,1.05391845,-0.91746
9094,7118204,16,16,0.922491,170,7181864,-1,160.0,9620168,9620184,2501964,16,24,7,True,True,0.02641777777777778,-0.922491
9095,7118234,9,4,0.768217,170,7181864,-1,92.0,9875168,9875177,2756934,9,21,9,True,True,0.0246399,-0.768217
9096,7118410,13,8,0.199471,170,7181864,-1,72.0,8615167,8615180,1496757,13,31,1,True,True,0.04564819999999999,-0.199471
9097,7118430,11342,32,0.328721,170,7181864,-1,640.0,9072094,9083436,1953664,11342,29,1,True,True,433.029024,-0.32156035319174897
9098,7118548,12493,143,0.317285,170,7181864,-1,715.0,9090709,9103202,1972161,12493,29,6,True,True,375.5517023194444,-0.3125619644423718
9099,7118583,6223,2,0.996438,170,7181864,-1,48.0,9258084,9264307,2139501,6223,29,11,True,True,9.9537956,-0.771813791200222
9100,7119045,14,4,0.486295,170,7181864,-1,60.0,10455326,10455340,3336281,14,14,11,True,True,0.04788233333333333,-0.486295
9101,7119078,11505,64,0.702291,170,7181864,-1,1344.0,7233264,7244769,114186,11505,48,8,True,True,633.4971776000001,-0.6859999728897507
9102,7119093,205,8,0.476219,170,7181864,-1,384.0,8377224,8377429,1258131,205,40,7,True,True,2.914608,-0.476219
9103,7120629,13,3,0.278375,170,7181864,-1,45.0,9480568,9480581,2359939,13,27,12,True,True,0.0169195,-0.278375
9104,7120844,9,8,0.038282,170,7181864,-1,328.0,11993747,11993756,4872903,9,6,9,True,True,0.036309600000000004,-0.038282
9105,7120858,1,16,0.155741,170,7181864,-1,272.0,9880577,9880578,2759719,1,22,8,True,True,0.007970355555555555,-0.155741
9106,7120917,6726,4,0.469968,170,7181864,-1,112.0,8507824,8514550,1386907,6726,43,10,True,True,18.186785866666668,-0.4604266055341558
9107,7122370,25,7,0.640216,170,7181864,-1,224.0,9167884,9167909,2045514,25,34,10,True,True,0.39711777777777774,-0.640216
9108,7122396,14,4,0.320187,170,7181864,-1,76.0,8757464,8757478,1635068,14,39,0,True,True,0.04994297777777777,-0.320187
9109,7123755,233,2,0.031323,170,7181864,-1,86.0,10209093,10209326,3085338,233,18,9,True,True,0.4475709944444444,-0.031323
9110,7123774,21286,32,0.601077,170,7181864,-1,224.0,12550627,12571913,5426853,21286,0,8,True,True,47.45337146666667,-0.560496178046971
9111,7123901,75,32,0.380285,170,7181864,-1,1408.0,10220126,10220201,3096225,75,18,2,True,True,1.8817333333333333,-0.380285
9112,7123916,2,32,0.93646,170,7181864,-1,1312.0,9891377,9891379,2767461,2,25,1,True,True,0.07922293333333334,-0.93646
9113,7123947,113,16,0.361493,170,7181864,-1,128.0,7678124,7678237,554177,113,55,7,True,True,0.3883985777777778,-0.361493
9114,7124055,10574,32,0.43011,170,7181864,-1,1408.0,8804364,8814938,1680309,10574,42,7,True,True,562.7908899555555,-0.42674138144748663
9115,7124427,388,39,0.47341,170,7181864,-1,1872.0,7604564,7604952,480137,388,59,8,True,True,23.145907200000003,-0.47340999999999994
9116,7124495,22,1,0.054078,170,7181864,-1,41.0,10490926,10490948,3366431,22,16,10,True,True,0.04220357777777778,-0.054078
9117,7124616,44,5,0.868021,170,7181864,-1,240.0,7226064,7226108,101448,44,64,11,True,True,0.540848,-0.868021
9118,7124801,7,32,0.952645,170,7181864,-1,480.0,9327984,9327991,2203183,7,37,10,True,True,0.22600666666666666,-0.952645
9119,7124812,19,1,0.683671,170,7181864,-1,37.0,9093409,9093428,1968597,19,41,6,True,True,0.033105441666666666,-0.683671
9120,7124848,23,1,0.269848,170,7181864,-1,42.0,11892947,11892970,4768099,23,9,6,True,True,0.02950861666666667,-0.269848
9121,7124867,5,66,0.635687,170,7181864,-1,2574.0,7676324,7676329,551457,5,61,1,True,True,0.34559525,-0.635687
9122,7125076,17378,8,0.083591,170,7181864,-1,280.0,9642268,9659646,2517192,17378,34,10,True,True,252.95808844444446,-0.07484724499490185
9123,7125353,8,1,0.069259,170,7181864,-1,8.0,12620557,12620565,5495204,8,0,2,True,True,0.0010044444444444443,-0.069259
9124,7125590,6757,1,0.405068,170,7181864,-1,40.0,12543427,12550184,5417837,6757,3,9,True,True,1.9760264444444446,-0.4049616147467157
9125,7125614,3678,1,0.298337,170,7181864,-1,50.0,7884424,7888102,758810,3678,61,9,True,True,3.7609169444444452,-0.28673551418087273
9126,7125662,32562,128,0.712207,170,7181864,-1,768.0,12288547,12321109,5162885,32562,6,2,True,True,451.0578901333334,-0.6855173385089449
9127,7125680,178,8,0.871289,170,7181864,-1,288.0,9982352,9982530,2856672,178,30,12,True,True,2.1137856,-0.871289
9128,7126585,3522,8,0.524778,170,7181864,-1,392.0,10324726,10328248,3198141,3522,22,11,True,True,34.84314648888889,-0.4292241980554555
9129,7126867,11,56,0.669644,170,7181864,-1,2352.0,10920473,10920484,3793606,11,19,11,True,True,1.2628410666666667,-0.6696439999999999
9130,7126915,64,2,0.259447,170,7181864,-1,16.0,9892352,9892416,2765437,64,33,2,True,True,0.030916266666666664,-0.259447
9131,7131804,6,36,0.830549,170,7181864,-1,1044.0,8985664,8985670,1853860,6,53,11,True,True,0.2548578,-0.830549
9132,7131838,13,1,0.092441,170,7181864,-1,21.0,10242226,10242239,3110388,13,25,10,True,True,0.011958158333333333,-0.092441
9133,7131896,178,6,0.901642,170,7181864,-1,192.0,7600964,7601142,469068,178,76,12,True,True,1.0739808,-0.901642
9134,7132443,7,1,0.342019,170,7181864,-1,14.0,12281347,12281354,5148904,7,8,6,True,True,0.003599866666666667,-0.342019
9135,7132562,60,1,0.753176,170,7181864,-1,35.0,9618368,9618428,2485806,60,45,12,True,True,0.03003,-0.753176
9136,7132627,24738,7,0.164533,170,7181864,-1,322.0,9876977,9901715,2744350,24738,38,7,True,True,262.46020449444444,-0.15573122186510036
9137,7132730,6994,4,0.349276,170,7181864,-1,148.0,11484976,11491970,4352246,6994,17,12,True,True,18.4421764,-0.24780165762803283
9138,7132808,95,4,0.419101,170,7181864,-1,128.0,10730926,10731021,3598118,95,23,11,True,True,0.4208711111111111,-0.419101
9139,7132911,5,4,0.475499,170,7181864,-1,24.0,10460726,10460731,3327815,5,25,7,True,True,0.007125,-0.475499
9140,7132920,5350,1,0.68883,170,7181864,-1,42.0,10468826,10474176,3335906,5350,25,9,True,True,12.527638433333333,-0.688710434262894
9141,7132949,22,18,0.160689,170,7181864,-1,270.0,12620527,12620549,5487578,22,1,11,True,True,0.09322500000000002,-0.160689
9142,7135100,719,1,0.69669,170,7181864,-1,31.0,9722968,9723687,2587868,719,49,10,True,True,0.4390547222222222,-0.26832996855772534
9143,7135118,16046,32,0.354692,170,7181864,-1,320.0,11282876,11298922,4147758,16046,19,11,True,True,92.63660088888889,-0.3511378171576567
9144,7135521,26,64,0.692901,170,7181864,-1,2880.0,8375424,8375450,1239903,26,76,12,True,True,2.853968,-0.692901
9145,7135638,30,13,0.389138,170,7181864,-1,416.0,10458926,10458956,3323288,30,29,8,True,True,0.741,-0.389138
9146,7135868,11419,94,0.009932,170,7181864,-1,1410.0,9075694,9087113,1939826,11419,64,1,True,True,977.5859704999999,-0.009922179763271763
9147,7135905,14386,8,0.783072,170,7181864,-1,216.0,10876273,10890659,3740368,14386,24,8,True,True,137.19412979999998,-0.7447499559612151
9148,7136048,8,6,0.597129,170,7181864,-1,252.0,10052430,10052438,2916382,8,42,10,True,True,0.0339248,-0.597129
9149,7136179,18,32,0.077809,170,7181864,-1,1568.0,10273326,10273344,3137147,18,34,10,True,True,1.3251168,-0.077809
9150,7137518,161,8,0.667962,170,7181864,-1,392.0,11668576,11668737,4531058,161,16,0,True,True,2.9904569333333337,-0.667962
9151,7137677,35,1,0.616512,170,7181864,-1,16.0,10008230,10008265,2870553,35,45,10,True,True,0.03567666666666667,-0.616512
9152,7138185,323,1,0.323733,170,7181864,-1,31.0,10074530,10074853,2936345,323,44,10,True,True,0.26940532777777776,-0.32373300000000005
9153,7138782,8253,1,0.986368,170,7181864,-1,38.0,10030330,10038583,2891548,8253,46,10,True,True,10.543915416666668,-0.8993734607864049
9154,7138878,10,16,0.938969,170,7181864,-1,336.0,10753026,10753036,3614148,10,27,10,True,True,0.079464,-0.938969
9155,7138938,9704,64,0.742836,170,7181864,-1,1088.0,7722324,7732028,583386,9704,92,0,True,True,108.72270364444445,-0.7356932297435812
9156,7138958,14911,32,0.736719,170,7181864,-1,544.0,10212926,10227837,3073968,14911,39,8,True,True,129.30662551111112,-0.6928742045455498
9157,7139006,14452,32,0.316515,170,7181864,-1,384.0,10872673,10887125,3733667,14452,26,10,True,True,228.84583253333332,-0.2994220529432481
9158,7139240,23347,128,0.150506,170,7181864,-1,4352.0,9697268,9720615,2558028,23347,62,8,True,True,1910.5560824888892,-0.14035295650701385
9159,7139285,12,1,0.458659,170,7181864,-1,8.0,12356227,12356239,5216942,12,6,11,True,True,0.0010928,-0.458659
9160,7139307,18,16,0.147487,170,7181864,-1,352.0,11582176,11582194,4442869,18,18,12,True,True,0.07265279999999999,-0.147487
9161,7139721,6,32,0.864301,170,7181864,-1,1376.0,8941464,8941470,1801743,6,80,8,True,True,0.45655680000000004,-0.864301
9162,7139796,465,4,0.113607,170,7181864,-1,48.0,11995547,11996012,4855751,465,13,7,True,True,0.31210800000000005,-0.113607
9163,7139815,33807,64,0.969976,170,7181864,-1,2688.0,11892047,11925854,4752232,33807,17,6,True,True,1610.0276192000003,-0.9330511738016101
9164,7140040,275,8,0.406387,170,7181864,-1,160.0,11760547,11760822,4620507,275,19,1,True,True,2.412666666666667,-0.406387
9165,7140102,3,4,0.520692,170,7181864,-1,192.0,10411126,10411129,3271024,3,40,12,True,True,0.019392000000000003,-0.520692
9166,7140866,346,4,0.003677,170,7181864,-1,20.0,9143927,9144273,2003061,346,79,7,True,True,0.34756661111111115,-0.0036402581855015342
9167,7141294,11097,10,0.450559,170,7181864,-1,420.0,7725924,7737021,584630,11097,103,2,True,True,42.1842645,-0.43247451943950954
9168,7141690,3596,256,0.832511,170,7181864,-1,9216.0,9087113,9090709,1945423,3596,82,0,True,True,1693.4637312,-0.8167797462024027
9169,7141900,30,8,0.125717,170,7181864,-1,224.0,12620527,12620557,5478627,30,1,0,True,True,0.10546666666666667,-0.125717
9170,7143944,103,8,0.449329,170,7181864,-1,336.0,9812968,9813071,2669024,103,67,8,True,True,2.6788514666666674,-0.449329
9171,7143981,7296,158,0.969458,170,7181864,-1,6162.0,7428164,7435460,284183,7296,114,12,True,True,1659.4433743333332,-0.7931698675408853
9172,7143987,78,16,0.097446,170,7181864,-1,192.0,10513926,10514004,3369939,78,36,10,True,True,0.9577984000000002,-0.097446
9173,7144695,42,4,0.218623,170,7181864,-1,64.0,10187230,10187272,3042535,42,53,9,True,True,0.06062933333333334,-0.218623
9174,7147554,19,1,0.979032,170,7181864,-1,49.0,10140830,10140849,2993276,19,56,10,True,True,0.009972044444444446,-0.979032
9175,7147640,49,1,0.420176,170,7181864,-1,13.0,12085547,12085596,4937907,49,12,8,True,True,0.03460325555555555,-0.420176
9176,7147674,11,35,0.546086,170,7181864,-1,1540.0,10200060,10200071,3052386,11,53,1,True,True,0.7271965555555555,-0.546086
9177,7148673,29,8,0.166101,170,7181864,-1,64.0,8713264,8713293,1564591,29,98,7,True,True,0.07138382222222223,-0.166101
9178,7148736,9465,32,0.377557,170,7181864,-1,416.0,11187276,11196741,4038540,9465,29,1,True,True,97.5033696,-0.35560831125911063
9179,7148820,116,32,0.348086,170,7181864,-1,576.0,8136324,8136440,987504,116,109,11,True,True,1.0723968,-0.348086
9180,7149228,9,1,0.952377,170,7181864,-1,21.0,9875168,9875177,2725940,9,70,0,True,True,0.005624325,-0.952377
9181,7149429,13,6,0.971745,170,7181864,-1,228.0,8515065,8515078,1365636,13,106,8,True,True,0.06324023333333334,-0.971745
9182,7149513,14084,1,0.576836,170,7181864,-1,32.0,9360884,9374968,2211371,14084,83,2,True,True,8.922691555555556,-0.5735266723428709
9183,7149817,41,1,0.014371,170,7181864,-1,37.0,8511424,8511465,1361607,41,108,8,True,True,0.03566214166666667,-0.014371
9184,7149890,17,1,0.813779,170,7181864,-1,7.0,9168784,9168801,2018894,17,88,6,True,True,0.008438752777777777,-0.813779
9185,7150081,4900,36,0.016191,170,7181864,-1,396.0,10212926,10217826,3062845,4900,50,0,True,True,40.9333826,-0.01608546972621428
9186,7150250,9583,32,0.896655,170,7181864,-1,320.0,9645868,9655451,2495618,9583,79,8,True,True,173.781512,-0.8006279201433385
9187,7150693,31580,2,0.502085,170,7181864,-1,22.0,12280447,12312027,5129754,31580,12,10,True,True,15.715894516666665,-0.486139972240474
9188,7150700,672,8,0.867758,170,7181864,-1,328.0,8059224,8059896,908524,672,119,10,True,True,2.0370112000000002,-0.867758
9189,7154274,8,1,0.699317,170,7181864,-1,26.0,9394168,9394176,2239894,8,85,1,True,True,0.01146368888888889,-0.699317
9190,7154312,9,1,0.648912,170,7181864,-1,40.0,9094309,9094318,1939997,9,95,6,True,True,0.015300000000000001,-0.648912
9191,7154448,15210,8,0.455997,170,7181864,-1,312.0,9867968,9883178,2713520,15210,74,2,True,True,149.21118853333334,-0.45132160593542
9192,7154533,7486,8,0.410387,170,7181864,-1,64.0,10686726,10694212,3532193,7486,39,12,True,True,27.30228266666667,-0.38228732691089073
9193,7158859,538,1,0.352211,170,7181864,-1,33.0,11804747,11805285,4645888,538,22,11,True,True,0.9865305999999999,-0.352211
9194,7158910,10206,4,0.542467,170,7181864,-1,44.0,8936964,8947170,1778054,10206,106,0,True,True,22.6192098,-0.5033939461294187
9195,7159012,38,3,0.52317,170,7181864,-1,135.0,8070024,8070062,911012,38,125,9,True,True,0.1480575,-0.52317
9196,7159053,7,8,0.765081,170,7181864,-1,240.0,12529027,12529034,5369974,7,6,12,True,True,0.03605,-0.765081
9197,7159623,5,4,0.11338,170,7181864,-1,192.0,10491826,10491831,3332203,5,43,6,True,True,0.04491733333333334,-0.11338
9198,7159669,206,12,0.175814,170,7181864,-1,156.0,11372876,11373082,4213207,206,30,8,True,True,0.27208479999999996,-0.175814
9199,7159767,103,1,0.428384,170,7181864,-1,43.0,11238676,11238779,4078909,103,32,9,True,True,0.10682501944444443,-0.428384
9200,7159820,5750,32,0.176895,170,7181864,-1,832.0,7739424,7745174,579604,5750,133,6,True,True,39.73464675555555,-0.15615201714967847
9201,7160054,37473,32,0.594892,170,7181864,-1,1600.0,9302284,9339757,2142230,37473,98,11,True,True,3283.19588,-0.5889057833761426
9202,7160100,414,8,0.542763,170,7181864,-1,392.0,9690068,9690482,2529968,414,87,11,True,True,5.4425084,-0.542763
9203,7160164,15,1,0.381563,170,7181864,-1,21.0,8544365,8544380,1384201,15,123,9,True,True,0.005375125,-0.381563
9204,7160343,14002,5,0.845092,170,7181864,-1,95.0,10797226,10811228,3636883,14002,40,10,True,True,52.75919683333333,-0.8079202996241748
9205,7160436,135,1,0.688551,170,7181864,-1,20.0,7648764,7648899,488328,135,145,11,True,True,0.0754725,-0.688551
9206,7160647,6502,3,0.437494,170,7181864,-1,150.0,10244026,10250528,3083379,6502,56,7,True,True,53.2985025,-0.39663032856882185
9207,7160727,498,9,0.283248,170,7181864,-1,90.0,9861668,9862166,2700941,498,83,8,True,True,1.781844,-0.283248
9208,7162746,14808,8,0.620376,170,7181864,-1,120.0,10251226,10266034,3088480,14808,56,9,True,True,96.23402733333333,-0.5944014374622657
9209,7162966,1,5,0.925136,170,7181864,-1,155.0,8266924,8266925,1103958,1,133,12,True,True,0.0052041249999999995,-0.925136
9210,7162997,11,64,0.856997,170,7181864,-1,1280.0,9213884,9213895,2050887,11,105,6,True,True,0.5203733333333335,-0.856997
9211,7163649,2114,1,0.995363,170,7181864,-1,21.0,11668576,11670690,4504927,2114,26,12,True,True,2.1035357,-0.995363
9212,7163720,4028,4,0.80594,170,7181864,-1,132.0,10922467,10926495,3758747,4028,37,1,True,True,23.453343466666666,-0.8054371720638948
9213,7164050,224,7,0.103812,170,7181864,-1,168.0,12554227,12554451,5390177,224,3,2,True,True,0.2956202666666667,-0.103812
9214,7164332,124,9,0.649625,170,7181864,-1,144.0,8937864,8937988,1773532,124,120,6,True,True,0.6595312,-0.649625
9215,7164528,34,1,0.61626,170,7181864,-1,20.0,7514564,7514598,350036,34,157,12,True,True,0.021306666666666665,-0.6162600000000001
9216,7165397,739,32,0.41128,170,7181864,-1,448.0,11758576,11759315,4593179,739,26,12,True,True,18.153781333333335,-0.41128
9217,7165501,74,64,0.496405,170,7181864,-1,2432.0,8015024,8015098,849523,74,145,11,True,True,5.1600824888888885,-0.496405
9218,7166578,7417,1,0.751727,170,7181864,-1,38.0,10800826,10808243,3634248,7417,44,8,True,True,12.19150981111111,-0.7239823421642287
9219,7170295,121,4,0.927229,170,7181864,-1,96.0,8555165,8555286,1384870,121,134,8,True,True,0.34502746666666667,-0.927229
9220,7172868,21,5,0.099702,170,7181864,-1,120.0,7855124,7855145,682256,21,149,9,True,True,0.10469200000000001,-0.099702
9221,7173828,18,18,0.444103,170,7181864,-1,630.0,9142109,9142127,1968281,18,114,10,True,True,0.5480685000000001,-0.444103
9222,7173913,321,1,0.581234,170,7181864,-1,24.0,9862568,9862889,2688655,321,89,6,True,True,0.3062768,-0.581234
9223,7184070,13,16,0.032636,251,7226064,-1,464.0,10199830,10199843,3015760,13,72,2,True,True,0.25894035555555556,-0.032636
9224,7184899,1013,4,0.289904,251,7226064,-1,148.0,10850573,10851586,3665674,1013,44,1,True,True,5.963227099999999,-0.289904
9225,7185016,16239,4,0.420641,251,7226064,-1,96.0,11282876,11299115,4097860,16239,34,0,True,True,28.120572800000005,-0.4168351884426243
9226,7186069,16,6,0.222879,251,7226064,-1,276.0,8802564,8802580,1616495,16,131,11,True,True,0.1474944,-0.222879
9227,7186102,2263,4,0.45463,251,7226064,-1,140.0,9368084,9370347,2181982,2263,108,9,True,True,6.5634543333333335,-0.45463
9228,7186416,8496,64,0.38108,251,7226064,-1,2112.0,10216526,10225022,3030110,8496,67,8,True,True,260.53734080000004,-0.2914357157387385
9229,7187747,5,8,0.19556,251,7226064,-1,312.0,9097909,9097914,1910162,5,121,2,True,True,0.064948,-0.19556
9230,7187993,11,4,0.469574,251,7226064,-1,24.0,9864368,9864379,2676375,11,93,7,True,True,0.0088242,-0.469574
9231,7188234,11,5,0.124441,251,7226064,-1,135.0,8537165,8537176,1348931,11,146,10,True,True,0.021846000000000004,-0.124441
9232,7189561,526,8,0.967616,251,7226064,-1,152.0,7229664,7230190,40103,526,178,8,True,True,4.449995066666667,-0.967616
9233,7189749,30690,64,0.914029,251,7226064,-1,2240.0,9986130,10016820,2796381,30690,84,8,True,True,4521.160000000001,-0.9129614000027959
9234,7189791,17197,128,0.412935,251,7226064,-1,5120.0,11495776,11512973,4305985,17197,30,2,True,True,2146.3952924444443,-0.4029841120406585
9235,7190455,12,1,0.820418,251,7226064,-1,10.0,12536227,12536239,5345772,12,7,9,True,True,0.001056,-0.8204180000000002
9236,7191158,93,1,0.703835,251,7226064,-1,6.0,8289024,8289117,1097866,93,155,10,True,True,0.024666699999999996,-0.7038350000000001
9237,7191735,12789,2,0.741153,251,7226064,-1,100.0,10461626,10474415,3269891,12789,58,6,True,True,78.92209055555557,-0.7408386358699621
9238,7192149,12,32,0.007605,251,7226064,-1,256.0,9190884,9190896,1998735,12,122,10,True,True,0.11642026666666669,-0.007605
9239,7192320,16,32,0.374644,251,7226064,-1,480.0,10179130,10179146,2986810,16,80,10,True,True,0.14912000000000003,-0.374644
9240,7192416,30,1,0.223937,251,7226064,-1,27.0,9072064,9072094,1879648,30,135,12,True,True,0.044691749999999995,-0.223937
9241,7192636,115,1,0.283604,251,7226064,-1,29.0,9142127,9142242,1949491,115,127,2,True,True,0.16118240277777776,-0.283604
9242,7192923,2,3,0.879607,251,7226064,-1,54.0,9700868,9700870,2507945,2,106,8,True,True,0.0039345000000000005,-0.879607
9243,7192945,38,12,0.264499,251,7226064,-1,504.0,11185467,11185505,3992522,38,41,12,True,True,0.505134,-0.264499
9244,7193263,44,1,0.838484,251,7226064,-1,47.0,9487768,9487812,2294505,44,114,9,True,True,0.07478692222222223,-0.838484
9245,7193967,9,32,0.795138,251,7226064,-1,1024.0,11187267,11187276,3993300,9,41,7,True,True,0.24307200000000004,-0.795138
9246,7194119,5,8,0.414717,251,7226064,-1,384.0,8848564,8848569,1654445,5,146,11,True,True,0.09258133333333333,-0.414717
9247,7194371,1835,1,0.241554,251,7226064,-1,37.0,12171947,12173782,4977576,1835,16,12,True,True,2.666010333333333,-0.241554
9248,7194423,7,1,0.900187,251,7226064,-1,12.0,10804426,10804433,3610003,7,51,2,True,True,0.003956633333333333,-0.900187
9249,7194433,1000,4,0.414557,251,7226064,-1,132.0,10600326,10601326,3405893,1000,58,12,True,True,9.318833333333334,-0.414557
9250,7195265,56,39,0.01553,251,7226064,-1,507.0,11099067,11099123,3903802,56,44,10,True,True,0.6050650666666667,-0.01553
9251,7195429,2,16,0.153375,251,7226064,-1,208.0,8485724,8485726,1290295,2,167,12,True,True,0.015004888888888887,-0.153375
9252,7196751,143,16,0.374406,251,7226064,-1,784.0,11032767,11032910,3836016,143,45,12,True,True,4.974035733333333,-0.374406
9253,7200934,5663,2,0.816707,251,7226064,-1,10.0,10196230,10201893,2995296,5663,86,7,True,True,1.8985817222222219,-0.7738935926485828
9254,7201056,70,1,0.820034,251,7226064,-1,14.0,7970824,7970894,769768,70,180,12,True,True,0.011272722222222222,-0.820034
9255,7201163,33,1,0.599946,251,7226064,-1,41.0,9350084,9350117,2148921,33,128,10,True,True,0.045291675,-0.599946
9256,7201177,268,4,0.33509,251,7226064,-1,112.0,11369276,11369544,4168099,268,37,12,True,True,0.27964906666666667,-0.33509
9257,7201192,24047,1,0.959161,251,7226064,-1,36.0,10826526,10850573,3625334,24047,54,10,True,True,30.0530877,-0.919497465276004
9258,7201286,7837,32,0.992829,251,7226064,-1,384.0,8037124,8044961,835838,7837,182,10,True,True,93.84453973333333,-0.9851504054116688
9259,7201325,14831,4,0.241831,251,7226064,-1,128.0,9895952,9910783,2694627,14831,100,2,True,True,96.55108622222222,-0.24166287183509874
9260,7201383,13,8,0.97349,251,7226064,-1,208.0,9142109,9142122,1940726,13,142,0,True,True,0.13068582222222222,-0.9734900000000002
9261,7201427,10394,8,0.19266,251,7226064,-1,280.0,8062824,8073218,861397,10394,183,8,True,True,74.14999355555557,-0.17467224323759742
9262,7201607,11188,2,0.644434,251,7226064,-1,64.0,9887777,9898965,2686170,11188,103,9,True,True,23.584731022222222,-0.6303110235928594
9263,7202871,7099,1,0.82855,251,7226064,-1,10.0,7652364,7659463,449493,7099,200,8,True,True,2.0347054166666667,-0.8209705023566918
9264,7203063,5,18,0.801332,251,7226064,-1,432.0,8515065,8515070,1312002,5,172,0,True,True,0.04608600000000001,-0.801332
9265,7203165,11669,8,0.577854,251,7226064,-1,208.0,8757464,8769133,1554299,11669,163,11,True,True,114.22482817777777,-0.5767443924434702
9266,7204406,19788,1,0.12887,251,7226064,-1,10.0,10280526,10300314,3076120,19788,73,9,True,True,11.506236833333334,-0.12687367365499266
9267,7204441,44,1,0.636273,251,7226064,-1,7.0,7738524,7738568,534083,44,196,9,True,True,0.0028926333333333335,-0.636273
9268,7204550,13130,64,0.977356,251,7226064,-1,2112.0,9353684,9366814,2149134,13130,133,8,True,True,584.1843861333334,-0.9541551047460467
9269,7204562,171,1,0.173717,251,7226064,-1,41.0,11760376,11760547,4555814,171,28,7,True,True,0.3844365,-0.173717
9270,7204763,49,4,0.904171,251,7226064,-1,64.0,10946367,10946416,3741604,49,48,10,True,True,0.19172284444444443,-0.904171
9271,7204775,8028,1,0.517277,251,7226064,-1,19.0,10180030,10188058,2975255,8028,93,6,True,True,3.291892711111111,-0.5167714691197
9272,7204795,58272,4,0.437402,251,7226064,-1,120.0,10142630,10200902,2937835,58272,97,7,True,True,140.35629933333334,-0.41932280517555154
9273,7204807,11697,256,0.099578,251,7226064,-1,4864.0,8701567,8713264,1496760,11697,171,12,True,True,2199.8472924444445,-0.0986593411203906
9274,7207802,4,4,0.801172,251,7226064,-1,196.0,7722324,7722328,514522,4,206,11,True,True,0.009151022222222223,-0.801172
9275,7208040,42,4,0.504257,251,7226064,-1,104.0,11398576,11398618,4190536,42,37,10,True,True,0.107198,-0.504257
9276,7208206,7328,1,0.631441,251,7226064,-1,31.0,9982530,9989858,2774324,7328,105,1,True,True,12.60670731111111,-0.6268324263986903
9277,7208246,81,16,0.784281,251,7226064,-1,176.0,9145784,9145865,1937538,81,149,1,True,True,0.7232544,-0.7842809999999999
9278,7209531,110,1,0.843031,251,7226064,-1,12.0,10118730,10118840,2909199,110,100,11,True,True,0.043637,-0.843031
9279,7209617,635,32,0.627318,251,7226064,-1,448.0,8892764,8893399,1683147,635,168,11,True,True,4.2253182222222225,-0.6273180000000002
9280,7209643,25,1,0.26023,251,7226064,-1,31.0,12292147,12292172,5082504,25,12,8,True,True,0.02176673611111111,-0.26023
9281,7209667,9,8,0.552906,251,7226064,-1,264.0,11900147,11900156,4690480,9,24,9,True,True,0.0572814,-0.552906
9282,7209674,336,32,0.9487,251,7226064,-1,960.0,7825824,7826160,616150,336,208,12,True,True,8.259328,-0.9487
9283,7209685,26645,16,0.203763,251,7226064,-1,304.0,8551565,8578210,1341880,26645,185,9,True,True,164.56626222222224,-0.20072769568988458
9284,7209720,15299,64,0.093265,251,7226064,-1,448.0,8399324,8414623,1189604,15299,193,10,True,True,233.48125048888892,-0.09233126647651796
9285,7209776,26,1,0.437421,251,7226064,-1,38.0,10826526,10826552,3616750,26,59,0,True,True,0.033166611111111105,-0.437421
9286,7210165,12871,16,0.628894,251,7226064,-1,272.0,10194430,10207301,2984265,12871,96,9,True,True,109.03791764444443,-0.5777806243818796
9287,7210313,11079,64,0.593288,251,7226064,-1,640.0,9120009,9131088,1909696,11079,159,10,True,True,396.64142400000003,-0.5887038444521314
9288,7210375,5745,32,0.027818,251,7226064,-1,832.0,10157030,10162775,2946655,5745,100,3,True,True,90.49596977777779,-0.027722492865052534
9289,7210382,28,16,0.707576,251,7226064,-1,256.0,9212984,9213012,2002602,28,152,10,True,True,0.26491733333333334,-0.707576
9290,7210418,167,32,0.920594,251,7226064,-1,1056.0,7877224,7877391,666806,167,213,10,True,True,6.985008800000001,-0.920594
9291,7210473,1381,32,0.078773,251,7226064,-1,1536.0,9371684,9373065,2161211,1381,142,8,True,True,42.15327573333334,-0.078773
9292,7210951,22437,1,0.382405,251,7226064,-1,29.0,7731324,7753761,520373,22437,220,8,True,True,5.019317825000001,-0.3660820544539534
9293,7211068,2274,1,0.74234,251,7226064,-1,5.0,11076967,11079241,3865899,2274,50,11,True,True,0.7161597777777778,-0.7402260488795755
9294,7211177,56,22,0.130548,251,7226064,-1,594.0,12576327,12576383,5365150,56,3,10,True,True,0.3979668,-0.130548
9295,7212319,6,8,0.453706,251,7226064,-1,160.0,12258347,12258353,5046028,6,18,12,True,True,0.028125333333333336,-0.453706
9296,7212722,1338,4,0.631502,251,7226064,-1,84.0,9092509,9093847,1879787,1338,169,7,True,True,5.1974587,-0.6201351046485947
9297,7212780,4929,4,0.358121,251,7226064,-1,196.0,8511465,8516394,1298685,4929,200,1,True,True,21.6917659,-0.35078836276193676
9298,7212857,57,8,0.239722,251,7226064,-1,96.0,9145727,9145784,1932870,57,161,7,True,True,0.2776128,-0.239722
9299,7212939,2,8,0.897909,251,7226064,-1,224.0,11672176,11672178,4459237,2,34,8,True,True,0.025092977777777775,-0.897909
9300,7213145,15255,32,0.296923,251,7226064,-1,1280.0,10848626,10863881,3635481,15255,63,10,True,True,797.0631182222222,-0.29634849315356104
9301,7213246,15842,225,0.535417,251,7226064,-1,6975.0,7970824,7986666,757578,15842,220,0,True,True,884.6148762499997,-0.5240574040783046
9302,7214147,27,1,0.245254,251,7226064,-1,20.0,9693668,9693695,2479521,27,138,8,True,True,0.018307499999999997,-0.245254
9303,7214162,3,4,0.780029,251,7226064,-1,100.0,11376476,11376479,4162314,3,43,8,True,True,0.0026941666666666668,-0.780029
9304,7214384,351,2,0.786048,251,7226064,-1,76.0,9531968,9532319,2317584,351,145,11,True,True,0.4384497,-0.7860480000000002
6365,4996152,288,8,0.943162,1,4996152,-1,88.0,5018252,5018540,22100,288,0,10,True,True,1.3627269333333332,-0.9430117891098484
6366,4996383,9,1,0.724234,28,5018252,-1,40.0,7388082,7388091,2391699,9,0,8,True,True,0.014197000000000001,-0.724234
6367,4996738,11299,256,0.14056,28,5018252,-1,8192.0,6806692,6817991,1809954,11299,1,8,True,True,3062.5577187555555,-0.13966702904868733
6368,4996862,19,8,0.111932,28,5018252,-1,240.0,8932637,8932656,3935775,19,0,1,True,True,0.3636853333333333,-0.111932
6369,4997024,11651,2,0.73448,28,5018252,-1,32.0,5417682,5429333,420658,11651,3,11,True,True,8.649596622222223,-0.6797958618355462
6370,4998240,68,32,0.932935,28,5018252,-1,1120.0,5084552,5084620,86312,68,4,10,True,True,2.7176426666666673,-0.932935
6371,4998380,9,2,0.521958,28,5018252,-1,18.0,5062452,5062461,64072,9,5,11,True,True,0.00802215,-0.521958
6372,5001282,11,1,0.828982,28,5018252,-1,19.0,7547082,7547093,2545800,11,1,10,True,True,0.010269447222222223,-0.828982
6373,5001393,8013,2,0.949675,28,5018252,-1,36.0,6234999,6243012,1233606,8013,4,9,True,True,8.430005999999999,-0.8715515903026456
6374,5003634,1429,2,0.931556,28,5018252,-1,36.0,6176252,6177681,1172618,1429,5,12,True,True,2.0231558,-0.8302167835721046
6375,5003672,396,11,0.251808,28,5018252,-1,550.0,7271292,7271688,2267620,396,3,11,True,True,7.00711,-0.251808
6376,5003800,518,4,0.884565,28,5018252,-1,40.0,6535603,6536121,1531803,518,5,7,True,True,0.8980393333333334,-0.884565
6377,5003985,4,16,0.238077,28,5018252,-1,576.0,8526497,8526501,3522512,4,1,10,True,True,0.10712319999999999,-0.238077
6378,5004083,382,8,0.122277,28,5018252,-1,120.0,7049592,7049974,2045509,382,5,12,True,True,1.6263013333333332,-0.12227699999999998
6379,5004332,179,1,0.806687,28,5018252,-1,48.0,5141352,5141531,137020,179,11,9,True,True,0.46599666666666667,-0.8066870000000003
6380,5004346,342,1,0.329286,28,5018252,-1,17.0,9055472,9055814,4051126,342,0,11,True,True,0.15563755,-0.329286
6381,5004375,7617,128,0.584326,28,5018252,-1,1408.0,9455860,9463477,4451485,7617,0,10,True,True,565.8130016,-0.5241210949153471
6382,5004770,7207,53,0.389951,28,5018252,-1,2385.0,5128752,5135959,123982,7207,14,11,True,True,650.0867904999999,-0.3771563029655357
6383,5008217,92,1,0.748374,28,5018252,-1,33.0,5799282,5799374,791065,92,12,10,True,True,0.05876346666666668,-0.748374
6384,5008449,72,16,0.235938,28,5018252,-1,400.0,8374997,8375069,3366548,72,4,11,True,True,1.63064,-0.23593800000000006
6385,5008526,6200,16,0.422869,28,5018252,-1,624.0,7575482,7581682,2566956,6200,5,8,True,True,154.3287893333333,-0.3966767735375304
6386,5008573,5,8,0.144278,28,5018252,-1,152.0,7831389,7831394,2822816,5,5,12,True,True,0.026082777777777778,-0.144278
6387,5009035,112,4,0.175154,28,5018252,-1,48.0,6279199,6279311,1270164,112,13,0,True,True,0.1935808,-0.175154
6388,5009187,92,16,0.969923,28,5018252,-1,336.0,6796400,6796492,1787213,92,12,7,True,True,0.9472810666666668,-0.969923
6389,5011695,36736,16,0.439475,28,5018252,-1,336.0,9011272,9048008,3999577,36736,2,9,True,True,774.0120789333336,-0.4342398673069745
6390,5012350,143,32,0.254306,28,5018252,-1,928.0,5850737,5850880,838387,143,18,1,True,True,3.442194311111111,-0.254306
6391,5012445,12,8,0.589481,28,5018252,-1,296.0,6918992,6919004,1906547,12,12,11,True,True,0.10400453333333333,-0.589481
6392,5013079,28,4,0.490359,28,5018252,-1,104.0,9055814,9055842,4042735,28,1,1,True,True,0.07795262222222223,-0.490359
6393,5013666,39,64,0.374705,28,5018252,-1,2688.0,9149429,9149468,4135763,39,1,8,True,True,4.112326400000001,-0.374705
6394,5035595,4,1,0.948711,141,5062452,-1,30.0,6347299,6347303,1311704,4,18,10,True,True,0.006023000000000001,-0.948711
6395,5035616,49,1,0.31649,141,5062452,-1,23.0,7096492,7096541,2060876,49,13,11,True,True,0.037341266666666664,-0.31649
6396,5035632,6541,32,0.423781,141,5062452,-1,1120.0,5642982,5649523,607350,6541,25,11,True,True,290.92016800000005,-0.4217600304775538
6397,5035672,13689,1,0.682738,141,5062452,-1,17.0,7973694,7987383,2938022,13689,8,11,True,True,10.122267075000002,-0.6716817642171609
6398,5035701,48,4,0.963315,141,5062452,-1,196.0,7925894,7925942,2890193,48,9,6,True,True,0.3992912,-0.963315
6399,5038555,27,25,0.879434,141,5062452,-1,900.0,9160229,9160256,4121674,27,1,9,True,True,2.2503824999999997,-0.879434
6400,5039384,9,8,0.936972,141,5062452,-1,128.0,5483982,5483991,444598,9,29,11,True,True,0.028563200000000004,-0.936972
6401,5039437,4609,128,0.362998,141,5062452,-1,640.0,6393299,6397908,1353862,4609,22,6,True,True,144.48544355555555,-0.344883025782117
6402,5039447,15719,8,0.715671,141,5062452,-1,312.0,6644103,6659822,1604656,15719,21,12,True,True,252.06193739999998,-0.7017989362973843
6403,5039464,2,1,0.821365,141,5062452,-1,11.0,8936237,8936239,3896773,2,6,8,True,True,0.001617122222222222,-0.821365
6404,5039486,489,1,0.021074,141,5062452,-1,39.0,9382360,9382849,4342874,489,1,10,True,True,1.3822237000000002,-0.021074
6405,5039769,60,1,0.966805,141,5062452,-1,16.0,6323399,6323459,1283630,60,27,11,True,True,0.043818666666666665,-0.966805
6406,5039891,10,4,0.605815,141,5062452,-1,144.0,6279199,6279209,1239308,10,29,11,True,True,0.051851999999999995,-0.605815
6407,5039964,11,2,0.841473,141,5062452,-1,68.0,5977752,5977763,937788,11,32,9,True,True,0.0441236888888889,-0.841473
6408,5040154,8196,8,0.662223,141,5062452,-1,168.0,6489603,6497799,1449449,8196,25,4,True,True,75.2339644,-0.6553318781284831
6409,5040184,9272,1,0.940848,141,5062452,-1,33.0,6872992,6882264,1832808,9272,21,10,True,True,11.192320333333335,-0.9342589583233979
6410,5040190,24297,78,0.690682,141,5062452,-1,3120.0,8531897,8556194,3491707,24297,9,7,True,True,3343.4473366666666,-0.6681578903953691
6411,5040213,572,8,0.788803,141,5062452,-1,328.0,9261029,9261601,4220816,572,2,9,True,True,14.07224231111111,-0.788803
6412,5040272,2900,64,0.239676,141,5062452,-1,2880.0,9004072,9006972,3963800,2900,8,11,True,True,765.2055999999999,-0.239676
6413,5040327,32,2,0.552728,141,5062452,-1,80.0,8797765,8797797,3757438,32,11,1,True,True,0.04993422222222223,-0.552728
6414,5040396,7193,1,0.309269,141,5062452,-1,14.0,5939452,5946645,899056,7193,39,12,True,True,4.368851744444445,-0.30253466912254406
6415,5040423,9,8,0.958484,141,5062452,-1,56.0,8308697,8308706,3268274,9,15,8,True,True,0.028562800000000003,-0.958484
6416,5040900,48,4,0.362855,141,5062452,-1,64.0,6666203,6666251,1625303,48,29,10,True,True,0.18429440000000002,-0.3628549999999999
6417,5040909,7,64,0.81225,141,5062452,-1,2496.0,7050492,7050499,2009583,7,24,6,True,True,0.6198677333333332,-0.81225
6418,5041154,752,8,0.122054,141,5062452,-1,376.0,8932637,8933389,3891483,752,10,0,True,True,22.551042844444446,-0.122054
6419,5041162,10,1,0.866953,141,5062452,-1,30.0,8958337,8958347,3917175,10,9,10,True,True,0.008179166666666666,-0.866953
6420,5041194,39,32,0.857647,141,5062452,-1,896.0,9248429,9248468,4207235,39,3,7,True,True,2.8671552,-0.857647
6421,5046220,1,16,0.388471,141,5062452,-1,752.0,7929494,7929495,2883274,1,20,8,True,True,0.0290084,-0.388471
6422,5046284,15625,4,0.909789,141,5062452,-1,192.0,9106335,9121960,4060051,15625,6,6,True,True,145.79496,-0.7950968739009391
6423,5046317,3,1,0.392976,141,5062452,-1,49.0,9145829,9145832,4099512,3,6,10,True,True,0.004378966666666667,-0.392976
6424,5046332,6729,4,0.977993,141,5062452,-1,44.0,5512382,5519111,466050,6729,52,8,True,True,6.12462571111111,-0.9230881748106455
6425,5046363,260,1,0.255534,141,5062452,-1,29.0,5317322,5317582,270959,260,55,7,True,True,0.2464323333333333,-0.255534
6426,5046749,11,9,0.09025,141,5062452,-1,99.0,5853052,5853063,806303,11,49,6,True,True,0.02824745,-0.09025
6427,5046809,257,1,0.822708,141,5062452,-1,32.0,5946652,5946909,899843,257,48,9,True,True,0.39717351111111115,-0.822708
6428,5046913,11,32,0.23546,141,5062452,-1,1248.0,5852152,5852163,805239,11,51,6,True,True,0.3560890666666667,-0.23546
6429,5047043,14,4,0.210386,141,5062452,-1,48.0,9456760,9456774,4409717,14,0,6,True,True,0.0424368,-0.210386
6430,5047140,22571,16,0.890247,141,5062452,-1,736.0,6279199,6301770,1232059,22571,45,0,True,True,383.06218479999995,-0.8484142264273107
6431,5047202,6,8,0.915891,141,5062452,-1,352.0,7744089,7744095,2696887,6,26,1,True,True,0.10445013333333332,-0.915891
6432,5047254,11,12,0.631353,141,5062452,-1,108.0,7710582,7710593,2663328,11,27,6,True,True,0.0412071,-0.631353
6433,5048161,10364,23,0.879467,141,5062452,-1,276.0,5999852,6010216,951691,10364,51,10,True,True,126.84387453333335,-0.7845828906117688
6434,5048205,473,2,0.766741,141,5062452,-1,72.0,8559180,8559653,3510975,473,18,7,True,True,1.1819324,-0.766741
6435,5048623,20,54,0.406289,141,5062452,-1,270.0,9482484,9482504,4433861,20,0,1,True,True,0.34450500000000006,-0.4062890000000001
6436,5048678,9806,32,0.033882,141,5062452,-1,1280.0,9927788,9937594,4879110,9806,0,8,True,True,928.3159253333333,-0.03344728510201991
6437,5049119,1583,2,0.866445,141,5062452,-1,74.0,8555797,8557380,3506678,1583,21,10,True,True,3.877733405555556,-0.8264323566558948
6438,5049130,11094,128,0.823198,141,5062452,-1,768.0,9105435,9116529,4056305,11094,11,11,True,True,498.8929088,-0.755713289153325
6439,5049135,11,80,0.940495,141,5062452,-1,2960.0,9613084,9613095,4563949,11,1,12,True,True,2.737029777777778,-0.940495
6440,5049317,7704,256,0.471091,141,5062452,-1,6144.0,9699484,9707188,4650167,7704,1,12,True,True,4609.4652074666665,-0.46557296972273937
6441,5049589,6,8,0.412961,141,5062452,-1,160.0,8443997,8444003,3394408,6,27,10,True,True,0.04320266666666667,-0.412961
6442,5049619,15133,8,0.841163,141,5062452,-1,384.0,7475382,7490515,2425763,15133,38,12,True,True,239.7788096,-0.8028491270918868
6443,5049809,7295,16,0.717386,141,5062452,-1,640.0,8607453,8614748,3557644,7295,23,8,True,True,170.23706311111113,-0.7142811655170871
6444,5050464,16097,1,0.876761,141,5062452,-1,45.0,6710403,6726500,1659939,16097,49,11,True,True,35.286945374999995,-0.8766671830256284
6445,5050620,3608,128,0.820241,141,5062452,-1,3712.0,8530097,8533705,3479477,3608,27,8,True,True,613.4495331555556,-0.7930606821353624
6446,5050703,99,4,0.824401,141,5062452,-1,20.0,6714903,6715002,1664200,99,50,6,True,True,0.09794400000000002,-0.824401
6447,5050777,49,2,0.698482,141,5062452,-1,84.0,6086252,6086301,1035475,49,64,12,True,True,0.1651773666666667,-0.698482
6448,5050915,24920,64,0.506335,141,5062452,-1,1344.0,9327329,9352249,4276414,24920,7,11,True,True,2642.2510352000004,-0.5054574542496348
6449,5051602,7919,2,0.351856,141,5062452,-1,54.0,9924188,9932107,4872586,7919,1,0,True,True,30.985802399999997,-0.3508438126557184
6450,5051620,4940,16,0.602116,141,5062452,-1,128.0,5486682,5491622,435062,4940,77,6,True,True,12.49459128888889,-0.6012427010966104
6451,5051644,11891,128,0.813428,141,5062452,-1,4992.0,6772500,6784391,1720856,11891,52,11,True,True,2138.410878933333,-0.8130768547901001
6452,5051662,10,32,0.737786,141,5062452,-1,512.0,6714003,6714013,1662341,10,54,1,True,True,0.25326933333333335,-0.737786
6453,5051696,12002,128,0.453262,141,5062452,-1,4608.0,5777182,5789184,725486,12002,77,11,True,True,1389.1842047999999,-0.4197699696387877
6454,5051826,9,28,0.027351,141,5062452,-1,728.0,5373482,5373491,321656,9,83,1,True,True,0.2964598,-0.027351
6455,5051887,12955,4,0.052099,141,5062452,-1,176.0,8751753,8764708,3699866,12955,25,11,True,True,67.724492,-0.05192037111768719
6456,5051994,549,1,0.641593,141,5062452,-1,48.0,8497197,8497746,3445203,549,32,9,True,True,1.9299912000000001,-0.641593
6457,5052030,7192,8,0.630156,141,5062452,-1,288.0,5417682,5424874,365652,7192,84,0,True,True,48.1651056,-0.5752267686297212
6458,5052093,9,1,0.791019,141,5062452,-1,34.0,8488197,8488206,3436104,9,33,11,True,True,0.01790695,-0.791019
6459,5053167,300,16,0.136092,141,5062452,-1,672.0,9385960,9386260,4332793,300,7,8,True,True,15.43248,-0.136092
6460,5053192,11523,32,0.400662,141,5062452,-1,320.0,9059414,9070937,4006222,11523,17,8,True,True,163.52028622222224,-0.36271154522625426
6461,5053311,60,4,0.628296,141,5062452,-1,136.0,9153029,9153089,4099718,60,13,8,True,True,0.547672,-0.628296
6462,5053321,42,1,0.313722,141,5062452,-1,22.0,7838594,7838636,2785273,42,43,1,True,True,0.039054399999999996,-0.313722
6463,5053390,9387,32,0.082232,141,5062452,-1,1600.0,8530097,8539484,3476707,9387,33,0,True,True,714.2735244444444,-0.0801878233930699
6464,5053409,409,1,0.157822,141,5062452,-1,32.0,5315522,5315931,262113,409,94,2,True,True,0.4512815111111111,-0.157822
6465,5053471,669,40,0.516366,141,5062452,-1,880.0,5314152,5314821,260681,669,95,0,True,True,20.299392666666666,-0.516366
6466,5053478,1370,4,0.969665,141,5062452,-1,68.0,5314152,5315522,260674,1370,96,12,True,True,3.2122085555555553,-0.9696650000000002
6467,5053524,4,1,0.830621,141,5062452,-1,28.0,6485099,6485103,1431575,4,68,0,True,True,0.0056068444444444445,-0.830621
6468,5053546,607,1,0.763163,141,5062452,-1,22.0,9879988,9880595,4826442,607,2,12,True,True,1.1445490833333332,-0.763163
6469,5053558,18448,160,0.84696,141,5062452,-1,4960.0,5369882,5388330,316324,18448,95,9,True,True,3775.8778444444442,-0.8386825074302516
6470,5053616,14,16,0.685753,141,5062452,-1,272.0,9351229,9351243,4297613,14,10,10,True,True,0.27856577777777786,-0.685753
6471,5053649,94,1,0.792642,141,5062452,-1,32.0,5851252,5851346,797603,94,86,2,True,True,0.07802417777777779,-0.792642
6472,5053681,194,8,0.319399,141,5062452,-1,192.0,6348199,6348393,1294518,194,72,6,True,True,1.8695392000000002,-0.31939900000000004
6473,5053696,1791,8,0.478365,141,5062452,-1,216.0,6483299,6485090,1429603,1791,71,1,True,True,19.6707522,-0.44433754504198403
6474,5054011,14447,128,0.735172,141,5062452,-1,4096.0,6479699,6494146,1425688,14447,72,12,True,True,3154.364609422222,-0.733830724278923
6475,5054052,7887,29,0.26068,141,5062452,-1,986.0,8797765,8805652,3743713,7887,29,0,True,True,180.04433949999998,-0.24540088954565392
6476,5054099,10840,32,0.687467,141,5062452,-1,1120.0,7737182,7748022,2683083,10840,50,6,True,True,581.3605404444445,-0.6870184924589551
6477,5054492,21,8,0.826769,141,5062452,-1,152.0,5948452,5948473,893960,21,87,7,True,True,0.17057693333333332,-0.826769
6478,5055358,13301,128,0.799529,141,5062452,-1,4224.0,8831565,8844866,3776207,13301,29,2,True,True,1677.2993600000002,-0.795486024422413
6479,5055377,15508,140,0.198664,141,5062452,-1,2800.0,8557380,8572888,3502003,15508,35,2,True,True,1431.8818577777774,-0.1973724381677224
6480,5055439,17,16,0.414496,141,5062452,-1,352.0,6227799,6227816,1172360,17,85,10,True,True,0.19497866666666663,-0.4144960000000001
6481,5055712,8,16,0.181889,141,5062452,-1,800.0,7714182,7714190,2658470,8,53,8,True,True,0.19324444444444447,-0.181889
6482,5055757,3,8,0.87639,141,5062452,-1,344.0,6198499,6198502,1142742,3,87,1,True,True,0.0323274,-0.87639
6483,5055783,1034,4,0.944757,141,5062452,-1,72.0,9793588,9794622,4737805,1034,3,12,True,True,3.5964587999999993,-0.944757
6484,5056411,109,2,0.884341,141,5062452,-1,12.0,9153029,9153138,4096618,109,16,0,True,True,0.08778860000000001,-0.884341
6485,5056458,266,9,0.224487,141,5062452,-1,225.0,9389560,9389826,4333102,266,9,8,True,True,4.4704625,-0.224487
6486,5056472,345,8,0.948109,141,5062452,-1,176.0,5132352,5132697,75880,345,117,1,True,True,2.167535333333333,-0.948109
6487,5056902,18,10,0.923112,141,5062452,-1,420.0,7744989,7745007,2688087,18,54,6,True,True,0.37388399999999994,-0.923112
6488,5057043,9038,32,0.647107,141,5062452,-1,960.0,6485103,6494141,1428060,9038,79,1,True,True,463.75693333333334,-0.6459007386894572
6489,5058075,16,1,0.626627,141,5062452,-1,39.0,8603853,8603869,3545778,16,37,11,True,True,0.019467066666666668,-0.626627
6490,5058146,12,7,0.906845,141,5062452,-1,161.0,8608353,8608365,3550207,12,36,6,True,True,0.06999206666666667,-0.906845
6491,5058434,553,4,0.974128,141,5062452,-1,32.0,8037694,8038247,2979260,553,51,9,True,True,1.0077872,-0.974128
6492,5058632,386,1,0.198266,141,5062452,-1,15.0,9160229,9160615,4101597,386,16,0,True,True,0.5362022499999999,-0.19826599999999994
6493,5058801,18,16,0.701261,141,5062452,-1,144.0,7924994,7925012,2866193,18,56,12,True,True,0.11000879999999999,-0.701261
6494,5058827,10593,1,0.168756,141,5062452,-1,7.0,8489997,8500590,3431170,10593,48,7,True,True,5.110555625,-0.162338997945485
6495,5058866,27,16,0.401035,141,5062452,-1,544.0,6533803,6533830,1474937,27,84,11,True,True,0.5381520000000001,-0.401035
6496,5058919,16733,1,0.428903,141,5062452,-1,7.0,8026894,8043627,2967975,16733,54,11,True,True,6.420084572222222,-0.3836768764965038
6497,5058961,39,1,0.260158,141,5062452,-1,36.0,9707188,9707227,4648227,39,4,9,True,True,0.1395303,-0.260158
6498,5059497,36,30,0.089061,141,5062452,-1,810.0,8237294,8237330,3177797,36,54,7,True,True,2.6687880000000006,-0.089061
6499,5059573,159,16,0.36792,141,5062452,-1,800.0,8038594,8038753,2979021,159,55,6,True,True,7.244040000000001,-0.3679200000000001
6500,5059943,270,8,0.947244,141,5062452,-1,56.0,8533697,8533967,3473754,270,44,7,True,True,0.716394,-0.947244
6501,5059974,12,1,0.117351,141,5062452,-1,36.0,5134152,5134164,74178,12,131,7,True,True,0.018062400000000003,-0.117351
6502,5060092,437,64,0.718583,141,5062452,-1,640.0,5970552,5970989,910460,437,109,10,True,True,22.996688,-0.718583
6503,5060119,11,3,0.435159,141,5062452,-1,126.0,9924188,9924199,4864069,11,2,11,True,True,0.09340870000000001,-0.43515899999999996
6504,5060145,147,4,0.919989,141,5062452,-1,132.0,6198352,6198499,1138207,147,106,10,True,True,0.6078302999999999,-0.9199889999999997
6505,5060291,12470,16,0.453708,141,5062452,-1,224.0,7182892,7195362,2122601,12470,76,12,True,True,104.70743982222223,-0.45283651210149817
6506,5060401,102,1,0.67361,141,5062452,-1,21.0,5598782,5598884,538381,102,123,0,True,True,0.03019625,-0.67361
6507,5060515,81,1,0.118512,141,5062452,-1,19.0,5802882,5802963,742367,81,120,8,True,True,0.033032925,-0.118512
6508,5064225,9,1,0.713564,198,5084552,-1,19.0,6722103,6722112,1657878,9,85,1,True,True,0.0069079250000000005,-0.713564
6509,5064232,10831,16,0.190544,198,5084552,-1,752.0,5317582,5328413,253350,10831,133,1,True,True,227.9044872888889,-0.18887880621444647
6510,5064330,156,2,0.861937,198,5084552,-1,88.0,6205699,6205855,1141369,156,107,9,True,True,0.42690266666666665,-0.861937
6511,5064361,26471,64,0.782122,198,5084552,-1,3008.0,7619682,7646153,2555321,26471,71,11,True,True,5285.258037333334,-0.7787732454642677
6512,5064423,8,16,0.287962,198,5084552,-1,608.0,7524982,7524990,2460559,8,74,11,True,True,0.2479694222222222,-0.287962
6513,5064462,9,1,0.494168,198,5084552,-1,30.0,8707553,8707562,3643091,9,39,9,True,True,0.0106395,-0.494168
6514,5064563,1019,21,0.130199,198,5084552,-1,336.0,8795953,8796972,3731390,1019,38,11,True,True,6.678390133333334,-0.130199
6515,5064589,14234,128,0.856338,198,5084552,-1,6400.0,7571882,7586116,2507293,14234,75,10,True,True,3707.117262222222,-0.8540944090159197
6516,5064614,13897,4,0.600083,198,5084552,-1,112.0,7227092,7240989,2162478,13897,81,11,True,True,56.25973266666667,-0.5936791263398078
6517,5064685,14,8,0.995207,198,5084552,-1,168.0,8037694,8037708,2973009,14,60,0,True,True,0.13394640000000002,-0.995207
6518,5064931,36,2,0.282967,198,5084552,-1,84.0,9329129,9329165,4264198,36,15,7,True,True,0.23294040000000002,-0.282967
6519,5064959,9070,16,0.677189,198,5084552,-1,336.0,7357692,7366762,2292733,9070,82,12,True,True,105.96128106666667,-0.6729084984885272
6520,5065030,92,1,0.418331,198,5084552,-1,32.0,9061235,9061327,3996205,92,27,1,True,True,0.08399395555555556,-0.418331
6521,5065053,8649,5,0.408524,198,5084552,-1,75.0,7549782,7558431,2484729,8649,79,7,True,True,31.151438125,-0.40393311978173013
6522,5065866,10726,1,0.145943,198,5084552,-1,35.0,5484882,5495608,419016,10726,140,6,True,True,7.531333833333335,-0.13685352643368748
6523,5066942,114,32,0.290193,198,5084552,-1,608.0,9253829,9253943,4186887,114,18,1,True,True,4.510285866666667,-0.290193
6524,5067190,7978,1,0.261799,198,5084552,-1,35.0,8421897,8429875,3354707,7978,59,11,True,True,16.701319930555556,-0.2559442120670032
6525,5067817,271,1,0.61768,198,5084552,-1,29.0,5362682,5362953,294865,271,148,6,True,True,0.25303796944444445,-0.61768
6526,5067939,8,2,0.907328,198,5084552,-1,12.0,7831389,7831397,2763450,8,72,0,True,True,0.0032946666666666667,-0.907328
6527,5068033,7742,128,0.369638,198,5084552,-1,1152.0,9116529,9124271,4048496,7742,26,2,True,True,306.1461408,-0.3661840553444409
6528,5068245,1090,16,0.684267,198,5084552,-1,400.0,7361292,7362382,2293047,1090,88,1,True,True,15.222931111111112,-0.6839618773484598
6529,5068303,4704,1,0.458164,198,5084552,-1,45.0,9971988,9976692,4903685,4704,0,11,True,True,13.563543,-0.4581592371992741
6530,5068311,8315,32,0.01032,198,5084552,-1,1536.0,9329129,9337444,4260818,8315,16,0,True,True,1042.190016,-0.010235672701157866
6531,5068393,5,1,0.133205,198,5084552,-1,26.0,9356629,9356634,4288236,5,15,8,True,True,0.009020194444444444,-0.133205
6532,5068451,6988,8,0.323246,198,5084552,-1,56.0,5132352,5139340,63901,6988,162,0,True,True,16.280775466666668,-0.31058871947386313
6533,5068510,404,1,0.693024,198,5084552,-1,49.0,7547982,7548386,2479472,404,87,6,True,True,0.9726984555555556,-0.693024
6534,5068560,16577,16,0.686852,198,5084552,-1,528.0,7362382,7378959,2293822,16577,92,1,True,True,328.6934713333333,-0.6760555903678305
6535,5070297,55,8,0.713336,198,5084552,-1,200.0,5850682,5850737,780385,55,143,11,True,True,0.2853277777777778,-0.713336
6536,5070488,21,16,0.708453,198,5084552,-1,464.0,6725703,6725724,1655215,21,106,3,True,True,0.38188360000000005,-0.708453
6537,5070530,24,64,0.736104,198,5084552,-1,384.0,9482460,9482484,4411930,24,10,10,True,True,0.5879552,-0.7361039999999999
6538,5070562,127,3,0.256226,198,5084552,-1,33.0,8801365,8801492,3730803,127,44,8,True,True,0.09095634166666666,-0.256226
6539,5070647,163,16,0.095279,198,5084552,-1,608.0,9283129,9283292,4212482,163,21,10,True,True,8.195350222222222,-0.095279
6540,5070842,18,2,0.058752,198,5084552,-1,32.0,9246629,9246647,4175787,18,25,12,True,True,0.0515808,-0.058752
6541,5071043,9435,128,0.332863,198,5084552,-1,3584.0,7706082,7715517,2635039,9435,87,0,True,True,1112.4335488,-0.31642940239896616
6542,5071157,12,2,0.234841,198,5084552,-1,70.0,8797753,8797765,3726596,12,49,7,True,True,0.01638466666666667,-0.234841
6543,5071348,14173,32,0.908227,198,5084552,-1,736.0,9526684,9540857,4455336,14173,9,11,True,True,777.9209694222221,-0.8869196489813255
6544,5075723,4,5,0.996739,198,5084552,-1,60.0,8559653,8559657,3483930,4,57,1,True,True,0.008329333333333334,-0.9967390000000003
6545,5075965,6144,4,0.939322,198,5084552,-1,100.0,7052292,7058436,1976327,6144,107,7,True,True,21.63520666666667,-0.9154432701574685
6546,5075987,14922,11,0.96721,198,5084552,-1,506.0,7480782,7495704,2404795,14922,98,8,True,True,292.82394569999997,-0.8956741960286655
6547,5076045,16635,1,0.598232,198,5084552,-1,39.0,8696753,8713388,3620708,16635,54,10,True,True,23.513804925,-0.5888204894446606
6548,5076650,191,16,0.748242,198,5084552,-1,720.0,6728300,6728491,1651650,191,117,7,True,True,5.244765999999999,-0.7281294590419616
6549,5077402,8956,1,0.045512,198,5084552,-1,36.0,8652553,8661509,3575151,8956,55,11,True,True,8.9912811,-0.04268808955816532
6550,5077548,1352,24,0.253657,198,5084552,-1,600.0,8126994,8128346,3049446,1352,76,11,True,True,74.13015999999999,-0.253657
6551,5077564,570,1,0.619658,198,5084552,-1,23.0,5850682,5851252,773118,570,158,0,True,True,0.3400588333333333,-0.619658
6552,5077611,21,1,0.302507,198,5084552,-1,15.0,7709682,7709703,2632071,21,93,0,True,True,0.010926125,-0.30250699999999997
6553,5078099,8601,32,0.394697,198,5084552,-1,1440.0,5598782,5607383,520683,8601,166,12,True,True,178.00210800000002,-0.38856976398026905
6554,5080001,6699,16,0.370901,198,5084552,-1,320.0,8959872,8966571,3879871,6699,42,1,True,True,57.855320000000006,-0.36615607055705546
6555,5080498,12679,4,0.968058,198,5084552,-1,168.0,8330797,8343476,3250299,12679,75,10,True,True,141.50770293333335,-0.9481796407043526
6556,5080698,22,8,0.55956,198,5084552,-1,40.0,7384482,7384504,2303784,22,107,10,True,True,0.03907200000000001,-0.55956
6557,5080742,9657,4,0.580487,198,5084552,-1,24.0,9120129,9129786,4039387,9657,33,2,True,True,7.6631732,-0.5699889088712217
6558,5080766,5194,9,0.260292,198,5084552,-1,396.0,8030494,8035688,2949728,5194,83,8,True,True,87.6816996,-0.21263959817172126
6559,5080810,21,1,0.503747,198,5084552,-1,49.0,9061214,9061235,3980404,21,38,7,True,True,0.02935794166666667,-0.503747
6560,5080885,14224,7,0.930327,198,5084552,-1,189.0,8060694,8074918,2979809,14224,81,10,True,True,249.18473579999997,-0.9154053845169345
6561,5080936,29582,64,0.877897,198,5084552,-1,1536.0,6485099,6514681,1404163,29582,140,7,True,True,2200.516586666667,-0.8692840011502813
6562,5081138,12826,2,0.13192,198,5084552,-1,52.0,8213394,8226220,3132256,12826,80,12,True,True,48.05634224444444,-0.12822971955292492
6563,5081581,2,1,0.317317,198,5084552,-1,18.0,5729382,5729384,647801,2,173,12,True,True,0.0010182,-0.317317
6564,5082006,14,128,0.530424,198,5084552,-1,4736.0,9360260,9360274,4278254,14,17,1,True,True,4.900418133333333,-0.530424
6565,5083355,53,1,0.141796,198,5084552,-1,20.0,6325199,6325252,1241844,53,148,7,True,True,0.05279444444444444,-0.14156851906911652
6566,5085337,14785,1,0.116842,220,5128752,-1,16.0,5227752,5242537,142415,14785,193,12,True,True,9.51610288888889,-0.11540265698768538
6567,5086109,6977,1,0.044162,220,5128752,-1,39.0,6718503,6725480,1632394,6977,132,2,True,True,11.164756525,-0.043768219217798346
6568,5089938,60780,1,0.127871,220,5128752,-1,6.0,7740782,7801562,2650844,60780,98,8,True,True,15.7571302,-0.1267329081565818
6569,5090018,12981,16,0.87168,220,5128752,-1,240.0,6392399,6405380,1302381,12981,148,11,True,True,165.537636,-0.8158522572883316
6570,5091684,9524,128,0.834804,220,5128752,-1,6272.0,7388982,7398506,2297298,9524,113,6,True,True,2218.231864177778,-0.818736299459171
6571,5094406,6929,64,0.747823,220,5128752,-1,832.0,8827965,8834894,3733559,6929,51,0,True,True,172.42588017777777,-0.7445061627079701
6572,5095444,3,1,0.926237,220,5128752,-1,8.0,7477182,7477185,2381738,3,113,7,True,True,0.0012265333333333335,-0.926237
6573,5095553,8195,223,0.282926,220,5128752,-1,6690.0,8929037,8937232,3833484,8195,50,8,True,True,3668.468989083334,-0.2606701498908002
6574,5096599,12262,1,0.876936,220,5128752,-1,36.0,5485782,5498044,389183,12262,188,6,True,True,8.5217128,-0.8059256902305004
6575,5096743,32,8,0.612932,220,5128752,-1,240.0,8827965,8827997,3731222,32,53,6,True,True,0.23406933333333335,-0.612932
6576,5097070,5,32,0.761564,220,5128752,-1,320.0,8305097,8305102,3208027,5,83,9,True,True,0.08229777777777778,-0.7615640000000002
6577,5100341,7807,1,0.263758,220,5128752,-1,21.0,7736282,7744089,2635941,7807,104,10,True,True,7.761248950000001,-0.25243453467251514
6578,5100628,80,2,0.31301,220,5128752,-1,60.0,5361782,5361862,261154,80,199,10,True,True,0.15454666666666667,-0.31301
6579,5100698,194,1,0.892672,220,5128752,-1,21.0,7979094,7979288,2878396,194,93,2,True,True,0.18021791666666667,-0.8926719999999999
6580,5100889,10353,16,0.315543,220,5128752,-1,224.0,9250229,9260582,4149340,10353,26,7,True,True,164.94200302222222,-0.295200362496468
6581,5100985,72,32,0.994565,220,5128752,-1,704.0,8674653,8674725,3573668,72,63,10,True,True,1.5435903999999998,-0.9945649999999999
6582,5101113,67,1,0.763675,220,5128752,-1,34.0,6874792,6874859,1773679,67,136,7,True,True,0.07912886111111112,-0.7636750000000002
6583,5101574,67,1,0.151265,220,5128752,-1,45.0,8827065,8827132,3725491,67,55,8,True,True,0.09538287499999999,-0.15126500000000004
6584,5101901,4297,16,0.853034,220,5128752,-1,112.0,6850892,6855189,1748991,4297,139,11,True,True,13.814720577777779,-0.8263042349668243
6585,5102944,20125,156,0.657419,220,5128752,-1,4992.0,6726500,6746625,1623556,20125,144,2,True,True,3331.56616,-0.6262602569688218
6586,5128242,32,1,0.79822,220,5128752,-1,31.0,5339682,5339714,211440,32,207,10,True,True,0.02245777777777778,-0.79822
6587,5128271,14108,1,0.053222,220,5128752,-1,30.0,9460360,9474468,4332089,14108,12,2,True,True,15.381305000000001,-0.045772389948729265
6588,5128407,7,4,0.148621,220,5128752,-1,116.0,5508782,5508789,380375,7,198,10,True,True,0.014694944444444446,-0.148621
6589,5130887,635,3,0.229861,227,5132352,-1,105.0,8959237,8959872,3828350,635,48,6,True,True,1.8178197916666667,-0.229861
6590,5130920,8067,4,0.035862,227,5132352,-1,112.0,7706082,7714149,2575162,8067,115,12,True,True,29.767654933333336,-0.0347790486277417
6591,5131077,16965,3,0.260224,227,5132352,-1,15.0,8700353,8717318,3569276,16965,65,8,True,True,9.444657583333333,-0.25815013354653926
6592,5131166,38503,256,0.705963,227,5132352,-1,1280.0,8266594,8305097,3135428,38503,90,9,True,True,1999.7738773333335,-0.7049549896390712
6593,5131444,11072,64,0.43643,227,5132352,-1,2816.0,8917965,8929037,3786521,11072,54,12,True,True,1190.6841251555556,-0.40788876959601816
6594,5131824,305,8,0.995202,227,5132352,-1,280.0,8823465,8823770,3691641,305,59,10,True,True,2.8833738888888893,-0.9220534547915115
6595,5131858,6,2,0.927206,227,5132352,-1,46.0,8259394,8259400,3127536,6,93,10,True,True,0.0114356,-0.927206
6596,5132001,31,1,0.040792,227,5132352,-1,12.0,9360229,9360260,4228228,31,19,2,True,True,0.027493899999999998,-0.040792
6597,5132627,12,2,0.35652,228,5134152,-1,70.0,8082794,8082806,2950167,12,98,10,True,True,0.06790233333333334,-0.35652
6598,5132646,11,32,0.709029,228,5134152,-1,672.0,5732982,5732993,600336,11,202,8,True,True,0.2610402666666667,-0.709029
6599,5132768,63,4,0.4852,228,5134152,-1,64.0,7709682,7709745,2576914,63,121,8,True,True,0.13985440000000002,-0.4851999999999999
6600,5137437,8,32,0.492989,248,5141352,-1,1312.0,8213394,8213402,3075957,8,96,0,True,True,0.5929948444444445,-0.492989
6601,5137751,372,4,0.845838,248,5141352,-1,60.0,6486003,6486375,1348252,372,168,6,True,True,1.117364,-0.845838
6602,5137821,23,16,0.866879,248,5141352,-1,384.0,8504397,8504420,3366576,23,84,9,True,True,0.6598730666666668,-0.866879
6603,5138159,13620,64,0.123654,248,5141352,-1,1280.0,7831394,7845014,2693235,13620,113,1,True,True,727.501376,-0.11766840415137493
6604,5138310,12092,4,0.093578,248,5141352,-1,136.0,6794600,6806692,1656290,12092,156,10,True,True,53.524876266666666,-0.09297855772202242
6605,5138315,44,8,0.868173,248,5141352,-1,168.0,8377697,8377741,3239382,44,90,6,True,True,0.5143394666666667,-0.868173
6606,5138352,14077,1,0.180655,248,5141352,-1,8.0,9353029,9367106,4214677,14077,21,7,True,True,8.244686711111111,-0.18040424983751432
6607,5138365,14606,4,0.168295,248,5141352,-1,92.0,6714903,6729509,1576538,14606,165,0,True,True,56.430319322222225,-0.1652572585366724
6608,5138746,14222,1,0.508738,248,5141352,-1,42.0,9433760,9447982,4295014,14222,15,11,True,True,39.739365166666666,-0.4763721011204272
6609,5138845,10425,128,0.272792,248,5141352,-1,4480.0,8235494,8245919,3096649,10425,100,10,True,True,4331.461306666667,-0.269843304942403
6610,5138867,11468,128,0.890895,248,5141352,-1,5120.0,7834994,7846462,2696127,11468,117,2,True,True,2552.563256888889,-0.8772290869844701
6611,5138915,3,51,0.585677,248,5141352,-1,561.0,7982694,7982697,2843779,3,111,3,True,True,0.07324790000000002,-0.585677
6612,5138991,9793,86,0.583547,248,5141352,-1,1978.0,5806482,5816275,667491,9793,212,8,True,True,533.6363838277778,-0.5639819910939833
6613,5139051,14,8,0.971627,248,5141352,-1,152.0,5439782,5439796,300731,14,227,10,True,True,0.055398933333333324,-0.971627
6614,5139119,21313,8,0.526015,248,5141352,-1,88.0,7975494,7996807,2836375,21313,113,7,True,True,78.21483706666668,-0.5166928024834104
6615,5139199,13858,1,0.570788,248,5141352,-1,48.0,6089852,6103710,950653,13858,200,8,True,True,23.51242453333333,-0.568061297022556
6616,5139261,25,2,0.416419,248,5141352,-1,30.0,8919765,8919790,3780504,25,57,7,True,True,0.029866666666666666,-0.416419
6617,5139386,84,16,0.076835,248,5141352,-1,144.0,9123729,9123813,3984343,84,39,2,True,True,0.38404799999999994,-0.07683499999999999
6618,5139411,23,2,0.768253,248,5141352,-1,72.0,8376797,8376820,3237386,23,95,7,True,True,0.0937618,-0.768253
6619,5139460,37,1,0.676909,248,5141352,-1,20.0,6963192,6963229,1823732,37,160,11,True,True,0.02511888888888889,-0.676909
6620,5140670,18710,8,0.887368,248,5141352,-1,328.0,6557703,6576413,1417033,18710,180,10,True,True,244.16022613333337,-0.8329548442811804
8062,6358221,342,32,0.360206,1,6358221,-1,1216.0,6361821,6362163,3600,342,0,8,True,True,10.9928832,-0.36020599999999997
8063,6358266,92,20,0.045754,18,6361821,-1,980.0,6364521,6364613,6255,92,0,6,True,True,2.3832293333333334,-0.045754
8064,6358282,6,2,0.807558,18,6361821,-1,42.0,9226786,9226792,2868504,6,0,9,True,True,0.0026341000000000003,-0.807558
8065,6358418,23,9,0.325525,18,6361821,-1,333.0,10448447,10448470,4090029,23,0,8,True,True,0.1933472,-0.325525
8066,6358437,80,1,0.444306,18,6361821,-1,27.0,7921282,7921362,1562845,80,2,11,True,True,0.09189000000000001,-0.444306
8067,6358476,4851,256,0.606763,18,6361821,-1,11008.0,6608221,6613072,249745,4851,3,12,True,True,2557.8732778666663,-0.5570669233845438
8068,6360282,60,1,0.400165,18,6361821,-1,17.0,9529317,9529377,3169035,60,1,10,True,True,0.014690833333333335,-0.400165
8069,6360357,119,32,0.612592,18,6361821,-1,384.0,6363621,6363740,3264,119,6,7,True,True,1.2078976,-0.612592
8070,6360389,6848,16,0.081369,18,6361821,-1,480.0,9854066,9860914,3493677,6848,1,2,True,True,32.333466666666666,-0.08114954576224066
8071,6360402,49,8,0.427916,18,6361821,-1,384.0,10860456,10860505,4500054,49,0,2,True,True,0.4544064,-0.427916
8072,6360462,15084,128,0.931483,18,6361821,-1,1280.0,6514621,6529705,154159,15084,7,9,True,True,646.5923484444445,-0.9009420739645283
8073,6360498,7,1,0.930845,18,6361821,-1,36.0,10536210,10536217,4175712,7,1,1,True,True,0.005373899999999999,-0.930845
8074,6360556,11,8,0.986871,18,6361821,-1,176.0,8846337,8846348,2485781,11,6,12,True,True,0.026603866666666667,-0.986871
8075,6360573,29,16,0.8571,18,6361821,-1,336.0,6428521,6428550,67948,29,10,10,True,True,0.2466856,-0.8571
8076,6360604,29,1,0.905203,18,6361821,-1,27.0,9671129,9671158,3310525,29,4,7,True,True,0.016656149999999998,-0.905203
8077,6361175,6398,8,0.734278,18,6361821,-1,80.0,6386621,6393019,25446,6398,12,10,True,True,8.107634222222224,-0.7258401208354156
8078,6361220,21,4,0.293863,18,6361821,-1,176.0,6397421,6397442,36201,21,12,8,True,True,0.037966133333333325,-0.293863
8079,6361398,70,10,0.195077,18,6361821,-1,170.0,6364521,6364591,3123,70,14,0,True,True,0.3145566666666667,-0.195077
8080,6361540,15,1,0.143161,18,6361821,-1,27.0,9760466,9760481,3398926,15,4,1,True,True,0.0034785000000000003,-0.14316100000000004
8081,6366417,26,8,0.520054,49,6386621,-1,224.0,7810782,7810808,1444365,26,10,0,True,True,0.1436424888888889,-0.520054
8082,6366489,53,2,0.571893,49,6386621,-1,14.0,10539810,10539863,4173321,53,1,0,True,True,0.009600655555555554,-0.571893
8083,6366594,21937,8,0.856803,49,6386621,-1,280.0,10032475,10054412,3665881,21937,4,0,True,True,107.81939155555557,-0.8252446412290227
8084,6368106,42,1,0.504637,49,6386621,-1,16.0,8980737,8980779,2612631,42,10,7,True,True,0.02203786666666667,-0.5046369999999999
8085,6368627,17831,40,0.127861,49,6386621,-1,800.0,10460147,10477978,4091520,17831,3,3,True,True,476.72208222222224,-0.1230045319517966
8086,6368649,17,16,0.796821,49,6386621,-1,560.0,6439321,6439338,70672,17,17,9,True,True,0.3799273333333334,-0.796821
8087,6368969,47,8,0.301348,49,6386621,-1,184.0,10019748,10019795,3650779,47,6,0,True,True,0.1295038,-0.301348
8088,6369032,435,8,0.673062,49,6386621,-1,216.0,6505621,6506056,136589,435,18,10,True,True,1.627074,-0.673062
8089,6369063,6,16,0.548747,49,6386621,-1,544.0,7674782,7674788,1305719,6,16,11,True,True,0.24654080000000006,-0.548747
8090,6369358,62,16,0.874786,49,6386621,-1,176.0,6393821,6393883,24463,62,23,9,True,True,0.13658186666666666,-0.874786
8091,6369380,5642,2,0.168053,49,6386621,-1,36.0,10811756,10817398,4442376,5642,1,12,True,True,2.7264817999999997,-0.1650930879397378
8092,6369945,13,1,0.446287,49,6386621,-1,31.0,10531347,10531360,4161402,13,4,7,True,True,0.008639872222222221,-0.446287
8093,6370044,10,4,0.115679,49,6386621,-1,196.0,10178222,10178232,3808178,10,7,8,True,True,0.03694600000000001,-0.115679
8094,6370359,41,4,0.662642,49,6386621,-1,144.0,9625129,9625170,3254770,41,13,6,True,True,0.0889208,-0.662642
8095,6370436,80,1,0.240902,49,6386621,-1,12.0,6937517,6937597,567081,80,21,0,True,True,0.03562666666666667,-0.240902
8096,6370648,4,64,0.211641,49,6386621,-1,2304.0,6948547,6948551,577899,4,21,2,True,True,0.4168448,-0.211641
8097,6370678,7258,32,0.753253,49,6386621,-1,896.0,7854982,7862240,1484304,7258,19,11,True,True,91.05440711111112,-0.6257503654184379
8098,6370994,8385,8,0.659745,49,6386621,-1,104.0,9413617,9422002,3042623,8385,15,12,True,True,16.8270102,-0.6053203044233942
8099,6371303,23,8,0.089432,49,6386621,-1,384.0,10463747,10463770,4092444,23,5,8,True,True,0.24759040000000002,-0.089432
8100,6371759,2185,2,0.434893,49,6386621,-1,32.0,9313192,9315377,2941433,2185,17,12,True,True,0.6333024,-0.41055590139062065
8101,6376479,24,8,0.715765,49,6386621,-1,400.0,9997648,9997672,3621169,24,11,2,True,True,0.14554666666666669,-0.715765
8102,6376561,701,25,0.160235,49,6386621,-1,825.0,9002879,9003580,2626318,701,20,0,True,True,4.613748333333333,-0.160235
8103,6376661,203,32,0.928967,49,6386621,-1,800.0,9647229,9647432,3270568,203,15,10,True,True,2.402617777777778,-0.928967
8104,6376712,103,5,0.902649,49,6386621,-1,70.0,9314992,9315095,2938280,103,19,7,True,True,0.06529055555555556,-0.902649
8105,6376806,18812,256,0.766309,49,6386621,-1,12032.0,10159410,10178222,3782604,18812,9,10,True,True,3331.6802517333335,-0.7193114999175123
8106,6377084,7,2,0.220376,49,6386621,-1,32.0,10130110,10130117,3753026,7,10,7,True,True,0.0018056888888888889,-0.220376
8107,6377095,11908,32,0.257629,49,6386621,-1,384.0,10539810,10551718,4162715,11908,3,2,True,True,60.2977152,-0.2521516253826891
8108,6377131,47,4,0.476302,49,6386621,-1,120.0,10030548,10030595,3653417,47,13,8,True,True,0.08497600000000001,-0.476302
8109,6378238,10,1,0.897511,49,6386621,-1,32.0,7630582,7630592,1252344,10,33,12,True,True,0.024585777777777776,-0.897511
8110,6378720,26,11,0.123098,49,6386621,-1,462.0,6662672,6662698,283952,26,36,7,True,True,0.11461450000000001,-0.123098
8111,6378935,136,8,0.135756,49,6386621,-1,352.0,6399221,6399357,20286,136,42,7,True,True,0.49175182222222213,-0.135756
8112,6378951,139,64,0.534543,49,6386621,-1,1152.0,9190279,9190418,2811328,139,26,8,True,True,1.4180224,-0.5345429999999999
8113,6379393,5,2,0.725414,49,6386621,-1,68.0,9925948,9925953,3546555,5,16,10,True,True,0.005032944444444445,-0.725414
8114,6379472,188,16,0.090442,49,6386621,-1,656.0,9093079,9093267,2713607,188,28,11,True,True,1.873215288888889,-0.090442
8115,6380095,12873,4,0.691785,49,6386621,-1,20.0,8398944,8411817,2018849,12873,32,6,True,True,7.6026105,-0.6737300215716499
8116,6391925,24763,3,0.871941,50,6393821,-1,36.0,10470947,10495710,4079022,24763,6,8,True,True,30.831576,-0.8545063203329556
8117,6393083,6,2,0.93178,50,6393821,-1,62.0,6406421,6406427,13338,6,47,9,True,True,0.005039566666666668,-0.93178
8118,6402404,10865,16,0.766337,54,6406421,-1,496.0,8956837,8967702,2554433,10865,32,0,True,True,130.30013,-0.6657468787339991
8119,6402494,34078,256,0.600679,54,6406421,-1,7680.0,9868286,9902364,3465792,34078,18,6,True,True,2276.5461333333333,-0.5962830503347095
8120,6402669,20,1,0.643987,54,6406421,-1,39.0,7207662,7207682,804993,20,41,7,True,True,0.010389166666666668,-0.643987
8121,6404470,327,1,0.37701,54,6406421,-1,18.0,6483521,6483848,79051,327,48,11,True,True,0.08982604999999999,-0.20932524912498668
8122,6405043,16695,8,0.717443,54,6406421,-1,144.0,10669910,10686605,4264867,16695,2,7,True,True,43.56707,-0.699861903505054
8123,6405474,12420,141,0.736002,54,6406421,-1,3666.0,9855866,9868286,3450392,12420,20,7,True,True,446.2239925,-0.7337479617874826
8124,6405788,47,4,0.381651,54,6406421,-1,152.0,8402544,8402591,1996756,47,37,4,True,True,0.2305726,-0.381651
8125,6406712,10245,128,0.642102,94,6428521,-1,3968.0,6835472,6845717,428760,10245,47,12,True,True,248.42276835555558,-0.6332748699349722
8126,6406866,2,4,0.5619,94,6428521,-1,172.0,9619317,9619319,3212451,2,26,12,True,True,0.00530811111111111,-0.5619
8127,6409679,62,16,0.856141,94,6428521,-1,752.0,8053382,8053444,1643703,62,40,10,True,True,0.5381186666666666,-0.856141
8128,6411880,3461,4,0.808447,94,6428521,-1,100.0,9619319,9622780,3207439,3461,26,1,True,True,5.340515277777778,-0.808447
8129,6412361,433,2,0.223551,94,6428521,-1,52.0,7810782,7811215,1398421,433,45,8,True,True,0.5553321222222223,-0.223551
8130,6412410,16,2,0.11569,94,6428521,-1,88.0,8392644,8392660,1980234,16,41,8,True,True,0.016500977777777776,-0.11569
8131,6412419,8503,32,0.08768,94,6428521,-1,672.0,10855956,10864459,4443537,8503,1,11,True,True,139.82434293333336,-0.08735272362961877
8132,6412478,35,4,0.089139,94,6428521,-1,168.0,10456547,10456582,4044069,35,11,2,True,True,0.1700626666666667,-0.089139
8133,6413657,15493,8,0.740581,94,6428521,-1,240.0,8389044,8404537,1975387,15493,44,12,True,True,81.43626599999999,-0.6785867677526429
8134,6413715,7,1,0.937211,94,6428521,-1,45.0,6521821,6521828,108106,7,58,9,True,True,0.011038125000000001,-0.937211
8135,6413904,35,5,0.744618,94,6428521,-1,155.0,9503617,9503652,3089713,35,31,8,True,True,0.105380625,-0.744618
8136,6414290,126,1,0.116106,94,6428521,-1,24.0,8544137,8544263,2129847,126,42,11,True,True,0.08526840000000002,-0.116106
8137,6414603,58,4,0.367737,94,6428521,-1,124.0,9715358,9715416,3300755,58,25,10,True,True,0.1303350222222222,-0.367737
8138,6421226,22,8,0.85333,94,6428521,-1,208.0,10725356,10725378,4304130,22,3,0,True,True,0.12145466666666666,-0.85333
8139,6421316,4,8,0.954069,94,6428521,-1,376.0,7360382,7360386,939066,4,56,10,True,True,0.015478666666666665,-0.954069
8140,6421412,60,4,0.576917,94,6428521,-1,68.0,10721756,10721816,4300344,60,4,8,True,True,0.10674866666666667,-0.576917
8141,6421880,8849,32,0.001678,94,6428521,-1,1216.0,10578110,10586959,4156230,8849,6,7,True,True,300.99440942222225,-0.001570697656101289
8142,6421934,8333,15,0.061885,94,6428521,-1,315.0,10946856,10955189,4524922,8333,0,0,True,True,41.087592875000006,-0.06045515692547425
8143,6422009,22,1,0.535603,94,6428521,-1,49.0,7404582,7404604,982573,22,59,11,True,True,0.04483282222222223,-0.535603
8144,6422033,20390,32,0.847119,94,6428521,-1,384.0,8053444,8073834,1631411,20390,52,1,True,True,86.5747968,-0.8415620315979683
8145,6422764,6751,32,0.979849,94,6428521,-1,1216.0,9212379,9219130,2789615,6751,41,10,True,True,161.59662808888888,-0.9757570137108078
8146,6423734,14,1,0.319643,94,6428521,-1,19.0,10032475,10032489,3608741,14,20,0,True,True,0.0040077333333333335,-0.319643
8147,6423866,23216,101,0.365024,94,6428521,-1,1616.0,8031282,8054498,1607416,23216,56,0,True,True,642.6812338666667,-0.3372281183735821
8148,6423995,349,4,0.679302,94,6428521,-1,156.0,8184044,8184393,1760049,349,54,12,True,True,1.6429989333333335,-0.679302
8149,6424009,34,8,0.796565,94,6428521,-1,312.0,7924882,7924916,1500873,34,58,8,True,True,0.4244673333333334,-0.796565
8150,6424161,8,1,0.519751,94,6428521,-1,44.0,9671158,9671166,3246997,8,31,1,True,True,0.007487822222222221,-0.519751
8151,6424189,31,2,0.601618,94,6428521,-1,60.0,7535182,7535213,1110993,31,66,11,True,True,0.024986,-0.601618
8152,6424395,7,1,0.222142,94,6428521,-1,21.0,10570910,10570917,4146515,7,8,3,True,True,0.004155608333333333,-0.222142
8153,6424449,25172,64,0.395312,94,6428521,-1,1152.0,6432121,6457293,7672,25172,81,8,True,True,1150.8215392,-0.3857213622276093
8154,6424472,20451,2,0.538293,94,6428521,-1,84.0,10856856,10877307,4432384,20451,2,6,True,True,41.3817551,-0.530762922252536
8155,6424527,15,4,0.460603,94,6428521,-1,196.0,7175647,7175662,751120,15,72,10,True,True,0.0202615,-0.460603
8156,6425008,71,1,0.144701,94,6428521,-1,16.0,9226792,9226863,2801784,71,44,1,True,True,0.008239955555555557,-0.10041217001343701
8157,6425300,7485,4,0.94289,94,6428521,-1,192.0,8581537,8589022,2156237,7485,53,6,True,True,40.90039253333333,-0.9078035846589084
8158,6425396,13324,16,0.837217,94,6428521,-1,192.0,8715737,8729061,2290341,13324,53,8,True,True,37.652896,-0.7966736920677617
8159,6425461,47,1,0.499833,94,6428521,-1,36.0,8097644,8097691,1672183,47,61,11,True,True,0.0328107,-0.499833
8160,6425543,224,1,0.455785,94,6428521,-1,7.0,6937517,6937741,511974,224,79,12,True,True,0.05819022222222222,-0.455785
8161,6425595,2,19,0.601465,94,6428521,-1,532.0,8184944,8184946,1759349,2,60,0,True,True,0.03210915555555556,-0.601465
8162,6425609,443,1,0.145871,94,6428521,-1,28.0,6943147,6943590,517538,443,79,7,True,True,0.5695503333333334,-0.145871
8163,6426025,8,1,0.665351,94,6428521,-1,40.0,9902364,9902372,3476339,8,28,9,True,True,0.002675555555555556,-0.6653510000000001
8164,6426378,7081,128,0.801292,94,6428521,-1,6144.0,8398044,8405125,1971666,7081,59,7,True,True,1315.44192,-0.7825226069328212
8165,6426457,11,1,0.702967,94,6428521,-1,46.0,7105747,7105758,679290,11,80,11,True,True,0.002551083333333333,-0.702967
8166,6455460,21180,4,0.59888,109,6483521,-1,196.0,6944947,6966127,489487,21180,82,7,True,True,166.12970888888887,-0.5913372840909854
8167,6455719,12,32,0.308891,109,6483521,-1,1056.0,8759937,8759949,2304218,12,54,11,True,True,0.8481792000000001,-0.3088910000000001
8168,6455822,29177,128,0.990335,109,6483521,-1,3712.0,9219586,9248763,2763764,29177,47,1,True,True,1043.8397756444444,-0.8231734719950443
8169,6455887,16,2,0.123464,109,6483521,-1,20.0,7057947,7057963,602060,16,83,10,True,True,0.005182222222222223,-0.123464
8170,6456027,100,1,0.996849,109,6483521,-1,47.0,8184944,8185044,1728917,100,65,6,True,True,0.14183555555555555,-0.996849
8171,6456047,127,2,0.706522,109,6483521,-1,84.0,9669329,9669456,3213282,127,36,10,True,True,0.23226606666666666,-0.706522
8172,6462804,16,1,0.478283,109,6483521,-1,44.0,9500017,9500033,3037213,16,43,0,True,True,0.016479466666666664,-0.478283
8173,6468167,12202,32,0.828687,109,6483521,-1,896.0,10039675,10051877,3571508,12202,22,2,True,True,202.97460586666668,-0.7150031645942704
8174,6468858,69,16,0.495026,109,6483521,-1,480.0,7972682,7972751,1503824,69,74,11,True,True,0.6138239999999998,-0.495026
8175,6468963,23944,16,0.70414,109,6483521,-1,256.0,7536982,7560926,1068019,23944,82,7,True,True,283.26191502222224,-0.6237320399225776
8176,6470414,2,40,0.376709,109,6483521,-1,600.0,9948048,9948050,3477634,2,28,10,True,True,0.010636666666666666,-0.376709
8177,6471051,30,4,0.981143,109,6483521,-1,88.0,6507421,6507451,36370,30,101,7,True,True,0.045716,-0.981143
8178,6472282,19,8,0.333145,109,6483521,-1,232.0,7061547,7061566,589265,19,90,8,True,True,0.08004193333333334,-0.333145
8179,6472694,35,2,0.827885,109,6483521,-1,72.0,9622780,9622815,3150086,35,41,1,True,True,0.03848599999999999,-0.8193900504050404
8180,6481475,21285,8,0.210613,109,6483521,-1,80.0,7207682,7228967,726207,21285,88,1,True,True,18.703993333333333,-0.20551129170559815
8181,6482751,3,1,0.732658,109,6483521,-1,40.0,10034275,10034278,3551524,3,23,7,True,True,0.0017070000000000002,-0.732658
8182,6482913,22,4,0.810419,109,6483521,-1,116.0,9327217,9327239,2844304,22,49,8,True,True,0.03806024444444445,-0.810419
8183,6483235,9208,8,0.700407,109,6483521,-1,272.0,9047079,9056287,2563844,9208,58,11,True,True,45.15247600000001,-0.6498889541203475
8184,6484147,1,32,0.052566,127,6505621,-1,1152.0,9190279,9190280,2706132,1,56,0,True,True,0.010201599999999998,-0.052566
8185,6485258,9,16,0.865432,127,6505621,-1,688.0,7720782,7720791,1235524,9,86,11,True,True,0.076712,-0.865432
8186,6485563,36,20,0.17902,127,6505621,-1,540.0,10578110,10578146,4092547,36,8,0,True,True,0.6663600000000001,-0.17902000000000004
8187,6492039,8,26,0.487505,127,6505621,-1,390.0,9760458,9760466,3268419,8,37,0,True,True,0.026797333333333336,-0.487505
8188,6492231,31,32,0.391808,127,6505621,-1,1440.0,8554937,8554968,2062706,31,69,2,True,True,1.076196,-0.391808
8189,6495591,2,1,0.98439,127,6505621,-1,8.0,9759558,9759560,3263967,2,38,11,True,True,0.0001465333333333333,-0.98439
8190,6495648,26,8,0.65925,127,6505621,-1,96.0,8890537,8890563,2394889,26,66,10,True,True,0.019295466666666667,-0.65925
8191,6495954,8,1,0.848518,127,6505621,-1,39.0,10308822,10308830,3812868,8,20,11,True,True,0.0038115999999999996,-0.848518
8192,6496746,14074,4,0.991063,127,6505621,-1,132.0,10533147,10547221,4036401,14074,14,7,True,True,28.367679266666663,-0.869501403983834
8193,6498268,835,2,0.547943,127,6505621,-1,44.0,7035847,7036682,537579,835,106,12,True,True,0.6953044999999999,-0.547943
8194,6498325,12165,64,0.33741,127,6505621,-1,1408.0,10330922,10343087,3832597,12165,21,10,True,True,393.2199744,-0.30723581347470397
8195,6498584,9640,64,0.677899,127,6505621,-1,1664.0,10570910,10580550,4072326,9640,10,0,True,True,507.76188088888887,-0.6722514123618827
8196,6498674,14962,32,0.990314,127,6505621,-1,800.0,10026948,10041910,3528274,14962,32,1,True,True,162.94354222222225,-0.9706367510020844
8197,6501826,1213,32,0.757714,127,6505621,-1,1312.0,8409937,8411150,1908111,1213,78,2,True,True,51.019426933333335,-0.757714
8198,6502035,6153,1,0.391063,127,6505621,-1,30.0,6851117,6857270,349082,6153,116,7,True,True,1.1468928333333333,-0.39046043068936753
8199,6502111,9289,8,0.527844,127,6505621,-1,120.0,9850466,9859755,3348355,9289,41,8,True,True,10.998043333333333,-0.5272765814228167
8200,6502185,26,1,0.28304,127,6505621,-1,8.0,10572710,10572736,4070525,26,10,7,True,True,0.005880044444444444,-0.28304
8201,6502386,77,27,0.696376,127,6505621,-1,675.0,7676582,7676659,1174196,77,100,7,True,True,3.9301762500000006,-0.696376
8202,6504417,98,8,0.195092,127,6505621,-1,88.0,9624229,9624327,3119812,98,52,1,True,True,0.1298870222222222,-0.195092
8203,6506506,16072,16,0.856252,131,6507421,-1,576.0,7987082,8003154,1480576,16072,94,9,True,True,213.920656,-0.8018420668963799
8204,6506530,393,2,0.393772,131,6507421,-1,60.0,10040575,10040968,3534045,393,28,6,True,True,0.29874549999999994,-0.393772
8205,6506670,9,10,0.130901,131,6507421,-1,60.0,10036075,10036084,3529405,9,30,7,True,True,0.007681499999999999,-0.130901
8206,6506850,53,32,0.752266,131,6507421,-1,1120.0,7877082,7877135,1370232,53,100,10,True,True,0.6734062222222224,-0.752266
8207,6506902,10238,16,0.580384,131,6507421,-1,656.0,10332743,10342981,3825841,10238,23,1,True,True,153.30698315555557,-0.5284970805343097
8208,6514749,11,4,0.805072,140,6521821,-1,148.0,8302644,8302655,1787895,11,90,11,True,True,0.029231644444444444,-0.805072
8209,6515182,17122,16,0.84981,140,6521821,-1,640.0,10041910,10059032,3526728,17122,29,2,True,True,227.4158542222222,-0.8175919179027726
8210,6515205,5924,65,0.709588,140,6521821,-1,2405.0,10540710,10546634,4025505,5924,13,6,True,True,180.5633649444444,-0.6768478153993747
8211,6515302,21,4,0.457533,140,6521821,-1,180.0,10444847,10444868,3929545,21,24,1,True,True,0.1338855,-0.457533
8212,6515336,13,4,0.163694,140,6521821,-1,156.0,10128310,10128323,3612974,13,31,12,True,True,0.01634793333333333,-0.163694
8213,6518831,318,1,0.137561,140,6521821,-1,23.0,6660872,6661190,142041,318,133,1,True,True,0.06978775,-0.137561
8214,6519316,9030,256,0.695956,140,6521821,-1,1536.0,9100279,9109309,2580963,9030,76,9,True,True,312.38613333333336,-0.572899460411797
8215,6520167,30595,8,0.291082,140,6521821,-1,56.0,7877082,7907677,1356915,30595,107,0,True,True,31.395661733333338,-0.27895313160901664
8216,6521012,76,8,0.144823,140,6521821,-1,136.0,8551337,8551413,2030325,76,88,9,True,True,0.35130915555555564,-0.14482300000000004
8217,6521112,549,11,0.218136,140,6521821,-1,429.0,9623680,9624229,3102568,549,60,6,True,True,3.5472079499999998,-0.218136
8218,6521118,54,4,0.748383,140,6521821,-1,32.0,10032475,10032529,3511357,54,39,2,True,True,0.0260352,-0.748383
8219,6523224,6,4,0.735319,238,6608221,-1,44.0,7338282,7338288,815058,6,123,11,True,True,0.010215333333333333,-0.735319
8220,6523228,25123,128,0.009133,238,6608221,-1,3456.0,7490982,7516105,967754,25123,121,12,True,True,3306.3857952,-0.008511561476075036
8221,6523268,45,32,0.725958,238,6608221,-1,1440.0,7204962,7205007,681694,45,127,10,True,True,0.6749999999999999,-0.725958
8222,6523290,5278,1,0.575682,238,6608221,-1,23.0,9507217,9512495,2983927,5278,66,2,True,True,2.0974825083333335,-0.38458062893296735
8223,6523551,26792,8,0.678318,238,6608221,-1,376.0,6657272,6684064,133721,26792,143,11,True,True,144.9672512,-0.6217238621298677
8224,6523577,26,32,0.988484,238,6608221,-1,512.0,9315095,9315121,2791518,26,71,1,True,True,0.12054755555555556,-0.988484
8225,6523687,13863,2,0.147605,238,6608221,-1,94.0,10522347,10536210,3998660,13863,19,8,True,True,28.48349695,-0.14299332994805833
8226,6523887,47,32,0.950398,238,6608221,-1,960.0,9323617,9323664,2799730,47,72,1,True,True,0.46887199999999996,-0.950398
8227,6525544,23,3,0.427111,238,6608221,-1,141.0,10718156,10718179,4192612,23,7,10,True,True,0.081047975,-0.427111
8228,6525619,311,2,0.84166,238,6608221,-1,32.0,8934737,8935048,2409118,311,89,11,True,True,0.24141893333333334,-0.84166
8229,6525992,180,14,0.925985,238,6608221,-1,406.0,8868437,8868617,2342445,180,91,10,True,True,1.048901,-0.925985
8230,6526033,15294,16,0.096048,238,6608221,-1,128.0,10570910,10586204,4044877,15294,12,0,True,True,58.06531626666667,-0.09417156574965609
8231,6526045,205,1,0.974159,238,6608221,-1,34.0,8396244,8396449,1870199,205,104,8,True,True,0.1805423611111111,-0.974159
8232,6526122,1222,1,0.179633,238,6608221,-1,49.0,6749072,6750294,222950,1222,149,12,True,True,0.5432714388888888,-0.1556725624117673
8233,6526796,10402,8,0.052472,238,6608221,-1,232.0,10946856,10957258,4420060,10402,1,12,True,True,37.53212608888889,-0.0514901078497147
8234,6526905,17,2,0.980277,238,6608221,-1,78.0,9532917,9532934,3006012,17,69,8,True,True,0.02615166666666667,-0.980277
8235,6526907,11573,6,0.650098,238,6608221,-1,234.0,8667937,8679510,2141030,11573,98,12,True,True,22.0506429,-0.5690615105069852
8236,6526938,14957,64,0.593392,238,6608221,-1,384.0,8544137,8559094,2017199,14957,102,0,True,True,171.69590293333334,-0.5756464442458952
8237,6527026,8,13,0.969727,238,6608221,-1,247.0,6613072,6613080,86046,8,157,6,True,True,0.0894085111111111,-0.969727
8238,6531734,19,16,0.626973,238,6608221,-1,512.0,10264622,10264641,3732888,19,32,12,True,True,0.18926364444444446,-0.626973
8239,6531754,102,4,0.403994,238,6608221,-1,136.0,8404537,8404639,1872783,102,106,2,True,True,0.44771880000000003,-0.403994
8240,6533797,30,16,0.033993,238,6608221,-1,320.0,10855956,10855986,4322159,30,4,0,True,True,0.22258666666666665,-0.033993
8241,6537960,162,32,0.240855,238,6608221,-1,640.0,8580637,8580799,2042677,162,102,1,True,True,1.846656,-0.240855
8242,6537985,38206,4,0.488626,238,6608221,-1,44.0,10518747,10556953,3980762,38206,24,8,True,True,29.349218677777777,-0.4602558927302557
8243,6539007,11,16,0.687984,238,6608221,-1,304.0,8258444,8258455,1719437,11,117,11,True,True,0.10011564444444444,-0.687984
8244,6547958,81,1,0.954555,238,6608221,-1,7.0,8031282,8031363,1483324,81,125,11,True,True,0.012370050000000002,-0.954555
8245,6547981,6,8,0.652797,238,6608221,-1,240.0,6941341,6941347,393360,6,156,1,True,True,0.06612000000000001,-0.652797
8246,6548054,15766,1,0.375372,238,6608221,-1,41.0,10137310,10153076,3589256,15766,37,8,True,True,9.242220683333334,-0.3506206901553985
8247,6548764,1472,6,0.691795,238,6608221,-1,264.0,9902372,9903844,3353608,1472,54,1,True,True,3.2951805333333337,-0.6463954064816478
8248,6549100,15973,4,0.795325,238,6608221,-1,148.0,8980779,8996752,2431679,15973,95,1,True,True,26.853122466666665,-0.5971584249393667
8249,6549404,11,16,0.658519,238,6608221,-1,512.0,7807182,7807193,1257778,11,138,12,True,True,0.17263644444444443,-0.658519
8250,6549461,127,2,0.777731,238,6608221,-1,40.0,10576310,10576437,4026849,127,13,4,True,True,0.1588911111111111,-0.777731
8251,6549590,12228,128,0.864896,238,6608221,-1,5248.0,9992248,10004476,3442658,12228,53,11,True,True,1161.9715754666665,-0.7347849799538433
8252,6550270,447,16,0.650311,238,6608221,-1,640.0,10725356,10725803,4175086,447,8,8,True,True,7.59304,-0.650311
8253,6550672,574,8,0.275216,238,6608221,-1,320.0,10666310,10666884,4115638,574,12,7,True,True,3.6487733333333336,-0.26766810719367906
8254,6550906,17,1,0.653195,238,6608221,-1,43.0,8192144,8192161,1641238,17,125,9,True,True,0.022055894444444446,-0.6531950000000001
8255,6551317,9,4,0.367323,238,6608221,-1,44.0,8956837,8956846,2405520,9,102,10,True,True,0.0075207,-0.367323
8256,6555872,21,16,0.12,238,6608221,-1,80.0,10332722,10332743,3776850,21,35,7,True,True,0.03723533333333334,-0.12
8257,6556914,38837,32,0.082637,238,6608221,-1,1536.0,10452947,10491784,3896033,38837,32,6,True,True,1977.4165504000002,-0.08211893119595627
8258,6556980,7,1,0.489218,238,6608221,-1,32.0,7149947,7149954,592967,7,161,11,True,True,0.0023302222222222222,-0.489218
8259,6557207,20,8,0.668792,238,6608221,-1,360.0,9693258,9693278,3136051,20,70,10,True,True,0.04302,-0.668792
8260,6557226,30122,16,0.509748,238,6608221,-1,224.0,7182862,7212984,625636,30122,161,9,True,True,54.25138382222222,-0.49151002831841184
8261,6560365,24923,8,0.023027,238,6608221,-1,152.0,9903844,9928767,3343479,24923,60,1,True,True,57.38717566666667,-0.02301154000719912
8262,6561375,4,4,0.572982,238,6608221,-1,140.0,9903844,9903848,3342469,4,60,0,True,True,0.005082000000000001,-0.572982
8263,6584225,8636,32,0.572631,238,6608221,-1,384.0,9846866,9855502,3262641,8636,68,12,True,True,33.46099413333333,-0.5692835353250634
8264,6584326,115,1,0.273725,238,6608221,-1,14.0,10664510,10664625,4080184,115,13,12,True,True,0.03288425,-0.273725
8265,6584470,5285,1,0.745359,238,6608221,-1,13.0,8396244,8401529,1811774,5285,128,0,True,True,1.9109152472222222,-0.7293682562571074
8266,6584524,17,8,0.794344,238,6608221,-1,368.0,9048879,9048896,2464355,17,104,7,True,True,0.06348102222222222,-0.794344
8267,6586397,15006,2,0.181097,238,6608221,-1,36.0,10562810,10577816,3976413,15006,21,10,True,True,14.870664999999997,-0.16883122330134134
8268,6595995,36,1,0.484191,238,6608221,-1,19.0,10467347,10467383,3871352,36,31,2,True,True,0.0203984,-0.48419099999999987
8269,6598188,13,2,0.644597,238,6608221,-1,100.0,10354843,10354856,3756655,13,38,10,True,True,0.027375833333333332,-0.644597
8270,6598204,29295,1,0.433656,238,6608221,-1,18.0,8554937,8584232,1956733,29295,123,0,True,True,11.74973365,-0.41303449201778575
8271,6598230,8526,1,0.571423,238,6608221,-1,28.0,6849317,6857843,251087,8526,185,8,True,True,1.4794699111111111,-0.570787749676074
8272,6598245,6341,32,0.099441,238,6608221,-1,928.0,10696056,10702397,4097811,6341,11,6,True,True,170.7967424888889,-0.09936303754470864
8273,6598319,6,32,0.063498,238,6608221,-1,1440.0,10529547,10529553,3931228,6,29,9,True,True,0.17325600000000002,-0.063498
8274,6598385,98,4,0.908881,238,6608221,-1,32.0,6949447,6949545,351062,98,180,6,True,True,0.14184302222222223,-0.908881
8275,6598409,63,4,0.795225,238,6608221,-1,200.0,10668110,10668173,4069701,63,13,7,True,True,0.20912500000000003,-0.7952250000000002
8276,6598586,39,1,0.18489,238,6608221,-1,42.0,6948547,6948586,349961,39,182,0,True,True,0.07408765000000002,-0.18489
8277,6598637,103,32,0.812868,238,6608221,-1,736.0,9215979,9216082,2617342,103,105,1,True,True,1.517231288888889,-0.8051670287738483
8278,6601227,155,32,0.019746,238,6608221,-1,1280.0,8214244,8214399,1613017,155,143,10,True,True,3.728266666666667,-0.019746
8279,6601244,6,11,0.55606,238,6608221,-1,132.0,7149947,7149953,548703,6,178,0,True,True,0.008239000000000002,-0.55606
8280,6601275,10,1,0.536417,238,6608221,-1,34.0,8978937,8978947,2377662,10,116,10,True,True,0.011150111111111112,-0.536417
8281,6601296,8,1,0.812196,238,6608221,-1,9.0,8413537,8413545,1812241,8,133,8,True,True,0.002571,-0.812196
8282,6601430,4,2,0.488563,238,6608221,-1,94.0,10441243,10441247,3839813,4,41,12,True,True,0.015884955555555556,-0.488563
8283,6601507,326,2,0.518901,238,6608221,-1,64.0,7153547,7153873,552040,326,181,8,True,True,0.18018382222222223,-0.518901
8284,6601557,3,8,0.584722,238,6608221,-1,40.0,10677110,10677113,4075553,3,12,8,True,True,0.002565333333333333,-0.584722
8285,6601724,7,16,0.713749,238,6608221,-1,368.0,9219579,9219586,2617855,7,107,3,True,True,0.052049511111111106,-0.713749
8286,6601793,12,2,0.790068,238,6608221,-1,82.0,9624229,9624241,3022436,12,88,0,True,True,0.014820133333333336,-0.7900680000000002
8287,6602243,16242,8,0.124089,238,6608221,-1,168.0,10441247,10457489,3839004,16242,42,1,True,True,86.885981,-0.11878748387713811
8288,6602328,45256,3,0.752988,238,6608221,-1,63.0,9186679,9231935,2584351,45256,114,12,True,True,42.49932015000001,-0.7392294697474312
8289,6602357,1768,4,0.965681,238,6608221,-1,48.0,7175662,7177430,573305,1768,185,1,True,True,0.5848544,-0.965681
8290,6602381,3627,16,0.897602,238,6608221,-1,624.0,6941347,6944974,338966,3627,199,1,True,True,105.26197413333334,-0.8411057044099636
8291,6602432,111,70,0.180664,238,6608221,-1,420.0,8406337,8406448,1803905,111,141,7,True,True,1.172752,-0.180664
8292,6602439,5630,63,0.599103,238,6608221,-1,1134.0,10567310,10572940,3964871,5630,24,6,True,True,173.13344999999998,-0.5962289773799276
8293,6602850,587,4,0.179938,238,6608221,-1,72.0,9002879,9003466,2400029,587,121,10,True,True,0.3371728,-0.17993799999999996
8294,6602886,1,8,0.554722,238,6608221,-1,88.0,7544182,7544183,941296,1,178,9,True,True,0.002353022222222222,-0.554722
8295,6602918,561,8,0.800513,238,6608221,-1,224.0,9760458,9761019,3157540,561,82,6,True,True,1.0793141333333331,-0.800513
8296,6602928,8,1,0.123045,238,6608221,-1,22.0,10673510,10673518,4070582,8,13,1,True,True,0.0025422222222222218,-0.123045
8297,6602934,6208,3,0.128816,238,6608221,-1,99.0,10566410,10572618,3963476,6208,26,8,True,True,16.48025665,-0.1275537104462326
8298,6603044,9451,256,0.20623,238,6608221,-1,4352.0,10686605,10696056,4083561,9451,12,6,True,True,824.8197994666667,-0.1716223015341812
8299,6603431,3571,256,0.16121,238,6608221,-1,5888.0,6845717,6849288,242286,3571,213,6,True,True,132.2639104,-0.1560135533248605
8300,6603479,6939,4,0.562496,238,6608221,-1,168.0,9903848,9910787,3300369,6939,74,1,True,True,10.438589,-0.5619726272440637
8301,6603637,8,1,0.85145,238,6608221,-1,39.0,10133710,10133718,3530073,8,57,8,True,True,0.0028166666666666665,-0.85145
8302,6603653,369,2,0.035005,238,6608221,-1,66.0,10019748,10020117,3416095,369,71,10,True,True,0.36470115,-0.035005
8303,6603719,80,8,0.979928,238,6608221,-1,296.0,8712137,8712217,2108418,80,140,11,True,True,0.43906666666666666,-0.979928
8304,6604464,116,12,0.506148,238,6608221,-1,96.0,8499937,8500053,1895473,116,149,12,True,True,0.1855072,-0.506148
8305,6604573,1322,28,0.36356,238,6608221,-1,1120.0,9322295,9323617,2717722,1322,111,9,True,True,15.386317333333333,-0.36356
8306,6604621,9127,32,0.544427,238,6608221,-1,1088.0,10023348,10032475,3418727,9127,70,8,True,True,146.3727018666667,-0.5353496166929042
8307,6604631,7934,1,0.423051,238,6608221,-1,8.0,8577037,8584971,1972406,7934,146,10,True,True,1.3119455333333336,-0.3930389346874823
8308,6606881,33034,2,0.945228,238,6608221,-1,18.0,9500017,9533051,2893136,33034,109,12,True,True,14.96656205,-0.8882303663951406
8309,6606899,42,16,8.6e-05,238,6608221,-1,592.0,10721756,10721798,4114857,42,9,0,True,True,0.6505389333333333,-8.6e-05
8310,6606945,21,64,0.3006,238,6608221,-1,1920.0,10515147,10515168,3908202,21,39,11,True,True,0.8732639999999999,-0.3006
8311,6606974,17,16,0.946215,238,6608221,-1,688.0,9994048,9994065,3387074,17,76,7,True,True,0.22170417777777776,-0.946215
8312,6607002,13375,128,0.519443,238,6608221,-1,1152.0,6937741,6951116,330739,13375,221,2,True,True,689.5195776,-0.5160547663812557
8313,6607032,18378,32,0.782802,238,6608221,-1,1376.0,7294082,7312460,687050,18378,201,12,True,True,864.4558931555555,-0.7154741908028868
8314,6607069,163,13,0.659158,238,6608221,-1,598.0,10452047,10452210,3844978,163,46,2,True,True,2.9794552666666667,-0.6591580000000001
8315,6607310,9106,128,0.44492,238,6608221,-1,6272.0,7205862,7214968,598552,9106,205,6,True,True,673.7925276444445,-0.44104763025379123
8316,6607654,318,16,0.577071,238,6608221,-1,560.0,7928482,7928800,1320828,318,183,8,True,True,6.334701333333334,-0.577071
8317,6607660,14,1,0.695101,238,6608221,-1,41.0,7979882,7979896,1372222,14,182,9,True,True,0.014150694444444445,-0.695101
4463,3615840,28,1,0.996973,1,3615840,-1,35.0,3660040,3660068,44200,28,0,11,True,True,0.03167577777777778,-0.996973
4464,3615880,7607,32,0.625132,16,3660040,-1,1600.0,4219940,4227547,604060,7607,0,7,True,True,225.0805288888889,-0.6218517620723165
4465,3615923,14759,32,0.059775,16,3660040,-1,832.0,7393420,7408179,3777497,14759,0,8,True,True,350.6430119111111,-0.05923361749507749
4466,3615992,10,32,0.644575,16,3660040,-1,640.0,7915520,7915530,4299528,10,0,11,True,True,0.24019555555555558,-0.644575
4467,3627860,12820,256,0.701328,16,3660040,-1,4864.0,8760901,8773721,5133041,12820,0,11,True,True,1373.0179726222223,-0.6518153208292468
4468,3628129,6,4,0.791466,16,3660040,-1,140.0,3707083,3707089,78954,6,4,0,True,True,0.015785000000000004,-0.791466
4469,3628218,19,32,0.125827,16,3660040,-1,1600.0,8592701,8592720,4964483,19,1,11,True,True,0.8408977777777779,-0.125827
4470,3628580,26,4,0.232675,16,3660040,-1,172.0,4010607,4010633,382027,26,5,1,True,True,0.1108559111111111,-0.232675
4471,3628688,27,16,0.981676,16,3660040,-1,512.0,8107442,8107469,4478754,27,2,10,True,True,0.1938432,-0.981676
4472,3628874,34,4,0.788562,16,3660040,-1,24.0,3704240,3704274,75366,34,8,11,True,True,0.0101864,-0.788562
4473,3628952,22,8,0.756698,16,3660040,-1,400.0,7992620,7992642,4363668,22,3,8,True,True,0.24292888888888892,-0.756698
4474,3628991,27,1,0.805525,16,3660040,-1,30.0,7389820,7389847,3760829,27,6,7,True,True,0.02308275,-0.805525
4475,3641283,24,10,0.438719,16,3660040,-1,310.0,6345368,6345392,2704085,24,7,12,True,True,0.18219733333333332,-0.438719
4476,3641363,6696,4,0.192965,16,3660040,-1,136.0,4772316,4779012,1130953,6696,8,6,True,True,7.678596266666668,-0.18620946933157403
4477,3643034,67,1,0.68925,16,3660040,-1,50.0,8536042,8536109,4893008,67,2,12,True,True,0.06915888888888888,-0.68925
4478,3643821,17,8,0.358167,16,3660040,-1,304.0,3910483,3910500,266662,17,12,7,True,True,0.19285253333333335,-0.358167
4479,3659990,2,4,0.134732,16,3660040,-1,120.0,7652520,7652522,3992530,2,6,12,True,True,0.004738666666666667,-0.134732
4480,3660044,204,25,0.898663,176,3704240,-1,425.0,5465980,5466184,1805936,204,10,3,True,True,1.4331991666666666,-0.898663
4481,3660260,7004,128,0.485302,176,3704240,-1,2176.0,5838855,5845859,2178595,7004,10,9,True,True,395.20443093333336,-0.46291795031156036
4482,3660679,5,16,0.4375,176,3704240,-1,368.0,8446042,8446047,4785363,5,3,2,True,True,0.03346755555555556,-0.4375
4483,3660746,5,1,0.294715,176,3704240,-1,13.0,7738920,7738925,4078174,5,7,12,True,True,0.0009544166666666666,-0.294715
4484,3660784,140,34,0.697038,176,3704240,-1,1360.0,7387880,7388020,3727096,140,11,12,True,True,5.425871111111112,-0.697038
4485,3660860,9450,32,0.189776,176,3704240,-1,1088.0,7998042,8007492,4337182,9450,5,7,True,True,267.1142816,-0.1846197793215218
4486,3661028,773,1,0.186627,176,3704240,-1,37.0,4640816,4641589,979788,773,17,0,True,True,0.7379058000000001,-0.186627
4487,3661037,3,2,0.347665,176,3704240,-1,30.0,5184980,5184983,1523943,3,16,10,True,True,0.00053775,-0.347665
4488,3661057,9,16,0.732402,176,3704240,-1,192.0,8085342,8085351,4424285,9,5,6,True,True,0.0429264,-0.732402
4489,3661097,2714,1,0.275324,176,3704240,-1,42.0,5564284,5566998,1903187,2714,16,6,True,True,2.9624553000000002,-0.2180246096735131
4490,3661187,11,16,0.83135,176,3704240,-1,96.0,5186780,5186791,1525593,11,18,7,True,True,0.006309600000000001,-0.83135
4491,3661202,4,6,0.914474,176,3704240,-1,210.0,8437042,8437046,4775840,4,4,8,True,True,0.021056,-0.914474
4492,3661241,8,1,0.55452,176,3704240,-1,27.0,4268216,4268224,606975,8,23,7,True,True,0.0105486,-0.55452
4493,3661274,20842,1,0.068877,176,3704240,-1,13.0,6703219,6724061,3041945,20842,15,6,True,True,7.2650819944444445,-0.06887542589537239
4494,3661337,35594,16,0.155025,176,3704240,-1,656.0,5043580,5079174,1382243,35594,22,12,True,True,263.60852328888893,-0.14511466311936275
4495,3661440,101,8,0.295673,176,3704240,-1,368.0,5462380,5462481,1800940,101,20,0,True,True,0.7631829333333334,-0.2956730000000001
4496,3661501,63,1,0.263349,176,3704240,-1,42.0,8716701,8716764,5055200,63,1,11,True,True,0.05935125000000001,-0.263349
4497,3662111,8148,64,0.367113,176,3704240,-1,832.0,8957601,8965749,5295490,8148,0,12,True,True,151.59212639999998,-0.3619111819035348
4498,3662159,5579,4,0.00072,176,3704240,-1,136.0,7492620,7498199,3830461,5579,14,0,True,True,22.525291644444447,-0.0007199927428086228
4499,3662220,11570,1,0.638026,176,3704240,-1,10.0,5329980,5341550,1667760,11570,24,6,True,True,1.357527222222222,-0.6185782002402025
4500,3663788,609,1,0.379044,176,3704240,-1,5.0,6867619,6868228,3203831,609,18,10,True,True,0.10994141666666665,-0.379044
4501,3663875,76,8,0.185534,176,3704240,-1,240.0,7119319,7119395,3455444,76,18,12,True,True,0.6131679999999999,-0.18553399999999998
4502,3663967,14665,10,0.01872,176,3704240,-1,460.0,6166968,6181633,2503001,14665,22,1,True,True,126.740741,-0.01846638904850169
4503,3664153,27,2,0.856829,176,3704240,-1,40.0,7996242,7996269,4332089,27,10,1,True,True,0.029979,-0.856829
4504,3664169,5448,2,0.776017,176,3704240,-1,56.0,7992642,7998090,4328473,5448,11,1,True,True,8.443427066666667,-0.7751451626323439
4505,3664201,8450,4,0.238787,176,3704240,-1,48.0,5460580,5469030,1796379,8450,29,12,True,True,7.217594666666667,-0.2372732924083976
4506,3664343,84,16,0.721004,176,3704240,-1,144.0,3818683,3818767,154340,84,40,2,True,True,0.5452944,-0.721004
4507,3664361,91,1,0.658289,176,3704240,-1,18.0,5566084,5566175,1901723,91,26,7,True,True,0.053758249999999994,-0.658289
4508,3664393,22,2,0.538957,176,3704240,-1,80.0,8871201,8871223,5206808,22,1,12,True,True,0.042821777777777785,-0.538957
4509,3664433,6,13,0.387491,176,3704240,-1,65.0,8433442,8433448,4769009,6,8,8,True,True,0.008651500000000001,-0.387491
4510,3664610,111,4,0.52407,176,3704240,-1,188.0,8373942,8374053,4709332,111,9,9,True,True,0.6179246666666667,-0.52407
4511,3664644,4,32,0.497549,176,3704240,-1,1600.0,6702319,6702323,3037675,4,26,0,True,True,0.19187555555555558,-0.497549
4512,3664668,188,32,0.551468,176,3704240,-1,160.0,5476984,5477172,1812316,188,32,8,True,True,0.6735413333333334,-0.551468
4513,3664712,4,8,0.613039,176,3704240,-1,64.0,4313316,4313320,648604,4,42,10,True,True,0.002735644444444444,-0.613039
4514,3664784,6124,1,0.3226,176,3704240,-1,32.0,7738920,7745044,4074136,6124,17,0,True,True,3.4167089777777777,-0.30135431175555094
4515,3664816,16150,121,0.640904,176,3704240,-1,1815.0,6702319,6718469,3037503,16150,28,10,True,True,805.0243992083333,-0.6250328138479243
4516,3665011,232,32,0.110464,176,3704240,-1,992.0,8366742,8366974,4701731,232,10,10,True,True,7.281500444444444,-0.110464
4517,3665100,33,4,0.523201,176,3704240,-1,104.0,4120907,4120940,455807,33,48,12,True,True,0.07991793333333333,-0.523201
4518,3665246,165,101,0.06668,176,3704240,-1,4242.0,3717883,3718048,52637,165,52,1,True,True,9.112699749999999,-0.06667999999999999
4519,3665281,7,64,0.835193,176,3704240,-1,2880.0,7300430,7300437,3635149,7,25,8,True,True,0.41468,-0.835193
4520,3665449,6317,8,0.129774,176,3704240,-1,104.0,7959720,7966037,4294271,6317,17,10,True,True,20.314020999999997,-0.1296348482742911
4521,3665460,328,4,0.873493,176,3704240,-1,88.0,4939416,4939744,1273956,328,45,8,True,True,1.2239939555555557,-0.873493
4522,3665924,9014,74,0.202079,176,3704240,-1,2220.0,8429842,8438856,4763918,9014,9,9,True,True,472.99727000000007,-0.19724595809078418
4523,3665959,15066,4,0.48537,176,3704240,-1,128.0,6389568,6404634,2723609,15066,33,11,True,True,30.231641600000003,-0.47645663757519396
4524,3665973,7608,3,0.098754,176,3704240,-1,15.0,4930416,4938024,1264443,7608,48,0,True,True,2.585135,-0.09619711377106517
4525,3666177,10056,113,0.571012,176,3704240,-1,1921.0,5327280,5337336,1661103,10056,44,11,True,True,240.20657846666668,-0.5550770800888528
4526,3666436,7,1,0.8363,176,3704240,-1,10.0,5283080,5283087,1616644,7,45,12,True,True,0.0004767777777777778,-0.8363
4527,3667058,8,8,0.657921,176,3704240,-1,48.0,4935816,4935824,1268758,8,50,7,True,True,0.0064970666666666664,-0.6579210000000001
4528,3667074,37,8,0.525821,176,3704240,-1,136.0,8140342,8140379,4473268,37,12,10,True,True,0.10775468888888891,-0.525821
4529,3668186,12,8,0.701314,176,3704240,-1,72.0,5684484,5684496,2016298,12,38,9,True,True,0.0086592,-0.701314
4530,3668196,39839,1,0.255939,176,3704240,-1,44.0,4210940,4250779,542744,39839,59,8,True,True,35.301464977777776,-0.24626642476300312
4531,3668426,38,4,0.366354,176,3704240,-1,24.0,8548501,8548539,4880075,38,5,9,True,True,0.020748000000000003,-0.366354
4532,3668615,13,64,0.605954,176,3704240,-1,640.0,3961883,3961896,293268,13,63,9,True,True,0.08828444444444444,-0.605954
4533,3668830,23991,4,0.070874,176,3704240,-1,92.0,3714283,3738274,45453,23991,67,8,True,True,53.49220348888889,-0.06312925922147525
4534,3668847,12081,256,0.930211,176,3704240,-1,12288.0,6066655,6078736,2397808,12081,38,12,True,True,4456.6646784,-0.91385820590633
4535,3668865,5,1,0.208738,176,3704240,-1,33.0,4290316,4290321,621451,5,59,10,True,True,0.0067352083333333335,-0.208738
4536,3669374,4541,184,0.491406,176,3704240,-1,4048.0,7740720,7745261,4071346,4541,22,7,True,True,334.42185431111113,-0.46809051974568316
4537,3669407,7819,4,0.889767,176,3704240,-1,96.0,5588184,5596003,1918777,7819,42,10,True,True,9.37128,-0.8389113855598179
4538,3669434,2,4,0.079957,176,3704240,-1,112.0,5684484,5684486,2015050,2,41,0,True,True,0.0022449777777777775,-0.079957
4539,3669546,5723,2,0.80102,176,3704240,-1,38.0,8649501,8655224,4979955,5723,4,9,True,True,4.560380527777778,-0.7871970440888283
4540,3669588,33704,64,0.0607,176,3704240,-1,1024.0,8344642,8378346,4675054,33704,14,8,True,True,1036.1776867555557,-0.06063067640662682
4541,3669597,10,1,0.55802,176,3704240,-1,26.0,7262130,7262140,3592533,10,33,7,True,True,0.005464333333333333,-0.55802
4542,3670045,612,43,0.938244,176,3704240,-1,430.0,4945716,4946328,1275671,612,59,6,True,True,10.423329,-0.938244
4543,3670118,3,16,0.415953,176,3704240,-1,96.0,6710419,6710422,3040301,3,36,4,True,True,0.008254400000000002,-0.415953
4544,3670126,12,8,0.369069,176,3704240,-1,120.0,5563384,5563396,1893258,12,50,12,True,True,0.026976,-0.369069
4545,3670158,26577,128,0.708434,176,3704240,-1,4352.0,5133580,5160157,1463422,26577,60,12,True,True,1971.214052977778,-0.6551779226731362
4546,3670351,9,2,0.823643,176,3704240,-1,70.0,6981519,6981528,3311168,9,35,8,True,True,0.015956500000000002,-0.823643
4547,3670440,3747,1,0.265816,176,3704240,-1,30.0,8784801,8788548,5114361,3747,2,0,True,True,2.8707062499999996,-0.26553815539842224
4548,3672786,28250,128,0.040653,176,3704240,-1,4224.0,7388020,7416270,3715234,28250,32,1,True,True,3371.3096853333336,-0.04027426197465051
4549,3672822,13457,128,0.070388,176,3704240,-1,3072.0,7003619,7017076,3330797,13457,37,10,True,True,1049.05792,-0.06973585238264084
4550,3673201,21313,16,0.303905,176,3704240,-1,144.0,4798016,4819329,1124815,21313,70,10,True,True,32.6500388,-0.2789657323961878
4551,3673565,89,1,0.944603,176,3704240,-1,12.0,7293230,7293319,3619665,89,35,10,True,True,0.0204878,-0.944603
4552,3673625,16711,4,0.960587,176,3704240,-1,68.0,5684486,5701197,2010861,16711,50,1,True,True,11.151871177777778,-0.9473908357401768
4553,3673741,75,2,0.097119,176,3704240,-1,16.0,3954683,3954758,280942,75,83,11,True,True,0.01600333333333333,-0.097119
4554,3673762,201,1,0.725172,176,3704240,-1,41.0,7260330,7260531,3586568,201,37,11,True,True,0.17594535,-0.725172
4555,3673920,5,1,0.531661,176,3704240,-1,25.0,8449642,8449647,4775722,5,9,8,True,True,0.002108333333333333,-0.531661
4556,3674946,25,1,0.18946,176,3704240,-1,24.0,3811483,3811508,136537,25,88,8,True,True,0.015039999999999998,-0.18946
4557,3674980,12598,32,0.526192,176,3704240,-1,1440.0,7937620,7950218,4262640,12598,25,10,True,True,582.047528,-0.5240064628879685
4558,3675045,21116,45,0.248763,176,3704240,-1,1215.0,8442442,8463558,4767397,21116,11,7,True,True,475.19530875,-0.24771838168043203
4559,3675284,288,3,0.625325,176,3704240,-1,105.0,6627866,6628154,2952582,288,49,11,True,True,0.25074,-0.625325
4560,3675406,1649,5,0.178898,176,3704240,-1,220.0,4120940,4122589,445534,1649,85,1,True,True,7.715248444444445,-0.16338609730006734
4561,3675425,101,1,0.749194,176,3704240,-1,6.0,7029319,7029420,3353894,101,42,8,True,True,0.01612296666666667,-0.749194
4562,3675572,12,2,0.415185,176,3704240,-1,28.0,6844619,6844631,3169047,12,46,0,True,True,0.012632666666666667,-0.415185
4563,3675590,8667,16,0.105514,176,3704240,-1,400.0,6706819,6715486,3031229,8667,48,2,True,True,97.6727688888889,-0.10550248426516373
4564,3675622,29,12,0.638624,176,3704240,-1,216.0,6489166,6489195,2813544,29,53,8,True,True,0.1419318,-0.638624
4565,3675637,7754,128,0.357963,176,3704240,-1,1920.0,7025719,7033473,3350082,7754,43,10,True,True,362.03984,-0.3501800416907343
4566,3675654,189,32,0.458721,176,3704240,-1,320.0,6977919,6978108,3302265,189,46,10,True,True,1.75812,-0.458721
4567,3675688,10761,1,0.665242,176,3704240,-1,46.0,3983983,3994744,308295,10761,94,10,True,True,7.119137994444445,-0.6370859861637485
4568,3675741,8744,4,0.882824,176,3704240,-1,196.0,6211168,6219912,2535427,8744,58,11,True,True,44.48234373333334,-0.8775021666468609
4569,3675872,9308,1,0.166809,176,3704240,-1,44.0,7301480,7310788,3625608,9308,37,2,True,True,10.426046888888889,-0.16634347861001614
4570,3675903,11829,72,0.180397,176,3704240,-1,2232.0,8671601,8683430,4995698,11829,5,10,True,True,463.4031466,-0.16934247434794764
4571,3676012,238,1,0.401557,176,3704240,-1,35.0,4640816,4641054,964804,238,88,0,True,True,0.21491399999999997,-0.401557
4572,3676024,33,8,0.337513,176,3704240,-1,360.0,4640816,4640849,964792,33,90,11,True,True,0.306504,-0.337513
4573,3676082,23,5,0.158176,176,3704240,-1,70.0,3710683,3710706,34601,23,107,8,True,True,0.017754722222222227,-0.158176
4574,3676130,45,1,0.998434,176,3704240,-1,50.0,7489020,7489065,3812890,45,34,10,True,True,0.06385,-0.9984339999999998
4575,3676133,2356,2,0.443012,176,3704240,-1,18.0,5196680,5199036,1520547,2356,79,6,True,True,0.3798412,-0.3250964420814616
4576,3676184,230,8,0.352324,176,3704240,-1,128.0,7400620,7400850,3724436,230,35,9,True,True,0.8351964444444443,-0.352324
4577,3677867,53,45,0.315155,176,3704240,-1,1710.0,6635066,6635119,2957199,53,58,9,True,True,0.7464387499999999,-0.315155
4578,3677893,32,1,0.991463,176,3704240,-1,33.0,6166936,6166968,2489043,32,65,7,True,True,0.02257493333333333,-0.991463
4579,3677973,1043,1,0.324654,176,3704240,-1,43.0,3706040,3707083,28067,1043,114,7,True,True,0.8427874583333332,-0.324654
4580,3677995,13208,38,0.37172,176,3704240,-1,608.0,7536820,7550028,3858825,13208,33,10,True,True,231.33639324444445,-0.34379555414462837
4581,3678079,1889,4,0.764184,176,3704240,-1,168.0,6955819,6957708,3277740,1889,52,0,True,True,9.138856066666667,-0.764184
4582,3678090,14913,128,0.430588,176,3704240,-1,1792.0,3807883,3822796,129793,14913,112,12,True,True,1065.0941205333334,-0.4160156599552031
4583,3678108,13165,16,0.725868,176,3704240,-1,128.0,6800419,6813584,3122311,13165,55,12,True,True,48.38490631111111,-0.725754104392023
4584,3678125,7,4,0.608413,176,3704240,-1,108.0,7300430,7300437,3622305,7,42,0,True,True,0.015550499999999998,-0.608413
4585,3678176,6,37,0.563145,176,3704240,-1,1295.0,5883055,5883061,2204879,6,71,11,True,True,0.08423975,-0.563145
4586,3678377,8869,256,0.213928,176,3704240,-1,9472.0,4399716,4408585,721339,8869,101,12,True,True,865.8809855999999,-0.2082147884163433
4587,3678440,12027,210,0.765708,176,3704240,-1,5250.0,5826828,5838855,2148388,12027,73,1,True,True,1536.3611375,-0.7575612370830723
4588,3679211,14,64,0.926147,176,3704240,-1,2176.0,6165136,6165150,2485925,14,70,12,True,True,0.4400355555555556,-0.926147
4589,3679280,44,128,0.254089,176,3704240,-1,5632.0,6389568,6389612,2710288,44,65,0,True,True,2.6219463111111114,-0.254089
4590,3679312,4,1,0.961652,176,3704240,-1,31.0,5892055,5892059,2212743,4,73,9,True,True,0.0013667555555555556,-0.961652
4591,3679372,7906,32,0.4475,176,3704240,-1,992.0,6706819,6714725,3027447,7906,58,0,True,True,221.96956453333334,-0.447446703089726
4592,3680172,1984,32,0.397091,176,3704240,-1,1024.0,4034507,4036491,354335,1984,114,10,True,True,58.06006328888889,-0.3928213518450973
4593,3680281,13,14,0.726313,176,3704240,-1,574.0,4771416,4771429,1091135,13,103,11,True,True,0.06688853888888889,-0.726313
4594,3680922,11742,86,0.982956,176,3704240,-1,602.0,5815086,5826828,2134164,11742,78,12,True,True,142.83899816666667,-0.931818587978249
4595,3681024,1300,8,0.595763,176,3704240,-1,168.0,7032919,7034219,3351895,1300,48,2,True,True,4.724113333333333,-0.595763
4596,3681070,19,1,0.517609,176,3704240,-1,28.0,5047180,5047199,1366110,19,98,8,True,True,0.007925322222222224,-0.517609
4597,3681095,23,32,0.993412,176,3704240,-1,288.0,7300437,7300460,3619342,23,42,2,True,True,0.136252,-0.993412
4598,3681213,5,32,0.301842,176,3704240,-1,1408.0,3707083,3707088,25870,5,132,1,True,True,0.13229333333333335,-0.301842
4599,3681391,13,8,0.300334,176,3704240,-1,264.0,7141419,7141432,3460028,13,48,10,True,True,0.1170598,-0.300334
4600,3681904,3459,4,0.221887,176,3704240,-1,156.0,8536042,8539501,4854138,3459,9,0,True,True,11.265953833333333,-0.19856357560308552
4601,3682096,13849,4,0.85572,176,3704240,-1,152.0,4956516,4970365,1274420,13849,103,9,True,True,74.09504944444444,-0.7595258941480594
4602,3682167,19827,32,0.021701,176,3704240,-1,352.0,4930416,4950243,1248249,19827,108,7,True,True,221.95305439999998,-0.019387178179596603
4603,3682283,6,1,0.82194,176,3704240,-1,19.0,6954019,6954025,3271736,6,58,0,True,True,0.0034941,-0.82194
4604,3682525,22,32,0.689719,176,3704240,-1,1248.0,5676384,5676406,1993859,22,87,0,True,True,0.40642506666666667,-0.689719
4605,3682574,13,1,0.275957,176,3704240,-1,35.0,5466184,5466197,1783610,13,93,0,True,True,0.007521402777777777,-0.275957
4606,3682589,3,4,0.553663,176,3704240,-1,56.0,8420842,8420845,4738253,3,17,6,True,True,0.0036969333333333335,-0.553663
4607,3683826,2914,1,0.556323,176,3704240,-1,29.0,4006983,4009897,323157,2914,129,6,True,True,2.7858811333333335,-0.556323
4608,3685104,2,1,0.925922,176,3704240,-1,14.0,7544020,7544022,3858916,2,35,9,True,True,0.0007963666666666666,-0.925922
4609,3688341,561,1,0.154715,176,3704240,-1,38.0,4012407,4012968,324066,561,129,7,True,True,0.5284495333333332,-0.154715
4610,3688365,19295,64,0.037736,176,3704240,-1,2112.0,5137180,5156475,1448815,19295,105,1,True,True,715.8635146666667,-0.036269155667537335
4611,3688398,12603,8,0.355656,176,3704240,-1,128.0,4242040,4254643,553642,12603,125,10,True,True,55.79346773333333,-0.33189102591542124
4612,3688772,56,1,0.138408,176,3704240,-1,42.0,6583666,6583722,2894894,56,72,1,True,True,0.038749200000000004,-0.138408
4613,3688871,53,8,0.367083,176,3704240,-1,160.0,5466184,5466237,1777313,53,97,1,True,True,0.14017911111111112,-0.367083
4614,3688977,11,8,0.582156,176,3704240,-1,112.0,6481966,6481977,2792989,11,74,11,True,True,0.012617733333333332,-0.582156
4615,3689104,7367,16,0.232994,176,3704240,-1,768.0,6580066,6587433,2890962,7367,73,6,True,True,78.98725546666667,-0.17311004192053406
4616,3689453,19,1,0.811074,176,3704240,-1,11.0,7032919,7032938,3343466,19,53,0,True,True,0.004520786111111111,-0.811074
4617,3690701,14513,16,0.091905,176,3704240,-1,592.0,8541301,8555814,4850600,14513,9,7,True,True,194.91096964444444,-0.09062327565684772
4618,3690792,149,32,0.399798,176,3704240,-1,1568.0,7215230,7215379,3524438,149,52,11,True,True,5.44102968888889,-0.399798
4619,3690846,16952,256,0.917882,176,3704240,-1,12800.0,4443916,4460868,753070,16952,128,11,True,True,5831.725368888889,-0.8193755562035928
4620,3690876,21615,64,0.734266,176,3704240,-1,896.0,5195780,5217395,1504904,21615,110,9,True,True,288.34969955555556,-0.686448886973807
4621,3690903,30,8,0.723581,176,3704240,-1,160.0,5462380,5462410,1771477,30,105,7,True,True,0.09856,-0.723581
4622,3691207,140,16,0.792904,176,3704240,-1,768.0,3906883,3907023,215676,140,148,12,True,True,3.83936,-0.792904
4623,3691710,20607,32,0.172902,176,3704240,-1,1312.0,4949316,4969923,1257606,20607,119,2,True,True,1001.1698269333334,-0.16266318453743436
4624,3691896,6844,35,0.825705,176,3704240,-1,1540.0,5980255,5987099,2288359,6844,87,7,True,True,313.1280117777778,-0.8209796211959695
4625,3692532,17,8,0.689595,176,3704240,-1,256.0,7514720,7514737,3822188,17,38,10,True,True,0.10541511111111111,-0.689595
4626,3692654,1207,32,0.576232,176,3704240,-1,608.0,8642301,8643508,4949647,1207,7,1,True,True,13.443834222222222,-0.576232
4627,3692800,10,1,0.907656,176,3704240,-1,50.0,3721483,3721493,28683,10,156,8,True,True,0.00823888888888889,-0.9076560000000002
4628,3692903,3,12,0.595231,176,3704240,-1,456.0,8422642,8422645,4729739,3,19,7,True,True,0.0301036,-0.595231
4629,3693006,11,21,0.300393,176,3704240,-1,861.0,6214768,6214779,2521762,11,85,1,True,True,0.24779819166666667,-0.300393
4630,3699045,8653,32,0.730789,176,3704240,-1,928.0,7871320,7879973,4172275,8653,34,12,True,True,247.47902453333336,-0.6943652978081774
4631,3699066,22116,32,0.576284,176,3704240,-1,288.0,7784920,7807036,4085854,22116,35,11,True,True,114.5520128,-0.5614844495095147
4632,3699271,21,1,0.078477,176,3704240,-1,16.0,4775916,4775937,1076645,21,133,1,True,True,0.0028476000000000005,-0.078477
4633,3699282,111,18,0.055923,176,3704240,-1,612.0,8419942,8420053,4720660,111,21,7,True,True,1.3497711000000001,-0.055923
4634,3699352,13,4,0.770902,176,3704240,-1,48.0,5884855,5884868,2185503,13,96,7,True,True,0.006765200000000001,-0.770902
4635,3699478,11,4,0.34793,176,3704240,-1,172.0,6485566,6485577,2786088,11,84,8,True,True,0.0280489,-0.34793
4636,3699527,13020,12,0.817142,176,3704240,-1,600.0,8784801,8797821,5085274,13020,2,0,True,True,202.56633999999997,-0.8143052865140302
4637,3700163,6,11,0.416522,176,3704240,-1,187.0,4242040,4242046,541877,6,148,0,True,True,0.028657750000000003,-0.416522
4638,3701086,44,32,0.867831,176,3704240,-1,1088.0,6955819,6955863,3254733,44,70,7,True,True,1.3785806222222226,-0.867831
4639,3701224,130,1,0.869787,176,3704240,-1,36.0,8114642,8114772,4413418,130,27,9,True,True,0.07103199999999998,-0.869787
4640,3701346,187,32,0.226718,176,3704240,-1,928.0,7271130,7271317,3569784,187,58,9,True,True,4.2776624,-0.226718
4641,3712058,24,36,0.652779,173,3714283,-1,216.0,8274742,8274766,4562684,24,26,7,True,True,0.09525600000000001,-0.652779
4642,3712151,13959,64,0.602302,173,3714283,-1,704.0,6579166,6593125,2867015,13959,88,8,True,True,115.99325173333332,-0.5146238566236785
4643,3714914,7407,9,0.011434,176,3717883,-1,288.0,8228742,8236149,4513828,7407,27,11,True,True,63.302004,-0.011405543043978016
4644,3715223,18,16,0.777419,176,3717883,-1,592.0,4596616,4596634,881393,18,149,12,True,True,0.1695784,-0.7774190000000002
4645,3715324,18,16,0.382487,176,3717883,-1,800.0,8272942,8272960,4557618,18,27,11,True,True,0.2646,-0.382487
4646,3715542,5,8,0.304783,176,3717883,-1,136.0,8296842,8296847,4581300,5,26,10,True,True,0.009342444444444445,-0.304783
4647,3720730,18,16,0.041182,177,3721483,-1,304.0,8366742,8366760,4646012,18,24,0,True,True,0.17312800000000003,-0.041182
4648,3720939,56,4,0.53993,177,3721483,-1,104.0,8118242,8118298,4397303,56,32,8,True,True,0.0853054222222222,-0.53993
4649,3721655,12,1,0.14958,246,3807883,-1,44.0,4266416,4266428,544761,12,159,8,True,True,0.025785466666666666,-0.14958
4650,3723113,108,2,0.502402,246,3807883,-1,54.0,8184542,8184650,4461429,108,31,11,True,True,0.127575,-0.502402
4651,3723509,38,1,0.220797,246,3807883,-1,43.0,5159280,5159318,1435771,38,136,0,True,True,0.035575811111111105,-0.220797
4652,3723658,819,1,0.05052,246,3807883,-1,22.0,6636019,6636838,2912361,819,90,6,True,True,0.14839824999999998,-0.05052
4653,3723949,12732,20,0.731579,246,3807883,-1,920.0,4957180,4969912,1233231,12732,142,1,True,True,417.1849071111111,-0.6413635741016106
4654,3724018,394,4,0.392883,246,3807883,-1,32.0,8341042,8341436,4617024,394,27,11,True,True,0.3161344,-0.38414527710281604
4655,3733006,4,16,0.445616,246,3807883,-1,112.0,8418142,8418146,4685136,4,23,11,True,True,0.00890151111111111,-0.445616
4656,3733414,122,4,0.595132,246,3807883,-1,96.0,4727216,4727338,993802,122,156,12,True,True,0.0807152,-0.595132
4657,3736777,71,3,0.504729,246,3807883,-1,114.0,5159280,5159351,1422503,71,140,10,True,True,0.17622436666666663,-0.504729
4658,3736867,291,2,0.222086,246,3807883,-1,94.0,4291216,4291507,554349,291,165,6,True,True,0.5857555166666667,-0.222086
4659,3737473,40,1,0.289783,246,3807883,-1,29.0,4218140,4218180,480667,40,172,9,True,True,0.010717111111111111,-0.289783
4660,3737586,14,4,0.394322,246,3807883,-1,200.0,7148930,7148944,3411344,14,71,1,True,True,0.07804222222222224,-0.394322
4661,3737606,16503,3,0.132189,246,3807883,-1,123.0,7492620,7509123,3755014,16503,56,8,True,True,57.44139565,-0.13110642028821556
4662,3737796,274,12,0.082545,246,3807883,-1,552.0,3820483,3820757,82687,274,187,7,True,True,10.984386,-0.082545
4663,3740770,18193,1,0.571441,246,3807883,-1,22.0,6437766,6455959,2696996,18193,103,11,True,True,6.08769211111111,-0.5641324343091498
4664,3740870,2,4,0.049311,246,3807883,-1,60.0,8636901,8636903,4896031,2,9,11,True,True,0.002256,-0.049311
4665,3740946,4650,1,0.399191,246,3807883,-1,42.0,7296830,7301480,3555884,4650,68,8,True,True,4.127824166666667,-0.35215721224304575
4666,3741105,22,1,0.085079,246,3807883,-1,42.0,6078736,6078758,2337631,22,114,7,True,True,0.01974536666666667,-0.085079
4667,3741132,20,4,0.501823,246,3807883,-1,116.0,3908683,3908703,167551,20,190,7,True,True,0.08284333333333334,-0.501823
4668,3741765,21010,1,0.773825,246,3807883,-1,12.0,7171030,7192040,3429265,21010,74,10,True,True,6.551386666666668,-0.7700449383918699
4669,3741794,1379,32,0.130375,246,3807883,-1,448.0,5674584,5675963,1932790,1379,128,12,True,True,9.14503768888889,-0.130375
4670,3741818,8052,16,0.134871,246,3807883,-1,144.0,8672501,8680553,4930683,8052,6,6,True,True,21.1325796,-0.1341651855363075
4671,3742130,11773,256,0.559296,246,3807883,-1,2560.0,4254643,4266416,512513,11773,178,1,True,True,1539.1684835555557,-0.5108329177255121
4672,3742226,27737,2,0.487861,246,3807883,-1,30.0,8440642,8468379,4698416,27737,19,8,True,True,15.922254416666664,-0.4654090247014006
4673,3744910,24,1,0.652248,246,3807883,-1,47.0,4010583,4010607,265673,24,190,8,True,True,0.027961866666666668,-0.652248
4674,3745166,37,4,0.196099,246,3807883,-1,152.0,6680219,6680256,2935053,37,99,11,True,True,0.20032375555555554,-0.196099
4675,3745225,5,16,0.615997,246,3807883,-1,800.0,4944816,4944821,1199591,5,160,7,True,True,0.15843333333333334,-0.615997
4676,3745556,5180,2,0.735668,246,3807883,-1,42.0,5473384,5478564,1727828,5180,137,9,True,True,4.072404466666667,-0.6964451691093019
4677,3745892,345,7,0.246246,246,3807883,-1,91.0,4488116,4488461,742224,345,175,11,True,True,0.23781712500000002,-0.246246
4678,3745926,7556,18,0.071644,246,3807883,-1,774.0,6393566,6401122,2647640,7556,110,1,True,True,94.908912,-0.07028643530188614
4679,3746126,1346,1,0.776772,246,3807883,-1,38.0,6954019,6955365,3207893,1346,90,12,True,True,1.5560692833333334,-0.7710159401501397
4680,3746157,12869,5,0.323412,246,3807883,-1,25.0,4510216,4523085,764059,12869,177,10,True,True,8.272309375,-0.31729215094231467
4681,3746241,9785,64,0.924138,246,3807883,-1,2816.0,4943016,4952801,1196775,9785,164,2,True,True,1062.4655203555556,-0.9187730089052613
4682,3746249,7103,1,0.089595,246,3807883,-1,10.0,4006083,4013186,259834,7103,200,10,True,True,2.0795526944444447,-0.0856886765071497
4683,3755003,82,3,0.671748,246,3807883,-1,39.0,8539501,8539583,4784498,82,14,2,True,True,0.07461111666666667,-0.671748
4684,3755163,75,16,0.423541,246,3807883,-1,688.0,5329080,5329155,1573917,75,148,7,True,True,0.6527399999999999,-0.423541
4685,3755216,149,15,0.348308,246,3807883,-1,75.0,7566120,7566269,3810904,149,56,10,True,True,0.34201708333333336,-0.348308
4686,3755303,664,1,0.320738,246,3807883,-1,49.0,4956516,4957180,1201213,664,163,0,True,True,1.3000843333333334,-0.320738
4687,3755563,12,7,0.593877,246,3807883,-1,154.0,8783001,8783013,5027438,12,4,10,True,True,0.04733446666666666,-0.593877
4688,3755616,5197,2,0.024207,246,3807883,-1,72.0,4842216,4847413,1086600,5197,174,11,True,True,3.3302851999999996,-0.024194446119361113
4689,3755685,162,1,0.304819,246,3807883,-1,12.0,6844619,6844781,3088934,162,96,11,True,True,0.073089,-0.304819
4690,3755779,25,4,0.987652,246,3807883,-1,44.0,7422720,7422745,3666941,25,64,10,True,True,0.02708138888888888,-0.987652
4691,3755886,133,1,0.616221,246,3807883,-1,39.0,4934016,4934149,1178130,133,174,2,True,True,0.14542330833333336,-0.616221
4692,3756006,65,1,0.990159,246,3807883,-1,18.0,7981820,7981885,4225814,65,48,10,True,True,0.029727749999999994,-0.990159
4693,3756031,311,16,0.44221,246,3807883,-1,800.0,7148619,7148930,3392588,311,83,9,True,True,6.934608888888889,-0.4422100000000001
4694,3756055,4751,128,0.145818,246,3807883,-1,1792.0,8638701,8643452,4882646,4751,11,7,True,True,157.08658062222224,-0.14400153819132738
4695,3756222,13626,35,0.044878,246,3807883,-1,315.0,6845519,6859145,3089297,13626,99,6,True,True,160.075470625,-0.04419909169497624
4696,3756261,33,32,0.818172,246,3807883,-1,1408.0,5188580,5188613,1432319,33,161,7,True,True,0.35157759999999993,-0.818172
4697,3756506,69,2,0.199685,246,3807883,-1,88.0,7216130,7216199,3459624,69,81,6,True,True,0.14141013333333333,-0.199685
4698,3756759,40,8,0.373821,246,3807883,-1,312.0,5728686,5728726,1971927,40,139,11,True,True,0.27404,-0.373821
4699,3756843,17162,1,0.757734,246,3807883,-1,14.0,7263930,7281092,3507087,17162,79,7,True,True,5.859516755555556,-0.7485669550946662
4700,3756862,6542,32,0.852764,246,3807883,-1,160.0,5978455,5984997,2221593,6542,134,12,True,True,32.276876,-0.8019489213325666
4701,3756895,3,1,0.112372,246,3807883,-1,40.0,4928616,4928619,1171721,3,186,12,True,True,0.0023030000000000004,-0.112372
4702,3756915,8,32,0.054538,246,3807883,-1,1472.0,5162880,5162888,1405965,8,168,8,True,True,0.25050168888888885,-0.054538
4703,3757054,179,8,0.948941,246,3807883,-1,360.0,4207340,4207519,450286,179,213,12,True,True,1.194825,-0.948941
4704,3757085,210,1,0.92673,246,3807883,-1,18.0,6635119,6635329,2878034,210,113,1,True,True,0.031132499999999997,-0.92673
4705,3762278,398,1,0.868752,246,3807883,-1,5.0,6393168,6393566,2630890,398,124,8,True,True,0.028186138888888893,-0.868752
4706,3762315,1072,16,0.820134,246,3807883,-1,384.0,5677284,5678356,1914969,1072,147,6,True,True,6.372539733333333,-0.820134
4707,3762596,873,2,0.013733,246,3807883,-1,32.0,8979701,8980574,5217105,873,0,10,True,True,0.42245439999999995,-0.013733
4708,3762738,3561,13,0.693795,246,3807883,-1,182.0,8592701,8596262,4829963,3561,14,0,True,True,17.99378591111111,-0.6933769918340938
4709,3763357,38,8,0.111278,246,3807883,-1,224.0,6258968,6259006,2495611,38,130,11,True,True,0.14872355555555555,-0.111278
4710,3763829,30,16,0.450062,246,3807883,-1,800.0,3815083,3815113,51254,30,236,2,True,True,0.6025333333333334,-0.450062
4711,3763901,3,1,0.022748,246,3807883,-1,35.0,6714019,6714022,2950118,3,107,5,True,True,0.002817791666666667,-0.022748
4712,3764374,127,1,0.20901,246,3807883,-1,45.0,5676384,5676511,1912010,127,153,7,True,True,0.08459787499999999,-0.20901
4713,3764568,25,1,0.538005,246,3807883,-1,45.0,7466920,7466945,3702352,25,68,11,True,True,0.037793749999999994,-0.538005
4714,3765006,404,1,0.203801,246,3807883,-1,8.0,5374180,5374584,1609174,404,168,11,True,True,0.029088,-0.203801
4715,3765081,180,8,0.523266,246,3807883,-1,368.0,7989020,7989200,4223939,180,51,9,True,True,1.704392,-0.523266
4716,3765135,8,64,0.258658,246,3807883,-1,2432.0,8784801,8784809,5019666,8,5,7,True,True,0.4974791111111111,-0.258658
4717,3765185,10,13,0.483026,246,3807883,-1,364.0,6575566,6575576,2810381,10,125,12,True,True,0.09147522222222222,-0.483026
4718,3766817,15506,16,0.729924,246,3807883,-1,192.0,8084442,8099948,4317625,15506,48,12,True,True,63.194889599999996,-0.6781428349216125
2412,2106290,17,16,0.418239,1,2106290,-1,320.0,2128390,2128407,22100,17,0,10,True,True,0.1849751111111111,-0.418239
2413,2106514,39,2,0.137867,62,2128390,-1,84.0,4300560,4300599,2194046,39,0,8,True,True,0.06917820000000001,-0.137867
2414,2107603,2989,8,0.38371,62,2128390,-1,56.0,4648260,4651249,2540657,2989,0,2,True,True,7.3389880666666665,-0.3429355968276864
2415,2108333,8303,4,0.185754,62,2128390,-1,64.0,6201262,6209565,4092929,8303,0,8,True,True,6.737988444444444,-0.1846519691421271
2416,2108437,24111,8,0.635502,62,2128390,-1,128.0,6074562,6098673,3966125,24111,1,8,True,True,144.07364053333333,-0.6040510595323194
2417,2108484,12,32,0.693433,62,2128390,-1,992.0,3631948,3631960,1523464,12,4,0,True,True,0.7583178666666668,-0.693433
2418,2108758,197,16,0.64526,62,2128390,-1,128.0,2459105,2459302,350347,197,5,9,True,True,1.2586286222222223,-0.64526
2419,2108788,39,8,0.9999,62,2128390,-1,64.0,2172590,2172629,63802,39,6,11,True,True,0.0882752,-0.9999
2420,2108947,3,8,0.554913,62,2128390,-1,312.0,5461871,5461874,3352924,3,2,9,True,True,0.0258752,-0.554913
2421,2108974,32,32,0.489642,62,2128390,-1,1440.0,5756971,5757003,3647997,32,2,8,True,True,0.468864,-0.489642
2422,2109516,18,16,0.140297,62,2128390,-1,624.0,4511360,4511378,2401844,18,5,8,True,True,0.1840488,-0.14029700000000003
2423,2111377,14909,1,0.31458,62,2128390,-1,10.0,5973762,5988671,3862385,14909,2,11,True,True,5.6130218888888885,-0.28868993635176793
2424,2112022,3,1,0.451001,62,2128390,-1,16.0,6227925,6227928,4115903,3,0,8,True,True,0.0010232000000000002,-0.4510010000000001
2425,2112643,18751,1,0.053611,62,2128390,-1,30.0,6118762,6137513,4006119,18751,2,11,True,True,40.68467116666666,-0.05125026874827239
2426,2113179,13130,1,0.359039,62,2128390,-1,19.0,4304160,4317290,2190981,13130,9,8,True,True,5.32799425,-0.3528381563013352
2427,2113265,28,16,0.009583,62,2128390,-1,656.0,2242490,2242518,129225,28,13,11,True,True,0.9251349333333333,-0.009583
2428,2113530,9,2,0.136535,62,2128390,-1,40.0,2734405,2734414,620875,9,12,10,True,True,0.008848,-0.136535
2429,2113630,12319,142,0.815216,62,2128390,-1,2698.0,2591705,2604024,478075,12319,13,11,True,True,1521.2208194555556,-0.7622756657381322
2430,2113724,4,14,0.963829,62,2128390,-1,210.0,4396160,4396164,2282436,4,9,0,True,True,0.03579333333333334,-0.963829
2431,2113880,30,1,0.505438,62,2128390,-1,21.0,2782205,2782235,668325,30,13,0,True,True,0.01352225,-0.505438
2432,2113923,63,1,0.49497,62,2128390,-1,22.0,6802188,6802251,4688265,63,0,11,True,True,0.0347424,-0.49497
2433,2114019,3743,64,0.684697,62,2128390,-1,2112.0,3212309,3216052,1098290,3743,14,11,True,True,247.25157013333336,-0.5506374816464035
2434,2114322,7782,32,0.41563,62,2128390,-1,640.0,6074562,6082344,3960240,7782,4,0,True,True,312.89182933333336,-0.3946228150907997
2435,2114423,162,1,0.839892,62,2128390,-1,19.0,2708705,2708867,594282,162,18,0,True,True,0.14619645,-0.839892
2436,2114439,8491,1,0.4887,62,2128390,-1,33.0,6661488,6669979,4547049,8491,1,10,True,True,8.714355466666667,-0.4816807920587759
2437,2114630,20986,16,0.082671,62,2128390,-1,112.0,4374060,4395046,2259430,20986,13,11,True,True,59.587889511111115,-0.08059398305366483
2438,2114633,6696,8,0.030861,62,2128390,-1,288.0,2688005,2694701,573372,6696,21,3,True,True,52.73199999999999,-0.029435230066782662
2439,2115210,34,1,0.761057,62,2128390,-1,9.0,5551871,5551905,3436661,34,9,1,True,True,0.00336515,-0.761057
2440,2115263,60,1,0.29209,62,2128390,-1,31.0,2325062,2325122,209799,60,25,8,True,True,0.05639416666666667,-0.29209
2441,2115285,85,1,0.274853,62,2128390,-1,9.0,4511360,4511445,2396075,85,12,0,True,True,0.012535375,-0.274853
2442,2117492,9,14,0.537609,62,2128390,-1,658.0,6070962,6070971,3953470,9,7,12,True,True,0.41412875000000005,-0.537609
2443,2117508,17722,1,0.168209,62,2128390,-1,30.0,5722271,5739993,3604763,17722,10,9,True,True,8.376264666666666,-0.163233677404695
2444,2117559,200,4,0.457321,62,2128390,-1,32.0,4296960,4297160,2179401,200,20,9,True,True,0.11363555555555555,-0.457321
2445,2117770,10177,85,0.742518,62,2128390,-1,1785.0,2678105,2688282,560335,10177,27,12,True,True,638.9156806666666,-0.6680122782913116
2446,2117824,8,32,0.76592,62,2128390,-1,864.0,4241960,4241968,2124136,8,21,1,True,True,0.0750528,-0.76592
2447,2117897,13108,8,0.549726,62,2128390,-1,136.0,2417205,2430313,299308,13108,31,1,True,True,62.92373577777778,-0.5116578812236278
2448,2117914,7364,8,0.113211,62,2128390,-1,168.0,5850603,5857967,3732689,7364,9,12,True,True,31.19298046666667,-0.08714002171333043
2449,2117989,8629,5,0.114207,62,2128390,-1,215.0,6215696,6224325,4097707,8629,3,8,True,True,24.556775638888887,-0.11394056438849927
2450,2118041,4874,32,0.775113,62,2128390,-1,1184.0,5922337,5927211,3804296,4874,10,11,True,True,258.1620832,-0.7709162499977698
2451,2118061,719,4,0.823283,62,2128390,-1,160.0,2786705,2787424,668644,719,27,6,True,True,2.774700888888889,-0.823283
2452,2118189,8698,1,0.366862,62,2128390,-1,47.0,4621660,4630358,2503471,8698,17,10,True,True,6.209313872222222,-0.29697812228669535
2453,2119686,8688,2,0.822611,62,2128390,-1,56.0,5160324,5169012,3040638,8688,16,10,True,True,12.241096,-0.7641113145997102
2454,2119735,139,1,0.041611,62,2128390,-1,19.0,3504409,3504548,1384674,139,28,10,True,True,0.028948294444444446,-0.041611
2455,2119857,8904,106,0.71898,62,2128390,-1,2226.0,2288490,2297394,168633,8904,40,7,True,True,630.9925705999999,-0.6372681692761228
2456,2120189,19141,1,0.546353,62,2128390,-1,34.0,3701848,3720989,1581659,19141,27,11,True,True,38.77396786111112,-0.5293519463303586
2457,2120488,210,59,0.989776,62,2128390,-1,649.0,3832448,3832658,1711960,210,27,12,True,True,5.006386000000001,-0.989776
2458,2120501,11,4,0.102416,62,2128390,-1,184.0,6168362,6168373,4047861,11,5,7,True,True,0.11209024444444445,-0.10241599999999998
2459,2120528,857,1,0.830071,62,2128390,-1,23.0,2321462,2322319,200934,857,43,0,True,True,0.5163362638888889,-0.7171631597653663
2460,2120571,19559,9,0.751345,62,2128390,-1,396.0,2547505,2567064,426934,19559,40,11,True,True,306.41688109999996,-0.7303804078471728
2461,2120598,31,4,0.297709,62,2128390,-1,80.0,5451071,5451102,3330473,31,17,11,True,True,0.07411066666666667,-0.297709
2462,2121350,12,1,0.999313,62,2128390,-1,48.0,6204896,6204908,4083546,12,4,2,True,True,0.007136000000000001,-0.999313
2463,2121572,14650,128,0.449732,62,2128390,-1,2048.0,3008209,3022859,886637,14650,35,1,True,True,433.94827377777773,-0.4374236907371055
2464,2121578,235,1,0.348577,62,2128390,-1,9.0,4504160,4504395,2382582,235,24,9,True,True,0.042535,-0.348577
2465,2124500,112,2,0.816729,62,2128390,-1,100.0,5648371,5648483,3523871,112,16,6,True,True,0.07765083333333334,-0.7861511585002204
2466,2124543,239,4,0.43907,62,2128390,-1,164.0,5714171,5714410,3589628,239,16,11,True,True,0.42244577777777775,-0.43907
2467,2124689,6917,15,0.993958,62,2128390,-1,600.0,5272661,5279578,3147972,6917,21,1,True,True,67.41621333333333,-0.9756491275595232
2468,2124740,12,1,0.775632,62,2128390,-1,10.0,2683505,2683517,558765,12,45,1,True,True,0.0040550000000000004,-0.775632
2469,2124925,6261,128,0.236946,62,2128390,-1,3072.0,4329860,4336121,2204935,6261,30,10,True,True,362.7386624,-0.22394710725103667
2470,2124997,143,4,0.810703,62,2128390,-1,56.0,2417062,2417205,292065,143,52,0,True,True,0.3004112222222222,-0.810703
2471,2125054,13211,4,0.587924,62,2128390,-1,72.0,6222896,6236107,4097842,13211,3,8,True,True,20.0982444,-0.5621041501787691
2472,2125176,104,4,0.350631,62,2128390,-1,40.0,6219296,6219400,4094120,104,4,2,True,True,0.05019733333333333,-0.350631
2473,2125179,31,1,0.710754,62,2128390,-1,41.0,5406871,5406902,3281692,31,23,11,True,True,0.007301188888888889,-0.710754
2474,2125414,19212,16,0.632771,62,2128390,-1,288.0,4140948,4160160,2015534,19212,38,11,True,True,78.6326112,-0.5810953582537952
2475,2132350,15615,1,0.165982,108,2172590,-1,39.0,4897824,4913439,2765474,15615,26,11,True,True,10.17560505,-0.15073654131576872
2476,2132729,25,64,0.139235,108,2172590,-1,960.0,3168109,3168134,1035380,25,45,8,True,True,0.35619999999999996,-0.139235
2477,2132819,14871,256,0.20662,108,2172590,-1,9728.0,6961437,6976308,4828618,14871,0,12,True,True,1647.9255509333334,-0.20567839134067853
2478,2134008,14246,1,0.206943,108,2172590,-1,28.0,6825437,6839683,4691429,14246,1,1,True,True,12.393629811111111,-0.17693963260857917
2479,2134043,15,2,0.059358,108,2172590,-1,48.0,2782205,2782220,648162,15,51,11,True,True,0.015454,-0.059358
2480,2134317,25475,128,0.350815,108,2172590,-1,3840.0,2286690,2312165,152373,25475,65,11,True,True,2882.757386666666,-0.3442211029986776
2481,2134804,225,8,0.281085,108,2172590,-1,72.0,2444705,2444930,309901,225,60,7,True,True,0.895635,-0.281085
2482,2134927,18621,64,0.538769,108,2172590,-1,2880.0,2785805,2804426,650878,18621,50,8,True,True,1370.5766319999998,-0.5386582324349585
2483,2134934,7127,2,0.323654,108,2172590,-1,58.0,5929562,5936689,3794628,7127,16,7,True,True,19.17408772777778,-0.31920737500483043
2484,2134970,77,1,0.704054,108,2172590,-1,23.0,4403360,4403437,2268390,77,35,9,True,True,0.060459972222222214,-0.7040540000000001
2485,2135214,3631,41,0.289333,108,2172590,-1,1927.0,6756188,6759819,4620974,3631,3,7,True,True,152.74541606388888,-0.21808844669155195
2486,2135239,16457,1,0.267343,108,2172590,-1,5.0,6459388,6475845,4324149,16457,5,1,True,True,1.7447175833333333,-0.26376257623363164
2487,2135398,391,8,0.858017,108,2172590,-1,104.0,5086824,5087215,2951426,391,31,9,True,True,2.029585422222222,-0.858017
2488,2135495,20,64,0.985488,108,2172590,-1,1664.0,4163048,4163068,2027553,20,46,10,True,True,0.7997368888888889,-0.985488
2489,2135551,18,1,0.679299,108,2172590,-1,44.0,6197662,6197680,4062111,18,12,10,True,True,0.009290599999999998,-0.679299
2490,2135886,4,32,0.095225,108,2172590,-1,960.0,6166562,6166566,4030676,4,14,11,True,True,0.22907733333333333,-0.095225
2491,2136844,10695,140,0.962772,108,2172590,-1,5180.0,4804560,4815255,2667716,10695,35,10,True,True,2055.7311308333333,-0.9622191945574522
2492,2139597,62,2,0.785691,108,2172590,-1,36.0,4842755,4842817,2703158,62,35,7,True,True,0.0556822,-0.785691
2493,2139648,15967,16,0.918769,108,2172590,-1,304.0,6074562,6090529,3934914,15967,16,0,True,True,255.96082897777777,-0.8749598393739507
2494,2139768,17844,2,0.992486,108,2172590,-1,40.0,5548271,5566115,3408503,17844,29,12,True,True,7.970388333333334,-0.9720178303517655
2495,2139994,19,10,0.867048,108,2172590,-1,420.0,4207248,4207267,2067254,19,52,11,True,True,0.107198,-0.8670480000000003
2496,2140004,18,1,0.126888,108,2172590,-1,29.0,6122362,6122380,3982358,18,15,8,True,True,0.0440336,-0.126888
2497,2140073,70,32,0.866079,108,2172590,-1,672.0,3631948,3632018,1491875,70,59,8,True,True,2.996578666666667,-0.866079
2498,2140389,2,16,0.249677,108,2172590,-1,576.0,4993224,4993226,2852835,2,37,12,True,True,0.023676799999999998,-0.249677
2499,2140483,10688,1,0.711395,108,2172590,-1,39.0,3160909,3171597,1020426,10688,64,12,True,True,8.776922375,-0.708942779002675
2500,2147589,73,8,0.828482,108,2172590,-1,184.0,4846355,4846428,2698766,73,39,8,True,True,0.3550525333333333,-0.828482
2501,2148088,63,16,0.761474,108,2172590,-1,608.0,2873105,2873168,725017,63,67,12,True,True,0.7100072000000001,-0.761474
2502,2148106,8109,128,0.676235,108,2172590,-1,1536.0,6175562,6183671,4027456,8109,13,9,True,True,149.78292053333334,-0.6694957352956813
2503,2148766,53,2,0.489459,108,2172590,-1,80.0,6448525,6448578,4299759,53,6,7,True,True,0.049572666666666675,-0.489459
2504,2150347,22243,64,0.577426,108,2172590,-1,1920.0,4643760,4666003,2493413,22243,45,10,True,True,1864.0614453333335,-0.5499451926286121
2505,2150391,9,1,0.268717,108,2172590,-1,11.0,4396160,4396169,2245769,9,52,10,True,True,0.0042185,-0.268717
2506,2150734,417,32,0.414225,108,2172590,-1,448.0,4818855,4819272,2668121,417,43,8,True,True,3.584272533333333,-0.414225
2507,2150755,1489,1,0.451992,108,2172590,-1,5.0,5603271,5604760,3452516,1489,31,9,True,True,0.06826651388888888,-0.451992
2508,2151909,206,1,0.633628,108,2172590,-1,25.0,4806360,4806566,2654451,206,45,7,True,True,0.19272444444444445,-0.633628
2509,2155978,12334,64,0.880125,108,2172590,-1,2816.0,3836048,3848382,1680070,12334,65,8,True,True,872.5571242666665,-0.8170746691307917
2510,2156228,71,1,0.093095,108,2172590,-1,34.0,2738005,2738076,581777,71,80,2,True,True,0.06366925,-0.093095
2511,2156396,10,2,0.515613,108,2172590,-1,60.0,3614848,3614858,1458452,10,70,10,True,True,0.029134999999999998,-0.515613
2512,2156730,10,2,0.278226,108,2172590,-1,26.0,2706005,2706015,549275,10,84,9,True,True,0.010187666666666666,-0.278226
2513,2159566,9504,4,0.936336,108,2172590,-1,120.0,3746048,3755552,1586482,9504,67,0,True,True,72.30416,-0.9362580995205986
2514,2159629,64,2,0.369071,108,2172590,-1,36.0,6360325,6360389,4200696,64,7,11,True,True,0.024806399999999996,-0.369071
2515,2160021,9,16,0.950254,108,2172590,-1,176.0,2921805,2921814,761784,9,78,11,True,True,0.0147576,-0.950254
2516,2160104,10,1,0.327289,108,2172590,-1,50.0,6635788,6635798,4475684,10,5,12,True,True,0.006490277777777777,-0.32728899999999994
2517,2160248,10513,32,0.002473,108,2172590,-1,320.0,4210848,4221361,2050600,10513,64,8,True,True,47.814969777777776,-0.0023738218602311688
2518,2168533,11303,32,0.774135,108,2172590,-1,192.0,5454671,5465974,3286138,11303,37,8,True,True,62.70947946666667,-0.7684341702274025
2519,2170528,45,1,0.732724,108,2172590,-1,24.0,6316125,6316170,4145597,45,9,7,True,True,0.026088,-0.732724
2520,2171776,42,1,0.730932,108,2172590,-1,35.0,3657648,3657690,1485872,42,74,10,True,True,0.10299391666666668,-0.7309319999999999
2521,2172033,50,32,0.458449,108,2172590,-1,384.0,2194690,2194740,22657,50,107,10,True,True,1.2669866666666667,-0.458449
2522,2177531,42,1,0.664144,154,2194690,-1,33.0,4599560,4599602,2422029,42,54,7,True,True,0.014148750000000002,-0.664144
2523,2177773,9989,34,0.358223,154,2194690,-1,1190.0,6212096,6222085,4034323,9989,14,9,True,True,148.09212172222223,-0.328459648197927
2524,2178120,19,1,0.063331,154,2194690,-1,40.0,5669971,5669990,3491851,19,34,9,True,True,0.0038548888888888895,-0.063331
2525,2179651,3,2,0.534424,154,2194690,-1,26.0,2876705,2876708,697054,3,87,8,True,True,0.0014081166666666666,-0.534424
2526,2179836,44885,1,0.21783,154,2194690,-1,38.0,5655571,5700456,3475735,44885,35,9,True,True,13.400819172222223,-0.20711364221772322
2527,2180791,11359,1,0.429643,154,2194690,-1,29.0,4842755,4854114,2661964,11359,50,0,True,True,9.280614719444445,-0.3979182120027482
2528,2180801,34,4,0.211851,154,2194690,-1,24.0,6204862,6204896,4024061,34,16,8,True,True,0.010109333333333335,-0.211851
2529,2180879,7170,1,0.268537,154,2194690,-1,16.0,5927762,5934932,3746883,7170,30,8,True,True,5.1845360000000005,-0.26201525998002106
2530,2181396,263,8,0.828344,154,2194690,-1,192.0,3988248,3988511,1806852,263,77,12,True,True,0.5809845333333333,-0.828344
2531,2181471,25629,33,0.337755,154,2194690,-1,297.0,3482309,3507938,1300838,25629,87,12,True,True,103.34103202499998,-0.3365987362586585
2532,2181633,26487,1,0.577934,154,2194690,-1,36.0,5924162,5950649,3742529,26487,31,1,True,True,43.9689104,-0.5708714915812481
2533,2181686,17746,1,0.566142,154,2194690,-1,11.0,6452188,6469934,4270502,17746,7,1,True,True,3.919567055555555,-0.5624313843376054
2534,2181740,275,8,0.485338,154,2194690,-1,72.0,3843248,3843523,1661508,275,80,9,True,True,0.556105,-0.485338
2535,2183780,63,32,0.34374,154,2194690,-1,192.0,6452125,6452188,4268345,63,8,7,True,True,0.22018080000000004,-0.34374
2536,2186989,42441,32,0.682552,154,2194690,-1,1408.0,3619348,3661789,1432359,42441,89,1,True,True,3496.1489454222215,-0.6616539356401404
2537,2187170,35360,128,0.048409,154,2194690,-1,6272.0,6754388,6789748,4567218,35360,4,7,True,True,4284.020468622222,-0.046769393775314874
2538,2187180,3613,4,0.099575,154,2194690,-1,96.0,4307760,4311373,2120580,3613,73,8,True,True,7.683646666666667,-0.09957500000000002
2539,2187316,13,42,0.78389,154,2194690,-1,840.0,3504548,3504561,1317232,13,93,1,True,True,0.11969533333333333,-0.78389
2540,2187337,81,16,0.459582,154,2194690,-1,592.0,4692460,4692541,2505123,81,61,0,True,True,1.4201784,-0.459582
2541,2187483,4,1,0.124237,154,2194690,-1,21.0,3628348,3628352,1440865,4,92,7,True,True,0.004828600000000001,-0.124237
2542,2187802,222,4,0.857652,154,2194690,-1,92.0,3626548,3626770,1438746,222,93,9,True,True,1.1740396,-0.857652
2543,2187819,142,16,0.441286,154,2194690,-1,144.0,3395909,3396051,1208090,142,99,12,True,True,1.3754687999999997,-0.441286
2544,2187867,9,1,0.000676,154,2194690,-1,6.0,4410560,4410569,2222693,9,69,9,True,True,0.00268965,-0.000676
2545,2188238,603,1,0.958032,154,2194690,-1,41.0,2503305,2503908,315067,603,121,11,True,True,1.24727535,-0.958032
2546,2189734,3130,32,0.202318,154,2194690,-1,1216.0,5764203,5767333,3574469,3130,37,8,True,True,68.85352408888889,-0.09437756275654247
2547,2189831,55185,1,0.688592,154,2194690,-1,49.0,5359071,5414256,3169240,55185,51,1,True,True,59.38074963333334,-0.6645564402112663
2548,2190353,4,32,0.131913,154,2194690,-1,1376.0,6639388,6639392,4449035,4,6,0,True,True,0.12769279999999997,-0.131913
2549,2190388,645,6,0.649997,154,2194690,-1,174.0,2708705,2709350,518317,645,118,6,True,True,5.33061325,-0.649997
2550,2190559,1,8,0.158977,154,2194690,-1,112.0,6757988,6757989,4567429,1,3,7,True,True,0.0021326666666666664,-0.158977
2551,2190639,2713,2,0.932726,154,2194690,-1,18.0,2394962,2397675,204323,2713,131,11,True,True,1.7805947999999996,-0.8540265914532704
2552,2190992,4281,32,0.274019,154,2194690,-1,800.0,2782205,2786486,591213,4281,115,0,True,True,76.9082288888889,-0.25773971066708645
2553,2191522,74,1,0.654588,154,2194690,-1,37.0,2310588,2310662,119066,74,135,9,True,True,0.07146940555555556,-0.654588
2554,2191699,664,1,0.250389,154,2194690,-1,14.0,2319662,2320326,127963,664,135,9,True,True,0.22078,-0.250389
2555,2192292,119,8,0.371844,154,2194690,-1,376.0,3746048,3746167,1553756,119,93,11,True,True,2.6326872444444445,-0.371844
2556,2192359,69,1,0.9038,154,2194690,-1,5.0,4853555,4853624,2661196,69,59,8,True,True,0.012457375,-0.9038
2557,2192404,5243,16,0.165525,154,2194690,-1,464.0,2350762,2356005,158358,5243,135,8,True,True,99.5662091111111,-0.1527558312422821
2558,2192462,6613,128,0.396342,154,2194690,-1,1152.0,2707805,2714418,515343,6613,123,7,True,True,360.1276768,-0.39579283431185774
2559,2193211,15,4,0.305509,154,2194690,-1,24.0,6730488,6730503,4537277,15,6,7,True,True,0.016454,-0.305509
2560,2193371,9234,32,0.699441,154,2194690,-1,224.0,2708705,2717939,515334,9234,122,0,True,True,87.90723946666667,-0.6669982274202858
2561,2193805,9,1,0.234144,154,2194690,-1,40.0,6549388,6549397,4355583,9,10,1,True,True,0.0043549999999999995,-0.234144
2562,2193848,46,8,0.655485,154,2194690,-1,88.0,2198290,2198336,4442,46,147,8,True,True,0.2588696,-0.655485
2563,2193938,41,1,0.703698,154,2194690,-1,41.0,5657371,5657412,3463433,41,46,7,True,True,0.011183319444444445,-0.7036979999999999
2564,2193984,79,1,0.001086,154,2194690,-1,39.0,6871437,6871516,4677453,79,1,7,True,True,0.04179034166666667,-0.001086
2565,2193987,10037,32,0.476807,154,2194690,-1,800.0,3506348,3516385,1312361,10037,107,7,True,True,82.32684888888889,-0.44775995605757773
2566,2193998,237,32,0.1327,154,2194690,-1,448.0,5272424,5272661,3078426,237,59,12,True,True,1.7855263999999997,-0.1327
2567,2194621,25,1,0.226191,154,2194690,-1,5.0,2439305,2439330,244684,25,140,10,True,True,0.005405902777777778,-0.22619099999999998
2568,2194663,77,1,0.679983,154,2194690,-1,22.0,2442905,2442982,248242,77,140,8,True,True,0.08141552222222222,-0.679983
2569,2194709,10,32,0.009287,164,2198290,-1,288.0,5647471,5647481,3452762,10,50,11,True,True,0.020744,-0.009287000000000002
2570,2194764,859,1,0.695597,164,2198290,-1,33.0,5984562,5985421,3789798,859,36,8,True,True,0.71009235,-0.695597
2571,2194836,28342,1,0.817109,164,2198290,-1,46.0,4692460,4720802,2497624,28342,74,11,True,True,56.24544455555556,-0.7843128434507851
2572,2194945,9,8,0.988155,164,2198290,-1,288.0,2691605,2691614,496660,9,135,4,True,True,0.06829199999999999,-0.988155
2573,2194955,18693,16,0.422314,164,2198290,-1,544.0,5548271,5566964,3353316,18693,54,0,True,True,112.79389386666668,-0.4138211793073444
2574,2195011,19,1,0.132175,164,2198290,-1,30.0,5922337,5922356,3727326,19,41,0,True,True,0.026163,-0.132175
2575,2195223,77,16,0.070828,164,2198290,-1,752.0,6728688,6728765,4533465,77,8,6,True,True,2.6465344888888884,-0.070828
2576,2195238,15430,32,0.38307,164,2198290,-1,1504.0,6869637,6885067,4674399,15430,2,11,True,True,403.21549831111105,-0.339772886676084
2577,2195505,32,4,0.730763,164,2198290,-1,104.0,2695205,2695237,499700,32,139,3,True,True,0.09346133333333333,-0.730763
2578,2195658,10815,128,0.102427,164,2198290,-1,2560.0,4219848,4230663,2024190,10815,97,7,True,True,396.93218133333335,-0.10121788174348831
2579,2195893,78,4,0.313351,164,2198290,-1,100.0,4096748,4096826,1900855,78,102,12,True,True,0.05701944444444444,-0.31295460404807074
2580,2206570,9594,128,0.880989,251,2242490,-1,4480.0,2300994,2310588,94424,9594,161,8,True,True,1120.56896,-0.8757334161129063
2581,2206573,16617,3,0.137129,251,2242490,-1,69.0,2877605,2894222,671032,16617,127,6,True,True,21.695334008333333,-0.1353452622691786
2582,2206646,72,32,0.77346,251,2242490,-1,1376.0,5662771,5662843,3456125,72,51,8,True,True,0.6605831999999999,-0.7483248881499396
2583,2206689,13325,2,0.753158,251,2242490,-1,28.0,2347162,2360487,140473,13325,159,10,True,True,14.427805,-0.7285700825758569
2584,2206734,10,1,0.133146,251,2242490,-1,28.0,5359061,5359071,3152327,10,65,12,True,True,0.0069782222222222225,-0.133146
2585,2206764,18494,1,0.99294,251,2242490,-1,38.0,3592748,3611242,1385984,18494,119,12,True,True,16.99906376666667,-0.8565578661212042
2586,2206779,1110,4,0.142853,251,2242490,-1,132.0,2312462,2313572,105683,1110,165,7,True,True,3.3719950000000005,-0.142853
2587,2206857,26637,32,0.530508,251,2242490,-1,1280.0,2712305,2738942,505448,26637,140,8,True,True,1009.9695111111112,-0.5062960626249753
2588,2207013,25,32,0.008475,251,2242490,-1,1472.0,5924137,5924162,3717124,25,43,7,True,True,1.68912,-0.008475
2589,2207065,18862,128,0.65002,251,2242490,-1,2944.0,4815255,4834117,2608190,18862,78,1,True,True,1318.2677955555555,-0.5760665942315549
2590,2207184,21992,4,0.440099,251,2242490,-1,160.0,2417062,2439054,209878,21992,162,10,True,True,140.03120711111112,-0.4257111276431854
2591,2207357,15,2,0.722432,251,2242490,-1,46.0,4644660,4644675,2437303,15,84,6,True,True,0.02029175,-0.722432
2592,2208090,232,1,0.62808,251,2242490,-1,33.0,4906824,4907056,2698734,232,72,9,True,True,0.13215106666666668,-0.62808
2593,2208115,17,13,0.151374,251,2242490,-1,403.0,6446725,6446742,4238610,17,18,12,True,True,0.10493448333333334,-0.151374
2594,2208129,286,16,0.41171,251,2242490,-1,640.0,5744371,5744657,3536242,286,50,10,True,True,1.8004017777777774,-0.41171
2595,2208414,12148,4,0.686566,251,2242490,-1,40.0,6455788,6467936,4247374,12148,15,8,True,True,10.127011555555557,-0.6863279244604646
2596,2208490,9,1,0.859963,251,2242490,-1,28.0,5186024,5186033,2977534,9,72,8,True,True,0.010061800000000001,-0.859963
2597,2208498,3658,1,0.086688,251,2242490,-1,16.0,5362671,5366329,3154173,3658,68,1,True,True,1.453456488888889,-0.08627460553831208
2598,2208577,29,29,0.100465,251,2242490,-1,986.0,5751571,5751600,3542994,29,51,9,True,True,0.26910131111111113,-0.100465
2599,2208764,14,2,0.752446,251,2242490,-1,98.0,5753371,5753385,3544607,14,51,7,True,True,0.0126567,-0.752446
2600,2208837,20,45,0.589574,251,2242490,-1,450.0,5182424,5182444,2973587,20,76,10,True,True,0.424,-0.589574
2601,2208985,23370,128,0.384032,251,2242490,-1,1536.0,5548271,5571641,3339286,23370,64,0,True,True,385.49899093333335,-0.3772684341174925
2602,2208989,13,16,0.963249,251,2242490,-1,112.0,5760603,5760616,3551614,13,50,8,True,True,0.02177933333333333,-0.963249
2603,2209089,77,2,0.314504,251,2242490,-1,18.0,4840955,4841032,2631866,77,88,10,True,True,0.03372599999999999,-0.314504
2604,2209115,20024,16,0.13983,251,2242490,-1,496.0,4289760,4309784,2080645,20024,113,11,True,True,198.3093422222222,-0.13503466339718798
2605,2209312,12,8,0.276968,251,2242490,-1,112.0,4241948,4241960,2032636,12,115,10,True,True,0.014593600000000003,-0.276968
2606,2209681,7,8,0.084249,251,2242490,-1,144.0,3898248,3898255,1688567,7,123,11,True,True,0.020106799999999998,-0.084249
2607,2209843,7,4,0.553397,251,2242490,-1,76.0,6752588,6752595,4542745,7,8,10,True,True,0.013554177777777777,-0.553397
2608,2209869,14334,200,0.600008,251,2242490,-1,7200.0,5757003,5771337,3547134,14334,52,1,True,True,2197.5936,-0.4760929977510603
2609,2210022,15128,16,0.607593,251,2242490,-1,528.0,2684405,2699533,474383,15128,169,6,True,True,242.92384453333335,-0.5783085441103943
2610,2210067,27,1,0.77897,251,2242490,-1,5.0,3309509,3309536,1099442,27,145,12,True,True,0.007402499999999999,-0.77897
2611,2210090,13392,4,0.690476,251,2242490,-1,56.0,4496960,4510352,2286870,13392,105,12,True,True,16.906499555555556,-0.6851558670052815
2612,2210114,5508,64,0.847892,251,2242490,-1,1664.0,3854048,3859556,1643934,5508,127,2,True,True,129.19493831111112,-0.6962890331624583
2613,2210138,12475,95,0.658405,251,2242490,-1,1900.0,2451905,2464380,241767,12475,179,9,True,True,1273.5997138888888,-0.650294576151822
2614,2210185,85,1,0.301649,251,2242490,-1,9.0,5596071,5596156,3385886,85,66,11,True,True,0.007620249999999999,-0.301649
2615,2210269,8658,16,0.517749,251,2242490,-1,336.0,6314325,6322983,4104056,8658,23,12,True,True,74.7550804,-0.5094069034626504
2616,2210293,1166,14,0.509523,251,2242490,-1,70.0,4010348,4011514,1800055,1166,127,10,True,True,1.4443372222222224,-0.4766407782999977
2617,2210526,487,5,0.747844,251,2242490,-1,125.0,2310662,2311149,100136,487,196,1,True,True,1.5890065972222223,-0.747844
2618,2210579,16,2,0.295542,251,2242490,-1,28.0,3052409,3052425,841830,16,154,11,True,True,0.011873244444444443,-0.295542
2619,2210710,57968,83,0.054569,251,2242490,-1,498.0,6545788,6603756,4335078,57968,15,12,True,True,574.3700928000001,-0.05452067599103193
2620,2210889,7752,64,0.897913,251,2242490,-1,1664.0,6224325,6232077,4013436,7752,26,1,True,True,280.6232277333333,-0.88617899246104
2621,2210918,5,2,0.954672,251,2242490,-1,90.0,3074509,3074514,863591,5,156,10,True,True,0.007730000000000001,-0.9546719999999999
2622,2211017,122,4,0.494888,251,2242490,-1,132.0,2698805,2698927,487788,122,176,2,True,True,0.6102968666666668,-0.494888
2623,2211488,280,3,0.112744,251,2242490,-1,87.0,2321462,2321742,109974,280,199,7,True,True,0.57855,-0.112744
2624,2211789,27,2,0.499583,251,2242490,-1,80.0,6639388,6639415,4427599,27,13,8,True,True,0.05011199999999999,-0.499583
2625,2211797,10983,64,0.59393,251,2242490,-1,2304.0,6727788,6738771,4515991,10983,11,11,True,True,1132.5619583999999,-0.5855069334099023
2626,2211812,15454,1,0.528287,251,2242490,-1,34.0,5856003,5871457,3644191,15454,54,2,True,True,20.33677775555556,-0.5272736373437591
2627,2211845,4,4,0.977697,251,2242490,-1,72.0,3008205,3008209,796360,4,162,12,True,True,0.0046424,-0.9776970000000003
2628,2211964,343,32,0.986883,251,2242490,-1,192.0,5715071,5715414,3503107,343,64,6,True,True,0.7097813333333334,-0.986883
2629,2211969,76,4,0.933924,251,2242490,-1,104.0,4899624,4899700,2687655,76,93,7,True,True,0.0926744,-0.933924
2630,2211985,12454,1,0.131983,251,2242490,-1,36.0,4849955,4862409,2637970,12454,96,2,True,True,13.7309385,-0.13069023073701486
2631,2212785,6,32,0.860814,251,2242490,-1,1184.0,4599560,4599566,2386775,6,111,0,True,True,0.07252,-0.860814
2632,2217450,13,4,0.56838,251,2242490,-1,152.0,5079624,5079637,2862174,13,91,12,True,True,0.12072811111111109,-0.56838
2633,2217922,28,64,0.365412,251,2242490,-1,2816.0,5852403,5852431,3634481,28,55,7,True,True,1.616822044444444,-0.365412
2634,2218080,3,8,0.682942,251,2242490,-1,120.0,4218048,4218051,1999968,3,133,9,True,True,0.0058390000000000004,-0.682942
2635,2218177,21171,128,0.762726,251,2242490,-1,2944.0,4507760,4528931,2289583,21171,117,8,True,True,1021.4740700444444,-0.7261594016608448
2636,2218200,4916,16,0.954453,251,2242490,-1,624.0,4096748,4101664,1878548,4916,139,0,True,True,22.424077866666664,-0.9537075478412119
2637,2218257,19,32,0.770367,251,2242490,-1,640.0,2297394,2297413,79137,19,218,2,True,True,0.3477084444444445,-0.770367
2638,2218294,549,1,0.016689,251,2242490,-1,26.0,3746048,3746597,1527754,549,149,0,True,True,0.8398663,-0.016689
2639,2218364,346,27,0.067533,251,2242490,-1,1323.0,6683588,6683934,4465224,346,12,10,True,True,14.8389885,-0.067533
2640,2218378,6,1,0.262185,251,2242490,-1,50.0,3223109,3223115,1004731,6,167,8,True,True,0.016803333333333333,-0.262185
2641,2218446,1149,8,0.039827,251,2242490,-1,216.0,6824288,6825437,4605842,1149,4,10,True,True,11.852164799999999,-0.039827
2642,2220087,297,16,0.060469,251,2242490,-1,576.0,5094024,5094321,2873937,297,93,9,True,True,7.7405327999999995,-0.060469
2643,2220171,31,13,0.78929,251,2242490,-1,481.0,3635548,3635579,1415377,31,156,8,True,True,0.8770153166666668,-0.78929
2644,2220465,52,4,0.506611,251,2242490,-1,24.0,5980962,5981014,3760497,52,49,9,True,True,0.0437736,-0.506611
2645,2223616,112,7,0.628571,251,2242490,-1,238.0,2876705,2876817,653089,112,181,0,True,True,0.48121484444444435,-0.628571
2646,2223755,4483,1,0.501049,251,2242490,-1,41.0,3615748,3620231,1391993,4483,163,6,True,True,9.715375147222222,-0.477230531228916
2647,2223976,4,6,0.415432,251,2242490,-1,294.0,4782460,4782464,2558484,4,111,12,True,True,0.025525733333333335,-0.415432
2648,2224069,34,3,0.701811,251,2242490,-1,144.0,5878103,5878137,3654034,34,57,10,True,True,0.16908879999999998,-0.7018109999999999
2649,2224162,9841,64,0.082428,251,2242490,-1,512.0,2786705,2796546,562543,9841,187,0,True,True,130.7464376888889,-0.08079562257474256
2650,2224894,3827,1,0.536565,251,2242490,-1,22.0,3850448,3854275,1625554,3827,151,2,True,True,1.4693931999999998,-0.479837253062791
2651,2224911,713,4,0.616047,251,2242490,-1,56.0,4696060,4696773,2471149,713,113,2,True,True,1.8689631333333334,-0.616047
2652,2224927,116,8,0.277468,251,2242490,-1,328.0,3164509,3164625,939582,116,179,8,True,True,1.0031989333333335,-0.277468
2653,2226269,118,8,0.309907,251,2242490,-1,88.0,5658271,5658389,3432002,118,73,6,True,True,0.06908244444444445,-0.309907
2654,2226296,4979,17,0.511305,251,2242490,-1,799.0,6875037,6880016,4648741,4979,1,2,True,True,50.84954296388889,-0.29741226516077823
2655,2226375,73,4,0.203197,251,2242490,-1,76.0,4245560,4245633,2019185,73,140,8,True,True,0.05948688888888889,-0.203197
2656,2226742,2595,16,0.80806,251,2242490,-1,624.0,3219509,3222104,992767,2595,180,9,True,True,77.28679226666668,-0.6885773800126059
2657,2226774,23165,1,0.53639,251,2242490,-1,39.0,5878137,5901302,3651363,23165,58,1,True,True,37.546328841666664,-0.5063482725687631
2658,2227829,24,4,0.390732,251,2242490,-1,164.0,6204862,6204886,3977033,24,37,0,True,True,0.048762666666666676,-0.390732
2659,2228113,10,8,0.634294,251,2242490,-1,144.0,3901848,3901858,1673735,10,155,8,True,True,0.027307999999999995,-0.634294
2660,2228175,6,16,0.834526,251,2242490,-1,768.0,5138224,5138230,2910049,6,99,11,True,True,0.057638400000000006,-0.834526
2661,2228383,432,32,0.681056,251,2242490,-1,1152.0,4597760,4598192,2369377,432,127,12,True,True,5.080319999999999,-0.681056
2662,2228637,7092,1,0.066115,251,2242490,-1,42.0,3846848,3853940,1618211,7092,161,2,True,True,5.540210666666667,-0.06292726100913312
2663,2229278,185,1,0.698676,251,2242490,-1,25.0,4010348,4010533,1781070,185,155,0,True,True,0.08324097222222222,-0.6647473595428027
2664,2229642,11216,1,0.729958,251,2242490,-1,40.0,2679905,2691121,450263,11216,221,7,True,True,14.481030555555558,-0.6895324099098676
2665,2229695,804,2,0.846468,251,2242490,-1,96.0,5659171,5659975,3429476,804,76,6,True,True,0.5312613333333334,-0.8454096625097006
2666,2229769,19826,32,0.057906,251,2242490,-1,896.0,4853624,4873450,2623855,19826,108,1,True,True,430.42725973333336,-0.05587188060062229
2667,2229799,5,1,0.086213,251,2242490,-1,36.0,6450325,6450330,4220526,5,25,7,True,True,0.0021045,-0.086213
5518,4447222,5,1,0.647793,1,4447222,-1,15.0,4491422,4491427,44200,5,0,11,True,True,0.0030645833333333332,-0.647793
5519,4447274,9180,256,0.176618,93,4491422,-1,10496.0,8718569,8727749,4271295,9180,0,1,True,True,2400.548906666667,-0.15662348574556303
5520,4447328,14,32,0.039331,93,4491422,-1,256.0,6992025,6992039,2544697,14,1,11,True,True,0.14478364444444444,-0.039331
5521,4447560,21273,4,0.384164,93,4491422,-1,80.0,5697975,5719248,1250415,21273,2,9,True,True,56.02664533333335,-0.37731246280944764
5522,4447584,229,4,0.191003,93,4491422,-1,52.0,5552775,5553004,1105191,229,3,12,True,True,0.5409208999999999,-0.191003
5523,4447982,25979,118,0.695882,93,4491422,-1,3776.0,8652713,8678692,4204731,25979,1,11,True,True,2111.066811911111,-0.6782574269546352
5524,4448069,22,1,0.896461,93,4491422,-1,7.0,8477913,8477935,4029844,22,2,3,True,True,0.003948816666666667,-0.896461
5525,4448097,102,16,0.630617,93,4491422,-1,160.0,7676866,7676968,3228769,102,3,11,True,True,0.6473599999999999,-0.630617
5526,4448179,5,15,0.359261,93,4491422,-1,75.0,4752351,4752356,304172,5,7,9,True,True,0.010933333333333333,-0.359261
5527,4448207,22666,32,0.084862,93,4491422,-1,928.0,7157072,7179738,2708865,22666,4,9,True,True,692.8305603555557,-0.08318830514881205
5528,4448248,31,4,0.632791,93,4491422,-1,116.0,8092911,8092942,3644663,31,3,8,True,True,0.12017632222222224,-0.632791
5529,4448319,7814,128,0.735324,93,4491422,-1,3456.0,8453613,8461427,4005294,7814,3,10,True,True,1539.1547328000001,-0.7338058285619022
5530,4448730,31,16,0.139943,93,4491422,-1,208.0,7102072,7102103,2653342,31,7,7,True,True,0.18303364444444442,-0.139943
5531,4448774,16,4,0.193093,93,4491422,-1,200.0,8383713,8383729,3934939,16,4,10,True,True,0.14196444444444445,-0.193093
5532,4448838,33,2,0.719739,93,4491422,-1,20.0,8058211,8058244,3609373,33,6,12,True,True,0.02377466666666667,-0.719739
5533,4449247,7918,1,0.592945,93,4491422,-1,8.0,7500555,7508473,3051308,7918,8,8,True,True,1.4258826,-0.5857514944343665
5534,4449408,16395,12,0.489233,93,4491422,-1,168.0,7100272,7116667,2650864,16395,11,0,True,True,76.90287500000001,-0.48189080642267657
5535,4449879,56,1,0.062993,93,4491422,-1,38.0,4821758,4821814,371879,56,15,8,True,True,0.05119022222222221,-0.062993
5536,4449895,2398,16,0.540552,93,4491422,-1,432.0,4500451,4502849,50556,2398,17,1,True,True,39.1842792,-0.540552
5537,4450351,3163,1,0.307731,93,4491422,-1,24.0,7167872,7171035,2717521,3163,9,2,True,True,2.0009138,-0.307731
5538,4450360,14342,4,0.53394,93,4491422,-1,128.0,5708127,5722469,1257767,14342,14,2,True,True,68.845312,-0.5294570313543763
5539,4450400,39,8,0.83425,93,4491422,-1,320.0,7056025,7056064,2605625,39,13,7,True,True,0.3289866666666667,-0.83425
5540,4450560,13230,1,0.449307,93,4491422,-1,44.0,7625466,7638696,3174906,13230,8,11,True,True,19.3070086,-0.4475126990149926
5541,4450635,25896,1,0.995834,93,4491422,-1,11.0,7579455,7605351,3128820,25896,9,9,True,True,15.099026250000001,-0.9748393610496959
5542,4450670,16527,32,0.037043,93,4491422,-1,800.0,7054225,7070752,2603555,16527,16,2,True,True,409.39682,-0.033969695564238116
5543,4450960,155,9,0.056054,93,4491422,-1,108.0,7319954,7320109,2868994,155,11,8,True,True,0.6650895,-0.056054
5544,4451396,7764,4,0.787779,93,4491422,-1,176.0,4493222,4500986,41826,7764,25,6,True,True,55.18232231111111,-0.7835371937936126
5545,4451584,107,82,0.042815,93,4491422,-1,2624.0,8089311,8089418,3637727,107,6,7,True,True,8.350508266666667,-0.042815
5546,4451620,44,32,0.118187,93,4491422,-1,1408.0,5059872,5059916,608252,44,23,8,True,True,2.5716963555555554,-0.118187
5547,4451634,8215,9,0.807104,93,4491422,-1,360.0,5376375,5384590,924741,8215,23,8,True,True,103.760965,-0.7964889793599367
5548,4452803,26155,4,0.667316,93,4491422,-1,48.0,7815511,7841666,3362708,26155,8,10,True,True,60.16912373333332,-0.6475860993497722
5549,4452848,156,2,0.45837,93,4491422,-1,78.0,5556375,5556531,1103527,156,23,8,True,True,0.6208046,-0.45837
5550,4453339,29,8,0.678078,93,4491422,-1,72.0,4500422,4500451,47083,29,30,2,True,True,0.07897859999999998,-0.678078
5551,4453369,15,7,0.874255,93,4491422,-1,112.0,7457783,7457798,3004414,15,13,12,True,True,0.03829933333333333,-0.874255
5552,4453378,6,32,0.148954,93,4491422,-1,1056.0,6348436,6348442,1895058,6,22,12,True,True,0.20194240000000002,-0.148954
5553,4453717,113,1,0.579346,93,4491422,-1,44.0,6100336,6100449,1646619,113,23,10,True,True,0.19052427777777778,-0.579346
5554,4453925,74,8,0.924816,93,4491422,-1,216.0,8935649,8935723,4481724,74,0,10,True,True,0.3506268,-0.924816
5555,4453933,9,1,0.036878,93,4491422,-1,38.0,5644775,5644784,1190842,9,27,11,True,True,0.011560550000000001,-0.036878
5556,4453955,12221,8,0.14159,93,4491422,-1,248.0,8124911,8137132,3670956,12221,6,7,True,True,82.84678286666667,-0.10970565933469735
5557,4454014,19588,16,0.653832,93,4491422,-1,432.0,5016658,5036246,562644,19588,33,12,True,True,337.84724879999993,-0.6404132940133243
5558,4454143,24945,32,0.47122,93,4491422,-1,864.0,7364183,7389128,2910040,24945,16,1,True,True,897.9037200000001,-0.4676678329877804
5559,4454163,5965,16,0.918019,93,4491422,-1,96.0,5893536,5899501,1439373,5965,27,8,True,True,22.642487466666665,-0.9141411418902324
5560,4454391,10287,188,0.045802,93,4491422,-1,3008.0,5801927,5812214,1347536,10287,28,0,True,True,1194.5234156444446,-0.04530417799073196
5561,4454436,55,16,0.701297,93,4491422,-1,800.0,7001025,7001080,2546589,55,24,7,True,True,1.904588888888889,-0.701297
5562,4454459,501,64,0.130538,93,4491422,-1,1728.0,8500013,8500514,4045554,501,3,10,True,True,26.1906768,-0.130538
5563,4454483,14827,128,0.172249,93,4491422,-1,2304.0,6802519,6817346,2348036,14827,27,10,True,True,939.6179071999999,-0.16656579983270697
5564,4454632,15,32,0.049958,93,4491422,-1,352.0,7816411,7816426,3361779,15,11,6,True,True,0.2546573333333333,-0.049958
5565,4454811,9,1,0.307337,93,4491422,-1,41.0,8654525,8654534,4199714,9,2,1,True,True,0.005656975000000001,-0.3073370000000001
5566,4454844,13049,16,0.793697,93,4491422,-1,384.0,6850319,6863368,2395475,13049,29,11,True,True,178.59026133333333,-0.7877877532622323
5567,4455102,16479,32,0.456185,93,4491422,-1,1312.0,6262036,6278515,1806934,16479,32,10,True,True,623.8123249777777,-0.43918367127113805
5568,4455208,4,32,0.170689,93,4491422,-1,1536.0,4492322,4492326,37114,4,49,6,True,True,0.25105066666666664,-0.170689
5569,4455263,5,16,0.591042,93,4491422,-1,512.0,4496822,4496827,41559,5,48,8,True,True,0.10186666666666667,-0.591042
5570,4455308,375,2,0.8178,93,4491422,-1,70.0,7312754,7313129,2857446,375,21,9,True,True,0.9144479166666668,-0.8178
5571,4455339,34906,1,0.106331,93,4491422,-1,16.0,8124911,8159817,3669572,34906,8,0,True,True,21.490628444444447,-0.09905292459761261
5572,4455394,18,4,0.497143,93,4491422,-1,188.0,6074636,6074654,1619242,18,36,6,True,True,0.0887266,-0.497143
5573,4455785,17910,1,0.799175,93,4491422,-1,17.0,5379975,5397885,924190,17910,44,2,True,True,10.274345250000001,-0.7741997404407168
5574,4455800,37228,37,0.220573,93,4491422,-1,740.0,4544651,4581879,88851,37228,50,11,True,True,1004.3643648333333,-0.21842598002231128
5575,4455844,11896,34,0.804454,93,4491422,-1,1190.0,6872419,6884315,2416575,11896,31,10,True,True,344.5580111944444,-0.8040223923309279
5576,4455958,137,1,0.426211,93,4491422,-1,21.0,8705176,8705313,4249218,137,2,7,True,True,0.09463731666666668,-0.42621099999999995
5577,4457648,36,1,0.811521,93,4491422,-1,7.0,6239936,6239972,1782288,36,37,9,True,True,0.005427100000000001,-0.811521
5578,4463451,4177,64,0.982193,93,4491422,-1,1024.0,5113675,5117852,650224,4177,49,10,True,True,112.81217706666666,-0.9196599735588078
5579,4463634,4,1,0.678398,93,4491422,-1,20.0,7304654,7304658,2841020,4,24,10,True,True,0.003134888888888889,-0.678398
5580,4463694,276,4,0.324235,93,4491422,-1,80.0,7501455,7501731,3037761,276,19,6,True,True,0.5110906666666666,-0.324235
5581,4463947,536,24,0.975853,93,4491422,-1,888.0,7235972,7236508,2772025,536,26,7,True,True,14.91652533333333,-0.8871662982007767
5582,4464265,6,8,0.575967,93,4491422,-1,336.0,7278948,7278954,2814683,6,26,7,True,True,0.09584960000000001,-0.575967
5583,4464805,14525,1,0.137329,93,4491422,-1,42.0,7149872,7164397,2685067,14525,30,11,True,True,26.775089366666666,-0.13529351207285054
5584,4464867,73,1,0.836427,93,4491422,-1,19.0,4788858,4788931,323991,73,58,1,True,True,0.03250588611111111,-0.836427
5585,4464895,499,4,0.793102,93,4491422,-1,160.0,5690775,5691274,1225880,499,49,11,True,True,1.8103719999999996,-0.793102
5586,4465011,103,8,0.764228,93,4491422,-1,104.0,7282554,7282657,2817543,103,26,1,True,True,0.4670134444444444,-0.764228
5587,4465046,13,2,0.593085,93,4491422,-1,100.0,5779827,5779840,1314781,13,48,10,True,True,0.037375,-0.593085
5588,4465557,56,8,0.335504,93,4491422,-1,112.0,8096511,8096567,3630954,56,11,2,True,True,0.29122986666666667,-0.335504
5589,4465601,18274,1,0.120745,93,4491422,-1,29.0,6561606,6579880,2096005,18274,42,11,True,True,21.086039522222222,-0.11786285714757715
5590,4465636,78,2,0.141237,93,4491422,-1,58.0,5801927,5802005,1336291,78,50,10,True,True,0.1680037666666667,-0.141237
5591,4476701,15193,1,0.415154,93,4491422,-1,36.0,8703376,8718569,4226675,15193,3,11,True,True,16.7822711,-0.39611551185791744
5592,4476870,237,1,0.696296,93,4491422,-1,34.0,6392636,6392873,1915766,237,44,0,True,True,0.2511633833333333,-0.696296
5593,4476890,59,2,0.553408,93,4491422,-1,84.0,7789811,7789870,3312921,59,18,8,True,True,0.2258284,-0.553408
5594,4477000,18387,1,0.438661,93,4491422,-1,24.0,7273548,7291935,2796548,18387,31,8,True,True,19.045905000000005,-0.43087708940992736
5595,4477331,7032,32,0.925676,93,4491422,-1,256.0,8454513,8461545,3977182,7032,8,6,True,True,102.78260053333335,-0.9216564671297869
5596,4477589,2634,1,0.040699,93,4491422,-1,5.0,7925811,7928445,3448222,2634,17,6,True,True,0.5575449583333333,-0.04051929717552064
5597,4479098,38,36,0.099968,93,4491422,-1,864.0,8211311,8211349,3732213,38,11,12,True,True,1.0171535999999999,-0.099968
5598,4479574,116,32,0.847367,93,4491422,-1,448.0,5363775,5363891,884201,116,67,12,True,True,1.7234609777777778,-0.847367
5599,4479759,23,1,0.612442,93,4491422,-1,35.0,8083911,8083934,3604152,23,17,10,True,True,0.02701893055555556,-0.612442
5600,4479965,23122,85,0.777662,93,4491422,-1,425.0,8089311,8112433,3609346,23122,16,0,True,True,395.2136329861112,-0.7483045302125921
5601,4479974,874,1,0.01563,93,4491422,-1,33.0,7924911,7925785,3444937,874,21,10,True,True,1.2264259333333334,-0.01563
5602,4480013,903,2,0.486967,93,4491422,-1,48.0,4766751,4767654,286738,903,76,8,True,True,1.9728744000000003,-0.486967
5603,4480707,9507,16,0.00635,93,4491422,-1,320.0,9077049,9086556,4596342,9507,0,10,True,True,100.47365333333335,-0.0062443607186766625
5604,4480767,60,1,0.179413,93,4491422,-1,5.0,6947825,6947885,2467058,60,49,6,True,True,0.008551666666666667,-0.179413
5605,4480810,29,1,0.089141,93,4491422,-1,13.0,7364154,7364183,2883344,29,33,11,True,True,0.013486127777777777,-0.089141
5606,4480861,9072,3,0.651756,93,4491422,-1,72.0,8317413,8326485,3836552,9072,12,11,True,True,28.5197814,-0.6381914850959342
5607,4482498,10,121,0.886915,93,4491422,-1,847.0,4755951,4755961,273453,10,81,7,True,True,0.2800511388888889,-0.8869149999999998
5608,4483981,53,28,0.416222,93,4491422,-1,1344.0,6876019,6876072,2392038,53,52,8,True,True,1.7865381333333334,-0.416222
5609,4485144,20673,1,0.807412,93,4491422,-1,23.0,8824249,8844922,4339105,20673,2,11,True,True,11.082286841666667,-0.8005643552455805
5610,4487909,4,1,0.772563,93,4491422,-1,7.0,7550155,7550159,3062246,4,31,6,True,True,0.000791,-0.772563
5611,4487985,15,64,0.692358,93,4491422,-1,1856.0,7971811,7971826,3483826,15,23,7,True,True,1.1842053333333333,-0.692358
5612,4510866,85,16,0.20616,214,4544651,-1,608.0,8946449,8946534,4435583,85,1,8,True,True,1.2014164444444444,-0.20616
5613,4510882,3,3,0.639826,214,4544651,-1,141.0,8087511,8087514,3576629,3,22,8,True,True,0.013927275,-0.639826
5614,4511154,16606,8,0.523087,214,4544651,-1,64.0,7047025,7063631,2535871,16606,54,11,True,True,36.34935253333334,-0.5099371065330609
5615,4511179,215,32,0.412031,214,4544651,-1,1024.0,4930258,4930473,419079,215,85,12,True,True,6.755854222222223,-0.412031
5616,4511310,19035,8,0.93809,214,4544651,-1,208.0,7234172,7253207,2722862,19035,47,10,True,True,129.59726115555554,-0.9270024526722733
5617,4511499,4827,1,0.610538,214,4544651,-1,22.0,5040558,5045385,529059,4827,85,7,True,True,3.599655216666666,-0.5997209303997718
5618,4511753,13257,16,0.037621,214,4544651,-1,560.0,8869349,8882606,4357596,13257,3,6,True,True,190.86947133333334,-0.035027864489997715
5619,4511871,26313,256,0.18,214,4544651,-1,7680.0,5812214,5838527,1300343,26313,72,0,True,True,6736.017962666667,-0.17315194941932924
5620,4511897,9,1,0.499888,214,4544651,-1,27.0,4700951,4700960,189054,9,95,11,True,True,0.007213725000000001,-0.4998880000000001
5621,4512052,29,1,0.950298,214,4544651,-1,13.0,7002825,7002854,2490773,29,57,7,True,True,0.011563427777777777,-0.950298
5622,4512336,7,4,0.627192,214,4544651,-1,148.0,5211075,5211082,698739,7,86,11,True,True,0.04059968888888889,-0.627192
5623,4512344,10183,128,0.782583,214,4544651,-1,1664.0,7371383,7381566,2859039,10183,39,9,True,True,744.7217902222221,-0.7808980158831542
5624,4512484,6867,1,0.347854,214,4544651,-1,40.0,5042358,5049225,529874,6867,90,6,True,True,8.841866,-0.3253494969634398
5625,4512523,10641,4,0.00457,214,4544651,-1,56.0,7460483,7471124,2947960,10641,38,6,True,True,13.3563136,-0.004531365082499572
5626,4512568,9408,20,0.235639,214,4544651,-1,700.0,6188536,6197944,1675968,9408,72,12,True,True,234.41131777777775,-0.22873711701463756
5627,4513133,10312,256,0.117508,214,4544651,-1,8960.0,7490243,7500555,2977110,10312,38,8,True,True,2186.317628444445,-0.11596557401363078
5628,4513172,278,8,0.530199,214,4544651,-1,200.0,8727749,8728027,4214577,278,5,8,True,True,1.1007255555555555,-0.530199
5629,4513229,131,1,0.095684,214,4544651,-1,36.0,7471283,7471414,2958054,131,40,8,True,True,0.09868229999999997,-0.095684
5630,4513502,29923,8,0.361901,214,4544651,-1,96.0,7902811,7932734,3389309,29923,30,12,True,True,128.88545493333334,-0.35866856384080753
5631,4513893,115,4,0.761128,214,4544651,-1,24.0,4656751,4656866,142858,115,106,10,True,True,0.12827866666666665,-0.761128
5632,4513961,12531,206,0.539723,214,4544651,-1,7622.0,5894436,5906967,1380475,12531,79,6,True,True,4273.188679533333,-0.5263946928603288
5633,4514005,12786,1,0.219276,214,4544651,-1,16.0,8269613,8282399,3755608,12786,17,10,True,True,7.784480088888889,-0.21759106894226013
5634,4516809,8,128,0.770331,214,4544651,-1,3968.0,6780419,6780427,2263610,8,72,12,True,True,0.9192533333333334,-0.770331
5635,4516825,14,2,0.659327,214,4544651,-1,72.0,5711727,5711741,1194902,14,87,8,True,True,0.0380604,-0.659327
5636,4516932,25708,1,0.276427,214,4544651,-1,42.0,5646575,5672283,1129643,25708,91,7,True,True,31.05985528333333,-0.2660003251694958
5637,4517075,17,1,0.193719,214,4544651,-1,41.0,5046355,5046372,529280,17,101,2,True,True,0.021303030555555557,-0.19371900000000006
5638,4517257,2,1,0.796613,214,4544651,-1,34.0,9054949,9054951,4537692,2,1,12,True,True,0.0018089888888888888,-0.796613
5639,4517345,1051,16,0.685244,214,4544651,-1,528.0,8658125,8659176,4140780,1051,10,8,True,True,9.310458666666667,-0.6852440000000001
5640,4517516,8846,64,0.968574,214,4544651,-1,1216.0,4631051,4639897,113535,8846,115,12,True,True,452.73890755555556,-0.9295790211761418
5641,4517639,67,16,0.474413,214,4544651,-1,288.0,9123049,9123116,4605410,67,0,11,True,True,0.6033751999999999,-0.47441299999999986
5642,4518334,13,4,0.176324,214,4544651,-1,140.0,6694006,6694019,2175672,13,76,11,True,True,0.07652088888888889,-0.176324
5643,4518433,41,4,0.670143,214,4544651,-1,72.0,7581266,7581307,3062833,41,40,1,True,True,0.17810399999999998,-0.6701430000000002
5644,4519280,15706,216,0.043116,214,4544651,-1,2376.0,5600575,5616281,1081295,15706,98,11,True,True,1519.4866235999998,-0.0421536945717501
5645,4520412,26,4,0.644861,214,4544651,-1,24.0,7100272,7100298,2579860,26,65,11,True,True,0.017712933333333333,-0.644861
5646,4521523,8,1,0.285065,214,4544651,-1,42.0,7160672,7160680,2639149,8,61,8,True,True,0.015904,-0.285065
5647,4521690,260,24,0.434672,214,4544651,-1,696.0,6649806,6650066,2128116,260,80,7,True,True,6.2581999999999995,-0.434672
5648,4521909,11,2,0.334295,214,4544651,-1,22.0,7581255,7581266,3059346,11,41,7,True,True,0.014600666666666665,-0.334295
5649,4522729,3,1,0.805154,214,4544651,-1,25.0,7698966,7698969,3176237,3,38,10,True,True,0.0031691666666666674,-0.8051540000000003
5650,4522899,35,3,0.758408,214,4544651,-1,69.0,6648006,6648041,2125107,35,83,12,True,True,0.07880279166666668,-0.7584080000000002
5651,4522924,5,1,0.043317,214,4544651,-1,9.0,8608513,8608518,4085589,5,14,10,True,True,0.0008829999999999999,-0.043317
5652,4522944,39,8,0.740417,214,4544651,-1,152.0,7632666,7632705,3109722,39,41,8,True,True,0.186979,-0.7404170000000001
5653,4522957,35,16,0.924861,214,4544651,-1,576.0,6923819,6923854,2400862,35,78,11,True,True,0.771232,-0.924861
5654,4523140,9578,16,0.175888,214,4544651,-1,368.0,4759551,4769129,236411,9578,124,8,True,True,148.12440066666665,-0.17282654797533203
5655,4523250,9,1,0.785492,214,4544651,-1,43.0,6028636,6028645,1505386,9,95,11,True,True,0.012131375,-0.785492
5656,4523363,12532,2,0.485061,214,4544651,-1,60.0,5466375,5478907,943012,12532,111,12,True,True,27.84349266666667,-0.4618281841570643
5657,4524246,9,3,0.116065,214,4544651,-1,141.0,5980836,5980845,1456590,9,96,12,True,True,0.04227884999999999,-0.116065
5658,4524794,22,8,0.895079,214,4544651,-1,296.0,5372775,5372797,847981,22,115,7,True,True,0.24061840000000004,-0.895079
5659,4526009,18052,32,0.721403,214,4544651,-1,864.0,7924911,7942963,3398902,18052,34,0,True,True,684.1365312,-0.7198932532679876
5660,4526106,312,1,0.592707,214,4544651,-1,15.0,7501455,7501767,2975349,312,48,0,True,True,0.108329,-0.592707
5661,4526425,95,4,0.325972,214,4544651,-1,32.0,8474313,8474408,3947888,95,17,2,True,True,0.08170906666666666,-0.324599062569669
5662,4528509,10985,7,0.198751,214,4544651,-1,70.0,8468913,8479898,3940404,10985,18,9,True,True,21.70850655555556,-0.18594266057023837
5663,4528532,13,2,0.676853,214,4544651,-1,42.0,4763151,4763164,234619,13,132,2,True,True,0.023813183333333335,-0.676853
5664,4528542,6902,256,0.325685,214,4544651,-1,7168.0,8240611,8247513,3712069,6902,24,9,True,True,2325.9633351111115,-0.325155395542217
5665,4528627,58,1,0.778975,214,4544651,-1,46.0,8119511,8119569,3590884,58,28,6,True,True,0.12300962222222221,-0.778975
5666,4528643,5,16,0.326132,214,4544651,-1,544.0,7316354,7316359,2787711,5,63,8,True,True,0.101184,-0.326132
5667,4528671,7501,2,0.098064,214,4544651,-1,44.0,7056072,7063573,2527401,7501,78,2,True,True,9.387550822222222,-0.09362682813772844
5668,4529621,14,2,0.737748,214,4544651,-1,54.0,5705175,5705189,1175554,14,113,9,True,True,0.0205527,-0.737748
5669,4529931,4,6,0.869886,214,4544651,-1,276.0,7474883,7474887,2944952,4,56,2,True,True,0.024223599999999998,-0.869886
5670,4530007,7692,8,0.375532,214,4544651,-1,96.0,8123111,8130803,3593104,7692,28,8,True,True,23.410298400000002,-0.32974737596201303
5671,4530554,17,10,0.220663,214,4544651,-1,110.0,8431513,8431530,3900959,17,21,11,True,True,0.09640369444444445,-0.220663
5672,4530578,845,1,0.47099,214,4544651,-1,17.0,7785366,7786211,3254788,845,46,12,True,True,0.7024884027777779,-0.47099
5673,4530844,8764,4,0.484408,214,4544651,-1,28.0,7277148,7285912,2746304,8764,72,8,True,True,10.604008177777779,-0.4697511378894171
5674,4531169,3,32,0.890489,214,4544651,-1,640.0,8659176,8659179,4128007,3,11,1,True,True,0.03221333333333334,-0.890489
5675,4531344,21,1,0.144941,214,4544651,-1,39.0,6495236,6495257,1963892,21,102,8,True,True,0.026501475,-0.14494099999999996
5676,4531526,20,16,0.927887,214,4544651,-1,240.0,4788851,4788871,257325,20,143,10,True,True,0.11249333333333333,-0.927887
5677,4531638,26,1,0.454991,214,4544651,-1,50.0,6073736,6073762,1542098,26,110,6,True,True,0.03408527777777778,-0.454991
5678,4531659,557,1,0.38733,214,4544651,-1,47.0,8946449,8947006,4414790,557,3,0,True,True,0.6085890305555556,-0.38733
5679,4531671,7658,4,0.136405,214,4544651,-1,60.0,6694019,6701677,2162348,7658,99,2,True,True,18.886118333333336,-0.13417377174260964
5680,4531782,62,1,0.719821,214,4544651,-1,45.0,6999225,6999287,2467443,62,91,9,True,True,0.12076825000000001,-0.719821
5681,4531933,1006,32,0.632021,214,4544651,-1,480.0,6945919,6946925,2413986,1006,94,10,True,True,13.764762666666666,-0.632021
5682,4532622,14,1,0.975556,214,4544651,-1,24.0,6232736,6232750,1700114,14,111,11,True,True,0.008877866666666666,-0.975556
5683,4532680,5732,128,0.202211,214,4544651,-1,1280.0,7459583,7465315,2926903,5732,64,7,True,True,165.77101866666663,-0.2020665853035659
5684,4532800,98,8,0.127212,214,4544651,-1,336.0,8734949,8735047,4202149,98,8,0,True,True,0.8309746666666666,-0.127212
5685,4534150,9493,16,0.692211,214,4544651,-1,720.0,8061811,8071304,3527661,9493,40,8,True,True,217.337534,-0.649981053802782
5686,4534165,11917,32,0.059652,214,4544651,-1,1184.0,6488036,6499953,1953871,11917,110,9,True,True,470.6971576,-0.059105473330075105
5687,4534238,47,1,0.136501,214,4544651,-1,7.0,5055372,5055419,521134,47,146,1,True,True,0.014216455555555558,-0.136501
5688,4534246,13,16,0.851651,214,4544651,-1,368.0,6694006,6694019,2159760,13,105,0,True,True,0.20114062222222223,-0.851651
5689,4534395,78,41,0.458579,214,4544651,-1,328.0,5697975,5698053,1163580,78,132,0,True,True,0.6219754666666667,-0.458579
5690,4534431,2356,32,0.171201,214,4544651,-1,1120.0,8477913,8480269,3943482,2356,19,0,True,True,73.78848711111112,-0.17065763505506018
5691,4534672,3,4,0.343576,214,4544651,-1,180.0,8586413,8586416,4051741,3,18,12,True,True,0.0101445,-0.343576
5692,4534701,127,1,0.886409,214,4544651,-1,38.0,5041458,5041585,506757,127,153,6,True,True,0.17302550555555554,-0.886409
5693,4534756,8,1,0.603636,214,4544651,-1,20.0,7105672,7105680,2570916,8,87,8,True,True,0.004235111111111111,-0.603636
5694,4534783,7493,13,0.789547,214,4544651,-1,585.0,4843858,4851351,309075,7493,158,10,True,True,166.375613625,-0.6926588823459102
5695,4535473,14324,32,0.637999,214,4544651,-1,768.0,7164272,7178596,2628799,14324,84,3,True,True,295.9674197333334,-0.6099734156298643
5696,4536952,7,2,0.611528,214,4544651,-1,22.0,4788851,4788858,251899,7,162,0,True,True,0.003609161111111111,-0.611528
5697,4537101,22782,64,0.169935,214,4544651,-1,960.0,5046372,5069154,509271,22782,153,2,True,True,832.640096,-0.16979735778800092
5698,4537167,10152,2,0.970136,214,4544651,-1,56.0,5697975,5708127,1160808,10152,136,0,True,True,15.632543733333335,-0.9156723385047065
5699,4537238,12,4,0.855004,214,4544651,-1,168.0,8654513,8654525,4117275,12,16,7,True,True,0.0309064,-0.855004
5700,4537337,23,4,0.086474,214,4544651,-1,192.0,5045385,5045408,508048,23,157,1,True,True,0.13497013333333333,-0.086474
5701,4537344,189,1,0.856974,214,4544651,-1,25.0,6806119,6806308,2268775,189,107,8,True,True,0.12670875,-0.8569739999999998
5702,4537367,11498,256,0.489213,214,4544651,-1,11264.0,5091575,5103073,554208,11498,154,6,True,True,4749.212566755555,-0.4809001482890698
5703,4537480,15,12,0.995664,214,4544651,-1,468.0,5119075,5119090,581595,15,153,7,True,True,0.17068350000000002,-0.995664
5704,4537510,203,32,0.591581,214,4544651,-1,1216.0,5056272,5056475,518762,203,157,6,True,True,10.666576355555556,-0.591581
5705,4537875,9,1,0.836989,214,4544651,-1,31.0,7189972,7189981,2652097,9,84,10,True,True,0.0071021,-0.836989
5706,4537929,4,4,0.279171,214,4544651,-1,52.0,5838536,5838540,1300607,4,132,1,True,True,0.0092976,-0.279171
5707,4537994,9,2,0.730018,214,4544651,-1,84.0,5838527,5838536,1300533,9,133,10,True,True,0.033793199999999995,-0.730018
5708,4538286,7597,2,0.736179,214,4544651,-1,84.0,5038758,5046355,500472,7597,168,10,True,True,21.334615166666666,-0.721352399867614
5709,4538325,12320,1,0.246654,214,4544651,-1,9.0,5277375,5289695,739050,12320,155,10,True,True,4.535098625,-0.24661270618497094
5710,4538828,2,16,0.327296,214,4544651,-1,448.0,7572255,7572257,3033427,2,61,10,True,True,0.028174222222222222,-0.3272959999999999
5711,4538836,3,4,0.579467,214,4544651,-1,68.0,7305554,7305557,2766718,3,78,6,True,True,0.007993966666666668,-0.579467
5712,4539024,19,4,0.891823,214,4544651,-1,180.0,8734949,8734968,4195925,19,9,7,True,True,0.0863075,-0.891823
5713,4539041,7308,2,0.591772,214,4544651,-1,34.0,8387313,8394621,3848272,7308,29,8,True,True,10.817728716666668,-0.52410238319607
5714,4539072,11767,4,0.14897,214,4544651,-1,200.0,6491636,6503403,1952564,11767,122,1,True,True,77.57053166666668,-0.14740123369293387
5715,4539154,266,4,0.573701,214,4544651,-1,72.0,7970011,7970277,3430857,266,48,11,True,True,0.6659044000000001,-0.5737010000000001
5716,4539197,12,32,0.005078,214,4544651,-1,608.0,8729549,8729561,4190352,12,10,7,True,True,0.14444053333333332,-0.005078
5717,4539250,24,1,0.980184,214,4544651,-1,34.0,5166875,5166899,627625,24,164,11,True,True,0.01957946666666667,-0.980184
5718,4539326,9,1,0.040059,214,4544651,-1,32.0,4634651,4634660,95325,9,192,8,True,True,0.011969600000000002,-0.040059
5719,4539362,12486,128,0.470653,214,4544651,-1,3584.0,5117275,5129761,577913,12486,166,8,True,True,1029.6977251555554,-0.457994592911586
5720,4539386,549,16,0.768606,214,4544651,-1,464.0,5757727,5758276,1218341,549,145,11,True,True,11.448968,-0.768606
5721,4539400,38,11,0.033621,214,4544651,-1,308.0,8233411,8233449,3694011,38,35,10,True,True,0.3916938666666667,-0.033621
5722,4539428,6673,11,0.531122,214,4544651,-1,187.0,5051772,5058445,512344,6673,174,0,True,True,51.06301371111111,-0.5122512036124931
5723,4539570,29,1,0.479269,214,4544651,-1,33.0,6078236,6078265,1538666,29,134,8,True,True,0.019671666666666667,-0.479269
5724,4539617,41,4,0.798018,214,4544651,-1,112.0,5255275,5255316,715658,41,166,11,True,True,0.15288808888888888,-0.798018
5725,4539651,11,4,0.821291,214,4544651,-1,48.0,7793411,7793422,3253760,11,57,8,True,True,0.0227304,-0.821291
5726,4539700,12,8,0.452441,214,4544651,-1,360.0,5984436,5984448,1444736,12,139,8,True,True,0.14860800000000002,-0.452441
5727,4539973,16323,2,0.240511,214,4544651,-1,34.0,8247513,8263836,3707540,16323,34,0,True,True,24.139733383333336,-0.21701937857112782
5728,4540032,20468,8,0.558487,214,4544651,-1,144.0,8939249,8959717,4399217,20468,5,8,True,True,79.798954,-0.5473172928120332
5729,4540119,7,1,0.012423,214,4544651,-1,43.0,5049972,5049979,509853,7,181,2,True,True,0.009882833333333332,-0.012423
5730,4540204,452,2,0.731786,214,4544651,-1,14.0,7629066,7629518,3088862,452,65,8,True,True,0.22420455555555555,-0.731786
5731,4540698,84,4,0.949934,214,4544651,-1,172.0,5889936,5890020,1349238,84,146,11,True,True,0.5754317333333333,-0.949934
5732,4540838,16624,128,0.132712,214,4544651,-1,4864.0,7278954,7295578,2738116,16624,90,1,True,True,3316.825264355556,-0.1277350872891863
5733,4541331,1361,16,0.29579,214,4544651,-1,320.0,5713527,5714888,1172196,1361,155,7,True,True,18.005122666666665,-0.29579
5734,4542711,39803,32,0.64764,214,4544651,-1,576.0,5051772,5091575,509061,39803,185,7,True,True,866.6827568,-0.6339743330283368
5735,4542733,93,16,0.09073,214,4544651,-1,640.0,7549255,7549348,3006522,93,72,11,True,True,1.68144,-0.09073
5736,4542757,20619,20,0.479783,214,4544651,-1,200.0,7505055,7525674,2962298,20619,73,3,True,True,101.506855,-0.4701832022040401
5737,4542826,24541,128,0.304837,214,4544651,-1,640.0,8735849,8760390,4193023,24541,9,6,True,True,342.52180444444446,-0.2965843607206757
5738,4542922,7192,32,0.703304,214,4544651,-1,1408.0,6480836,6488028,1937914,7192,135,7,True,True,364.51701048888884,-0.6864279849359097
5739,4545593,10098,1,0.857922,248,4631051,-1,32.0,5122675,5132773,577082,10098,181,8,True,True,7.8239576,-0.8202743085056211
5740,4545652,134,1,0.747287,248,4631051,-1,11.0,8458113,8458247,3912461,134,29,8,True,True,0.08652789444444443,-0.747287
5741,4545678,8,3,0.024413,248,4631051,-1,45.0,6072836,6072844,1527158,8,147,11,True,True,0.013699,-0.024413
5742,4546241,62,1,0.454841,248,4631051,-1,38.0,8968549,8968611,4422308,62,3,10,True,True,0.07534618888888889,-0.454841
5743,4546266,5,8,0.771835,248,4631051,-1,264.0,8868449,8868454,4322183,5,9,11,True,True,0.030510333333333337,-0.771835
5744,4546278,312,1,0.874199,248,4631051,-1,16.0,7050625,7050937,2504347,312,115,8,True,True,0.1962688,-0.874199
5745,4546309,18,2,0.40536,248,4631051,-1,36.0,4796058,4796076,249749,18,208,9,True,True,0.013089599999999998,-0.40536
5746,4546313,22560,16,0.789859,248,4631051,-1,416.0,7467683,7490243,2921370,22560,84,9,True,True,206.48358062222223,-0.7860100308812765
5747,4546388,15476,256,0.37042,248,4631051,-1,8704.0,7258072,7273548,2711684,15476,101,10,True,True,5066.757296355556,-0.34705338569700356
5748,4547692,5567,32,0.464296,248,4631051,-1,1280.0,8942849,8948416,4395157,5567,6,8,True,True,161.9009351111111,-0.460286567354995
5749,4547799,23,32,0.633402,248,4631051,-1,192.0,6479036,6479059,1931237,23,143,12,True,True,0.1615152,-0.633402
5750,4548559,15,2,0.860383,248,4631051,-1,54.0,7786211,7786226,3237652,15,66,1,True,True,0.03961125,-0.860383
5751,4548601,49,1,0.070699,248,4631051,-1,43.0,6392636,6392685,1844035,49,146,11,True,True,0.06567401944444443,-0.070699
5752,4548870,23,4,0.893434,248,4631051,-1,40.0,6102136,6102159,1553266,23,152,7,True,True,0.027270333333333334,-0.893434
5753,4548920,25,8,0.332906,248,4631051,-1,384.0,8913549,8913574,4364629,25,9,11,True,True,0.24122666666666664,-0.332906
5754,4548991,127,32,0.032714,248,4631051,-1,864.0,8361613,8361740,3812622,127,39,11,True,True,5.9688984,-0.032714
5755,4549079,9,1,0.425902,248,4631051,-1,30.0,8273213,8273222,3724134,9,41,8,True,True,0.010218,-0.425902
5756,4549091,7,8,0.269789,248,4631051,-1,128.0,4745151,4745158,196060,7,227,11,True,True,0.028316088888888886,-0.269789
5757,4550800,140,2,0.946095,248,4631051,-1,70.0,6946925,6947065,2396125,140,129,1,True,True,0.2793544444444445,-0.946095
5758,4550857,10170,8,0.542435,248,4631051,-1,56.0,4818158,4828328,267301,10170,219,10,True,True,14.037722222222223,-0.5151891889836739
5759,4551076,11945,4,0.794479,248,4631051,-1,164.0,9078849,9090794,4527773,11945,1,7,True,True,64.62485782222222,-0.791758034099752
5760,4551090,221,8,0.787692,248,4631051,-1,256.0,8118611,8118832,3567521,221,52,10,True,True,2.608467911111111,-0.787692
5761,4551512,47,1,0.080959,248,4631051,-1,32.0,7056025,7056072,2504513,47,122,0,True,True,0.03964711111111112,-0.080959
5762,4551543,9,2,0.880847,248,4631051,-1,46.0,5046355,5046364,494812,9,212,0,True,True,0.01265345,-0.880847
5763,4551700,51326,1,0.735761,248,4631051,-1,34.0,8461713,8513039,3910013,51326,34,8,True,True,57.027749594444444,-0.7118436927260126
5764,4551709,72,4,0.054812,248,4631051,-1,128.0,8780049,8780121,4228340,72,14,11,True,True,0.2591744,-0.054812
5765,4551801,1050,2,0.945322,248,4631051,-1,46.0,5845736,5846786,1293935,1050,173,9,True,True,1.9937989555555555,-0.8695799887027751
5766,4551830,14819,1,0.674653,248,4631051,-1,8.0,7212072,7226891,2660242,14819,113,10,True,True,4.041148222222222,-0.6440075965000466
5767,4553656,7380,16,0.887978,248,4631051,-1,528.0,6517406,6524786,1963750,7380,150,1,True,True,133.60332186666665,-0.8593159578837443
5768,4554141,18,6,0.110967,248,4631051,-1,156.0,6879619,6879637,2325478,18,138,8,True,True,0.0595452,-0.110967
5769,4554431,72,1,0.365591,248,4631051,-1,27.0,8470713,8470785,3916282,72,34,7,True,True,0.06943320000000001,-0.365591
5770,4554453,5978,128,0.619133,248,4631051,-1,2176.0,4754151,4760129,199698,5978,239,7,True,True,426.40131377777783,-0.5695495561345871
5771,4554771,52873,10,0.365571,248,4631051,-1,70.0,5370975,5423848,816204,52873,202,9,True,True,134.3571265555556,-0.36152462317316064
5772,4554882,283,32,0.175267,248,4631051,-1,960.0,8733149,8733432,4178267,283,18,8,True,True,6.0282773333333335,-0.175267
5773,4554941,70,8,0.55879,248,4631051,-1,176.0,6517336,6517406,1962395,70,154,10,True,True,0.45221244444444436,-0.55879
862,803344,420,32,0.443679,1,803344,-1,416.0,805144,805564,1800,420,0,7,True,True,7.491605333333333,-0.443679
863,803495,6902,4,0.694001,6,805144,-1,120.0,816006,822908,12511,6902,0,9,True,True,36.86776533333333,-0.674665966799305
864,803568,20120,2,0.903424,6,805144,-1,46.0,806944,827064,3376,20120,1,7,True,True,41.186563066666665,-0.8968972140671276
865,803679,7452,128,0.045991,6,805144,-1,768.0,4013165,4020617,3209486,7452,0,0,True,True,205.18198613333334,-0.045778994244977375
866,804449,15046,128,0.796143,6,805144,-1,4352.0,2004824,2019870,1200375,15046,1,8,True,True,2192.6665884444446,-0.7303464446748176
867,804482,33606,16,0.293368,6,805144,-1,208.0,819606,853212,15124,33606,2,0,True,True,345.58789546666657,-0.2925188167974956
868,805102,62,32,0.374841,6,805144,-1,1312.0,808744,808806,3642,62,4,7,True,True,3.3479834666666664,-0.374841
869,805220,10332,32,0.14557,9,806944,-1,704.0,3456700,3467032,2651480,10332,1,2,True,True,240.59983004444445,-0.14501373490263095
870,805230,29,1,0.531166,9,806944,-1,10.0,3648179,3648208,2842949,29,1,11,True,True,0.009680361111111112,-0.531166
871,805243,4,1,0.565928,9,806944,-1,12.0,808806,808810,3563,4,6,1,True,True,0.0019755999999999997,-0.565928
872,805292,77,5,0.792519,9,806944,-1,75.0,823206,823283,17914,77,4,2,True,True,0.2472502083333333,-0.792519
873,811926,8,12,0.169984,14,816006,-1,588.0,4429859,4429867,3617933,8,0,8,True,True,0.2185008,-0.169984
874,812010,19832,32,0.078968,14,816006,-1,1248.0,4009565,4029397,3197555,19832,2,4,True,True,947.0558309333334,-0.07563276794521874
875,812082,21614,3,0.87084,14,816006,-1,48.0,819606,841220,7524,21614,8,1,True,True,49.935768,-0.8655560391736427
876,812749,20,16,0.61971,14,816006,-1,96.0,4924622,4924642,4111873,20,0,1,True,True,0.07372266666666666,-0.61971
877,812915,14297,64,0.24083,14,816006,-1,1024.0,4211211,4225508,3398296,14297,2,6,True,True,577.412096,-0.23729471778950093
878,813568,1417,1,0.912829,14,816006,-1,34.0,3693279,3694696,2879711,1417,5,6,True,True,1.6371072722222226,-0.8875751565330479
879,813725,9665,1,0.143118,14,816006,-1,25.0,1730506,1740171,916781,9665,9,11,True,True,8.975109930555558,-0.13726702540969893
880,813919,40458,1,0.46115,14,816006,-1,21.0,1589106,1629564,775187,40458,10,7,True,True,44.98739245,-0.4568985834291556
881,822832,22853,1,0.253977,17,823206,-1,29.0,870106,892959,47274,22853,11,6,True,True,30.415059027777783,-0.24037525434660867
882,822838,110,64,0.255327,17,823206,-1,960.0,1994388,1994498,1171550,110,9,8,True,True,2.4183679999999996,-0.2551548125355372
883,822900,33,32,0.009397,17,823206,-1,224.0,956506,956539,133606,33,12,12,True,True,0.22625679999999998,-0.009396999999999999
884,822952,4,8,0.804633,17,823206,-1,96.0,867406,867410,44454,4,14,11,True,True,0.026066133333333335,-0.804633
885,822990,16,1,0.901209,17,823206,-1,28.0,2245717,2245733,1422727,16,8,6,True,True,0.006273244444444444,-0.901209
886,823196,6103,1,0.677611,17,823206,-1,10.0,4596959,4603062,3773763,6103,1,9,True,True,2.680295055555556,-0.6737723171223461
887,823236,17,8,0.157976,44,867406,-1,376.0,2108324,2108341,1285088,17,10,9,True,True,0.1602794,-0.157976
888,825223,23,6,0.44173,44,867406,-1,48.0,4382059,4382082,3556836,23,3,8,True,True,0.0549148,-0.44173
889,825864,1998,1,0.345566,44,867406,-1,45.0,4814284,4816282,3988420,1998,1,11,True,True,8.157334500000001,-0.345566
890,825996,5,1,0.587572,44,867406,-1,20.0,2806944,2806949,1980948,5,11,11,True,True,0.004183611111111112,-0.587572
891,826016,18972,12,0.638939,44,867406,-1,516.0,4143987,4162959,3317971,18972,6,8,True,True,349.2363336,-0.6307820677859547
892,826170,219,16,0.424309,44,867406,-1,640.0,3792479,3792698,2966309,219,9,9,True,True,5.1049386666666665,-0.424309
893,826200,20,1,0.250098,44,867406,-1,17.0,3961363,3961383,3135163,20,9,2,True,True,0.010670333333333335,-0.250098
894,826364,216,7,0.845304,44,867406,-1,259.0,2507744,2507960,1681380,216,15,10,True,True,1.4268827999999998,-0.845304
895,826367,752,1,0.199217,44,867406,-1,27.0,4652846,4653598,3826479,752,2,1,True,True,0.7451004000000001,-0.199217
896,849581,23,1,0.384693,44,867406,-1,24.0,2966437,2966460,2116856,23,15,1,True,True,0.02184386666666667,-0.384693
897,855437,12693,16,0.483208,44,867406,-1,480.0,2109224,2121917,1253787,12693,19,6,True,True,153.80700933333333,-0.47929150471362875
898,855480,6,16,0.237206,44,867406,-1,512.0,3580079,3580085,2724599,6,14,10,True,True,0.09425066666666668,-0.237206
899,855897,7,2,0.571923,44,867406,-1,60.0,1311706,1311713,455809,7,26,10,True,True,0.019419166666666664,-0.571923
900,855953,8,6,0.574812,44,867406,-1,270.0,3367437,3367445,2511484,8,16,0,True,True,0.09145800000000001,-0.574812
901,856547,12,3,0.992692,44,867406,-1,144.0,4617185,4617197,3760638,12,3,8,True,True,0.076776,-0.992692
902,856672,8973,256,0.295231,44,867406,-1,6656.0,5289542,5298515,4432870,8973,0,6,True,True,1732.6831530666664,-0.291117444051932
903,856901,5276,1,0.977944,44,867406,-1,22.0,2675444,2680720,1818543,5276,21,8,True,True,5.23908171111111,-0.916452112698145
904,857055,2147,1,0.65823,44,867406,-1,22.0,1289606,1291753,432551,2147,31,6,True,True,1.0033288833333331,-0.65823
905,857294,280,4,0.27448,44,867406,-1,180.0,3818179,3818459,2960885,280,13,10,True,True,1.78472,-0.27448000000000006
906,857423,10533,256,0.565929,44,867406,-1,2816.0,3256937,3267470,2399514,10533,20,11,True,True,1281.5781909333332,-0.49185089379395347
907,857764,2,16,0.685799,44,867406,-1,160.0,869206,869208,11442,2,36,7,True,True,0.019984888888888892,-0.685799
908,857872,23,32,0.744669,44,867406,-1,832.0,1059106,1059129,201234,23,34,12,True,True,0.9842814222222223,-0.744669
909,857926,13543,41,0.049044,44,867406,-1,984.0,5080942,5094485,4223016,13543,1,7,True,True,671.2171609333333,-0.04811510033691994
910,858044,130,2,0.606406,44,867406,-1,36.0,4281259,4281389,3423215,130,9,1,True,True,0.31479499999999994,-0.6064060000000001
911,858080,14815,32,0.496727,44,867406,-1,224.0,4237056,4251871,3378976,14815,10,8,True,True,125.97880026666667,-0.48168778036759935
912,858233,4292,256,0.904155,44,867406,-1,10496.0,1816906,1821198,958673,4292,33,12,True,True,2449.102119822222,-0.8813780038809813
913,858316,633,8,0.286194,44,867406,-1,344.0,4602398,4603031,3744082,633,6,7,True,True,9.665769333333333,-0.286194
914,858633,5104,16,0.79886,44,867406,-1,464.0,3956259,3961363,3097626,5104,17,9,True,True,79.37957333333334,-0.7790153937648204
915,869045,28,4,0.607065,44,869206,-1,28.0,3367437,3367465,2498392,28,25,11,True,True,0.03319586666666667,-0.607065
916,872125,2,4,0.352321,192,956506,-1,192.0,1355906,1355908,483781,2,39,11,True,True,0.028298666666666666,-0.352321
917,872597,2,8,0.636618,192,956506,-1,368.0,3997863,3997865,3125266,2,16,8,True,True,0.02601964444444444,-0.6366180000000001
918,872822,7,1,0.620891,192,956506,-1,49.0,2514944,2514951,1642122,7,31,9,True,True,0.008751263888888888,-0.620891
919,874005,8,3,0.677764,192,956506,-1,81.0,2350844,2350852,1476839,8,33,2,True,True,0.015723,-0.677764
920,874367,121,4,0.720928,192,956506,-1,64.0,1854788,1854909,980421,121,39,10,True,True,0.2998003555555556,-0.720928
921,874462,30081,118,0.659182,192,956506,-1,2950.0,3581879,3611960,2707417,30081,23,7,True,True,2938.7838131944445,-0.6531215744079278
922,874661,25,8,0.838337,192,956506,-1,264.0,1359506,1359531,484845,25,44,8,True,True,0.4641633333333333,-0.838337
923,875287,124,1,0.628248,192,956506,-1,8.0,3279037,3279161,2403750,124,28,0,True,True,0.040666488888888894,-0.628248
924,875915,116,1,0.903404,192,956506,-1,22.0,2671844,2671960,1795929,116,33,1,True,True,0.09747931111111109,-0.903404
925,876833,31818,22,0.646341,192,956506,-1,770.0,4001465,4033283,3124632,31818,16,2,True,True,937.9122680277778,-0.6295294672455981
926,879025,6633,4,0.308933,192,956506,-1,64.0,3119137,3125770,2240112,6633,31,10,True,True,16.806084622222222,-0.27286439578191735
927,879294,29,1,0.440823,192,956506,-1,9.0,2241217,2241246,1361923,29,40,8,True,True,0.0037540499999999992,-0.440823
928,879729,170,1,0.579574,192,956506,-1,33.0,3949059,3949229,3069330,170,20,12,True,True,0.18255050000000003,-0.5746912626295821
929,880101,14947,8,0.73236,192,956506,-1,360.0,2257240,2272187,1377139,14947,40,1,True,True,146.611254,-0.6729856942909335
930,880390,8887,73,0.090133,192,956506,-1,2847.0,4661846,4670733,3781456,8887,4,6,True,True,1055.11618355,-0.08986203638942693
931,880414,11490,32,0.29511,192,956506,-1,352.0,1821198,1832688,940784,11490,49,7,True,True,256.9979925333333,-0.2886484010492749
932,880813,36514,15,0.747481,192,956506,-1,270.0,2354444,2390958,1473631,36514,40,8,True,True,284.1896115,-0.7400400793978201
933,881078,5,8,0.17564,192,956506,-1,184.0,4692946,4692951,3811868,5,4,0,True,True,0.0769477777777778,-0.17564
934,881223,28,16,0.13216,192,956506,-1,656.0,4816084,4816112,3934861,28,3,7,True,True,1.6664878222222224,-0.13216
935,881791,19419,2,0.539408,192,956506,-1,78.0,2093924,2113343,1212133,19419,49,0,True,True,39.182973700000005,-0.5388599283524251
936,882069,133,32,0.97149,192,956506,-1,576.0,3279037,3279170,2396968,133,34,10,True,True,3.1405024000000004,-0.97149
937,883386,108,31,0.530852,192,956506,-1,1147.0,4371259,4371367,3487873,108,13,8,True,True,5.354195999999999,-0.530852
938,883775,287,2,0.913487,192,956506,-1,40.0,965506,965793,81731,287,64,9,True,True,0.3119052222222223,-0.913487
939,883852,219,2,0.830473,192,956506,-1,88.0,3796079,3796298,2912227,219,26,8,True,True,0.7764474666666666,-0.830473
940,883929,246,8,0.25697,192,956506,-1,288.0,2144017,2144263,1260088,246,50,10,True,True,1.2664079999999995,-0.25697
941,884401,10356,1,0.82469,192,956506,-1,49.0,4378459,4388815,3494058,10356,13,9,True,True,24.422364944444443,-0.81584423459827
942,886266,17,42,0.481848,192,956506,-1,1470.0,3374637,3374654,2488371,17,34,9,True,True,0.97939975,-0.481848
943,886308,10,16,0.806488,192,956506,-1,448.0,4016765,4016775,3130457,10,19,2,True,True,0.15727288888888888,-0.806488
944,887364,49,8,0.746559,192,956506,-1,96.0,4692046,4692095,3804682,49,6,10,True,True,0.39343733333333336,-0.7465590000000001
945,887483,4,16,0.338715,192,956506,-1,240.0,2256551,2256555,1369068,4,52,1,True,True,0.014717333333333334,-0.338715
946,888404,19181,64,0.11517,192,956506,-1,2880.0,4111087,4130268,3222683,19181,20,2,True,True,3446.8098,-0.10986915877528236
947,888428,7,4,0.962893,192,956506,-1,60.0,4233311,4233318,3344883,7,18,10,True,True,0.018617666666666668,-0.962893
948,890340,32,8,0.140757,192,956506,-1,168.0,3785279,3785311,2894939,32,33,11,True,True,0.18477013333333336,-0.140757
949,890943,933,1,0.9665,192,956506,-1,49.0,4924642,4925575,4033699,933,2,1,True,True,1.959837891666667,-0.9463744709712261
950,898449,8685,8,0.860141,192,956506,-1,200.0,1244506,1253191,346057,8685,74,12,True,True,47.374166111111116,-0.7779337702904422
951,898487,4,31,0.724217,192,956506,-1,1178.0,3985263,3985267,3086776,4,28,10,True,True,0.16591475555555554,-0.7242170000000001
952,899563,16,16,0.979942,192,956506,-1,544.0,2657444,2657460,1757881,16,52,11,True,True,0.3777294222222222,-0.979942
953,899573,6726,4,0.96727,192,956506,-1,52.0,2762744,2769470,1863171,6726,50,6,True,True,9.96286171111111,-0.9460712814191571
954,899742,37,1,0.804588,192,956506,-1,29.0,4662746,4662783,3763004,37,8,6,True,True,0.04411818333333334,-0.804588
955,900455,21812,4,0.365775,192,956506,-1,92.0,2829044,2850856,1928589,21812,50,10,True,True,67.73227066666666,-0.34641203872555043
956,900532,88,64,0.790682,192,956506,-1,448.0,2850644,2850732,1950112,88,50,9,True,True,1.2302478222222222,-0.790682
957,900557,1004,1,0.013919,192,956506,-1,42.0,3862659,3863663,2962102,1004,33,11,True,True,1.5437370666666668,-0.013917220383922168
958,900601,3,2,0.536572,192,956506,-1,96.0,2854244,2854247,1953643,3,51,8,True,True,0.008956,-0.536572
959,900967,2394,2,0.454786,192,956506,-1,24.0,3543100,3545494,2642133,2394,42,12,True,True,1.2929196000000003,-0.454786
960,900973,1191,16,0.672828,192,956506,-1,128.0,2761844,2763035,1860871,1191,57,12,True,True,4.3333344,-0.672828
961,901023,7663,1,0.672341,192,956506,-1,26.0,3449037,3456700,2548014,7663,44,8,True,True,6.595683466666666,-0.6704886641497942
962,901302,88,4,0.58456,192,956506,-1,140.0,2456344,2456432,1555042,88,64,11,True,True,0.3610102222222223,-0.58456
963,901346,11,2,0.822417,192,956506,-1,32.0,1495506,1495517,594160,11,82,8,True,True,0.011956266666666666,-0.822417
964,901612,8,1,0.940292,192,956506,-1,22.0,3557979,3557987,2656367,8,42,7,True,True,0.005057555555555555,-0.940292
965,901663,23878,7,0.108346,192,956506,-1,224.0,3997865,4021743,3096202,23878,28,1,True,True,188.70704968888893,-0.10608089161608439
966,902461,19,2,0.233822,192,956506,-1,46.0,3557979,3557998,2655518,19,43,0,True,True,0.025115361111111113,-0.233822
967,902471,1293,1,0.025025,192,956506,-1,48.0,3419737,3421030,2517266,1293,48,6,True,True,2.185696533333333,-0.024636457896804645
968,902499,7017,42,0.884235,192,956506,-1,1512.0,2560944,2567961,1658445,7017,66,7,True,True,457.7926248,-0.8683527319977432
969,902511,126,8,0.561407,192,956506,-1,344.0,1686306,1686432,783795,126,86,8,True,True,2.2351056,-0.561407
970,902522,52,1,0.915256,192,956506,-1,17.0,1682706,1682758,780184,52,87,12,True,True,0.04189177777777778,-0.915256
971,902557,23,32,0.221367,192,956506,-1,1280.0,3323237,3323260,2420680,23,52,11,True,True,1.4773155555555557,-0.221367
972,902661,93,1,0.063217,192,956506,-1,10.0,4210311,4210404,3307650,93,22,10,True,True,0.038812000000000006,-0.063217
973,903095,8782,32,0.823855,192,956506,-1,768.0,2399544,2408326,1496449,8782,72,11,True,True,127.62435413333333,-0.7955756914592966
974,903110,860,16,0.909388,192,956506,-1,752.0,972706,973566,69596,860,99,9,True,True,19.480643555555556,-0.909388
975,903135,6,16,0.30219,192,956506,-1,352.0,2101124,2101130,1197989,6,82,9,True,True,0.056883199999999995,-0.30219
976,903148,44954,1,0.408296,192,956506,-1,35.0,3097037,3141991,2193889,44954,58,11,True,True,76.48425380555557,-0.4001648437185704
977,903524,11752,256,0.139777,192,956506,-1,6912.0,4641094,4652846,3737570,11752,11,7,True,True,3141.7640447999997,-0.1392384313196183
978,903601,92,1,0.946262,192,956506,-1,17.0,2485644,2485736,1582043,92,73,10,True,True,0.04048153333333334,-0.946262
979,903638,68,1,0.304365,192,956506,-1,40.0,1288706,1288774,385068,68,101,11,True,True,0.06450177777777778,-0.304365
980,903680,4122,32,0.492625,192,956506,-1,672.0,4106965,4111087,3203285,4122,26,7,True,True,163.6982872,-0.49164622633819594
981,903718,45,8,0.097192,192,956506,-1,192.0,5364815,5364860,4461097,45,0,11,True,True,0.319824,-0.097192
982,904017,60,2,0.887259,192,956506,-1,12.0,3205537,3205597,2301520,60,60,12,True,True,0.028362000000000002,-0.887259
983,904225,19,1,0.135664,192,956506,-1,12.0,1585506,1585525,681281,19,99,12,True,True,0.013751566666666666,-0.13566399999999998
984,904339,39,33,0.453644,192,956506,-1,429.0,3212737,3212776,2308398,39,60,9,True,True,0.42059874999999997,-0.453644
985,905570,22716,12,0.670486,192,956506,-1,252.0,1064506,1087222,158936,22716,108,7,True,True,308.58397360000004,-0.6622614479776207
986,905590,9,4,0.74314,192,956506,-1,60.0,2001224,2001233,1095634,9,92,8,True,True,0.013483499999999999,-0.74314
987,905623,13136,1,0.945974,192,956506,-1,32.0,2876344,2889480,1970721,13136,65,10,True,True,13.578752,-0.917285878295701
988,906078,9022,64,0.419127,192,956506,-1,768.0,2962744,2971766,2056666,9022,65,12,True,True,272.3432277333333,-0.399144256621601
989,906231,66,8,0.742269,192,956506,-1,168.0,2005724,2005790,1099493,66,93,6,True,True,0.38059560000000003,-0.742269
990,906267,19,2,0.154523,192,956506,-1,40.0,4992742,4992761,4086475,19,3,11,True,True,0.03801477777777778,-0.154523
991,906314,10719,32,0.414885,192,956506,-1,736.0,3737479,3748198,2831165,10719,44,11,True,True,259.9335943111111,-0.4145067774213664
992,906561,65,1,0.099022,192,956506,-1,33.0,2007524,2007589,1100963,65,95,7,True,True,0.07362712499999999,-0.099022
993,906605,6836,4,0.489347,192,956506,-1,52.0,1990788,1997624,1084183,6836,100,7,True,True,8.11954,-0.48917500789053014
994,906648,38,16,0.408116,192,956506,-1,128.0,4924584,4924622,4017936,38,6,12,True,True,0.18676408888888887,-0.408116
995,907346,10685,256,0.951522,192,956506,-1,1792.0,3545494,3556179,2638148,10685,52,1,True,True,468.08514915555554,-0.940487512264373
996,907418,22137,186,0.032716,192,956506,-1,1674.0,4747984,4770121,3840566,22137,9,1,True,True,1624.5055813499998,-0.027323356395247425
997,907611,11406,130,0.37053,192,956506,-1,4420.0,4613585,4624991,3705974,11406,17,6,True,True,2186.879716666667,-0.36469173085828377
998,907659,13541,8,0.443383,192,956506,-1,72.0,4746146,4759687,3838487,13541,10,9,True,True,35.113154,-0.4369099081627885
999,908719,13369,32,0.950555,192,956506,-1,512.0,1592706,1606075,683987,13369,112,1,True,True,392.1245240888889,-0.8300956292922054
1000,908991,87,16,0.85545,192,956506,-1,176.0,3992463,3992550,3083472,87,39,9,True,True,0.5192043999999999,-0.85545
1001,909120,27,4,0.099355,192,956506,-1,84.0,3818459,3818486,2909339,27,45,0,True,True,0.0803124,-0.099355
1002,909179,43100,1,0.68568,192,956506,-1,12.0,3963163,4006263,3053984,43100,41,7,True,True,18.0341573,-0.6782972026721598
1003,909201,123,2,0.544466,192,956506,-1,44.0,3737479,3737602,2828278,123,51,0,True,True,0.17552919999999997,-0.544466
1004,909536,33,1,0.977843,192,956506,-1,49.0,3556179,3556212,2646643,33,59,8,True,True,0.04439114166666667,-0.977843
1005,909593,16765,128,0.358674,192,956506,-1,5632.0,3052837,3069602,2143244,16765,76,12,True,True,6114.082131911111,-0.3491690083234805
1006,909608,12,4,0.39814,192,956506,-1,192.0,4770084,4770096,3860476,12,9,10,True,True,0.20817280000000002,-0.39814
1007,909629,54,39,0.189809,192,956506,-1,507.0,4060965,4061019,3151336,54,34,11,True,True,0.94872375,-0.189809
1008,909664,402,8,0.12216,192,956506,-1,256.0,4589759,4590161,3680095,402,22,11,True,True,4.244434488888889,-0.1195795793185969
1009,909671,508,32,0.848033,192,956506,-1,800.0,2836244,2836752,1926573,508,85,9,True,True,14.449777777777777,-0.848033
1010,909734,7262,128,0.454717,192,956506,-1,2944.0,3692379,3699641,2782645,7262,57,11,True,True,737.7128600888889,-0.4457560241327807
1011,910051,9,1,0.662769,192,956506,-1,6.0,4188211,4188220,3278160,9,32,1,True,True,0.0025452,-0.662769
1012,910264,145,32,0.641704,192,956506,-1,864.0,4233311,4233456,3323047,145,29,0,True,True,5.553384000000001,-0.641704
1013,912627,17,11,0.597146,192,956506,-1,517.0,2151217,2151234,1238590,17,108,9,True,True,0.15742075555555557,-0.597146
1014,913063,10,8,0.021357,192,956506,-1,136.0,3445437,3445447,2532374,10,70,10,True,True,0.04464200000000001,-0.021357
1015,913159,10,2,0.786795,192,956506,-1,24.0,1381606,1381616,468447,10,131,10,True,True,0.010202666666666667,-0.786795
1016,913181,4,32,0.243569,192,956506,-1,256.0,4105165,4105169,3191984,4,37,11,True,True,0.05679786666666666,-0.243569
1017,913189,52,2,0.125924,192,956506,-1,28.0,2244817,2244869,1331628,52,109,8,True,True,0.02038804444444444,-0.125924
1018,913206,10652,32,0.564578,192,956506,-1,448.0,4426259,4436911,3513053,10652,24,11,True,True,209.95065653333333,-0.5476541707442468
1019,913376,10586,4,0.06861,192,956506,-1,72.0,4233456,4244042,3320080,10586,30,2,True,True,28.2381344,-0.0642165049336064
1020,913679,13,1,0.765157,192,956506,-1,8.0,2412144,2412157,1498465,13,105,7,True,True,0.0022264666666666666,-0.7651570000000002
1021,913776,5090,128,0.207157,192,956506,-1,2560.0,4140387,4145477,3226611,5090,37,10,True,True,540.2660693333335,-0.20584424465850135
1022,913837,8334,86,0.215951,192,956506,-1,3440.0,1592706,1601040,678869,8334,133,0,True,True,1474.595904,-0.2059829721338586
1023,913856,34,1,0.869695,192,956506,-1,5.0,2347244,2347278,1433388,34,110,1,True,True,0.004510666666666666,-0.869695
1024,913878,12987,102,0.32856,192,956506,-1,2856.0,4600598,4613585,3686720,12987,21,1,True,True,1575.4841335333333,-0.3210962213429595
1025,914416,1453,8,0.147554,192,956506,-1,88.0,5320615,5322068,4406199,1453,1,10,True,True,3.904938644444444,-0.14472799540053505
1026,914447,10233,26,0.900531,192,956506,-1,234.0,4604198,4614431,3689751,10233,21,7,True,True,99.35361735,-0.8644981875620639
1027,917303,12378,32,0.002836,192,956506,-1,864.0,4692946,4705324,3775643,12378,14,6,True,True,858.1625472,-0.002747177011192181
1028,917615,29897,224,0.858406,192,956506,-1,10976.0,2093924,2123821,1176309,29897,126,12,True,True,8447.64745377778,-0.858148251676018
1029,917671,30,8,0.144688,192,956506,-1,216.0,1858388,1858418,940717,30,133,8,True,True,0.255654,-0.144688
1030,917677,24,1,0.129992,192,956506,-1,39.0,4188187,4188211,3270510,24,40,11,True,True,0.044116800000000005,-0.129992
1031,918317,103,8,0.250654,192,956506,-1,264.0,2403144,2403247,1484827,103,112,1,True,True,0.48341333333333336,-0.250654
1032,918364,38,2,0.174497,192,956506,-1,46.0,4669946,4669984,3751582,38,16,8,True,True,0.07247402222222223,-0.174497
1033,918775,3,9,0.661058,192,956506,-1,333.0,1062706,1062709,143931,3,156,8,True,True,0.055641525000000004,-0.661058
1034,919307,9385,1,0.02578,192,956506,-1,32.0,2564544,2573929,1645237,9385,107,8,True,True,13.434379200000002,-0.02576730207783158
1035,919364,89,32,0.01486,192,956506,-1,1600.0,4600559,4600648,3681195,89,26,1,True,True,6.244240000000001,-0.01486
1036,919452,3,64,0.789985,192,956506,-1,2688.0,4738946,4738949,3819494,3,13,7,True,True,0.34343680000000004,-0.789985
1037,920324,34,8,0.237932,192,956506,-1,112.0,2252917,2252951,1332593,34,123,9,True,True,0.05333315555555555,-0.237932
1038,920891,48,2,0.323771,192,956506,-1,70.0,1403706,1403754,482815,48,152,10,True,True,0.2300106666666667,-0.323771
1039,920971,97,16,0.174246,192,956506,-1,704.0,1988988,1989085,1068017,97,140,10,True,True,1.5459644444444445,-0.174246
1040,921010,137,32,0.052399,192,956506,-1,1248.0,2121917,2122054,1200907,137,129,7,True,True,4.447750666666668,-0.052399
1041,921138,19,32,0.741718,192,956506,-1,1024.0,3603979,3603998,2682841,19,73,10,True,True,0.6669624888888889,-0.741718
1042,921155,4,16,0.526086,192,956506,-1,352.0,2347240,2347244,1426085,4,122,1,True,True,0.03735893333333333,-0.526086
1043,921476,16,2,0.745665,192,956506,-1,48.0,1499106,1499122,577630,16,155,8,True,True,0.026451199999999998,-0.7456650000000001
1044,922091,7318,1,0.476246,192,956506,-1,21.0,2355344,2362662,1433253,7318,119,6,True,True,3.82634,-0.47484964910546246
1045,922453,8,32,0.778017,192,956506,-1,832.0,2661044,2661052,1738591,8,109,8,True,True,0.26847715555555557,-0.778017
1046,923100,8145,4,0.513238,192,956506,-1,180.0,4948542,4956687,4025442,8145,5,7,True,True,79.772148,-0.4969359586596197
1047,923295,14,4,0.109054,192,956506,-1,112.0,1966888,1966902,1043593,14,147,12,True,True,0.051247466666666665,-0.109054
1048,924235,1805,4,0.503839,192,956506,-1,192.0,5298515,5300320,4374280,1805,2,0,True,True,11.360778666666667,-0.49107919330549527
1049,924270,4,4,0.945416,192,956506,-1,76.0,2410344,2410348,1486074,4,120,9,True,True,0.006697288888888889,-0.945416
1050,924347,478,32,0.043365,192,956506,-1,960.0,2843444,2843922,1919097,478,104,9,True,True,16.05187733333333,-0.043365
1051,924458,5852,24,0.783227,192,956506,-1,792.0,2613244,2619096,1688786,5852,114,6,True,True,327.11177840000005,-0.7284682873318221
1052,924597,126,1,0.866981,192,956506,-1,30.0,4281259,4281385,3356662,126,37,0,True,True,0.2542575,-0.866981
1053,924998,6,8,0.521451,192,956506,-1,312.0,4005065,4005071,3080067,6,56,8,True,True,0.061417200000000005,-0.5214509999999999
1054,925011,39,16,0.458043,192,956506,-1,688.0,4600559,4600598,3675548,39,29,0,True,True,1.1765832,-0.458043
1055,936420,9172,256,0.964026,192,956506,-1,3072.0,1832688,1841860,896268,9172,157,2,True,True,1526.9966506666667,-0.9472230407525937
1056,940082,17,1,0.060825,192,956506,-1,35.0,5195042,5195059,4254960,17,4,10,True,True,0.02596018055555556,-0.060825
1057,946443,136,4,0.478982,192,956506,-1,120.0,5079142,5079278,4132699,136,6,12,True,True,0.9218533333333332,-0.478982
1058,947436,101,4,0.401617,192,956506,-1,52.0,4656446,4656547,3709010,101,24,8,True,True,0.19668739999999998,-0.401617
1059,948335,228,2,0.686097,192,956506,-1,78.0,4459159,4459387,3510824,228,36,10,True,True,0.7137312000000001,-0.686097
1060,948427,60,128,0.490269,192,956506,-1,1664.0,4545559,4545619,3597132,60,36,12,True,True,4.573504,-0.490269
1061,950872,20,1,0.909701,192,956506,-1,21.0,1880488,1880508,929616,20,160,10,True,True,0.017334333333333337,-0.909701
1062,951596,93,6,0.073491,192,956506,-1,114.0,2966344,2966437,2014748,93,108,1,True,True,0.39672190000000007,-0.06949316521672184
1063,952049,4,1,0.08079,192,956506,-1,40.0,4737146,4737150,3785097,4,18,11,True,True,0.010301333333333334,-0.08079
1064,954290,6001,1,0.608297,192,956506,-1,27.0,958306,964307,4016,6001,190,7,True,True,4.746484274999999,-0.5994366055453476
1065,954364,14892,1,0.065682,192,956506,-1,28.0,3741079,3755971,2786715,14892,79,8,True,True,13.61684621111111,-0.06531586031723105
1066,958951,49,2,0.275016,197,965506,-1,70.0,2612344,2612393,1653393,49,126,11,True,True,0.19694869444444446,-0.275016
1067,959062,1,16,0.633077,197,965506,-1,96.0,4110604,4110605,3151542,1,57,1,True,True,0.0057368,-0.633077
1068,960718,5,1,0.548356,197,965506,-1,16.0,5198642,5198647,4237924,5,4,2,True,True,0.0029924444444444447,-0.548356
1069,961037,26,1,0.325185,197,965506,-1,45.0,3456237,3456263,2495200,26,96,9,True,True,0.038619749999999994,-0.325185
1070,961492,11010,4,0.994628,197,965506,-1,140.0,1490106,1501116,528614,11010,182,12,True,True,52.337026,-0.9944175910172097
1071,962758,3023,14,0.530557,197,965506,-1,616.0,4013165,4016188,3050407,3023,64,2,True,True,65.25956873333332,-0.5296409290369286
1072,964846,8,16,0.453715,197,965506,-1,688.0,2237617,2237625,1272771,8,152,12,True,True,0.11006471111111109,-0.453715
1073,965817,8624,1,0.605427,210,972706,-1,15.0,1150906,1159530,185089,8624,193,12,True,True,5.1401025833333325,-0.562606418825499
1074,967377,34871,32,0.099178,210,972706,-1,1248.0,3423337,3458208,2455960,34871,100,8,True,True,1440.600252,-0.09710642553959721
1075,967509,1078,4,0.701779,210,972706,-1,196.0,2257240,2258318,1289731,1078,147,0,True,True,4.829691533333334,-0.701779
1076,968389,9,5,0.852793,210,972706,-1,155.0,4639285,4639294,3670896,9,29,10,True,True,0.056826875,-0.852793
1077,968414,72,16,0.650917,210,972706,-1,160.0,1822998,1823070,854584,72,176,7,True,True,0.706592,-0.650917
1078,969769,154,39,0.768963,210,972706,-1,1170.0,1596306,1596460,626537,154,182,3,True,True,8.579571,-0.768963
1079,971202,34,2,0.72084,210,972706,-1,52.0,2256517,2256551,1285315,34,151,8,True,True,0.02710442222222222,-0.7208399999999999
1080,971335,38,5,0.215023,210,972706,-1,225.0,4747946,4747984,3776611,38,17,7,True,True,0.277685,-0.215023
1081,971395,4,1,0.451555,210,972706,-1,26.0,972706,972710,1311,4,204,0,True,True,0.003132711111111111,-0.451555
1082,971409,19,16,0.228494,210,972706,-1,736.0,4948542,4948561,3977133,19,9,0,True,True,0.7966607111111111,-0.22849399999999997
1083,972347,8440,4,0.338932,210,972706,-1,132.0,4118287,4126727,3145940,8440,60,9,True,True,63.210022333333335,-0.287229696013291
1084,972419,46,64,0.453499,210,972706,-1,2752.0,5288642,5288688,4316223,46,4,12,True,True,3.5948611555555554,-0.453499
1085,972472,202,7,0.41599,210,972706,-1,252.0,1491906,1492108,519434,202,194,7,True,True,1.7054254,-0.41599
1086,972562,9,16,0.095086,210,972706,-1,368.0,5171142,5171151,4198580,9,7,11,True,True,0.13045600000000002,-0.095086
1087,973330,8268,1,0.426764,239,1059106,-1,38.0,2343640,2351908,1370310,8268,153,12,True,True,8.327224999999999,-0.42653756437553725
1088,976350,1795,8,0.665108,239,1059106,-1,392.0,1587306,1589101,610956,1795,193,7,True,True,36.23826686666667,-0.5679259837643444
1089,977243,39,1,0.374301,239,1059106,-1,30.0,4660046,4660085,3682803,39,30,8,True,True,0.045025499999999996,-0.374301
1090,977252,11,1,0.152639,239,1059106,-1,22.0,4639294,4639305,3662042,11,34,1,True,True,0.009858138888888889,-0.152639
1091,977766,685,12,0.922985,239,1059106,-1,132.0,2256555,2257240,1278789,685,158,1,True,True,1.4259355,-0.6367742018435779
1092,977881,13472,8,0.067133,239,1059106,-1,104.0,5126942,5140414,4149061,13472,8,11,True,True,80.89038764444444,-0.06685154968545298
1093,977908,132,1,0.831772,239,1059106,-1,41.0,4367659,4367791,3389751,132,53,12,True,True,0.2322800333333333,-0.831772
1094,978328,59,16,0.09323,239,1059106,-1,528.0,5172942,5173001,4194614,59,7,7,True,True,1.227042666666667,-0.09323
1095,978363,3,8,0.096564,239,1059106,-1,48.0,4281256,4281259,3302893,3,57,11,True,True,0.009686,-0.096564
1096,978418,13818,1,0.738796,239,1059106,-1,8.0,5195042,5208860,4216624,13818,6,0,True,True,4.101932133333333,-0.7341962968596446
1097,978486,10996,1,0.811769,239,1059106,-1,20.0,1997624,2008620,1019138,10996,183,2,True,True,6.2659633333333336,-0.8064829406012335
1098,978991,526,1,0.556371,239,1059106,-1,36.0,3418837,3419363,2439846,526,115,11,True,True,0.6773828,-0.556371
1099,980530,24,4,0.586465,239,1059106,-1,28.0,4660946,4660970,3680416,24,33,6,True,True,0.0258608,-0.586465
1100,980556,14205,5,0.561586,239,1059106,-1,140.0,2559144,2573349,1578588,14205,149,11,True,True,87.44333033333335,-0.5582770405997587
1101,980782,174,1,0.329646,239,1059106,-1,21.0,1158106,1158280,177324,174,219,2,True,True,0.15169175,-0.329646
1102,981035,110,1,0.122231,239,1059106,-1,18.0,3959859,3959969,2978824,110,88,1,True,True,0.06789749999999999,-0.122231
1103,981285,15835,1,0.353598,239,1059106,-1,28.0,1154506,1170341,173221,15835,221,1,True,True,19.05652318888889,-0.35107947798256334
1104,981445,6,1,0.665341,239,1059106,-1,25.0,4666346,4666352,3684901,6,31,8,True,True,0.0063791666666666675,-0.665341
1105,982056,602,32,0.750284,239,1059106,-1,1600.0,4005965,4006567,3023909,602,81,6,True,True,31.600986666666664,-0.750284
1106,982101,37,4,0.868092,239,1059106,-1,160.0,2568144,2568181,1586043,37,150,3,True,True,0.26659733333333335,-0.868092
1107,982123,110,8,0.721061,239,1059106,-1,176.0,3818459,3818569,2836336,110,95,1,True,True,0.6855591111111111,-0.721061
1108,982164,7,8,0.968399,239,1059106,-1,224.0,4838184,4838191,3856020,7,19,10,True,True,0.07641386666666666,-0.968399
1109,982252,5,1,0.60041,239,1059106,-1,6.0,4946742,4946747,3964490,5,16,10,True,True,0.0017090833333333335,-0.60041
1110,982290,4761,32,0.351646,239,1059106,-1,256.0,2668244,2673005,1685954,4761,149,9,True,True,42.31345991111111,-0.33146764827040964
1111,982603,17270,32,0.577919,239,1059106,-1,1504.0,4992742,5010012,4010139,17270,13,0,True,True,1209.5289907555555,-0.559535201597775
1112,982610,6,1,0.212739,239,1059106,-1,30.0,4437059,4437065,3454449,6,55,9,True,True,0.007146,-0.212739
1113,982622,638,32,0.656736,239,1059106,-1,160.0,2463544,2464182,1480922,638,163,9,True,True,2.084416888888889,-0.656736
1114,982989,235,32,0.224245,239,1059106,-1,960.0,5202242,5202477,4219253,235,5,8,True,True,7.421613333333333,-0.224245
1115,983056,39,1,0.108218,239,1059106,-1,17.0,4110565,4110604,3127509,39,79,8,True,True,0.039619775,-0.108218
1116,983155,9737,1,0.845373,239,1059106,-1,48.0,3994263,4004000,3011108,9737,92,7,True,True,16.5026612,-0.8432147184189652
1117,983164,29666,2,0.367561,239,1059106,-1,10.0,5082742,5112408,4099578,29666,12,7,True,True,13.597997333333334,-0.3488824751160616
8108,6377131,47,4,0.476302,1,6377131,-1,120.0,6399231,6399278,22100,47,0,10,True,True,0.21546366666666666,-0.476302
8109,6378238,10,1,0.897511,9,6399231,-1,32.0,9864919,9864929,3486681,10,0,1,True,True,0.020693333333333334,-0.897511
8110,6378720,26,11,0.123098,9,6399231,-1,462.0,7116220,7116246,737500,26,1,11,True,True,0.9256247000000001,-0.123098
8111,6378935,136,8,0.135756,9,6399231,-1,352.0,9201235,9201371,2822300,136,1,7,True,True,1.3813731555555553,-0.135756
8112,6378951,139,64,0.534543,9,6399231,-1,1152.0,6400178,6400317,21227,139,3,6,True,True,6.1173344,-0.534543
8113,6379393,5,2,0.725414,9,6399231,-1,68.0,6399278,6399283,19885,5,4,1,True,True,0.012988944444444445,-0.725414
8114,6379472,188,16,0.090442,9,6399231,-1,656.0,9065235,9065423,2685763,188,2,1,True,True,3.726903644444445,-0.090442
8115,6380095,12873,4,0.691785,9,6399231,-1,20.0,6655917,6668790,275822,12873,4,12,True,True,24.057370333333335,-0.6782528234982901
8116,6391925,24763,3,0.871941,9,6399231,-1,36.0,6425878,6450641,33953,24763,5,10,True,True,31.507009899999996,-0.8597432104569791
8117,6393083,6,2,0.93178,9,6399231,-1,62.0,6403778,6403784,10695,6,6,8,True,True,0.0135563,-0.93178
8118,6402404,10865,16,0.766337,9,6403778,-1,496.0,10465928,10476793,4063524,10865,0,11,True,True,213.80360240000002,-0.7416259873702905
8119,6402494,34078,256,0.600679,9,6403778,-1,7680.0,9829928,9864006,3427434,34078,2,11,True,True,12615.458474666666,-0.561953216878409
8120,6402669,20,1,0.643987,9,6403778,-1,39.0,6547417,6547437,144748,20,7,2,True,True,0.02137416666666667,-0.643987
8121,6404470,327,1,0.37701,50,6425878,-1,18.0,9431037,9431364,3026567,327,3,0,True,True,0.18879345,-0.37700999999999996
8122,6405043,16695,8,0.717443,50,6425878,-1,144.0,6538014,6554709,132971,16695,9,8,True,True,65.85921359999999,-0.7150314889670774
8123,6405474,12420,141,0.736002,50,6425878,-1,3666.0,7718717,7731137,1313243,12420,6,11,True,True,2035.1677614666667,-0.7330496980360884
8124,6405788,47,4,0.381651,50,6425878,-1,152.0,9459837,9459884,3054049,47,3,8,True,True,0.29526548888888887,-0.381651
8125,6406712,10245,128,0.642102,50,6425878,-1,3968.0,9562637,9572882,3155925,10245,3,8,True,True,1111.8258844444445,-0.6365543867404945
8126,6406866,2,4,0.5619,50,6425878,-1,172.0,11542596,11542598,5135730,2,0,7,True,True,0.013909066666666664,-0.5619
8127,6409679,62,16,0.856141,50,6425878,-1,752.0,6512278,6512340,102599,62,14,12,True,True,2.0350080888888886,-0.856141
8128,6411880,3461,4,0.808447,50,6425878,-1,100.0,8445396,8448857,2033516,3461,9,9,True,True,12.079697222222224,-0.8070877891173737
8129,6412361,433,2,0.223551,50,6425878,-1,52.0,11540796,11541229,5128435,433,1,1,True,True,0.867866711111111,-0.223551
8130,6412410,16,2,0.11569,50,6425878,-1,88.0,9385937,9385953,2973527,16,8,12,True,True,0.04217742222222222,-0.11569
8131,6412419,8503,32,0.08768,50,6425878,-1,672.0,6538914,6547417,126495,8503,16,6,True,True,154.55215066666668,-0.08709670645517287
8132,6412478,35,4,0.089139,50,6425878,-1,168.0,11488216,11488251,5075738,35,2,8,True,True,0.2377316666666667,-0.089139
8133,6413657,15493,8,0.740581,50,6425878,-1,240.0,7626711,7642204,1213054,15493,14,10,True,True,168.0338293333333,-0.7373432754106496
8134,6413715,7,1,0.937211,50,6425878,-1,45.0,9909119,9909126,3495404,7,4,11,True,True,0.016158625,-0.937211
8135,6413904,35,5,0.744618,50,6425878,-1,155.0,11513951,11513986,5100047,35,2,8,True,True,0.1581688888888889,-0.744618
8136,6414290,126,1,0.116106,50,6425878,-1,24.0,10824294,10824420,4410004,126,4,11,True,True,0.10836000000000001,-0.116106
8137,6414603,58,4,0.367737,50,6425878,-1,124.0,10874794,10874852,4460191,58,4,11,True,True,0.24816395555555554,-0.36773700000000004
8138,6421226,22,8,0.85333,50,6425878,-1,208.0,9443637,9443659,3022411,22,12,8,True,True,0.1570584888888889,-0.85333
8139,6421316,4,8,0.954069,50,6425878,-1,376.0,8326996,8327000,1905680,4,18,8,True,True,0.12502835555555555,-0.954069
8140,6421412,60,4,0.576917,50,6425878,-1,68.0,6823917,6823977,402505,60,22,8,True,True,0.30583000000000005,-0.576917
8141,6421880,8849,32,0.001678,50,6425878,-1,1216.0,7237520,7246369,815640,8849,21,10,True,True,949.6998506666666,-0.0016533847318506354
8142,6421934,8333,15,0.061885,50,6425878,-1,315.0,11510351,11518684,5088417,8333,3,10,True,True,73.86707824999999,-0.06143186933714292
8143,6422009,22,1,0.535603,50,6425878,-1,49.0,10922594,10922616,4500585,22,5,8,True,True,0.05156133888888889,-0.535603
8144,6422033,20390,32,0.847119,50,6425878,-1,384.0,8966019,8986409,2543986,20390,19,10,True,True,369.5251424,-0.775652227845422
8145,6422764,6751,32,0.979849,50,6425878,-1,1216.0,9514837,9521588,3092073,6751,13,8,True,True,244.54076497777777,-0.9791844248412608
8146,6423734,14,1,0.319643,50,6425878,-1,19.0,6910317,6910331,486583,14,27,0,True,True,0.020490127777777777,-0.319643
8147,6423866,23216,101,0.365024,50,6425878,-1,1616.0,8048117,8071333,1624251,23216,23,6,True,True,3448.9776984888895,-0.3606219651484293
8148,6423995,349,4,0.679302,50,6425878,-1,156.0,8847419,8847768,2423424,349,21,12,True,True,2.7758878333333334,-0.679302
8149,6424009,34,8,0.796565,50,6425878,-1,312.0,8943919,8943953,2519910,34,21,10,True,True,0.3741088,-0.7965649999999999
8150,6424161,8,1,0.519751,50,6425878,-1,44.0,8447196,8447204,2023035,8,23,7,True,True,0.01230631111111111,-0.519751
8151,6424189,31,2,0.601618,50,6425878,-1,60.0,10254628,10254659,3830439,31,9,2,True,True,0.171988,-0.601618
8152,6424395,7,1,0.222142,50,6425878,-1,21.0,8568168,8568175,2143773,7,24,8,True,True,0.008938416666666667,-0.222142
8153,6424449,25172,64,0.395312,50,6425878,-1,1152.0,6534414,6559586,109965,25172,39,1,True,True,813.8237247999999,-0.3625234818899
8154,6424472,20451,2,0.538293,50,6425878,-1,84.0,8163817,8184268,1739345,20451,28,9,True,True,120.12860043333336,-0.47908846887880946
8155,6424527,15,4,0.460603,50,6425878,-1,196.0,10280328,10280343,3855801,15,9,1,True,True,0.29581300000000005,-0.460603
8156,6425008,71,1,0.144701,50,6425878,-1,16.0,8654568,8654639,2229560,71,25,12,True,True,0.06682204444444444,-0.144701
8157,6425300,7485,4,0.94289,50,6425878,-1,192.0,10421728,10429213,3996428,7485,9,9,True,True,54.462472000000005,-0.9313002668120415
8158,6425396,13324,16,0.837217,50,6425878,-1,192.0,11308016,11321340,4882620,13324,5,8,True,True,81.23628373333334,-0.8240916346213383
8159,6425461,47,1,0.499833,50,6425878,-1,36.0,8728068,8728115,2302607,47,27,8,True,True,0.0830067,-0.499833
8160,6425543,224,1,0.455785,50,6425878,-1,7.0,9434637,9434861,3009094,224,20,2,True,True,0.04959235555555556,-0.455785
8161,6425595,2,19,0.601465,50,6425878,-1,532.0,9566237,9566239,3140642,2,16,1,True,True,0.028804844444444446,-0.601465
8162,6425609,443,1,0.145871,50,6425878,-1,28.0,10242028,10242471,3816419,443,13,1,True,True,1.3694016000000002,-0.145871
8163,6426025,8,1,0.665351,94,6512278,-1,40.0,6546114,6546122,120089,8,46,9,True,True,0.00876888888888889,-0.665351
8164,6426378,7081,128,0.801292,94,6512278,-1,6144.0,8761019,8768100,2334641,7081,30,1,True,True,2544.145783466667,-0.7417038487121633
8165,6426457,11,1,0.702967,94,6512278,-1,46.0,8165617,8165628,1739160,11,37,7,True,True,0.048769966666666664,-0.702967
8166,6455460,21180,4,0.59888,94,6512278,-1,196.0,9764548,9785728,3309088,21180,17,8,True,True,199.27589173333334,-0.5777719739414565
8167,6455719,12,32,0.308891,94,6512278,-1,1056.0,11540784,11540796,5085065,12,2,10,True,True,0.48843520000000007,-0.308891
8168,6455822,29177,128,0.990335,94,6512278,-1,3712.0,9504037,9533214,3048215,29177,22,11,True,True,3234.1079740444447,-0.9790116553031972
8169,6455887,16,2,0.123464,94,6512278,-1,20.0,6913917,6913933,458030,16,47,2,True,True,0.026653333333333338,-0.123464
8170,6456027,100,1,0.996849,94,6512278,-1,47.0,8735268,8735368,2279241,100,34,9,True,True,0.2033663888888889,-0.9968489999999999
8171,6456047,127,2,0.706522,94,6512278,-1,84.0,9760948,9761075,3304901,127,19,0,True,True,0.7510272,-0.706522
8172,6462804,16,1,0.478283,94,6512278,-1,44.0,8047217,8047233,1584413,16,45,11,True,True,0.0676935111111111,-0.478283
8173,6468167,12202,32,0.828687,94,6512278,-1,896.0,8196833,8209035,1728666,12202,42,7,True,True,867.6697344,-0.7427850302863385
8174,6468858,69,16,0.495026,94,6512278,-1,480.0,11514851,11514920,5045993,69,3,6,True,True,0.9656319999999997,-0.495026
8175,6468963,23944,16,0.70414,94,6512278,-1,256.0,10491694,10515638,4022731,23944,11,1,True,True,241.73675946666668,-0.685838006776464
8176,6470414,2,40,0.376709,94,6512278,-1,600.0,7244720,7244722,774306,2,51,7,True,True,0.11366666666666667,-0.376709
8177,6471051,30,4,0.981143,94,6512278,-1,88.0,6569517,6569547,98466,30,58,10,True,True,0.20584666666666662,-0.981143
8178,6472282,19,8,0.333145,94,6512278,-1,232.0,6700117,6700136,227835,19,57,11,True,True,0.15912880000000001,-0.333145
8179,6472694,35,2,0.827885,94,6512278,-1,72.0,9645141,9645176,3172447,35,22,2,True,True,0.08638699999999999,-0.827885
8180,6481475,21285,8,0.210613,94,6512278,-1,80.0,11207694,11228979,4726219,21285,8,0,True,True,56.55877066666667,-0.19392390361019557
8181,6482751,3,1,0.732658,94,6512278,-1,40.0,7000317,7000320,517566,3,56,12,True,True,0.007826666666666668,-0.732658
8182,6482913,22,4,0.810419,94,6512278,-1,116.0,7789017,7789039,1306104,22,51,9,True,True,0.1396582,-0.810419
8183,6483235,9208,8,0.700407,94,6512278,-1,272.0,7345710,7354918,862475,9208,54,12,True,True,158.3873075555556,-0.6833073930447433
8184,6484147,1,32,0.052566,94,6512278,-1,1152.0,7835017,7835018,1350870,1,51,7,True,True,0.043971199999999995,-0.052566
8185,6485258,9,16,0.865432,94,6512278,-1,688.0,10238419,10238428,3753161,9,18,11,True,True,0.6169296,-0.865432
8186,6485563,36,20,0.17902,94,6512278,-1,540.0,6534378,6534414,48815,36,72,10,True,True,0.592542,-0.17901999999999998
8187,6492039,8,26,0.487505,94,6512278,-1,390.0,10780094,10780102,4288055,8,12,1,True,True,0.11902800000000001,-0.487505
8188,6492231,31,32,0.391808,94,6512278,-1,1440.0,9639741,9639772,3147510,31,26,9,True,True,1.6673040000000001,-0.391808
8189,6495591,2,1,0.98439,94,6512278,-1,8.0,11208141,11208143,4712550,2,8,1,True,True,0.0005685333333333333,-0.98439
8190,6495648,26,8,0.65925,94,6512278,-1,96.0,10658794,10658820,4163146,26,14,10,True,True,0.10531733333333333,-0.65925
8191,6495954,8,1,0.848518,94,6512278,-1,39.0,8134517,8134525,1638563,8,54,12,True,True,0.02812766666666667,-0.848518
8192,6496746,14074,4,0.991063,94,6512278,-1,132.0,7164020,7178094,667274,14074,64,11,True,True,163.8766528666667,-0.9906743476379943
8193,6498268,835,2,0.547943,94,6512278,-1,44.0,9511237,9512072,3012969,835,32,9,True,True,1.1384297222222222,-0.547943
8194,6498325,12165,64,0.33741,94,6512278,-1,1408.0,8156617,8168782,1658292,12165,55,10,True,True,1705.9632284444442,-0.33429182723036777
8195,6498584,9640,64,0.677899,94,6512278,-1,1664.0,8898819,8908459,2400235,9640,43,9,True,True,720.6480273777777,-0.6710475369449125
8196,6498674,14962,32,0.990314,94,6512278,-1,800.0,8448857,8463819,1950183,14962,50,2,True,True,843.9193088888888,-0.852971498979279
8197,6501826,1213,32,0.757714,94,6512278,-1,1312.0,7674517,7675730,1172691,1213,64,10,True,True,68.12943395555556,-0.7536755135236776
8198,6502035,6153,1,0.391063,94,6512278,-1,30.0,10629494,10635647,4127459,6153,15,10,True,True,8.260392666666666,-0.38140667455313665
8199,6502111,9289,8,0.527844,94,6512278,-1,120.0,6729417,6738706,227306,9289,76,0,True,True,73.75608866666667,-0.5081405847618865
8200,6502185,26,1,0.28304,94,6512278,-1,8.0,9452637,9452663,2950452,26,36,7,True,True,0.008303822222222222,-0.28304
8201,6502386,77,27,0.696376,94,6512278,-1,675.0,10498894,10498971,3996508,77,16,0,True,True,2.3710706249999998,-0.696376
8202,6504417,98,8,0.195092,94,6512278,-1,88.0,8698768,8698866,2194351,98,51,11,True,True,0.4183598222222221,-0.195092
8203,6506506,16072,16,0.856252,94,6512278,-1,576.0,8470957,8487029,1964451,16072,54,10,True,True,805.7508479999999,-0.854849108101204
8204,6506530,393,2,0.393772,94,6512278,-1,60.0,7000320,7000713,493790,393,76,1,True,True,1.5379399999999999,-0.39377199999999996
8205,6506670,9,10,0.130901,94,6512278,-1,60.0,11121294,11121303,4614624,9,10,11,True,True,0.021993,-0.130901
8206,6506850,53,32,0.752266,94,6512278,-1,1120.0,9021019,9021072,2514169,53,45,1,True,True,2.1765333333333334,-0.752266
8207,6506902,10238,16,0.580384,94,6512278,-1,656.0,7652417,7662655,1145515,10238,72,8,True,True,286.9992182666667,-0.5630846031416358
8208,6514749,11,4,0.805072,126,6534378,-1,148.0,9010219,9010230,2495470,11,46,11,True,True,0.070818,-0.805072
8209,6515182,17122,16,0.84981,126,6534378,-1,640.0,10924394,10941516,4409212,17122,11,7,True,True,518.9381582222222,-0.8243861943901214
8210,6515205,5924,65,0.709588,126,6534378,-1,2405.0,7912117,7918041,1396912,5924,70,10,True,True,931.5440754027777,-0.6685274917176854
8211,6515302,21,4,0.457533,126,6534378,-1,180.0,9440037,9440058,2924735,21,41,2,True,True,0.134736,-0.457533
8212,6515336,13,4,0.163694,126,6534378,-1,156.0,9864906,9864919,3349570,13,28,6,True,True,0.131144,-0.163694
8213,6518831,318,1,0.137561,126,6534378,-1,23.0,10633094,10633412,4114263,318,17,2,True,True,0.3292519,-0.137561
8214,6519316,9030,256,0.695956,126,6534378,-1,1536.0,9785728,9794758,3266412,9030,31,6,True,True,570.9494016,-0.6639642840460754
8215,6520167,30595,8,0.291082,126,6534378,-1,56.0,10276728,10307323,3756561,30595,24,10,True,True,148.8712204,-0.2835564881164521
8216,6521012,76,8,0.144823,126,6534378,-1,136.0,8724468,8724544,2203456,76,60,8,True,True,0.4703454222222223,-0.144823
8217,6521112,549,11,0.218136,126,6534378,-1,429.0,9864906,9865455,3343794,549,30,0,True,True,15.230357999999999,-0.218136
8218,6521118,54,4,0.748383,126,6534378,-1,32.0,7027820,7027874,506702,54,89,10,True,True,0.090024,-0.748383
8219,6523224,6,4,0.735319,126,6534378,-1,44.0,8195033,8195039,1671809,6,71,10,True,True,0.0088968,-0.735319
8220,6523228,25123,128,0.009133,126,6534378,-1,3456.0,11540784,11565907,5017556,25123,2,0,True,True,3464.2045343999994,-0.008950900566475255
8221,6523268,45,32,0.725958,126,6534378,-1,1440.0,9213137,9213182,2689869,45,51,1,True,True,1.7999999999999998,-0.725958
8222,6523290,5278,1,0.575682,126,6534378,-1,23.0,7551410,7556688,1028120,5278,87,9,True,True,7.7692398944444445,-0.575064117738663
8223,6523551,26792,8,0.678318,126,6534378,-1,376.0,10249228,10276020,3725677,26792,27,9,True,True,986.4677845333335,-0.6719937018195689
8224,6523577,26,32,0.988484,126,6534378,-1,512.0,8289596,8289622,1766019,26,73,6,True,True,0.7233223111111111,-0.988484
8225,6523687,13863,2,0.147605,126,6534378,-1,94.0,10776494,10790357,4252807,13863,17,11,True,True,52.05463092777777,-0.14264868455242577
8226,6523887,47,32,0.950398,126,6534378,-1,960.0,9430137,9430184,2906250,47,52,11,True,True,1.447224,-0.950398
8227,6525544,23,3,0.427111,126,6534378,-1,141.0,11518451,11518474,4992907,23,4,2,True,True,0.086236775,-0.427111
8228,6525619,311,2,0.84166,126,6534378,-1,32.0,7119820,7120131,594201,311,97,8,True,True,0.8448971555555556,-0.84166
8229,6525992,180,14,0.925985,126,6534378,-1,406.0,10725094,10725274,4199102,180,19,10,True,True,3.2092270000000003,-0.925985
8230,6526033,15294,16,0.096048,126,6534378,-1,128.0,11438616,11453910,4912583,15294,9,11,True,True,62.483325866666675,-0.09394535584059013
8231,6526045,205,1,0.974159,126,6534378,-1,34.0,10830594,10830799,4304549,205,17,8,True,True,0.2657893333333333,-0.974159
8232,6526122,1222,1,0.179633,126,6534378,-1,49.0,10826094,10827316,4299972,1222,18,7,True,True,2.035020361111111,-0.179633
8233,6526796,10402,8,0.052472,126,6534378,-1,232.0,10990694,11001096,4463898,10402,14,11,True,True,71.75661013333334,-0.04931569776942496
8234,6526905,17,2,0.980277,126,6534378,-1,78.0,7781817,7781834,1254912,17,93,2,True,True,0.07026695000000001,-0.980277
8235,6526907,11573,6,0.650098,126,6534378,-1,234.0,7777317,7788890,1250410,11573,94,8,True,True,146.8409904,-0.6449825888195155
8236,6526938,14957,64,0.593392,126,6534378,-1,384.0,7005720,7020677,478782,14957,107,7,True,True,478.3139957333333,-0.5921499649607878
8237,6527026,8,13,0.969727,126,6534378,-1,247.0,7560410,7560418,1033384,8,99,7,True,True,0.12379091111111111,-0.9697269999999998
8238,6531734,19,16,0.626973,126,6534378,-1,512.0,10106019,10106038,3574285,19,37,12,True,True,0.36539448888888887,-0.626973
8239,6531754,102,4,0.403994,126,6534378,-1,136.0,8437296,8437398,1905542,102,81,10,True,True,0.6184985333333334,-0.4039939999999999
8240,6533797,30,16,0.033993,126,6534378,-1,320.0,10702994,10703024,4169197,30,24,11,True,True,0.3675733333333333,-0.033993
8241,6537960,162,32,0.240855,126,6538014,-1,640.0,9670841,9671003,3132881,162,47,10,True,True,3.13776,-0.240855
8242,6537985,38206,4,0.488626,126,6538014,-1,44.0,9436437,9474643,2898452,38206,59,7,True,True,63.474268977777776,-0.4873699707352175
8243,6539007,11,16,0.687984,125,6546114,-1,304.0,7544210,7544221,1005203,11,106,8,True,True,0.18565702222222225,-0.6879840000000002
8244,6547958,81,1,0.954555,142,6569517,-1,7.0,9632541,9632622,3084583,81,50,1,True,True,0.02025135,-0.954555
8245,6547981,6,8,0.652797,142,6569517,-1,240.0,7648811,7648817,1100830,6,104,10,True,True,0.06563200000000001,-0.652797
8246,6548054,15766,1,0.375372,142,6569517,-1,41.0,7890017,7905783,1341963,15766,97,8,True,True,40.50304890833334,-0.355742036927366
8247,6548764,1472,6,0.691795,142,6569517,-1,264.0,8002117,8003589,1453353,1472,96,0,True,True,23.1255816,-0.5105564089165596
8248,6549100,15973,4,0.795325,142,6569517,-1,148.0,9641541,9657514,3092441,15973,49,7,True,True,78.8172820111111,-0.7852876531364301
8249,6549404,11,16,0.658519,142,6569517,-1,512.0,8564557,8564568,2015153,11,82,12,True,True,0.34081422222222224,-0.658519
8250,6549461,127,2,0.777731,142,6569517,-1,40.0,7842217,7842344,1292756,127,101,9,True,True,0.15983655555555554,-0.777731
8251,6549590,12228,128,0.864896,142,6569517,-1,5248.0,6910317,6922545,360727,12228,126,12,True,True,5239.055702400001,-0.864053011642737
8252,6550270,447,16,0.650311,142,6569517,-1,640.0,11207694,11208141,4657424,447,13,0,True,True,10.165376,-0.650311
8253,6550672,574,8,0.275216,142,6569517,-1,320.0,7558610,7559184,1007938,574,113,9,True,True,11.757050666666668,-0.275216
8254,6550906,17,1,0.653195,142,6569517,-1,43.0,10283928,10283945,3733022,17,33,8,True,True,0.07377414444444444,-0.653195
8255,6551317,9,4,0.367323,142,6569517,-1,44.0,8474557,8474566,1923240,9,85,1,True,True,0.03570489999999999,-0.367323
8256,6555872,21,16,0.12,142,6569517,-1,80.0,10194219,10194240,3638347,21,40,0,True,True,0.14259000000000002,-0.12
8257,6556914,38837,32,0.082637,142,6569517,-1,1536.0,10019619,10058456,3462705,38837,42,10,True,True,2543.8979839999997,-0.0820278762544873
8258,6556980,7,1,0.489218,142,6569517,-1,32.0,7259310,7259317,702330,7,121,1,True,True,0.02382177777777778,-0.489218
8259,6557207,20,8,0.668792,142,6569517,-1,360.0,8720868,8720888,2163661,20,83,10,True,True,0.38194,-0.668792
8260,6557226,30122,16,0.509748,142,6569517,-1,224.0,11077094,11107216,4519868,30122,15,12,True,True,203.0942144,-0.4765280018344595
8261,6560365,24923,8,0.023027,142,6569517,-1,152.0,10520994,10545917,3960629,24923,30,10,True,True,131.35646242222222,-0.022561444976403226
8262,6561375,4,4,0.572982,142,6569517,-1,140.0,7215420,7215424,654045,4,127,11,True,True,0.04219911111111111,-0.572982
8263,6584225,8636,32,0.572631,242,6655917,-1,384.0,10728694,10737330,4144469,8636,25,8,True,True,139.93410346666667,-0.5652200329743249
8264,6584326,115,1,0.273725,242,6655917,-1,14.0,7171220,7171335,586894,115,129,9,True,True,0.14326763888888888,-0.273725
8265,6584470,5285,1,0.745359,242,6655917,-1,13.0,10469528,10474813,3885058,5285,34,8,True,True,2.6614391555555557,-0.7221338883145074
8266,6584524,17,8,0.794344,242,6655917,-1,368.0,10498894,10498911,3914370,17,33,9,True,True,0.2853952444444444,-0.794344
8267,6586397,15006,2,0.181097,242,6655917,-1,36.0,8738868,8753874,2152471,15006,85,8,True,True,26.7790938,-0.17710594580930367
8268,6595995,36,1,0.484191,242,6655917,-1,19.0,7604611,7604647,1008616,36,123,1,True,True,0.031437400000000004,-0.484191
8269,6598188,13,2,0.644597,242,6655917,-1,100.0,10392428,10392441,3794240,13,38,10,True,True,0.062363888888888885,-0.644597
8270,6598204,29295,1,0.433656,242,6655917,-1,18.0,8413396,8442691,1815192,29295,101,12,True,True,30.67438865,-0.4320613961631256
8271,6598230,8526,1,0.571423,242,6655917,-1,28.0,8415196,8423722,1816966,8526,101,7,True,True,15.844197600000001,-0.5708848673733787
8272,6598245,6341,32,0.099441,242,6655917,-1,928.0,11488251,11494592,4890006,6341,8,1,True,True,200.4879426666667,-0.09600177004907104
8273,6598319,6,32,0.063498,242,6655917,-1,1440.0,7454210,7454216,855891,6,132,10,True,True,0.6787920000000001,-0.063498
8274,6598385,98,4,0.908881,242,6655917,-1,32.0,6820317,6820415,221932,98,150,6,True,True,0.21715057777777777,-0.908881
8275,6598409,63,4,0.795225,242,6655917,-1,200.0,8283233,8283296,1684824,63,106,12,True,True,0.4566450000000001,-0.795225
8276,6598586,39,1,0.18489,242,6655917,-1,42.0,10414528,10414567,3815942,39,39,10,True,True,0.08476195,-0.18489
8277,6598637,103,32,0.812868,242,6655917,-1,736.0,8891619,8891722,2292982,103,86,11,True,True,3.3043864888888885,-0.812868
8278,6601227,155,32,0.019746,242,6655917,-1,1280.0,9113035,9113190,2511808,155,80,8,True,True,6.5637333333333325,-0.019746
8279,6601244,6,11,0.55606,242,6655917,-1,132.0,9213137,9213143,2611893,6,78,0,True,True,0.022000000000000002,-0.55606
8280,6601275,10,1,0.536417,242,6655917,-1,34.0,9450837,9450847,2849562,10,71,2,True,True,0.013573555555555557,-0.536417
8281,6601296,8,1,0.812196,242,6655917,-1,9.0,8438196,8438204,1836900,8,106,6,True,True,0.0032101999999999994,-0.812196
8282,6601430,4,2,0.488563,242,6655917,-1,94.0,7915717,7915721,1314287,4,122,1,True,True,0.02668242222222222,-0.48856300000000014
8283,6601507,326,2,0.518901,242,6655917,-1,64.0,7648817,7649143,1047310,326,133,1,True,True,0.9509347555555556,-0.518901
8284,6601557,3,8,0.584722,242,6655917,-1,40.0,7072020,7072023,470463,3,151,11,True,True,0.007661333333333334,-0.5847219999999999
8285,6601724,7,16,0.713749,242,6655917,-1,368.0,8478157,8478164,1876433,7,101,8,True,True,0.21895284444444443,-0.713749
8286,6601793,12,2,0.790068,242,6655917,-1,82.0,11484616,11484628,4882823,12,10,7,True,True,0.04087153333333334,-0.790068
8287,6602243,16242,8,0.124089,242,6655917,-1,168.0,8286896,8303138,1684653,16242,114,8,True,True,170.3638962666667,-0.1182729798562218
8288,6602328,45256,3,0.752988,242,6655917,-1,63.0,11295416,11340672,4693088,45256,13,12,True,True,91.85718080000002,-0.7430780423578334
8289,6602357,1768,4,0.965681,242,6655917,-1,48.0,10918994,10920762,4316637,1768,22,11,True,True,3.114273066666667,-0.965681
8290,6602381,3627,16,0.897602,242,6655917,-1,624.0,9199435,9203062,2597054,3627,85,0,True,True,65.51000906666667,-0.8935581509290753
8291,6602432,111,70,0.180664,242,6655917,-1,420.0,11394416,11394527,4791984,111,12,12,True,True,1.4202265,-0.180664
8292,6602439,5630,63,0.599103,242,6655917,-1,1134.0,9017419,9023049,2414980,5630,90,9,True,True,239.56655625,-0.5651918424521808
8293,6602850,587,4,0.179938,242,6655917,-1,72.0,9997519,9998106,3394669,587,55,11,True,True,1.9486052,-0.179938
8294,6602886,1,8,0.554722,242,6655917,-1,88.0,7604610,7604611,1001724,1,146,11,True,True,0.004044577777777778,-0.554722
8295,6602918,561,8,0.800513,242,6655917,-1,224.0,11302616,11303177,4699698,561,14,9,True,True,4.027182133333333,-0.800513
8296,6602928,8,1,0.123045,242,6655917,-1,22.0,10251028,10251036,3648100,8,50,7,True,True,0.01841693333333333,-0.123045
8297,6602934,6208,3,0.128816,242,6655917,-1,99.0,10946494,10952702,4343560,6208,22,10,True,True,20.061903400000002,-0.12499671816363189
8298,6603044,9451,256,0.20623,242,6655917,-1,4352.0,7249859,7259310,646815,9451,157,7,True,True,4251.240984888889,-0.2029801817391782
8299,6603431,3571,256,0.16121,242,6655917,-1,5888.0,9757377,9760948,3153946,3571,67,0,True,True,1535.2440384000001,-0.15778174238906212
8300,6603479,6939,4,0.562496,242,6655917,-1,168.0,7242920,7249859,639441,6939,160,2,True,True,111.27216566666668,-0.5616537914532751
8301,6603637,8,1,0.85145,242,6655917,-1,39.0,10732294,10732302,4128657,8,32,1,True,True,0.0128102,-0.85145
8302,6603653,369,2,0.035005,242,6655917,-1,66.0,11209016,11209385,4605363,369,16,2,True,True,0.8653788,-0.035005
8303,6603719,80,8,0.979928,242,6655917,-1,296.0,9203035,9203115,2599316,80,92,7,True,True,0.6885617777777778,-0.979928
8304,6604464,116,12,0.506148,242,6655917,-1,96.0,8172817,8172933,1568353,116,131,9,True,True,0.9373109333333333,-0.506148
8305,6604573,1322,28,0.36356,242,6655917,-1,1120.0,11207694,11209016,4603121,1322,20,12,True,True,52.61207466666667,-0.36356
8306,6604621,9127,32,0.544427,242,6655917,-1,1088.0,7725917,7735044,1121296,9127,148,9,True,True,449.8145448888889,-0.5427903834960038
8307,6604631,7934,1,0.423051,242,6655917,-1,8.0,8311696,8319630,1707065,7934,127,10,True,True,4.595092844444444,-0.41774458428356415
8308,6606881,33034,2,0.945228,242,6655917,-1,18.0,8323396,8356430,1716515,33034,127,9,True,True,45.170711,-0.9445259461904383
8309,6606899,42,16,8.6e-05,242,6655917,-1,592.0,8315296,8315338,1708397,42,128,8,True,True,1.7785357333333334,-8.6e-05
8310,6606945,21,64,0.3006,242,6655917,-1,1920.0,8899719,8899740,2292774,21,103,6,True,True,1.7980479999999999,-0.3006
8311,6606974,17,16,0.946215,242,6655917,-1,688.0,9299537,9299554,2692563,17,91,12,True,True,0.33557773333333335,-0.946215
8312,6607002,13375,128,0.519443,242,6655917,-1,1152.0,7773717,7787092,1166715,13375,153,8,True,True,812.8513343999999,-0.503464688110523
8313,6607032,18378,32,0.782802,242,6655917,-1,1376.0,10238428,10256806,3631396,18378,57,1,True,True,2599.116928533333,-0.7722622990297974
8314,6607069,163,13,0.659158,242,6655917,-1,598.0,9559037,9559200,2951968,163,79,11,True,True,2.7631171388888887,-0.659158
8315,6607310,9106,128,0.44492,242,6655917,-1,6272.0,9065219,9074325,2457909,9106,101,0,True,True,1568.467333688889,-0.42827358905589974
8316,6607654,318,16,0.577071,242,6655917,-1,560.0,8172933,8173251,1565279,318,140,1,True,True,14.988894666666669,-0.577071
8317,6607660,14,1,0.695101,242,6655917,-1,41.0,8002117,8002131,1394457,14,149,0,True,True,0.04628353333333333,-0.695101
8318,6607677,12718,2,0.522666,242,6655917,-1,10.0,6729417,6742135,121740,12718,195,9,True,True,9.296508083333332,-0.5034424020749119
8319,6607681,77,32,0.98602,242,6655917,-1,1120.0,6722217,6722294,114536,77,196,10,True,True,2.8677195555555555,-0.98602
8320,6608094,151,1,0.352117,242,6655917,-1,42.0,11482816,11482967,4874722,151,11,11,True,True,0.22070160000000003,-0.35211699999999996
8321,6608243,24,4,0.538209,242,6655917,-1,44.0,8283296,8283320,1675053,24,138,1,True,True,0.0382712,-0.538209
8322,6608269,17286,72,0.20984,242,6655917,-1,3312.0,10370328,10387614,3762059,17286,51,12,True,True,4174.6004088,-0.19979833620309034
8323,6608636,12173,33,0.099009,242,6655917,-1,1254.0,7811117,7823290,1202481,12173,158,10,True,True,661.9334582666667,-0.09757547670931195
8324,6608641,7850,2,0.819763,242,6655917,-1,28.0,9431037,9438887,2822396,7850,93,6,True,True,7.4858931,-0.8108021912685116
8325,6608689,14,16,0.2371,242,6655917,-1,320.0,7833217,7833231,1224528,14,159,10,True,True,0.17905066666666666,-0.2371
8326,6609037,2902,32,0.188074,242,6655917,-1,1152.0,9210235,9213137,2601198,2902,99,9,True,True,93.88934400000001,-0.18737740540890754
8327,6609647,18,32,0.299709,242,6655917,-1,1088.0,9199435,9199453,2589788,18,103,12,True,True,0.5651072,-0.299709
8328,6609672,8,1,0.832628,242,6655917,-1,38.0,8002117,8002125,1392445,8,156,12,True,True,0.02451253333333333,-0.832628
8329,6609718,136,8,0.957423,242,6655917,-1,328.0,9757241,9757377,3147523,136,74,12,True,True,3.3278807111111113,-0.957423
8330,6609805,11572,2,0.602144,242,6655917,-1,76.0,7886417,7897989,1276612,11572,161,11,True,True,43.04365091111111,-0.5895120680492764
8331,6609811,28668,16,0.21604,242,6655917,-1,704.0,9648741,9677409,3038930,28668,76,2,True,True,608.0269829333333,-0.2069545462088689
8332,6610311,17,16,0.359065,242,6655917,-1,768.0,10107819,10107836,3497508,17,62,7,True,True,0.4903978666666667,-0.359065
8333,6610437,18881,16,0.128492,242,6655917,-1,704.0,10636694,10655575,4026257,18881,40,3,True,True,538.3115349333333,-0.12712589591214093
8334,6610602,61,2,0.622313,242,6655917,-1,24.0,7540610,7540671,930008,61,186,12,True,True,0.08062980000000002,-0.622313
8335,6610813,6518,1,0.07436,242,6655917,-1,24.0,7778217,7784735,1167404,6518,171,6,True,True,8.415987400000002,-0.0730064040708041
8336,6611122,34,5,0.254967,242,6655917,-1,110.0,11518684,11518718,4907562,34,4,2,True,True,0.09945283333333334,-0.254967
8337,6615704,17343,3,0.381782,242,6655917,-1,72.0,8288696,8306039,1672992,17343,146,7,True,True,81.38168979999999,-0.35865643490224525
8338,6615735,16,22,0.90366,242,6655917,-1,264.0,9588337,9588353,2972602,16,84,10,True,True,0.14937706666666667,-0.90366
8339,6616571,166,1,0.400059,242,6655917,-1,37.0,9641541,9641707,3024970,166,81,0,True,True,0.23726887222222218,-0.400059
8340,6616591,14827,128,0.083254,242,6655917,-1,3456.0,10194219,10209046,3577628,14827,64,12,True,True,5000.010768,-0.08309093525488424
8341,6617362,14120,2,0.254179,242,6655917,-1,54.0,8921819,8935939,2304457,14120,120,10,True,True,35.55819405,-0.24527896395480528
8342,6617493,51,13,0.425343,242,6655917,-1,273.0,8760968,8761019,2143475,51,126,10,True,True,0.85015385,-0.425343
8343,6618406,2,4,0.694515,242,6655917,-1,200.0,6733017,6733019,114611,2,217,2,True,True,0.026846666666666668,-0.694515
8344,6618418,23,16,0.535904,242,6655917,-1,432.0,9864006,9864029,3245588,23,73,10,True,True,0.6425280000000001,-0.5359040000000002
8345,6618438,11672,2,0.070558,242,6655917,-1,50.0,9953319,9964991,3334881,11672,69,11,True,True,28.11365152777778,-0.06111636594967708
8346,6618468,4,1,0.732675,242,6655917,-1,35.0,9632537,9632541,3014069,4,88,11,True,True,0.005000333333333334,-0.732675
8347,6618580,26,32,0.995359,242,6655917,-1,384.0,10826994,10827020,4208414,26,32,6,True,True,0.3393173333333333,-0.9953589999999999
8348,6619963,33909,64,0.696803,242,6655917,-1,2112.0,10607394,10641303,3987431,33909,45,12,True,True,3201.9145664000002,-0.6949162401736705
8349,6619988,15803,16,0.192627,242,6655917,-1,336.0,11513951,11529754,4893963,15803,7,0,True,True,157.34184666666667,-0.18882896167616187
8350,6620056,9,1,0.372142,242,6655917,-1,38.0,8316196,8316205,1696140,9,154,6,True,True,0.025026800000000002,-0.372142
8351,6622312,5,1,0.657318,242,6655917,-1,15.0,8564568,8564573,1942256,5,141,1,True,True,0.004538541666666666,-0.657318
8352,6622397,12,8,0.820508,242,6655917,-1,48.0,7432110,7432122,809713,12,204,12,True,True,0.0421616,-0.820508
8353,6622983,8,1,0.604945,242,6655917,-1,22.0,8003017,8003025,1380034,8,173,6,True,True,0.007255111111111111,-0.604945
8354,6622999,19984,1,0.419686,242,6655917,-1,43.0,7770117,7790101,1147118,19984,190,11,True,True,44.77124525,-0.41711963318348444
8355,6630985,28,1,0.153491,242,6655917,-1,47.0,9447237,9447265,2816252,28,102,8,True,True,0.05354292222222222,-0.153491
8356,6632064,10,2,0.992449,242,6655917,-1,40.0,7003920,7003930,371856,10,222,8,True,True,0.017904444444444445,-0.992449
8357,6632105,2358,32,0.433627,242,6655917,-1,896.0,9456237,9458595,2824132,2358,100,8,True,True,88.1295968,-0.42794532845071676
8358,6632456,13,1,0.02591,242,6655917,-1,35.0,6819417,6819430,186961,13,231,12,True,True,0.03150622222222222,-0.02591
8359,6632537,232,1,0.603607,242,6655917,-1,14.0,7239320,7239552,606783,232,214,7,True,True,0.22003395555555555,-0.603607
8360,6633392,16,64,0.077525,242,6655917,-1,3136.0,9065219,9065235,2431827,16,123,11,True,True,1.5162908444444445,-0.077525
8361,6633783,55,8,0.124621,242,6655917,-1,128.0,11304416,11304471,4670633,55,17,7,True,True,0.2264533333333333,-0.124621
8362,6635342,7653,128,0.10999,242,6655917,-1,5248.0,9109435,9117088,2474093,7653,122,11,True,True,1369.8708476444444,-0.10735546698515569
8363,6635459,66,1,0.548369,242,6655917,-1,7.0,10491628,10491694,3856169,66,52,10,True,True,0.0217756,-0.548369
6249,4878338,11,32,0.304912,1,4878338,-1,992.0,4964738,4964749,86400,11,0,12,True,True,0.36052035555555556,-0.304912
6250,4879071,26,2,0.337594,65,4964738,-1,94.0,10551386,10551412,5672315,26,0,7,True,True,0.056218788888888885,-0.337594
6251,4879130,60,2,0.019712,65,4964738,-1,70.0,10732325,10732385,5853195,60,0,12,True,True,0.05427333333333334,-0.019712
6252,4879180,6680,256,0.326117,65,4964738,-1,2560.0,9400260,9406940,4521080,6680,2,10,True,True,195.85877333333332,-0.31364308202935676
6253,4879208,137,1,0.460909,65,4964738,-1,10.0,6699808,6699945,1820600,137,3,8,True,True,0.0883231388888889,-0.4609090000000001
6254,4879296,7,1,0.863369,65,4964738,-1,13.0,4968338,4968345,89042,7,4,8,True,True,0.001812922222222222,-0.863369
6255,4879534,312,1,0.568049,65,4964738,-1,32.0,8415069,8415381,3535535,312,3,8,True,True,0.10081066666666667,-0.568049
6256,4879804,7273,2,0.90141,65,4964738,-1,72.0,6959042,6966315,2079238,7273,4,6,True,True,35.556453399999995,-0.8776047922617762
6257,4879828,53,5,0.266619,65,4964738,-1,140.0,9024269,9024322,4144441,53,3,6,True,True,0.09126600000000001,-0.266619
6258,4879844,274,4,0.695958,65,4964738,-1,140.0,6609808,6610082,1729964,274,7,1,True,True,0.7441840000000002,-0.695958
6259,4879850,72,16,0.587989,65,4964738,-1,576.0,7459050,7459122,2579200,72,5,2,True,True,2.0729088,-0.587989
6260,4880161,38027,32,0.985765,65,4964738,-1,608.0,8034869,8072896,3154708,38027,5,0,True,True,993.9185067555554,-0.9772615773393452
6261,4880191,17280,16,0.377738,65,4964738,-1,752.0,10395974,10413254,5515783,17280,2,12,True,True,485.7075211555555,-0.36644194385202244
6262,4880221,16,8,0.390301,65,4964738,-1,264.0,9466560,9466576,4586339,16,3,11,True,True,0.04859946666666667,-0.390301
6263,4880293,160,16,0.572539,65,4964738,-1,336.0,10552286,10552446,5671993,160,1,6,True,True,1.0795306666666669,-0.572539
6264,4887016,13116,4,0.808327,65,4964738,-1,32.0,9476476,9489592,4589460,13116,4,7,True,True,6.7130111999999995,-0.8081159006883458
6265,4887503,7015,8,0.100057,65,4964738,-1,40.0,7983469,7990484,3095966,7015,10,7,True,True,13.566473111111112,-0.09741050238498061
6266,4887513,78,16,0.675111,65,4964738,-1,512.0,7144691,7144769,2257178,78,12,1,True,True,0.9616810666666666,-0.675111
6267,4887636,911,32,0.335967,65,4964738,-1,1376.0,7275250,7276161,2387614,911,12,11,True,True,64.36886337777777,-0.3077481630539447
6268,4887999,37,1,0.502769,65,4964738,-1,34.0,7665150,7665187,2777151,37,11,8,True,True,0.08215788333333335,-0.502769
6269,4888110,373,16,0.764904,65,4964738,-1,672.0,9789257,9789630,4901147,373,4,11,True,True,5.552726666666667,-0.764904
6270,4888363,310,8,0.339539,65,4964738,-1,120.0,9067550,9067860,4179187,310,8,9,True,True,0.7463766666666667,-0.339539
6271,4888651,28881,256,0.614828,65,4964738,-1,4096.0,9031469,9060350,4142818,28881,9,9,True,True,1465.0569841777778,-0.5786978097045581
6272,4888977,17,4,0.363334,65,4964738,-1,104.0,7800169,7800186,2911192,17,14,8,True,True,0.04199,-0.363334
6273,4889116,13,16,0.435991,65,4964738,-1,704.0,8119169,8119182,3230053,13,12,10,True,True,0.27303466666666665,-0.435991
6274,4890037,71,32,0.496952,65,4964738,-1,1184.0,5788923,5788994,898886,71,23,12,True,True,3.9652521777777774,-0.496952
6275,4890192,3313,1,0.847334,65,4964738,-1,6.0,5572895,5576208,682703,3313,24,11,True,True,0.33919598333333334,-0.847334
6276,4890349,18465,16,0.78715,65,4964738,-1,672.0,9483676,9502141,4593327,18465,5,9,True,True,263.1028530666667,-0.7790633598751753
6277,4890532,7,16,0.84038,65,4964738,-1,416.0,9280960,9280967,4390428,7,9,7,True,True,0.07866444444444444,-0.84038
6278,4890539,85,1,0.535834,65,4964738,-1,30.0,9743172,9743257,4852633,85,5,7,True,True,0.045531666666666665,-0.535834
6279,4890755,96,32,0.287356,65,4964738,-1,352.0,10147857,10147953,5257102,96,4,11,True,True,1.4818730666666666,-0.28735600000000006
6280,4890793,21669,4,0.047531,65,4964738,-1,40.0,9662472,9684141,4771679,21669,7,10,True,True,10.510252,-0.04609233526939866
6281,4891211,34,16,0.996228,65,4964738,-1,608.0,6051608,6051642,1160397,34,28,11,True,True,0.4931420444444444,-0.996228
6282,4891255,335,1,0.402027,65,4964738,-1,29.0,9291760,9292095,4400505,335,12,8,True,True,0.330552875,-0.402027
6283,4891280,34,1,0.225886,65,4964738,-1,23.0,7451850,7451884,2560570,34,24,7,True,True,0.03545718333333333,-0.225886
6284,4891308,16879,123,0.742888,65,4964738,-1,2460.0,9664272,9681151,4772964,16879,7,7,True,True,495.7052178333333,-0.7150554634834522
6285,4891483,14135,2,0.091958,65,4964738,-1,90.0,6745808,6759943,1854325,14135,29,7,True,True,46.278683,-0.08160763859481752
6286,4891580,37,14,0.844187,65,4964738,-1,588.0,7678469,7678506,2786889,37,23,8,True,True,1.3912962,-0.844187
6287,4891601,32005,16,0.094734,65,4964738,-1,192.0,7796569,7828574,2904968,32005,23,10,True,True,174.22578293333333,-0.0926665969553164
6288,4891744,15533,256,0.336838,65,4964738,-1,5888.0,9198460,9213993,4306716,15533,15,12,True,True,3720.651488,-0.32017678362785057
6289,4891751,25,1,0.06727,65,4964738,-1,37.0,9743257,9743282,4851506,25,6,1,True,True,0.016516388888888886,-0.06727
6290,4891772,333,1,0.801186,65,4964738,-1,46.0,10309574,10309907,5417802,333,4,7,True,True,0.4869422,-0.801186
6291,4892703,136,1,0.475268,65,4964738,-1,32.0,5054738,5054874,162035,136,40,12,True,True,0.09401528888888888,-0.475268
6292,4892784,23,1,0.209739,65,4964738,-1,46.0,9640372,9640395,4747588,23,11,7,True,True,0.029291905555555556,-0.209739
6293,4892987,5403,13,0.795652,65,4964738,-1,377.0,5996616,6002019,1103629,5403,39,10,True,True,67.52147285,-0.740941353927559
6294,4893037,9824,2,0.651537,65,4964738,-1,34.0,9973057,9982881,5080020,9824,6,7,True,True,7.6690383,-0.6270680905610941
6295,4893058,119,4,0.301847,65,4964738,-1,164.0,7227191,7227310,2334133,119,34,11,True,True,0.43347204444444437,-0.301847
6296,4893092,3,4,0.804127,65,4964738,-1,68.0,7770869,7770872,2877777,3,29,0,True,True,0.006330800000000001,-0.804127
6297,4893139,107,2,0.43291,65,4964738,-1,42.0,9741372,9741479,4848233,107,10,10,True,True,0.07637303333333334,-0.43291
6298,4893163,21,32,0.539948,65,4964738,-1,1376.0,7569550,7569571,2676387,21,33,10,True,True,1.7182685333333332,-0.539948
6299,4893256,25,16,0.200077,65,4964738,-1,640.0,6599008,6599033,1705752,25,43,12,True,True,0.6592444444444445,-0.200077
6300,4893306,12864,64,0.402301,65,4964738,-1,2304.0,9719272,9732136,4825966,12864,11,11,True,True,352.2553344,-0.3590581563079388
6301,4893349,211,8,0.624964,65,4964738,-1,312.0,6189408,6189619,1296059,211,45,12,True,True,4.335951533333334,-0.624964
6302,4894139,371,1,0.453229,65,4964738,-1,8.0,7181191,7181562,2287052,371,39,8,True,True,0.04501466666666667,-0.4532290000000001
6303,4894205,48,32,0.763442,65,4964738,-1,1600.0,7729869,7729917,2835664,48,32,8,True,True,5.466666666666668,-0.763442
6304,4894231,44,8,0.180601,65,4964738,-1,352.0,5921316,5921360,1027085,44,50,0,True,True,0.21278791111111112,-0.180601
6305,4895612,10,32,0.018603,65,4964738,-1,1088.0,9675072,9675082,4779460,10,12,8,True,True,0.12421333333333336,-0.018603
6306,4895622,11994,8,0.703332,65,4964738,-1,208.0,10221357,10233351,5325735,11994,5,11,True,True,52.31903559999999,-0.688860235021971
6307,4895882,3,1,0.86271,65,4964738,-1,9.0,10307757,10307760,5411875,3,5,12,True,True,0.0008583,-0.86271
6308,4895968,23,2,0.576843,65,4964738,-1,70.0,9023369,9023392,4127401,23,28,10,True,True,0.019803000000000005,-0.576843
6309,4895984,8,16,0.212953,65,4964738,-1,480.0,9227760,9227768,4331776,8,24,9,True,True,0.23477333333333333,-0.212953
6310,4895993,11,8,0.962117,65,4964738,-1,152.0,5965516,5965527,1069523,11,55,11,True,True,0.06175717777777778,-0.962117
6311,4896003,16,41,0.742208,65,4964738,-1,1722.0,7981669,7981685,3085666,16,34,10,True,True,1.3899984,-0.742208
6312,4896291,3098,16,0.467295,65,4964738,-1,176.0,7151891,7154989,2255600,3098,47,9,True,True,13.05392391111111,-0.3617990589932373
6313,4896671,17362,128,0.937163,65,4964738,-1,4608.0,8438969,8456331,3542298,17362,30,7,True,True,883.8108159999998,-0.9360162371877208
6314,4896798,333,2,0.532719,65,4964738,-1,78.0,6981142,6981475,2084344,333,50,10,True,True,1.5864342,-0.532719
6315,4964811,8,1,0.614422,83,4968338,-1,49.0,8888269,8888277,3923458,8,30,8,True,True,0.023282622222222223,-0.614422
6316,4964818,13609,128,0.769119,83,4968338,-1,3584.0,7666950,7680559,2702132,13609,42,7,True,True,3189.9230819555555,-0.7656700763906461
6317,4964905,4,16,0.433724,83,4968338,-1,656.0,7805569,7805573,2840664,4,37,2,True,True,0.10816711111111113,-0.433724
6318,4965079,16,7,0.566116,83,4968338,-1,140.0,10827025,10827041,5861946,16,0,7,True,True,0.018467555555555557,-0.5661159999999998
6319,4965091,8164,1,0.626758,83,4968338,-1,38.0,8337969,8346133,3372878,8164,34,12,True,True,8.604444922222223,-0.6234110916733342
6320,4965152,13,1,0.52227,83,4968338,-1,20.0,9067860,9067873,4102708,13,27,1,True,True,0.005216611111111111,-0.52227
6321,4965209,19140,13,0.364275,83,4968338,-1,260.0,8251569,8270709,3286360,19140,36,7,True,True,113.1923065,-0.3602666334460412
6322,4965225,5348,8,0.147744,83,4968338,-1,336.0,6865108,6870456,1899883,5348,59,10,True,True,138.8172016,-0.1385514046693075
6323,4965337,26,32,0.150473,83,4968338,-1,1440.0,10177157,10177183,5211820,26,8,10,True,True,1.7525039999999998,-0.150473
6324,4965341,44,16,0.685307,83,4968338,-1,480.0,8437169,8437213,3471828,44,35,0,True,True,0.19876266666666667,-0.685307
6325,4965528,13,1,0.300276,83,4968338,-1,37.0,6275808,6275821,1310280,13,66,12,True,True,0.036204602777777775,-0.300276
6326,4965570,9,1,0.435389,83,4968338,-1,12.0,6913942,6913951,1948372,9,61,1,True,True,0.0033342000000000003,-0.43538900000000014
6327,4966013,54,4,0.318653,83,4968338,-1,128.0,7617350,7617404,2651337,54,51,10,True,True,0.2928576,-0.318653
6328,4966019,111,29,0.830214,83,4968338,-1,174.0,9796457,9796568,4830438,111,11,9,True,True,0.36455175,-0.830214
6329,4966028,14475,1,0.064428,83,4968338,-1,45.0,9528272,9542747,4562244,14475,21,1,True,True,12.615060125,-0.06118486362302752
6330,4967530,350,16,0.203558,83,4968338,-1,160.0,10549586,10549936,5582056,350,4,1,True,True,1.2881555555555557,-0.203558
6331,4967600,6113,1,0.412438,83,4968338,-1,37.0,7671269,7677382,2703669,6113,52,7,True,True,14.770112530555554,-0.40540237775676197
6332,4968036,187,16,0.823711,83,4968338,-1,400.0,8341569,8341756,3373533,187,40,7,True,True,2.1189177777777783,-0.823711
6333,4968040,16106,16,0.646043,83,4968338,-1,480.0,7569550,7585656,2601510,16106,57,0,True,True,582.3175333333332,-0.6226150458995832
6334,4968931,5,1,0.256447,226,5054738,-1,33.0,5528695,5528700,559764,5,82,1,True,True,0.004279458333333334,-0.256447
6335,4969066,8270,24,0.601232,226,5054738,-1,144.0,6103008,6111278,1133942,8270,76,11,True,True,70.58398559999999,-0.584872258491792
6336,4969076,22,1,0.405866,226,5054738,-1,14.0,7722669,7722691,2753593,22,52,11,True,True,0.022342833333333333,-0.405866
6337,4972025,54,16,0.113559,226,5054738,-1,800.0,5833123,5833177,861098,54,82,11,True,True,1.44288,-0.113559
6338,4972673,518,8,0.191916,226,5054738,-1,344.0,9466576,9467094,4493903,518,25,1,True,True,2.050197955555556,-0.191916
6339,4972718,376,1,0.245587,226,5054738,-1,22.0,7801969,7802345,2829251,376,49,7,True,True,0.2508024444444445,-0.245587
6340,4975919,5657,2,0.827229,226,5054738,-1,32.0,6606208,6611865,1630289,5657,76,9,True,True,3.996996977777778,-0.8211176322959498
6341,4976027,259,4,0.46416,226,5054738,-1,172.0,7230791,7231050,2254764,259,65,8,True,True,1.9123466444444444,-0.46416
6342,4976257,34,8,0.559825,226,5054738,-1,280.0,6417208,6417242,1440951,34,79,12,True,True,0.1696146666666667,-0.559825
6343,4976907,30,2,0.436133,226,5054738,-1,84.0,8996769,8996799,4019862,30,37,10,True,True,0.030023,-0.436133
6344,4977065,26811,64,0.646922,226,5054738,-1,2816.0,9422360,9449171,4445295,26811,27,10,True,True,807.5849955555556,-0.6441837771884137
6345,4978639,12,2,0.037004,226,5054738,-1,68.0,10418974,10418986,5440335,12,5,6,True,True,0.04005653333333334,-0.037004
6346,4978779,16654,94,0.159358,226,5054738,-1,2538.0,6323608,6340262,1344829,16654,83,11,True,True,1331.2613699999997,-0.12857485574090524
6347,4978840,91,32,0.136431,226,5054738,-1,384.0,8525369,8525460,3546529,91,41,12,True,True,1.0409429333333333,-0.136431
6348,4986046,13928,256,0.258397,226,5054738,-1,2048.0,5659295,5673223,673249,13928,94,12,True,True,1072.2398321777778,-0.2577762051697769
6349,4986058,7,8,0.803538,226,5054738,-1,360.0,7595250,7595257,2609192,7,64,10,True,True,0.139902,-0.803538
6350,4986134,20,4,0.658671,226,5054738,-1,44.0,7990669,7990689,3004535,20,50,9,True,True,0.042970888888888885,-0.658671
6351,4986480,6,53,0.175985,226,5054738,-1,2491.0,7319450,7319456,2332970,6,70,11,True,True,0.9342910666666667,-0.175985
6352,4987189,67,64,0.852521,226,5054738,-1,1408.0,8042069,8042136,3054880,67,49,9,True,True,3.465013688888888,-0.852521
6353,4987212,14787,128,0.963787,226,5054738,-1,4096.0,7952369,7967156,2965157,14787,54,9,True,True,2759.4652785777776,-0.9024593333864194
6354,4987740,78,1,0.485842,226,5054738,-1,31.0,9060350,9060428,4072610,78,36,1,True,True,0.038829050000000004,-0.485842
6355,4987840,365,4,0.019909,226,5054738,-1,24.0,8339769,8340134,3351929,365,47,7,True,True,0.24729966666666667,-0.019909000000000003
6356,4989169,109,8,0.859584,226,5054738,-1,80.0,7674869,7674978,2685700,109,65,8,True,True,0.5754231111111111,-0.859584
6357,4989371,31,8,0.08393,226,5054738,-1,328.0,9614672,9614703,4625301,31,23,12,True,True,0.1197282,-0.08393
6358,4989557,10336,8,0.6016,226,5054738,-1,216.0,8771669,8782005,3782112,10336,43,11,True,True,50.3660724,-0.5500940133666824
6359,4989575,14084,1,0.867172,226,5054738,-1,49.0,5281877,5295961,292302,14084,107,11,True,True,25.478100433333335,-0.8614905981867327
6360,4990729,108,2,0.900575,226,5054738,-1,84.0,8097069,8097177,3106340,108,53,11,True,True,0.5460084,-0.900575
6361,4990830,666,2,0.407007,226,5054738,-1,98.0,7770869,7771535,2780039,666,65,8,True,True,2.0254836,-0.407007
6362,4991259,16734,1,0.363434,226,5054738,-1,46.0,9089960,9106694,4098701,16734,35,10,True,True,39.9824226,-0.354039715107946
6363,4991313,1000,3,0.657431,226,5054738,-1,117.0,6512608,6513608,1521295,1000,96,7,True,True,4.664725,-0.657431
6364,4991342,21,8,0.090306,226,5054738,-1,360.0,6696208,6696229,1704866,21,93,12,True,True,0.498981,-0.09030600000000001
6365,4996152,288,8,0.943162,226,5054738,-1,88.0,8052869,8053157,3056717,288,55,9,True,True,1.2317183999999999,-0.943162
6366,4996383,9,1,0.724234,226,5054738,-1,40.0,6053408,6053417,1057025,9,104,7,True,True,0.008588,-0.724234
6367,4996738,11299,256,0.14056,226,5054738,-1,8192.0,10645925,10657224,5649187,11299,2,0,True,True,4415.614065777778,-0.1371214285534737
6368,4996862,19,8,0.111932,226,5054738,-1,240.0,6744008,6744027,1747146,19,94,11,True,True,0.06926133333333333,-0.111932
6369,4997024,11651,2,0.73448,226,5054738,-1,32.0,6909308,6920959,1912284,11651,92,11,True,True,11.048647022222223,-0.7256642128129371
6370,4998240,68,32,0.932935,226,5054738,-1,1120.0,5061938,5062006,63698,68,118,9,True,True,2.0476462222222227,-0.932935
6371,4998380,9,2,0.521958,226,5054738,-1,18.0,9378160,9378169,4379780,9,32,12,True,True,0.0030721499999999996,-0.521958
6372,5001282,11,1,0.828982,226,5054738,-1,19.0,6330808,6330819,1329526,11,104,9,True,True,0.004455763888888889,-0.828982
6373,5001393,8013,2,0.949675,226,5054738,-1,36.0,7122542,7130555,2121149,8013,90,8,True,True,12.9179013,-0.9368694888810837
6374,5003634,1429,2,0.931556,226,5054738,-1,36.0,9636772,9638201,4633138,1429,24,10,True,True,1.2150351,-0.794696141504614
6375,5003672,396,11,0.251808,226,5054738,-1,550.0,9527876,9528272,4524204,396,27,11,True,True,5.085025,-0.251808
6376,5003800,518,4,0.884565,226,5054738,-1,40.0,5528177,5528695,524377,518,122,11,True,True,0.5373962222222223,-0.884565
6377,5003985,4,16,0.238077,226,5054738,-1,576.0,7851569,7851573,2847584,4,66,11,True,True,0.09061759999999999,-0.238077
6378,5004083,382,8,0.122277,226,5054738,-1,120.0,6958142,6958524,1954059,382,96,11,True,True,3.2165673333333333,-0.122277
6379,5004332,179,1,0.806687,226,5054738,-1,48.0,7547450,7547629,2543118,179,84,11,True,True,0.5448044000000001,-0.806687
6380,5004346,342,1,0.329286,226,5054738,-1,17.0,5106138,5106480,101792,342,127,11,True,True,0.054716200000000006,-0.329286
6381,5004375,7617,128,0.584326,226,5054738,-1,1408.0,10820725,10828342,5816350,7617,1,11,True,True,74.43208568888889,-0.569991373321981
6382,5004770,7207,53,0.389951,226,5054738,-1,2385.0,7767269,7774476,2762499,7207,74,6,True,True,572.4850384999999,-0.34692353545362836
6383,5008217,92,1,0.748374,226,5054738,-1,33.0,9474676,9474768,4466459,92,31,6,True,True,0.021429100000000003,-0.7483739999999999
6384,5008449,72,16,0.235938,226,5054738,-1,400.0,7855169,7855241,2846720,72,68,8,True,True,1.0348622222222223,-0.2170572176469194
6385,5008526,6200,16,0.422869,226,5054738,-1,624.0,9234960,9241160,4226434,6200,39,1,True,True,207.82313066666666,-0.41240481508278004
6386,5008573,5,8,0.144278,226,5054738,-1,152.0,6005616,6005621,997043,5,122,2,True,True,0.020870444444444445,-0.144278
6387,5009035,112,4,0.175154,226,5054738,-1,48.0,7669469,7669581,2660434,112,83,0,True,True,0.35883306666666664,-0.175154
6388,5009187,92,16,0.969923,226,5054738,-1,336.0,7231050,7231142,2221863,92,95,1,True,True,1.3269834666666667,-0.969923
6389,5011695,36736,16,0.439475,226,5054738,-1,336.0,9231360,9268096,4219665,36736,40,8,True,True,554.0224853333333,-0.41603086695299546
6390,5012350,143,32,0.254306,226,5054738,-1,928.0,5857023,5857166,844673,143,129,7,True,True,6.324451466666666,-0.254306
6391,5012445,12,8,0.589481,226,5054738,-1,296.0,10549574,10549586,5537129,12,7,11,True,True,0.08170586666666667,-0.589481
6392,5013079,28,4,0.490359,226,5054738,-1,104.0,7669469,7669497,2656390,28,86,1,True,True,0.1943679111111111,-0.490359
6393,5013666,39,64,0.374705,226,5054738,-1,2688.0,8437169,8437208,3423503,39,57,10,True,True,0.9865856000000002,-0.374705
6394,5035595,4,1,0.948711,226,5054738,-1,30.0,8727469,8727473,3691874,4,54,12,True,True,0.00288,-0.948711
6395,5035616,49,1,0.31649,226,5054738,-1,23.0,9112060,9112109,4076444,49,44,0,True,True,0.06628638333333332,-0.31649
6396,5035632,6541,32,0.423781,226,5054738,-1,1120.0,5974516,5981057,938884,6541,132,9,True,True,411.941236,-0.40233357608240083
6397,5035672,13689,1,0.682738,226,5054738,-1,17.0,5695323,5709012,659651,13689,138,10,True,True,10.610813783333334,-0.6815385717975624
6398,5035701,48,4,0.963315,226,5054738,-1,196.0,9995157,9995205,4959456,48,15,10,True,True,0.1686384,-0.963315
6399,5038555,27,25,0.879434,226,5054738,-1,900.0,5237677,5237704,199122,27,145,11,True,True,0.532305,-0.8794340000000003
6400,5039384,9,8,0.936972,226,5054738,-1,128.0,7503250,7503259,2463866,9,98,11,True,True,0.0626944,-0.936972
6401,5039437,4609,128,0.362998,226,5054738,-1,640.0,5877116,5881725,837679,4609,137,1,True,True,137.86258844444444,-0.3556088396119195
6402,5039447,15719,8,0.715671,226,5054738,-1,312.0,9288160,9303879,4248713,15719,40,9,True,True,165.54490766666666,-0.697259745589541
6403,5039464,2,1,0.821365,226,5054738,-1,11.0,8363669,8363671,3324205,2,63,10,True,True,0.00047917222222222216,-0.821365
6404,5039486,489,1,0.021074,226,5054738,-1,39.0,10081557,10082046,5042071,489,15,12,True,True,0.314300675,-0.021074
6405,5039769,60,1,0.966805,226,5054738,-1,16.0,6510808,6510868,1471039,60,127,12,True,True,0.027765333333333336,-0.966805
6406,5039891,10,4,0.605815,226,5054738,-1,144.0,8881969,8881979,3842078,10,57,10,True,True,0.092148,-0.605815
6407,5039964,11,2,0.841473,226,5054738,-1,68.0,6058808,6058819,1018844,11,135,8,True,True,0.02966443333333334,-0.841473
6408,5040154,8196,8,0.662223,226,5054738,-1,168.0,7990669,7998865,2950515,8196,75,0,True,True,72.04526886666667,-0.6584239928843033
6409,5040184,9272,1,0.940848,226,5054738,-1,33.0,7405850,7415122,2365666,9272,106,12,True,True,11.363125766666666,-0.9370058348306405
6410,5040190,24297,78,0.690682,226,5054738,-1,3120.0,7450050,7474347,2409860,24297,106,11,True,True,3528.1270440000003,-0.6854944526113964
6411,5040213,572,8,0.788803,226,5054738,-1,328.0,10871225,10871797,5831012,572,0,11,True,True,8.149830577777777,-0.788803
6412,5040272,2900,64,0.239676,226,5054738,-1,2880.0,9280960,9283860,4240688,2900,43,0,True,True,225.61999999999998,-0.239676
6413,5040327,32,2,0.552728,226,5054738,-1,80.0,7959569,7959601,2919242,32,81,9,True,True,0.10946177777777778,-0.5153035339773484
6414,5040396,7193,1,0.309269,226,5054738,-1,14.0,7115342,7122535,2074946,7193,120,12,True,True,4.797960261111111,-0.3057966881582706
6415,5040423,9,8,0.958484,226,5054738,-1,56.0,8641069,8641078,3600646,9,62,12,True,True,0.011079600000000002,-0.958484
6416,5040900,48,4,0.362855,226,5054738,-1,64.0,9971257,9971305,4930357,48,19,11,True,True,0.09590613333333335,-0.362855
6417,5040909,7,64,0.81225,226,5054738,-1,2496.0,7766369,7766376,2725460,7,94,9,True,True,0.7662442666666666,-0.81225
6418,5041154,752,8,0.122054,226,5054738,-1,376.0,10821625,10822377,5780471,752,2,6,True,True,1.6972974222222221,-0.122054
6419,5041162,10,1,0.866953,226,5054738,-1,30.0,5193477,5193487,152315,10,165,6,True,True,0.006359166666666667,-0.866953
6420,5041194,39,32,0.857647,226,5054738,-1,896.0,5192538,5192577,151344,39,166,12,True,True,0.7407157333333334,-0.857647
6421,5046220,1,16,0.388471,226,5054738,-1,752.0,10938425,10938426,5892205,1,0,11,True,True,0.0227104,-0.388471
6422,5046284,15625,4,0.909789,226,5054738,-1,192.0,6103008,6118633,1056724,15625,146,0,True,True,176.84845120000003,-0.9067212007700157
6423,5046317,3,1,0.392976,226,5054738,-1,49.0,5476777,5476780,430460,3,165,12,True,True,0.003729716666666667,-0.392976
6424,5046332,6729,4,0.977993,226,5054738,-1,44.0,6002016,6008745,955684,6729,152,7,True,True,8.632217733333333,-0.9533128261437672
6425,5046363,260,1,0.255534,226,5054738,-1,29.0,5855223,5855483,808860,260,159,10,True,True,0.3593438333333333,-0.255534
6426,5046749,11,9,0.09025,226,5054738,-1,99.0,10825225,10825236,5778476,11,3,8,True,True,0.0089782,-0.09025
6427,5046809,257,1,0.822708,226,5054738,-1,32.0,9279160,9279417,4232351,257,49,11,True,True,0.3260587555555555,-0.822708
6428,5046913,11,32,0.23546,226,5054738,-1,1248.0,10307774,10307785,5260861,11,15,2,True,True,0.4363978666666667,-0.23546
6429,5047043,14,4,0.210386,226,5054738,-1,48.0,9671472,9671486,4624429,14,31,1,True,True,0.0074816,-0.210386
6430,5047140,22571,16,0.890247,226,5054738,-1,736.0,9220560,9243131,4173420,22571,55,10,True,True,969.2762160888889,-0.8779415866491108
6431,5047202,6,8,0.915891,226,5054738,-1,352.0,9112060,9112066,4064858,6,58,10,True,True,0.1242208,-0.915891
6432,5047254,11,12,0.631353,226,5054738,-1,108.0,5702523,5702534,655269,11,168,9,True,True,0.0508002,-0.631353
6433,5048161,10364,23,0.879467,226,5054738,-1,276.0,9473776,9484140,4425615,10364,42,9,True,True,37.66205840000001,-0.7896955730500181
6434,5048205,473,2,0.766741,226,5054738,-1,72.0,10872125,10872598,5823920,473,1,6,True,True,1.0036114,-0.766741
6435,5048623,20,54,0.406289,226,5054738,-1,270.0,8045669,8045689,2997046,20,87,8,True,True,0.20112000000000005,-0.406289
6436,5048678,9806,32,0.033882,226,5054738,-1,1280.0,8974669,8984475,3925991,9806,69,12,True,True,162.70140800000001,-0.03110317002175571
6437,5049119,1583,2,0.866445,226,5054738,-1,74.0,5483977,5485560,434858,1583,178,9,True,True,3.7332504611111115,-0.8664449999999999
6438,5049130,11094,128,0.823198,226,5054738,-1,768.0,7155491,7166585,2106361,11094,132,8,True,True,143.60548266666666,-0.7975894742742936
6439,5049135,11,80,0.940495,226,5054738,-1,2960.0,7945169,7945180,2896034,11,97,12,True,True,1.7409651111111113,-0.940495
6440,5049317,7704,256,0.471091,226,5054738,-1,6144.0,10505374,10513078,5456057,7704,13,12,True,True,2197.440273066667,-0.46693402791408006
6441,5049589,6,8,0.412961,226,5054738,-1,160.0,7774469,7774475,2724880,6,105,8,True,True,0.028288,-0.412961
6442,5049619,15133,8,0.841163,226,5054738,-1,384.0,8034869,8050002,2985250,15133,92,11,True,True,218.10315413333336,-0.7750715757246994
6443,5049809,7295,16,0.717386,226,5054738,-1,640.0,5673223,5680518,623414,7295,179,1,True,True,116.24359466666667,-0.6738418875162928
6444,5050464,16097,1,0.876761,226,5054738,-1,45.0,7858769,7874866,2808305,16097,100,8,True,True,24.252188375,-0.843885701325963
6445,5050620,3608,128,0.820241,226,5054738,-1,3712.0,5921316,5924924,870696,3608,173,11,True,True,196.09353528888886,-0.8087136878712005
6446,5050703,99,4,0.824401,226,5054738,-1,20.0,7759169,7759268,2708466,99,112,10,True,True,0.06853000000000001,-0.824401
6447,5050777,49,2,0.698482,226,5054738,-1,84.0,7144642,7144691,2093865,49,141,10,True,True,0.09911556666666667,-0.698482
6448,5050915,24920,64,0.506335,226,5054738,-1,1344.0,7182991,7207911,2132076,24920,137,7,True,True,630.0717658666667,-0.47712760799306236
6449,5051602,7919,2,0.351856,226,5054738,-1,54.0,7661550,7669469,2609948,7919,122,11,True,True,28.243890150000002,-0.3491513006246828
6450,5051620,4940,16,0.602116,226,5054738,-1,128.0,7595250,7600190,2543630,4940,124,0,True,True,25.813941333333336,-0.4828245113383762
6451,5051644,11891,128,0.813428,226,5054738,-1,4992.0,5872793,5884684,821149,11891,180,9,True,True,2787.9498261333333,-0.808338953052253
6452,5051662,10,32,0.737786,226,5054738,-1,512.0,8163369,8163379,3111707,10,86,11,True,True,0.17301333333333335,-0.737786
6453,5051696,12002,128,0.453262,226,5054738,-1,4608.0,6832208,6844210,1780512,12002,154,12,True,True,2769.1932416,-0.34473576275869494
6454,5051826,9,28,0.027351,226,5054738,-1,728.0,7573150,7573159,2521324,9,127,0,True,True,0.4743284,-0.027351
6455,5051887,12955,4,0.052099,226,5054738,-1,176.0,8773469,8786424,3721582,12955,73,7,True,True,64.78222715555555,-0.048377054262266024
6456,5051994,549,1,0.641593,226,5054738,-1,48.0,8554669,8555218,3502675,549,77,10,True,True,0.45266880000000004,-0.641593
6457,5052030,7192,8,0.630156,226,5054738,-1,288.0,6000216,6007408,948186,7192,179,8,True,True,62.9913344,-0.5959247060104926
6458,5052093,9,1,0.791019,226,5054738,-1,34.0,7177591,7177600,2125498,9,145,10,True,True,0.003963550000000001,-0.791019
6459,5053167,300,16,0.136092,226,5054738,-1,672.0,10418074,10418374,5364907,300,15,10,True,True,8.99808,-0.136092
6460,5053192,11523,32,0.400662,226,5054738,-1,320.0,5865593,5877116,812401,11523,189,2,True,True,172.07204355555555,-0.39637253446987575
6461,5053311,60,4,0.628296,226,5054738,-1,136.0,7726269,7726329,2672958,60,118,8,True,True,0.567392,-0.628296
6462,5053321,42,1,0.313722,226,5054738,-1,22.0,5368277,5368319,314956,42,204,12,True,True,0.04728826666666667,-0.31372199999999995
6463,5053390,9387,32,0.082232,226,5054738,-1,1600.0,9638572,9647959,4585182,9387,38,7,True,True,317.89284000000004,-0.07521972620937292
6464,5053409,409,1,0.157822,226,5054738,-1,32.0,6843008,6843417,1789599,409,161,8,True,True,1.0130839111111112,-0.157822
6465,5053471,669,40,0.516366,226,5054738,-1,880.0,10638686,10639355,5585215,669,9,12,True,True,6.1586653333333325,-0.516366
6466,5053478,1370,4,0.969665,226,5054738,-1,68.0,5864223,5865593,810745,1370,194,9,True,True,4.151080022222223,-0.965218276370793
6467,5053524,4,1,0.830621,226,5054738,-1,28.0,6279408,6279412,1225884,4,176,8,True,True,0.006780044444444445,-0.830621
6468,5053546,607,1,0.763163,226,5054738,-1,22.0,7737069,7737676,2683523,607,119,9,True,True,0.6124292777777777,-0.763163
6469,5053558,18448,160,0.84696,226,5054738,-1,4960.0,8997669,9016117,3944111,18448,72,6,True,True,1075.234008,-0.8275829944787199
6470,5053616,14,16,0.685753,226,5054738,-1,272.0,9001269,9001283,3947653,14,72,8,True,True,0.04461706666666667,-0.685753
6471,5053649,94,1,0.792642,226,5054738,-1,32.0,9927057,9927151,4873408,94,28,12,True,True,0.08351377777777778,-0.792642
6472,5053681,194,8,0.319399,226,5054738,-1,192.0,8411469,8411663,3357788,194,89,11,True,True,0.3604778666666667,-0.319399
6473,5053696,1791,8,0.478365,226,5054738,-1,216.0,7118942,7120733,2065246,1791,160,8,True,True,19.2052512,-0.478365
6474,5054011,14447,128,0.735172,226,5054738,-1,4096.0,6984742,6999189,1930731,14447,162,8,True,True,1807.5478698666668,-0.6648500902212362
6475,5054052,7887,29,0.26068,226,5054738,-1,986.0,8532569,8540456,3478517,7887,84,9,True,True,177.18063944444447,-0.2555043762523559
6476,5054099,10840,32,0.687467,226,5054738,-1,1120.0,10776525,10787365,5722426,10840,7,11,True,True,88.28927333333334,-0.6263593887231711
6477,5054492,21,8,0.826769,226,5054738,-1,152.0,7455450,7455471,2400958,21,146,2,True,True,0.16925579999999998,-0.8267690000000002
6478,5055358,13301,128,0.799529,252,5061938,-1,4224.0,9840657,9853958,4785299,13301,30,11,True,True,1203.4284416,-0.7933465773854229
6479,5055377,15508,140,0.198664,252,5061938,-1,2800.0,8367269,8382777,3311892,15508,93,8,True,True,660.9702011111111,-0.19523613334299172
6480,5055439,17,16,0.414496,252,5061938,-1,352.0,10307757,10307774,5252318,17,21,0,True,True,0.19022471111111108,-0.4144960000000001
6481,5055712,8,16,0.181889,252,5061938,-1,800.0,6424408,6424416,1368696,8,186,9,True,True,0.3527288888888889,-0.181889
6482,5055757,3,8,0.87639,252,5061938,-1,344.0,8249769,8249772,3194012,3,100,12,True,True,0.019327066666666667,-0.87639
6483,5055783,1034,4,0.944757,252,5061938,-1,72.0,6912908,6913942,1857125,1034,174,1,True,True,2.2983751999999997,-0.944757
6484,5056411,109,2,0.884341,252,5061938,-1,12.0,7028942,7029051,1972531,109,169,11,True,True,0.0933367,-0.884341
6485,5056458,266,9,0.224487,252,5061938,-1,225.0,5192577,5192843,136119,266,230,1,True,True,1.2686537500000001,-0.224487
6486,5056472,345,8,0.948109,252,5061938,-1,176.0,6839408,6839753,1782936,345,179,9,True,True,2.425089333333333,-0.948109
6487,5056902,18,10,0.923112,252,5061938,-1,420.0,8884669,8884687,3827767,18,81,6,True,True,0.48377699999999996,-0.923112
6488,5057043,9038,32,0.647107,252,5061938,-1,960.0,10155057,10164095,5098014,9038,25,9,True,True,431.82644533333337,-0.6130599889619069
6489,5058075,16,1,0.626627,252,5061938,-1,39.0,8883769,8883785,3825694,16,83,7,True,True,0.0399308,-0.626627
6490,5058146,12,7,0.906845,252,5061938,-1,161.0,8859869,8859881,3801723,12,85,12,True,True,0.06747510000000001,-0.906845
6491,5058434,553,4,0.974128,252,5061938,-1,32.0,6007408,6007961,948974,553,206,2,True,True,0.4859518222222222,-0.974128
6492,5058632,386,1,0.198266,252,5061938,-1,15.0,10103657,10104043,5045025,386,27,10,True,True,0.07467491666666666,-0.198266
6493,5058801,18,16,0.701261,252,5061938,-1,144.0,7573150,7573168,2514349,18,150,8,True,True,0.1876464,-0.701261
6494,5058827,10593,1,0.168756,252,5061938,-1,7.0,9667872,9678465,4609045,10593,42,1,True,True,0.855539475,-0.16397249333626956
6495,5058866,27,16,0.401035,252,5061938,-1,544.0,5873693,5873720,814827,27,219,6,True,True,0.7090224,-0.401035
6496,5058919,16733,1,0.428903,252,5061938,-1,7.0,5967316,5984049,908397,16733,215,7,True,True,6.360410738888889,-0.4105888554505296
6497,5058961,39,1,0.260158,252,5061938,-1,36.0,10645886,10645925,5586925,39,10,9,True,True,0.0546468,-0.260158
6498,5059497,36,30,0.089061,252,5061938,-1,810.0,9745057,9745093,4685560,36,37,7,True,True,0.5206680000000001,-0.089061
6499,5059573,159,16,0.36792,252,5061938,-1,800.0,10894225,10894384,5834652,159,1,10,True,True,1.1306666666666667,-0.36792
6500,5059943,270,8,0.947244,252,5061938,-1,56.0,5865123,5865393,805180,270,226,6,True,True,0.6768299999999999,-0.947244
6501,5059974,12,1,0.117351,252,5061938,-1,36.0,8641069,8641081,3581095,12,94,0,True,True,0.0094968,-0.117351
6502,5060092,437,64,0.718583,252,5061938,-1,640.0,5390377,5390814,330285,437,242,10,True,True,10.648816,-0.718583
6503,5060119,11,3,0.435159,252,5061938,-1,126.0,6055208,6055219,995089,11,211,7,True,True,0.04770535,-0.435159
6504,5060145,147,4,0.919989,252,5061938,-1,132.0,7807369,7807516,2747224,147,129,7,True,True,0.799876,-0.919989
