job_id,submit_time,request_time,request_processors,carbon_consideration,queue_length_at_submission,submission_timestamp,user_id,power,scheduled_time,completion_time,wait_time,actual_runtime,action1,action2,scheduled,completed,carbon_emissions,carbon_reward
7599,6084716,8396,8,0.537604,1,6084716,-1,4000.0,6095516,6103912,10800,8396,0,9,True,True,964.1448,-0.47916425981684463
7600,6085683,12,4,0.32608,18,6095516,-1,2000.0,7062667,7062679,976984,12,0,11,True,True,0.6048666666666668,-0.32608
7601,6085768,291,64,0.02324,18,6095516,-1,32000.0,8153109,8153400,2067341,291,0,9,True,True,335.4389333333333,-0.02324
7602,6085843,31,32,0.785358,18,6095516,-1,16000.0,7477795,7477826,1391952,31,1,12,True,True,19.59888888888889,-0.785358
7603,6085865,8087,26,0.922144,18,6095516,-1,13000.0,8514885,8522972,2429020,8087,0,0,True,True,4402.788758333333,-0.8906694882948852
7604,6093970,4,2,0.153691,18,6095516,-1,1000.0,6515251,6515255,421281,4,4,8,True,True,0.14135555555555557,-0.153691
7605,6094137,1277,1,0.952638,18,6095516,-1,500.0,8808180,8809457,2714043,1277,0,6,True,True,18.643943055555553,-0.8657381037935058
7606,6094181,836,16,0.330251,18,6095516,-1,8000.0,8721292,8722128,2627111,836,1,9,True,True,109.83182222222221,-0.330251
7607,6094592,4818,1,0.629839,18,6095516,-1,500.0,6691679,6696497,597087,4818,6,6,True,True,78.76757222222223,-0.5649087491635139
7608,6094727,8,8,0.603003,18,6095516,-1,4000.0,6181916,6181924,87189,8,8,12,True,True,0.6442666666666667,-0.603003
7609,6094907,18787,2,0.607837,18,6095516,-1,1000.0,6523255,6542042,428348,18787,7,6,True,True,523.8585527777777,-0.5925475092050776
7610,6094978,10,4,0.866945,18,6095516,-1,2000.0,8499685,8499695,2404707,10,3,8,True,True,0.9888333333333335,-0.866945
7611,6095254,11,44,0.980172,18,6095516,-1,22000.0,8386622,8386633,2291368,11,4,0,True,True,6.970944444444445,-0.980172
7612,6095273,34,1,0.204205,18,6095516,-1,500.0,8487785,8487819,2392512,34,4,8,True,True,0.785163888888889,-0.204205
7613,6095276,750,8,0.390636,18,6095516,-1,4000.0,6715975,6716725,620699,750,9,7,True,True,109.56666666666666,-0.390636
7614,6095281,697,1,0.534491,18,6095516,-1,500.0,6300928,6301625,205647,697,13,0,True,True,8.121018055555556,-0.534491
7615,6095288,87,1,0.188339,18,6095516,-1,500.0,7845095,7845182,1749807,87,7,12,True,True,1.9350249999999998,-0.188339
7616,6095300,5354,8,0.108638,18,6095516,-1,4000.0,6095516,6100870,216,5354,16,0,True,True,566.0388222222223,-0.10554796479285314
7617,6095363,19008,8,0.569515,18,6095516,-1,4000.0,6960667,6979675,865304,19008,10,12,True,True,1954.0111555555557,-0.5427998324715997
7618,6095534,31,4,0.451535,144,6181916,-1,2000.0,8807080,8807111,2711546,31,1,6,True,True,1.7645888888888888,-0.451535
7619,6095582,113,2,0.894744,144,6181916,-1,1000.0,8469953,8470066,2374371,113,6,7,True,True,5.451622222222222,-0.894744
7620,6095896,137,32,0.093242,144,6181916,-1,16000.0,7587995,7588132,1492099,137,10,12,True,True,52.656711111111115,-0.093242
7621,6095972,9,2,0.104313,144,6181916,-1,1000.0,6849334,6849343,753362,9,14,7,True,True,0.32335,-0.104313
7622,6095994,6961,17,0.552907,144,6181916,-1,8500.0,7389195,7396156,1293201,6961,12,12,True,True,2236.2924833333336,-0.5315903877478164
7623,6096053,39045,8,0.032059,144,6181916,-1,4000.0,8324209,8363254,2228156,39045,8,0,True,True,6792.471144444444,-0.031435004500992646
7624,6096103,12315,4,0.689025,144,6181916,-1,2000.0,8046395,8058710,1950292,12315,10,7,True,True,1044.5375555555554,-0.6858421190155726
7625,6096127,23680,2,0.488613,144,6181916,-1,1000.0,8488885,8512565,2392758,23680,5,6,True,True,1229.9114722222223,-0.4881506236991737
7626,6096190,11,1,0.186692,144,6181916,-1,500.0,7270980,7270991,1174790,11,16,0,True,True,0.11647777777777778,-0.186692
7627,6096215,699,18,0.069491,144,6181916,-1,9000.0,8088610,8089309,1992395,699,11,10,True,True,208.0124,-0.06835642492757962
7628,6096769,50,1,0.962995,144,6181916,-1,500.0,7943395,7943445,1846626,50,13,9,True,True,1.3258333333333332,-0.962995
7629,6096778,13995,36,0.283818,144,6181916,-1,18000.0,7253580,7267575,1156802,13995,19,6,True,True,8826.754500000001,-0.24259816283786742
7630,6096933,51,1,0.233039,144,6181916,-1,500.0,8482385,8482436,2385452,51,7,2,True,True,1.0102958333333332,-0.233039
7631,6096961,72,4,0.65957,144,6181916,-1,2000.0,7291765,7291837,1194804,72,19,0,True,True,4.6956,-0.65957
7632,6097020,8852,128,0.069979,144,6181916,-1,64000.0,6874267,6883119,777247,8852,24,0,True,True,18201.303466666668,-0.06982829217995913
7633,6097126,33,8,0.057453,144,6181916,-1,4000.0,8156409,8156442,2059283,33,11,6,True,True,4.3571,-0.057453
7634,6097130,279,4,0.518532,144,6181916,-1,2000.0,8805980,8806259,2708850,279,2,8,True,True,15.8813,-0.518532
7635,6097184,6985,8,0.171826,144,6181916,-1,4000.0,6850434,6857419,753250,6985,27,6,True,True,863.9658666666667,-0.15818127434310225
7636,6097211,410,4,0.859707,144,6181916,-1,2000.0,8466653,8467063,2369442,410,10,11,True,True,41.15488888888889,-0.859707
7637,6097271,3,8,0.410861,144,6181916,-1,4000.0,7302565,7302568,1205294,3,22,9,True,True,0.333,-0.410861
7638,6097277,278,2,0.157035,144,6181916,-1,1000.0,8040595,8040873,1943318,278,17,0,True,True,11.930061111111112,-0.157035
7639,6097332,23,4,0.110744,144,6181916,-1,2000.0,7175367,7175390,1078035,23,27,9,True,True,1.3977611111111112,-0.110744
7640,6097351,23,32,0.536453,144,6181916,-1,16000.0,6969767,6969790,872416,23,29,7,True,True,9.229644444444446,-0.536453
7641,6098046,203,8,0.478251,144,6181916,-1,4000.0,8423453,8423656,2325407,203,11,8,True,True,33.061933333333336,-0.478251
7642,6098145,19,1,0.068763,144,6181916,-1,500.0,6872048,6872067,773903,19,33,1,True,True,0.28402361111111113,-0.068763
7643,6098202,1062,2,0.955097,144,6181916,-1,1000.0,8142309,8143371,2044107,1062,16,8,True,True,36.331625,-0.8058360271991112
7644,6098431,6,1,0.865699,144,6181916,-1,500.0,7954195,7954201,1855764,6,20,9,True,True,0.14540833333333336,-0.865699
7645,6098546,4961,16,0.129932,144,6181916,-1,8000.0,8423453,8428414,2324907,4961,11,0,True,True,1645.6803555555557,-0.12808494416260127
7646,6098955,14,1,0.205677,144,6181916,-1,500.0,6702175,6702189,603220,14,40,2,True,True,0.22471944444444442,-0.205677
7647,6100368,8,26,0.432201,144,6181916,-1,13000.0,7291765,7291773,1191397,8,29,4,True,True,3.3912666666666667,-0.43220099999999995
7648,6100373,624,1,0.709672,144,6181916,-1,500.0,7160967,7161591,1060594,624,33,9,True,True,9.8722,-0.709672
7649,6100434,3,2,0.47478,144,6181916,-1,1000.0,8472153,8472156,2371719,3,9,7,True,True,0.13856666666666667,-0.47478
7650,6100512,20254,16,0.603709,144,6181916,-1,8000.0,6405728,6425982,305216,20254,47,8,True,True,5027.324,-0.5985120968252706
7651,6100987,28,2,0.939154,144,6181916,-1,1000.0,6231637,6231665,130650,28,49,9,True,True,0.8218777777777778,-0.939154
7652,6101020,9091,128,0.587492,144,6181916,-1,64000.0,7668695,7677786,1567675,9091,25,10,True,True,31109.244622222224,-0.5800735806177013
7653,6101026,128,16,0.502475,144,6181916,-1,8000.0,8515985,8516113,2414959,128,4,6,True,True,42.73208888888889,-0.502475
7654,6101073,7,1,0.684836,144,6181916,-1,500.0,6595468,6595475,494395,7,47,7,True,True,0.12050694444444444,-0.684836
7655,6106453,89,16,0.275441,144,6181916,-1,8000.0,8704985,8705074,2598532,89,4,12,True,True,14.016511111111111,-0.275441
7656,6106775,9486,8,0.007443,144,6181916,-1,4000.0,7617195,7626681,1510420,9486,28,0,True,True,1036.7015000000001,-0.0071915768169563896
7657,6106898,10,16,0.142692,144,6181916,-1,8000.0,8046395,8046405,1939497,10,22,0,True,True,3.273333333333334,-0.142692
7658,6107010,66,32,0.06397,144,6181916,-1,16000.0,6739068,6739134,632058,66,47,8,True,True,32.0144,-0.06397
7659,6107212,15,1,0.399237,144,6181916,-1,500.0,7909895,7909910,1802683,15,27,10,True,True,0.36172916666666666,-0.399237
7660,6107349,5513,1,0.807566,144,6181916,-1,500.0,6518555,6524068,411206,5513,54,7,True,True,86.57682361111111,-0.7676523308316511
7661,6107760,42,4,0.525857,144,6181916,-1,2000.0,6724668,6724710,616908,42,49,2,True,True,2.8149333333333333,-0.525857
7662,6107783,6,4,0.910303,144,6181916,-1,2000.0,7624395,7624401,1516612,6,30,1,True,True,0.35363333333333336,-0.910303
7663,6108059,58,1,0.879239,144,6181916,-1,500.0,6739134,6739192,631075,58,49,1,True,True,0.8791833333333333,-0.879239
7664,6108112,537,1,0.460205,144,6181916,-1,500.0,6847134,6847671,739022,537,49,8,True,True,9.766691666666667,-0.4230824941012113
7665,6108162,11,4,0.576133,144,6181916,-1,2000.0,7302795,7302806,1194633,11,35,2,True,True,0.6105,-0.576133
7666,6108299,73,1,0.737291,144,6181916,-1,500.0,8708292,8708365,2599993,73,4,0,True,True,0.7185430555555555,-0.737291
7667,6109439,8251,8,0.287912,144,6181916,-1,4000.0,8373952,8382203,2264513,8251,18,6,True,True,1011.478188888889,-0.2787808935842867
7668,6110021,745,2,0.880994,144,6181916,-1,1000.0,8062310,8063055,1952289,745,24,1,True,True,25.90323611111111,-0.880994
7669,6110292,24,16,0.456307,144,6181916,-1,8000.0,6733668,6733692,623376,24,56,2,True,True,6.035733333333334,-0.456307
7670,6110560,683,2,0.700317,144,6181916,-1,1000.0,6872067,6872750,761507,683,50,0,True,True,20.091191666666667,-0.6890469622819843
7671,6110618,475,1,0.711648,144,6181916,-1,500.0,8183809,8184284,2073191,475,20,7,True,True,7.063645833333333,-0.711648
7672,6111648,10744,4,0.297449,144,6181916,-1,2000.0,7910995,7921739,1799347,10744,31,6,True,True,1022.1640277777776,-0.29495554274064384
7673,6111677,29494,4,0.613028,144,6181916,-1,2000.0,6681868,6711362,570191,29494,64,12,True,True,2041.576722222222,-0.6109761270821775
7674,6112290,396,7,0.809985,144,6181916,-1,3500.0,6755334,6755730,643044,396,57,8,True,True,51.47065,-0.809985
7675,6112402,206,1,0.175126,144,6181916,-1,500.0,8722392,8722598,2609990,206,3,6,True,True,1.6914888888888888,-0.175126
7676,6112602,13650,14,0.249135,144,6181916,-1,7000.0,8393654,8407304,2281052,13650,18,6,True,True,5258.8352444444445,-0.24120418339215804
7677,6112924,20785,193,0.899965,144,6181916,-1,96500.0,7270980,7291765,1158056,20785,46,0,True,True,50895.55152083333,-0.8671393121149749
7678,6116203,5,8,0.733244,144,6181916,-1,4000.0,6398128,6398133,281925,5,74,12,True,True,0.46805555555555556,-0.733244
7679,6116352,1695,8,0.457828,144,6181916,-1,4000.0,8415258,8416953,2298906,1695,18,1,True,True,320.7509333333333,-0.4493332105166584
7680,6116390,8,4,0.910833,144,6181916,-1,2000.0,8709392,8709400,2593002,8,5,6,True,True,0.31586666666666663,-0.910833
7681,6116853,16547,64,0.183444,144,6181916,-1,32000.0,6311728,6328275,194875,16547,77,9,True,True,13062.042311111112,-0.18084485141276382
7682,6117029,5,2,0.568615,144,6181916,-1,1000.0,6545668,6545673,428639,5,72,0,True,True,0.14151388888888888,-0.568615
7683,6118255,11693,41,0.393551,144,6181916,-1,20500.0,6709375,6721068,591120,11693,68,3,True,True,8591.612240277778,-0.38257574325925137
7684,6118441,9726,24,0.945687,144,6181916,-1,12000.0,7620795,7630521,1502354,9726,40,2,True,True,3134.2778,-0.9150084976084505
7685,6118880,394,1,0.239695,144,6181916,-1,500.0,6874267,6874661,755387,394,58,7,True,True,5.704791666666667,-0.239695
7686,6118914,18,1,0.87054,144,6181916,-1,500.0,6721068,6721086,602154,18,69,4,True,True,0.3644,-0.87054
7687,6118928,95,1,0.273776,144,6181916,-1,500.0,8730198,8730293,2611270,95,3,8,True,True,0.7881041666666666,-0.273776
7688,6119064,23817,2,0.628083,144,6181916,-1,1000.0,6970867,6994684,851803,23817,56,6,True,True,525.3915694444445,-0.6129404631600394
7689,6119108,9,4,0.29189,144,6181916,-1,2000.0,8392554,8392563,2273446,9,22,6,True,True,0.7764,-0.29189
7690,6123749,14,4,0.916296,144,6181916,-1,2000.0,6872034,6872048,748285,14,64,10,True,True,0.8371222222222222,-0.916296
7691,6123915,18,4,0.698044,144,6181916,-1,2000.0,8181609,8181627,2057694,18,27,9,True,True,1.1853,-0.698044
7692,6124059,81,1,0.722409,144,6181916,-1,500.0,6689479,6689560,565420,81,79,8,True,True,1.5277500000000002,-0.722409
7693,6124598,92,2,0.217255,144,6181916,-1,1000.0,8382222,8382314,2257624,92,24,8,True,True,2.814944444444445,-0.217255
7694,6124770,8,1,0.493488,144,6181916,-1,500.0,6421228,6421236,296458,8,87,2,True,True,0.12144444444444444,-0.493488
7695,6125092,2,5,0.99239,144,6181916,-1,2500.0,8723698,8723700,2598606,2,4,6,True,True,0.07875,-0.99239
7696,6125214,4,4,0.552824,144,6181916,-1,2000.0,8415254,8415258,2290040,4,22,10,True,True,0.3856222222222222,-0.552824
7697,6125511,10193,16,0.995316,144,6181916,-1,8000.0,8618585,8628778,2493074,10193,10,12,True,True,2775.3420444444446,-0.9915880882876748
7698,6125774,15531,128,0.076534,144,6181916,-1,64000.0,6515255,6530786,389481,15531,89,1,True,True,30230.17422222222,-0.07221281353915272
7699,6126004,10,16,0.105225,144,6181916,-1,8000.0,8383322,8383332,2257318,10,27,6,True,True,2.447777777777778,-0.105225
7700,6126999,20414,256,0.766539,144,6181916,-1,128000.0,6211223,6231637,84224,20414,98,0,True,True,64647.96906666666,-0.7038846692630568
7701,6127255,15208,4,0.326013,144,6181916,-1,2000.0,6721068,6736276,593813,15208,79,0,True,True,915.2972,-0.29191787197836166
7702,6127551,151,16,0.450936,144,6181916,-1,8000.0,7266580,7266731,1139029,151,59,9,True,True,22.998977777777778,-0.450936
7703,6128779,3,1,0.252767,144,6181916,-1,500.0,7711895,7711898,1583116,3,46,11,True,True,0.04106666666666667,-0.252767
7704,6128835,200,32,0.506065,144,6181916,-1,16000.0,6275937,6276137,147102,200,100,11,True,True,104.45333333333333,-0.506065
7705,6128855,154,2,0.462167,144,6181916,-1,1000.0,6524068,6524222,395213,154,91,1,True,True,4.671761111111111,-0.462167
7706,6129010,26,32,0.073195,144,6181916,-1,16000.0,6684079,6684105,555069,26,88,6,True,True,18.17688888888889,-0.073195
7707,6130829,3,5,0.694486,144,6181916,-1,2500.0,7501595,7501598,1370766,3,52,10,True,True,0.197125,-0.694486
7708,6132809,32539,37,0.749736,144,6181916,-1,18500.0,8136909,8169448,2004100,32539,36,7,True,True,21380.4356625,-0.7304461872100965
7709,6133298,352,1,0.381156,144,6181916,-1,500.0,6547868,6548220,414570,352,93,7,True,True,4.981288888888889,-0.381156
7710,6133568,34,106,0.745957,144,6181916,-1,53000.0,8386622,8386656,2253054,34,27,6,True,True,51.90761111111111,-0.745957
7711,6133731,53,4,0.855773,144,6181916,-1,2000.0,8710492,8710545,2576761,53,7,6,True,True,2.0926166666666663,-0.855773
7712,6133928,6435,4,0.396674,144,6181916,-1,2000.0,8134709,8141144,2000781,6435,39,11,True,True,505.26722222222224,-0.3591695031161611
7713,6134348,3,8,0.010737,144,6181916,-1,4000.0,7943395,7943398,1809047,3,46,0,True,True,0.6364,-0.010737
7714,6134461,109,4,0.114683,144,6181916,-1,2000.0,8324209,8324318,2189748,109,33,11,True,True,6.97055,-0.114683
7715,6134542,144,8,0.917137,144,6181916,-1,4000.0,6965367,6965511,830825,144,74,6,True,True,17.0352,-0.917137
7716,6157938,30,8,0.32711,144,6181916,-1,4000.0,8391454,8391484,2233516,30,27,6,True,True,4.091666666666667,-0.32711
7717,6158059,72,1,0.748676,144,6181916,-1,500.0,7617195,7617267,1459136,72,58,10,True,True,1.0118,-0.748676
7718,6158070,1194,32,0.484759,144,6181916,-1,16000.0,6967567,6968761,809497,1194,76,7,True,True,537.1408,-0.484759
7719,6158142,61,8,0.068237,144,6181916,-1,4000.0,7277880,7277941,1119738,61,67,2,True,True,5.5103333333333335,-0.068237
7720,6166540,36,1,0.548429,144,6181916,-1,500.0,6749934,6749970,583394,36,89,9,True,True,0.60845,-0.548429
7721,6166801,8740,64,0.242294,144,6181916,-1,32000.0,8415254,8423994,2248453,8740,24,0,True,True,11478.950222222222,-0.22927675999699274
7722,6167111,15477,8,0.950018,144,6181916,-1,4000.0,6411128,6426605,244017,15477,113,8,True,True,1870.895411111111,-0.920694883339868
7723,6167127,12518,64,0.140256,144,6181916,-1,32000.0,8708292,8720810,2541165,12518,10,6,True,True,7340.348088888888,-0.1342114143073019
7724,6167151,6896,1,0.820427,144,6181916,-1,500.0,6695279,6702175,528128,6896,101,4,True,True,111.63617083333334,-0.819331924702647
7725,6167179,4606,42,0.841563,144,6181916,-1,21000.0,8514885,8519491,2347706,4606,15,7,True,True,3970.1344083333333,-0.8350371792701299
7726,6167293,35,32,0.170589,144,6181916,-1,16000.0,8737798,8737833,2570505,35,3,7,True,True,9.71288888888889,-0.170589
7727,6167321,2351,32,0.018066,144,6181916,-1,16000.0,6507628,6509979,340307,2351,116,12,True,True,1089.7677777777778,-0.017783813546954907
7728,6167402,3,64,0.100515,144,6181916,-1,32000.0,8829780,8829783,2662378,3,0,10,True,True,2.4226666666666667,-0.100515
7729,6168363,50,16,0.294145,144,6181916,-1,8000.0,8170809,8170859,2002446,50,42,3,True,True,15.84,-0.294145
7730,6170285,6,15,0.534654,144,6181916,-1,7500.0,7595595,7595601,1425310,6,65,8,True,True,1.041625,-0.534654
7731,6170812,28303,8,0.39085,144,6181916,-1,4000.0,7014067,7042370,843255,28303,82,11,True,True,3783.7142333333336,-0.3855375835071114
7732,6170820,852,1,0.077585,144,6181916,-1,500.0,7180080,7180932,1009260,852,79,6,True,True,12.6522,-0.077585
7733,6171254,11,32,0.763589,144,6181916,-1,16000.0,6682968,6682979,511714,11,112,6,True,True,7.690222222222223,-0.763589
7734,6171266,6290,1,0.677383,144,6181916,-1,500.0,8386656,8392946,2215390,6290,33,2,True,True,109.76106666666666,-0.602022840026788
7735,6171277,10237,3,0.153496,144,6181916,-1,1500.0,6416528,6426765,245251,10237,125,8,True,True,458.4081458333334,-0.15321439889977298
7736,6171329,8,10,0.358087,144,6181916,-1,5000.0,8475753,8475761,2304424,8,22,0,True,True,1.7745555555555557,-0.358087
7737,6171796,29,4,0.216672,144,6181916,-1,2000.0,7268780,7268809,1096984,29,79,7,True,True,1.228311111111111,-0.216672
7738,6171947,8514,128,0.034445,144,6181916,-1,64000.0,7479995,7488509,1308048,8514,70,7,True,True,22281.481066666667,-0.034376773531718016
7739,6180587,10886,2,0.675044,144,6181916,-1,1000.0,6184116,6195002,3529,10886,137,7,True,True,334.5361722222222,-0.6537902114856766
7740,6180626,47,1,0.216166,144,6181916,-1,500.0,7177567,7177614,996941,47,84,7,True,True,0.7140736111111111,-0.216166
7741,6180674,58,1,0.696742,144,6181916,-1,500.0,8479353,8479411,2298679,58,22,4,True,True,1.5200833333333332,-0.696742
7742,6180804,34,2,0.836501,144,6181916,-1,1000.0,7270980,7271014,1090176,34,81,0,True,True,0.7200444444444444,-0.836501
7743,6180922,3,1,0.811512,144,6181916,-1,500.0,8724798,8724801,2543876,3,6,6,True,True,0.023625000000000004,-0.811512
7744,6181531,14512,1,0.641012,144,6181916,-1,500.0,6522155,6536667,340624,14512,127,1,True,True,198.6792486111111,-0.619854877098577
7745,6181893,34,4,0.71641,144,6181916,-1,2000.0,6194916,6194950,13023,34,142,9,True,True,2.605722222222222,-0.71641
7746,6181980,11445,16,0.89701,159,6184116,-1,8000.0,6195002,6206447,13022,11445,142,2,True,True,2763.4482,-0.8309205452411516
7747,6182070,10698,256,0.390618,159,6184116,-1,128000.0,8363254,8373952,2181184,10698,42,8,True,True,53186.27768888889,-0.38703617730478024
7748,6182223,59,2,0.308324,159,6184116,-1,1000.0,7251380,7251439,1069157,59,87,6,True,True,2.7241611111111115,-0.308324
7749,6182229,14021,8,0.052415,159,6184116,-1,4000.0,6197202,6211223,14973,14021,144,7,True,True,1624.8313777777778,-0.051344515336646114
7750,6182245,6,7,0.004666,159,6184116,-1,3500.0,8067010,8067016,1884765,6,54,2,True,True,0.8932583333333334,-0.004665999999999999
7751,6182363,11,15,0.77241,159,6184116,-1,7500.0,7921795,7921806,1739432,11,62,9,True,True,3.7789583333333336,-0.7724099999999998
7752,6182386,12,2,0.767114,159,6184116,-1,1000.0,6421228,6421240,238842,12,136,0,True,True,0.36433333333333334,-0.767114
7753,6182528,13,32,0.928821,159,6184116,-1,16000.0,8385522,8385535,2202994,13,39,7,True,True,5.991555555555555,-0.928821
7754,6182662,527,8,0.374645,159,6184116,-1,4000.0,8512685,8513212,2330023,527,19,0,True,True,89.2620888888889,-0.374645
7755,6182694,1989,2,0.23854,159,6184116,-1,1000.0,7273180,7275169,1090486,1989,85,7,True,True,44.58675,-0.23854
7756,6182782,38,2,0.091386,159,6184116,-1,1000.0,8057195,8057233,1874413,38,58,9,True,True,1.3216611111111112,-0.091386
7757,6182850,21,4,0.421683,159,6184116,-1,2000.0,8510485,8510506,2327635,21,20,9,True,True,1.7784666666666666,-0.421683
7758,6182870,18,2,0.989291,159,6184116,-1,1000.0,8376822,8376840,2193952,18,44,1,True,True,0.60895,-0.989291
7759,6182876,16473,21,0.337117,159,6184116,-1,10500.0,6697479,6713952,514603,16473,126,7,True,True,5608.857800000001,-0.33543752641297814
7760,6183019,13368,6,0.192152,159,6184116,-1,3000.0,6682979,6696347,499960,13368,131,1,True,True,1443.2283499999999,-0.18491567009996088
7761,6183053,24,4,0.668949,159,6184116,-1,2000.0,8155309,8155333,1972256,24,53,7,True,True,1.5844,-0.668949
7762,6184878,28,1,0.220568,177,6194916,-1,500.0,8800580,8800608,2615702,28,4,11,True,True,0.4605222222222222,-0.220568
7763,6186030,10651,4,0.882286,177,6194916,-1,2000.0,8181609,8192260,1995579,10651,51,0,True,True,743.0660166666665,-0.8172603648267472
7764,6186037,134,4,0.796924,177,6194916,-1,2000.0,6545668,6545802,359631,134,140,10,True,True,7.585144444444444,-0.796924
7765,6186291,7,1,0.830451,177,6194916,-1,500.0,8745480,8745487,2559189,7,5,2,True,True,0.05628194444444444,-0.830451
7766,6186296,4,1,0.167883,177,6194916,-1,500.0,6964267,6964271,777971,4,110,1,True,True,0.05915,-0.167883
7767,6186359,9079,16,0.167047,177,6194916,-1,8000.0,6593268,6602347,406909,9079,140,7,True,True,2602.8105333333333,-0.16688577291794401
7768,6186610,2,64,0.41568,177,6194916,-1,32000.0,8167209,8167211,1980599,2,55,8,True,True,2.2968888888888888,-0.41568
7769,6186646,12762,5,0.107684,177,6194916,-1,2500.0,8707192,8719954,2520546,12762,16,1,True,True,592.4579444444445,-0.10464638027468882
7770,6186691,94,4,0.327141,177,6194916,-1,2000.0,6300928,6301022,114237,94,161,1,True,True,4.380922222222223,-0.327141
7771,6186720,10727,1,0.562054,177,6194916,-1,500.0,6417628,6428355,230908,10727,155,6,True,True,160.0157847222222,-0.5615455979146043
7772,6186760,4,16,0.189548,177,6194916,-1,8000.0,6699679,6699683,512919,4,133,7,True,True,1.027288888888889,-0.189548
7773,6187354,35732,16,0.207119,177,6194916,-1,8000.0,7932595,7968327,1745241,35732,73,9,True,True,14090.685044444444,-0.20466067851236505
7774,6187374,16088,32,0.541703,177,6194916,-1,16000.0,8040595,8056683,1853221,16088,70,12,True,True,11192.96791111111,-0.5387864580734019
7775,6187428,7,4,0.938923,177,6194916,-1,2000.0,7281480,7281487,1094052,7,95,4,True,True,0.33821666666666667,-0.938923
7776,6187452,40,4,0.120804,177,6194916,-1,2000.0,8830880,8830920,2643428,40,0,6,True,True,1.8646666666666667,-0.120804
7777,6187476,230,32,0.21378,177,6194916,-1,16000.0,7302565,7302795,1115089,230,93,0,True,True,102.12,-0.21378
7778,6187562,4,1,0.356576,177,6194916,-1,500.0,6509851,6509855,322289,4,158,1,True,True,0.05702777777777778,-0.356576
7779,6187628,5482,64,0.173622,177,6194916,-1,32000.0,8739998,8745480,2552370,5482,7,7,True,True,2945.5118222222222,-0.16963763339994434
7780,6187688,7780,16,0.402139,177,6194916,-1,8000.0,6516355,6524135,328667,7780,157,6,True,True,2003.4582222222223,-0.39994681587953124
7781,6196956,48,8,0.31624,177,6197202,-1,4000.0,8044195,8044243,1847239,48,71,2,True,True,8.271466666666667,-0.31624
7782,6197065,8715,64,0.389187,177,6197202,-1,32000.0,7755095,7763810,1558030,8715,82,11,True,True,10436.582222222223,-0.3798886515492844
7783,6197309,20587,32,0.458776,216,6211223,-1,16000.0,8281009,8301596,2083700,20587,54,12,True,True,11378.35408888889,-0.4555514215888908
7784,6197333,132,8,0.066016,216,6211223,-1,4000.0,8722598,8722730,2525265,132,12,1,True,True,8.670933333333332,-0.066016
7785,6197371,40,8,0.815085,216,6211223,-1,4000.0,7711895,7711935,1514524,40,85,0,True,True,4.380444444444445,-0.815085
7786,6197433,8,4,0.649945,216,6211223,-1,2000.0,7943395,7943403,1745962,8,77,0,True,True,0.8485333333333333,-0.649945
7787,6198518,5,2,0.36898,216,6211223,-1,1000.0,8735598,8735603,2537080,5,9,8,True,True,0.085625,-0.36898
7788,6198545,6037,1,0.067331,216,6211223,-1,500.0,6713775,6719812,515230,6037,144,7,True,True,113.9972736111111,-0.06538931860373975
7789,6198567,13942,3,0.218561,216,6211223,-1,1500.0,7270980,7284922,1072413,13942,111,7,True,True,486.8820333333333,-0.2147532925858749
7790,6199325,12,4,0.301534,216,6211223,-1,2000.0,6695279,6695291,495954,12,150,0,True,True,0.7605333333333334,-0.301534
7791,6199601,9528,16,0.598869,216,6211223,-1,8000.0,7019467,7028995,819866,9528,121,8,True,True,2814.485577777778,-0.5850188161264859
7792,6199623,16060,128,0.983102,216,6211223,-1,64000.0,6690579,6706639,490956,16060,154,6,True,True,33549.50097777778,-0.9625675475887175
7793,6200106,14,3,0.101814,216,6211223,-1,1500.0,7590195,7590209,1390089,14,95,7,True,True,0.5176499999999999,-0.101814
7794,6200395,17,19,0.536182,216,6211223,-1,9500.0,8416953,8416970,2216558,17,39,1,True,True,6.184552777777778,-0.536182
7795,6201790,98,3,0.990531,216,6211223,-1,1500.0,8390256,8390354,2188466,98,46,1,True,True,5.012291666666666,-0.990531
7796,6201992,13,32,0.850465,216,6211223,-1,16000.0,8494285,8494298,2292293,13,29,8,True,True,10.730488888888889,-0.850465
7797,6202188,15248,8,0.171459,216,6211223,-1,4000.0,8063410,8078658,1861222,15248,73,6,True,True,2376.018422222222,-0.17101123457745415
7798,6202259,119,4,0.959035,216,6211223,-1,2000.0,6232737,6232856,30478,119,190,6,True,True,6.985961111111111,-0.959035
7799,6202348,13269,32,0.599867,216,6211223,-1,16000.0,8161809,8175078,1959461,13269,65,8,True,True,7657.776533333333,-0.5972271446729855
7800,6202504,4977,8,0.981416,216,6211223,-1,4000.0,8532185,8537162,2329681,4977,23,9,True,True,1016.0164777777777,-0.9795709249561074
7801,6202738,9543,16,0.696315,216,6211223,-1,8000.0,7282580,7292123,1079842,9543,112,6,True,True,2190.6586,-0.6697764867384071
7802,6202784,3,4,0.677901,216,6211223,-1,2000.0,7758695,7758698,1555911,3,92,1,True,True,0.21408333333333332,-0.677901
7803,6202795,12009,1,0.972367,216,6211223,-1,500.0,6872067,6884076,669272,12009,141,1,True,True,190.75022083333332,-0.93103310313654
7804,6202868,670,1,0.693721,216,6211223,-1,500.0,8376152,8376822,2173284,670,56,7,True,True,11.333236111111113,-0.693721
7805,6203049,269,8,0.332047,216,6211223,-1,4000.0,7391395,7391664,1188346,269,108,0,True,True,39.154444444444444,-0.332047
7806,6203171,1197,3,0.635353,216,6211223,-1,1500.0,6705775,6706972,502604,1197,160,3,True,True,57.383804166666664,-0.5788320215171575
7807,6204006,19249,128,0.883967,216,6211223,-1,64000.0,8281009,8300258,2077003,19249,61,0,True,True,42727.28408888889,-0.8773517928032911
7808,6204286,8237,4,0.317967,216,6211223,-1,2000.0,8089309,8097546,1885023,8237,75,1,True,True,554.4930444444444,-0.3047423708494189
7809,6204343,16776,1,0.851554,216,6211223,-1,500.0,8757380,8774156,2553037,16776,6,9,True,True,214.11945000000003,-0.8081347612807349
7810,6206461,119,16,0.48213,216,6211223,-1,8000.0,8521385,8521504,2314924,119,25,8,True,True,43.6016,-0.48213
7811,6207230,21,4,0.335105,216,6211223,-1,2000.0,6730068,6730089,522838,21,158,8,True,True,1.1638666666666668,-0.335105
7812,6207482,681,8,0.608533,216,6211223,-1,4000.0,7255780,7256461,1048298,681,129,0,True,True,128.936,-0.608533
7813,6207629,10100,64,0.585037,216,6211223,-1,32000.0,6277037,6287137,69408,10100,203,6,True,True,10891.379022222221,-0.5829489214294091
7814,6207858,109,32,0.382371,216,6211223,-1,16000.0,7178980,7179089,971122,109,133,2,True,True,51.796800000000005,-0.382371
7815,6207901,27,32,0.640592,216,6211223,-1,16000.0,7149067,7149094,941166,27,137,12,True,True,18.459600000000002,-0.640592
7816,6208349,196,1,0.232425,216,6211223,-1,500.0,8194609,8194805,1986260,196,65,9,True,True,4.110283333333333,-0.232425
7817,6210331,11382,10,0.587469,216,6211223,-1,5000.0,8467753,8479135,2257422,11382,40,6,True,True,2662.4186944444446,-0.5641642833590236
7818,6210539,12,2,0.988381,216,6211223,-1,1000.0,7647095,7647107,1436556,12,104,10,True,True,0.35303333333333337,-0.988381
7819,6210662,20824,32,0.232606,216,6211223,-1,16000.0,7274280,7295104,1063618,20824,125,6,True,True,8947.541333333333,-0.22646905239895396
7820,6210840,189,3,0.616349,216,6211223,-1,1500.0,6718175,6718364,507335,189,169,0,True,True,11.4786,-0.616349
7821,6210850,9410,4,0.896779,216,6211223,-1,2000.0,8091509,8100919,1880659,9410,79,7,True,True,668.8648888888889,-0.8415892457819525
7822,6211134,23,4,0.308849,216,6211223,-1,2000.0,6509828,6509851,298694,23,200,7,True,True,1.311638888888889,-0.308849
7823,6211443,21,5,0.737913,226,6231637,-1,2500.0,6711575,6711596,500132,21,173,7,True,True,1.6223958333333333,-0.7379129999999999
7824,6212544,5,2,0.757246,226,6231637,-1,1000.0,7888295,7888300,1675751,5,99,11,True,True,0.22309722222222222,-0.757246
7825,6214784,7,16,0.619766,226,6231637,-1,8000.0,8707185,8707192,2492401,7,22,7,True,True,1.1024222222222222,-0.619766
7826,6214847,161,4,0.059923,226,6231637,-1,2000.0,7391395,7391556,1176548,161,119,7,True,True,11.71722222222222,-0.059923
7827,6219088,11,1,0.374524,226,6231637,-1,500.0,8475753,8475764,2256665,11,39,3,True,True,0.24400138888888892,-0.374524
7828,6223783,10,4,0.296615,226,6231637,-1,2000.0,6841734,6841744,617951,10,165,12,True,True,0.8628888888888889,-0.296615
7829,6224187,10232,4,0.151671,226,6231637,-1,2000.0,8472153,8482385,2247966,10232,40,0,True,True,966.5953944444444,-0.14975188194658795
7830,6225090,18531,100,0.204385,226,6231637,-1,50000.0,7164567,7183098,939477,18531,146,2,True,True,30402.6425,-0.20324156473969654
7831,6225413,11946,113,0.037907,226,6231637,-1,56500.0,6279237,6291183,53824,11946,220,7,True,True,23666.100854166667,-0.036722284196804504
7832,6226281,9339,64,0.923409,226,6231637,-1,32000.0,6591068,6600407,364787,9339,197,11,True,True,10307.410666666668,-0.8899286181581489
7833,6226847,91,1,0.598075,226,6231637,-1,500.0,6300837,6300928,73990,91,221,10,True,True,1.0602763888888889,-0.598075
7834,6232781,8,8,0.945876,245,6275937,-1,4000.0,7019467,7019475,786686,8,150,0,True,True,1.2241777777777778,-0.945876
7835,6234484,38,64,0.739256,245,6275937,-1,32000.0,8710492,8710530,2476008,38,17,0,True,True,24.005866666666666,-0.739256
7836,6234645,5418,32,0.32869,245,6275937,-1,16000.0,8418053,8423471,2183408,5418,48,6,True,True,3438.6871111111113,-0.32674194208512447
7837,6234774,319,4,0.278126,245,6275937,-1,2000.0,7207080,7207399,972306,319,144,10,True,True,19.265505555555556,-0.27223637471964374
7838,6235408,28813,1,0.643602,245,6275937,-1,500.0,7150167,7178980,914759,28813,151,6,True,True,458.46962499999995,-0.6366013892811625
7839,6237416,7,8,0.760494,245,6275937,-1,4000.0,7625495,7625502,1388079,7,112,6,True,True,0.6801666666666667,-0.760494
7840,6237461,1018,1,0.520873,245,6275937,-1,500.0,7758695,7759713,1521234,1018,106,0,True,True,18.161402777777777,-0.520873
7841,6237706,12201,1,0.977568,245,6275937,-1,500.0,8058710,8070911,1821004,12201,90,2,True,True,232.97990694444445,-0.9750106199913993
7842,6237799,10444,14,0.648046,245,6275937,-1,7000.0,7250280,7260724,1012481,10444,147,11,True,True,3320.504911111111,-0.6480378031779918
7843,6237848,14170,2,0.288455,245,6275937,-1,1000.0,8512685,8526855,2274837,14170,32,7,True,True,620.9539027777778,-0.27833034325213013
7844,6239963,212,2,0.023693,245,6275937,-1,1000.0,6718175,6718387,478212,212,188,7,True,True,8.583644444444444,-0.023693
7845,6240057,14,1,0.846935,245,6275937,-1,500.0,8743598,8743612,2503541,14,8,1,True,True,0.11816388888888889,-0.846935
7846,6240278,19618,2,0.33127,245,6275937,-1,1000.0,8746580,8766198,2506302,19618,7,6,True,True,381.5740888888889,-0.29904787238393576
7847,6241516,23,1,0.242249,245,6275937,-1,500.0,8829780,8829803,2588264,23,1,0,True,True,0.2902152777777778,-0.242249
7848,6242557,54,4,0.539312,245,6275937,-1,2000.0,8390354,8390408,2147797,54,60,1,True,True,3.6824999999999997,-0.539312
7849,6242604,9233,64,0.906632,245,6275937,-1,32000.0,7255780,7265013,1013176,9233,150,7,True,True,10814.462399999999,-0.8130579933948788
7850,6242942,14832,119,0.665006,245,6275937,-1,59500.0,6400328,6415160,157386,14832,233,7,True,True,27350.4245,-0.6645448227700602
7851,6244121,9,64,0.248338,245,6275937,-1,32000.0,7252480,7252489,1008359,9,152,6,True,True,13.297600000000001,-0.248338
7852,6244172,10,8,0.68735,245,6275937,-1,4000.0,6277037,6277047,32865,10,241,0,True,True,1.3056666666666668,-0.68735
7853,6244213,24,1,0.719502,245,6275937,-1,500.0,6507628,6507652,263415,24,227,0,True,True,0.3531666666666667,-0.719502
7854,6244275,3,8,0.608063,245,6275937,-1,4000.0,7185480,7185483,941205,3,156,8,True,True,0.3216666666666667,-0.608063
4420,3599033,10,8,0.121962,1,3599033,-1,4000.0,3601659,3601243,2626,10,0,7,True,True,0.8979999999999999,-0.121962
4421,3601659,10,1,0.768146,1,3601659,-1,500.0,3602759,3602769,1100,10,0,6,True,True,0.11224999999999999,-0.768146
4422,3601907,6031,4,0.248962,5,3602759,-1,2000.0,3604959,3610990,3052,6031,0,7,True,True,309.32410555555555,-0.22880830970182514
4423,3601977,9968,128,0.771225,5,3602759,-1,64000.0,3602759,3612727,782,9968,1,0,True,True,16378.574577777777,-0.7437950129514072
4424,3602335,9031,2,0.442961,5,3602759,-1,1000.0,5388461,5397492,1786126,9031,0,0,True,True,314.24035000000003,-0.3498113244222286
4425,3602647,10350,1,0.737619,5,3602759,-1,500.0,4682467,4692817,1079820,10350,1,6,True,True,92.57213611111112,-0.700769360284705
4426,3602663,886,8,0.03351,5,3602759,-1,4000.0,3650359,3651245,47696,886,2,7,True,True,92.17705555555557,-0.0329759452936969
4427,3604547,6,6,0.460835,6,3604959,-1,3000.0,3933459,3933465,328912,6,2,7,True,True,0.52335,-0.460835
4428,3604641,1145,32,0.770996,6,3604959,-1,16000.0,3648159,3649304,43518,1145,4,11,True,True,484.2077777777778,-0.770996
4429,3604922,15,1,0.521139,6,3604959,-1,500.0,4526460,4526475,921538,15,2,11,True,True,0.19635416666666666,-0.521139
4430,3604995,7,4,0.982116,54,3648159,-1,2000.0,5458363,5458370,1853368,7,0,2,True,True,0.3566111111111111,-0.982116
4431,3605014,40369,50,0.472826,54,3648159,-1,25000.0,5532963,5573332,1927949,40369,0,7,True,True,18720.403819444444,-0.42590994611751604
4432,3605223,9932,1,0.681442,54,3648159,-1,500.0,4533867,4543799,928644,9932,4,2,True,True,121.96267638888888,-0.6579682361826077
4433,3605492,4812,256,0.312109,54,3648159,-1,128000.0,5893808,5898620,2288316,4812,0,6,True,True,17490.857244444443,-0.3003290616557592
4434,3605570,579,4,0.323063,54,3648159,-1,2000.0,5749857,5750436,2144287,579,1,6,True,True,46.96333333333333,-0.323063
4435,3605841,241,2,0.629164,54,3648159,-1,1000.0,6045240,6045481,2439399,241,0,0,True,True,4.373480555555555,-0.629164
4436,3605933,11431,2,0.042186,54,3648159,-1,1000.0,3672359,3683790,66426,11431,10,1,True,True,411.9743666666667,-0.04218385569123695
4437,3606018,184,16,0.937421,54,3648159,-1,8000.0,5388461,5388645,1782443,184,6,6,True,True,83.2416,-0.937421
4438,3606157,43,1,0.520926,54,3648159,-1,500.0,5325761,5325804,1719604,43,7,12,True,True,0.5067430555555555,-0.520926
4439,3607787,11,8,0.253313,54,3648159,-1,4000.0,5447561,5447572,1839774,11,5,6,True,True,0.9714222222222223,-0.253313
4440,3607835,3669,32,0.63852,54,3648159,-1,16000.0,3921159,3924828,313324,3669,13,0,True,True,1565.562,-0.6279526302361911
4441,3607893,10395,32,0.198724,54,3648159,-1,16000.0,6038040,6048435,2430147,10395,1,0,True,True,2991.3433333333332,-0.19565428307807894
4442,3607918,131,4,0.88752,54,3648159,-1,2000.0,5831387,5831518,2223469,131,3,11,True,True,9.715833333333332,-0.88752
4443,3608069,9617,128,0.863658,54,3648159,-1,64000.0,4342157,4351774,734088,9617,14,6,True,True,9635.775466666666,-0.8508728131649707
4444,3608142,45,4,0.217788,54,3648159,-1,2000.0,5742669,5742714,2134527,45,5,1,True,True,3.6552500000000006,-0.217788
4445,3609215,18897,5,0.112928,54,3648159,-1,2500.0,5649830,5668727,2040615,18897,6,8,True,True,1043.5341944444444,-0.11076828890763972
4446,3609235,6,16,0.632909,54,3648159,-1,8000.0,5708069,5708075,2098834,6,6,1,True,True,1.3302666666666667,-0.632909
4447,3609295,102,1,0.324513,54,3648159,-1,500.0,4991354,4991456,1382059,102,14,0,True,True,1.2783999999999998,-0.324513
4448,3609324,52,1,0.16736,54,3648159,-1,500.0,5105558,5105610,1496234,52,14,2,True,True,0.5678833333333333,-0.16736
4449,3612264,97,32,0.2761,54,3648159,-1,16000.0,5785987,5786084,2173723,97,4,4,True,True,56.492799999999995,-0.2761
4450,3612998,3,8,0.11965,54,3648159,-1,4000.0,5854283,5854286,2241285,3,3,6,True,True,0.8333,-0.11965
4451,3613280,117,16,0.789144,54,3648159,-1,8000.0,4595186,4595303,981906,117,19,6,True,True,16.3384,-0.789144
4452,3613362,13488,8,0.00893,54,3648159,-1,4000.0,4616786,4630274,1003424,13488,19,10,True,True,1046.577711111111,-0.008795769445267065
4453,3614472,25974,8,0.041993,54,3648159,-1,4000.0,5742957,5768931,2128485,25974,7,2,True,True,4422.122733333334,-0.04194105157215347
4454,3614510,5239,4,0.783475,54,3648159,-1,2000.0,3697559,3702798,83049,5239,27,9,True,True,314.76815555555555,-0.7772597771815
4455,3614555,18,32,0.475271,54,3648159,-1,16000.0,4287828,4287846,673273,18,25,6,True,True,4.164,-0.475271
4456,3614578,139,1,0.596212,54,3648159,-1,500.0,5029154,5029293,1414576,139,18,8,True,True,1.618945833333333,-0.5780758551468917
4457,3614804,416,16,0.371399,54,3648159,-1,8000.0,3661159,3661575,46355,416,31,9,True,True,94.05833333333332,-0.37120123648722037
4458,3615033,9,8,0.08948,54,3648159,-1,4000.0,6047440,6047449,2432407,9,0,7,True,True,0.6533,-0.08948
4459,3615173,17,14,0.157698,54,3648159,-1,7000.0,5107758,5107775,1492585,17,18,7,True,True,2.599158333333333,-0.157698
4460,3615213,396,1,0.091402,54,3648159,-1,500.0,5344161,5344557,1728948,396,17,9,True,True,5.037999999999999,-0.091402
4461,3615711,16582,256,0.618645,54,3648159,-1,128000.0,4293045,4309627,677334,16582,29,1,True,True,40279.27217777778,-0.5870231035997856
4462,3615813,15389,16,0.930849,54,3648159,-1,8000.0,4177667,4193056,561854,15389,31,1,True,True,3030.0103111111107,-0.8958206526602756
4463,3615840,28,1,0.996973,54,3648159,-1,500.0,3834759,3834787,218919,28,34,10,True,True,0.3511277777777778,-0.996973
4464,3615880,7607,32,0.625132,54,3648159,-1,16000.0,3976659,3984266,360779,7607,32,10,True,True,3157.9364888888886,-0.6193919504588078
4465,3615923,14759,32,0.059775,54,3648159,-1,16000.0,5856483,5871242,2240560,14759,4,7,True,True,9563.263155555554,-0.0514580762672542
4466,3615992,10,32,0.644575,54,3648159,-1,16000.0,3662259,3662269,46267,10,39,6,True,True,4.524444444444445,-0.644575
4467,3627860,12820,256,0.701328,54,3648159,-1,128000.0,4781734,4794554,1153874,12820,24,3,True,True,47591.731199999995,-0.6977542727260915
4468,3628129,6,4,0.791466,54,3648159,-1,2000.0,5657105,5657111,2028976,6,12,1,True,True,0.2675,-0.791466
4469,3628218,19,32,0.125827,54,3648159,-1,16000.0,3667659,3667678,39441,19,41,8,True,True,7.525688888888889,-0.125827
4470,3628580,26,4,0.232675,54,3648159,-1,2000.0,5394261,5394287,1765681,26,17,2,True,True,1.4564333333333332,-0.232675
4471,3628688,27,16,0.981676,54,3648159,-1,8000.0,5525363,5525390,1896675,27,15,11,True,True,4.6175999999999995,-0.981676
4472,3628874,34,4,0.788562,54,3648159,-1,2000.0,4775467,4775501,1146593,34,28,6,True,True,1.6582555555555556,-0.788562
4473,3628952,22,8,0.756698,54,3648159,-1,4000.0,5838987,5839009,2210035,22,6,7,True,True,2.9846666666666666,-0.756698
4474,3628991,27,1,0.805525,54,3648159,-1,500.0,3992859,3992886,363868,27,39,9,True,True,0.34957499999999997,-0.805525
4475,3641283,24,10,0.438719,54,3648159,-1,5000.0,5239361,5239385,1598078,24,24,8,True,True,2.1973333333333334,-0.438719
4476,3641363,6696,4,0.192965,54,3648159,-1,2000.0,4534967,4541663,893604,6696,34,0,True,True,330.5082888888889,-0.1885451609592866
4477,3643034,67,1,0.68925,54,3648159,-1,500.0,4578167,4578234,935133,67,34,11,True,True,0.36766249999999995,-0.68925
4478,3643821,17,8,0.358167,54,3648159,-1,4000.0,5153158,5153175,1509337,17,25,11,True,True,2.070788888888889,-0.358167
4479,3659990,2,4,0.134732,63,3661159,-1,2000.0,4991354,4991356,1331364,2,30,7,True,True,0.10026666666666666,-0.134732
4480,3660044,204,25,0.898663,63,3661159,-1,12500.0,5684269,5684473,2024225,204,13,1,True,True,57.30538194444444,-0.8885771024660781
4481,3660260,7004,128,0.485302,63,3661159,-1,64000.0,5691469,5698473,2031209,7004,13,2,True,True,10815.416355555555,-0.48428587614780993
4482,3660679,5,16,0.4375,63,3661159,-1,8000.0,4396860,4396865,736181,5,42,11,True,True,1.2301111111111112,-0.4375
4483,3660746,5,1,0.294715,63,3661159,-1,500.0,4042559,4042564,381813,5,47,11,True,True,0.07326388888888889,-0.294715
4484,3660784,140,34,0.697038,63,3661159,-1,17000.0,4314040,4314180,653256,140,44,7,True,True,49.781666666666666,-0.697038
4485,3660860,9450,32,0.189776,63,3661159,-1,16000.0,5198558,5208008,1537698,9450,27,7,True,True,3082.5872000000004,-0.18843527130351875
4486,3661028,773,1,0.186627,63,3661159,-1,500.0,3926559,3927332,265531,773,53,8,True,True,9.658205555555556,-0.186627
4487,3661037,3,2,0.347665,63,3661159,-1,1000.0,5210858,5210861,1549821,3,27,0,True,True,0.06453333333333333,-0.347665
4488,3661057,9,16,0.732402,63,3661159,-1,8000.0,5870598,5870607,2209541,9,4,7,True,True,2.6378,-0.732402
4489,3661097,2714,1,0.275324,63,3661159,-1,500.0,4932954,4935668,1271857,2714,36,12,True,True,38.44061388888888,-0.2743274024466309
4490,3661187,11,16,0.83135,72,3662259,-1,8000.0,5868387,5868398,2207200,11,5,9,True,True,3.223977777777778,-0.83135
4491,3661202,4,6,0.914474,72,3662259,-1,3000.0,3686759,3686763,25557,4,61,9,True,True,0.3693333333333333,-0.914474
4492,3661241,8,1,0.55452,72,3662259,-1,500.0,3699759,3699767,38518,8,60,7,True,True,0.1255111111111111,-0.55452
4493,3661274,20842,1,0.068877,72,3662259,-1,500.0,5096154,5116996,1434880,20842,34,11,True,True,243.9499583333333,-0.0666244694099174
4494,3661337,35594,16,0.155025,72,3662259,-1,8000.0,5101958,5137552,1440621,35594,34,2,True,True,7707.8100444444435,-0.15112143104991227
4495,3661440,101,8,0.295673,72,3662259,-1,4000.0,5551375,5551476,1889935,101,19,1,True,True,5.769344444444444,-0.295673
4496,3661501,63,1,0.263349,72,3662259,-1,500.0,4335640,4335703,674139,63,52,0,True,True,0.41842500000000005,-0.263349
4497,3662111,8148,64,0.367113,72,3662259,-1,32000.0,5479963,5488111,1817852,8148,22,10,True,True,7722.448177777778,-0.36220395526639854
4498,3662159,5579,4,0.00072,72,3662259,-1,2000.0,3710559,3716138,48400,5579,65,9,True,True,262.10505555555557,-0.0006451627798479293
4499,3662220,11570,1,0.638026,72,3662259,-1,500.0,6045240,6056810,2383020,11570,2,0,True,True,99.4168611111111,-0.629552128824561
4500,3663788,609,1,0.379044,100,3667659,-1,500.0,6045240,6045849,2381452,609,3,2,True,True,5.525829166666666,-0.379044
4501,3663875,76,8,0.185534,100,3667659,-1,4000.0,5782387,5782463,2118512,76,13,0,True,True,11.362844444444445,-0.185534
4502,3663967,14665,10,0.01872,100,3667659,-1,5000.0,3668759,3683424,4792,14665,73,6,True,True,2456.139597222222,-0.017748110147566325
4503,3664153,27,2,0.856829,100,3667659,-1,1000.0,5716369,5716396,2052216,27,17,6,True,True,0.6267,-0.856829
4504,3664169,5448,2,0.776017,100,3667659,-1,1000.0,4350457,4355905,686288,5448,56,5,True,True,108.99172222222222,-0.7735074440340898
4505,3664201,8450,4,0.238787,100,3667659,-1,2000.0,4772167,4780617,1107966,8450,48,12,True,True,421.28728888888895,-0.23804823525224134
4506,3664343,84,16,0.721004,100,3667659,-1,8000.0,5023754,5023838,1359411,84,43,9,True,True,14.502133333333333,-0.721004
4507,3664361,91,1,0.658289,100,3667659,-1,500.0,3955059,3955150,290698,91,68,10,True,True,1.2908097222222221,-0.658289
4508,3664393,22,2,0.538957,100,3667659,-1,1000.0,5210858,5210880,1546465,22,35,0,True,True,0.47324444444444447,-0.538957
4509,3664433,6,13,0.387491,100,3667659,-1,6500.0,4685767,4685773,1021334,6,51,0,True,True,0.6261666666666666,-0.387491
4510,3664610,111,4,0.52407,100,3667659,-1,2000.0,5204358,5204469,1539748,111,37,7,True,True,4.533116666666667,-0.52407
4511,3664644,4,32,0.497549,100,3667659,-1,16000.0,5771457,5771461,2106813,4,14,10,True,True,2.5100444444444445,-0.497549
4512,3664668,188,32,0.551468,100,3667659,-1,16000.0,4684667,4684855,1019999,188,54,7,True,True,48.29511111111111,-0.551468
4513,3664712,4,8,0.613039,100,3667659,-1,4000.0,5857583,5857587,2192871,4,8,6,True,True,0.7272000000000001,-0.613039
4514,3664784,6124,1,0.3226,100,3667659,-1,500.0,4199267,4205391,534483,6124,70,10,True,True,68.39290277777778,-0.31988950481327716
4515,3664816,16150,121,0.640904,100,3667659,-1,60500.0,5773687,5789837,2108871,16150,15,1,True,True,37577.472625,-0.6319472530812963
4516,3665011,232,32,0.110464,100,3667659,-1,16000.0,6037808,6038040,2372797,232,5,2,True,True,65.55804444444445,-0.110464
4517,3665100,33,4,0.523201,100,3667659,-1,2000.0,5109958,5109991,1444858,33,44,7,True,True,1.5143333333333333,-0.523201
4518,3665246,165,101,0.06668,100,3667659,-1,50500.0,4772167,4772332,1106921,165,56,0,True,True,190.09672916666665,-0.06668
4519,3665281,7,64,0.835193,100,3667659,-1,32000.0,4780167,4780174,1114886,7,55,0,True,True,5.910488888888889,-0.835193
4520,3665449,6317,8,0.129774,100,3667659,-1,4000.0,4286728,4293045,621279,6317,75,6,True,True,386.91402222222223,-0.11157626639588272
4521,3665460,328,4,0.873493,100,3667659,-1,2000.0,4820554,4820882,1155094,328,54,10,True,True,13.896266666666667,-0.873493
4522,3665924,9014,74,0.202079,100,3667659,-1,37000.0,5857587,5866601,2191663,9014,9,1,True,True,13363.338305555555,-0.20005565734598654
4523,3665959,15066,4,0.48537,100,3667659,-1,2000.0,5870598,5885664,2204639,15066,7,0,True,True,964.0473,-0.4589826491447087
4524,3665973,7608,3,0.098754,100,3667659,-1,1500.0,5050754,5058362,1384781,7608,51,10,True,True,372.53364166666665,-0.09431855262855642
4525,3666177,10056,113,0.571012,100,3667659,-1,56500.0,3809559,3819615,143382,10056,90,1,True,True,12064.946908333333,-0.5509474472198675
4526,3666436,7,1,0.8363,100,3667659,-1,500.0,4483260,4483267,816824,7,72,12,True,True,0.12026388888888889,-0.8363
4527,3667058,8,8,0.657921,100,3667659,-1,4000.0,5215561,5215569,1548503,8,41,4,True,True,0.8228444444444444,-0.657921
4528,3667074,37,8,0.525821,100,3667659,-1,4000.0,4346857,4346894,679783,37,76,2,True,True,2.285366666666667,-0.525821
4529,3668186,12,8,0.701314,103,3668759,-1,4000.0,5551363,5551375,1883177,12,30,7,True,True,0.6854666666666667,-0.701314
4530,3668196,39839,1,0.255939,103,3668759,-1,500.0,5644430,5684269,1976234,39839,29,3,True,True,461.5280986111111,-0.25585256069977547
4531,3668426,38,4,0.366354,103,3668759,-1,2000.0,5640830,5640868,1972404,38,30,0,True,True,1.428588888888889,-0.366354
4532,3668615,13,64,0.605954,103,3668759,-1,32000.0,5390661,5390674,1722046,13,39,7,True,True,15.952444444444446,-0.605954
4533,3668830,23991,4,0.070874,117,3672359,-1,2000.0,4261828,4285819,592998,23991,87,11,True,True,714.6626388888889,-0.06331193225570872
4534,3668847,12081,256,0.930211,117,3672359,-1,128000.0,5601749,5613830,1932902,12081,31,1,True,True,22408.83448888889,-0.8983221606604793
4535,3668865,5,1,0.208738,117,3672359,-1,500.0,4346857,4346862,677992,5,81,0,True,True,0.03860416666666667,-0.208738
4536,3669374,4541,184,0.491406,117,3672359,-1,92000.0,5624630,5629171,1955256,4541,31,9,True,True,5877.73918888889,-0.4873693895051321
4537,3669407,7819,4,0.889767,117,3672359,-1,2000.0,4343257,4351076,673850,7819,84,6,True,True,245.73898333333332,-0.8564163968179376
4538,3669434,2,4,0.079957,117,3672359,-1,2000.0,4531860,4531862,862426,2,78,8,True,True,0.1034888888888889,-0.079957
4539,3669546,5723,2,0.80102,117,3672359,-1,1000.0,3927659,3933382,258113,5723,100,6,True,True,169.1306638888889,-0.8008042760634821
4540,3669588,33704,64,0.0607,117,3672359,-1,32000.0,4798954,4832658,1129366,33704,65,7,True,True,22726.33297777778,-0.06057180314095699
4541,3669597,10,1,0.55802,117,3672359,-1,500.0,3675959,3675969,6362,10,110,2,True,True,0.1697638888888889,-0.55802
4542,3670045,612,43,0.938244,117,3672359,-1,21500.0,4670786,4671398,1000741,612,74,9,True,True,199.7092,-0.938244
4543,3670118,3,16,0.415953,117,3672359,-1,8000.0,5233961,5233964,1563843,3,47,7,True,True,0.5196000000000001,-0.415953
4544,3670126,12,8,0.369069,117,3672359,-1,4000.0,4776567,4776579,1106441,12,69,6,True,True,1.1705333333333334,-0.369069
4545,3670158,26577,128,0.708434,117,3672359,-1,64000.0,5739069,5765646,2068911,26577,23,10,True,True,71124.56426666667,-0.69951108778936
4546,3670351,9,2,0.823643,117,3672359,-1,1000.0,3796959,3796968,126608,9,110,12,True,True,0.2311,-0.823643
4547,3670440,3747,1,0.265816,117,3672359,-1,500.0,5781287,5785034,2110847,3747,18,7,True,True,70.47546527777777,-0.2491745342200968
4548,3672786,28250,128,0.040653,139,3675959,-1,64000.0,6023408,6051658,2350622,28250,6,0,True,True,31602.7232,-0.04064787069218212
4549,3672822,13457,128,0.070388,139,3675959,-1,64000.0,5557175,5570632,1884353,13457,36,2,True,True,20440.96764444444,-0.0661206037187877
4550,3673201,21313,16,0.303905,139,3675959,-1,8000.0,3802359,3823672,129158,21313,113,8,True,True,3784.3418666666666,-0.29599591723784735
4551,3673565,89,1,0.944603,139,3675959,-1,500.0,4335640,4335729,662075,89,96,10,True,True,0.5911083333333333,-0.944603
4552,3673625,16711,4,0.960587,139,3675959,-1,2000.0,5678705,5695416,2005080,16711,30,10,True,True,785.3810111111111,-0.9414004053720227
4553,3673741,75,2,0.097119,139,3675959,-1,1000.0,5657030,5657105,1983289,75,32,0,True,True,1.671875,-0.097119
4554,3673762,201,1,0.725172,139,3675959,-1,500.0,5839009,5839210,2165247,201,15,1,True,True,3.419208333333333,-0.6846933175473234
4555,3673920,5,1,0.531661,139,3675959,-1,500.0,5421261,5421266,1747341,5,47,8,True,True,0.06319444444444444,-0.531661
4556,3674946,25,1,0.18946,139,3675959,-1,500.0,6023408,6023433,2348462,25,7,11,True,True,0.20878472222222222,-0.18946
4557,3674980,12598,32,0.526192,139,3675959,-1,16000.0,4264028,4276626,589048,12598,106,7,True,True,3183.7962666666667,-0.4906546838587578
4558,3675045,21116,45,0.248763,139,3675959,-1,22500.0,3921159,3942275,246114,21116,118,12,True,True,13311.530125,-0.24371190304718984
4559,3675284,288,3,0.625325,139,3675959,-1,1500.0,5742669,5742957,2067385,288,26,0,True,True,17.5452,-0.625325
4560,3675406,1649,5,0.178898,139,3675959,-1,2500.0,5746557,5748206,2071151,1649,25,1,True,True,168.99959722222223,-0.178898
4561,3675425,101,1,0.749194,139,3675959,-1,500.0,5788187,5788288,2112762,101,19,7,True,True,1.8381999999999998,-0.749194
4562,3675572,12,2,0.415185,139,3675959,-1,1000.0,3813159,3813171,137587,12,123,3,True,True,0.25620000000000004,-0.415185
4563,3675590,8667,16,0.105514,139,3675959,-1,8000.0,3931259,3939926,255669,8667,118,2,True,True,2003.8948666666668,-0.1054746642375715
4564,3675622,29,12,0.638624,139,3675959,-1,6000.0,4989154,4989183,1313532,29,76,0,True,True,3.8599,-0.638624
4565,3675637,7754,128,0.357963,139,3675959,-1,64000.0,5211961,5219715,1536324,7754,61,6,True,True,12753.052622222222,-0.355304970573112
4566,3675654,189,32,0.458721,139,3675959,-1,16000.0,5202158,5202347,1526504,189,65,1,True,True,61.748400000000004,-0.458721
4567,3675688,10761,1,0.665242,139,3675959,-1,500.0,5415861,5426622,1740173,10761,52,10,True,True,130.96032916666667,-0.655900228251071
4568,3675741,8744,4,0.882824,139,3675959,-1,2000.0,4201467,4210211,525726,8744,115,7,True,True,384.20950555555555,-0.8430189154963044
4569,3675872,9308,1,0.166809,139,3675959,-1,500.0,4846554,4855862,1170682,9308,81,10,True,True,67.24883055555554,-0.16437219583475315
4570,3675903,11829,72,0.180397,139,3675959,-1,36000.0,6034208,6046037,2358305,11829,6,9,True,True,7506.5561,-0.1782389418086717
4571,3676012,238,1,0.401557,176,3686759,-1,500.0,5451163,5451401,1775151,238,51,1,True,True,2.750552777777777,-0.401557
4572,3676024,33,8,0.337513,176,3686759,-1,4000.0,5876398,5876431,2200374,33,10,2,True,True,4.7806,-0.337513
4573,3676082,23,5,0.158176,176,3686759,-1,2500.0,5839210,5839233,2163128,23,18,1,True,True,2.071916666666667,-0.158176
4574,3676130,45,1,0.998434,176,3686759,-1,500.0,4204228,4204273,528098,45,120,2,True,True,0.51975,-0.998434
4575,3676133,2356,2,0.443012,176,3686759,-1,1000.0,4207828,4210184,531695,2356,120,4,True,True,54.66980000000001,-0.4227983283507746
4576,3676184,230,8,0.352324,176,3686759,-1,4000.0,4203667,4203897,527483,230,122,0,True,True,21.252,-0.352324
4577,3677867,53,45,0.315155,176,3686759,-1,22500.0,4798954,4799007,1121087,53,87,0,True,True,26.824625,-0.315155
4578,3677893,32,1,0.991463,176,3686759,-1,500.0,4659986,4660018,982093,32,99,11,True,True,0.21573333333333333,-0.991463
4579,3677973,1043,1,0.324654,176,3686759,-1,500.0,5653430,5654473,1975457,1043,41,3,True,True,12.576841666666665,-0.324654
4580,3677995,13208,38,0.37172,176,3686759,-1,19000.0,5687869,5701077,2009874,13208,37,2,True,True,5986.939688888889,-0.3716993960443937
4581,3678079,1889,4,0.764184,176,3686759,-1,2000.0,5551363,5553252,1873284,1889,50,0,True,True,53.95193888888888,-0.764184
4582,3678090,14913,128,0.430588,176,3686759,-1,64000.0,5635430,5650343,1957340,14913,46,9,True,True,20664.35057777778,-0.4142765616940199
4583,3678108,13165,16,0.725868,176,3686759,-1,8000.0,3805959,3819124,127851,13165,145,1,True,True,2283.6576666666665,-0.7215778022980086
4584,3678125,7,4,0.608413,176,3686759,-1,2000.0,3982059,3982066,303934,7,134,8,True,True,0.3720888888888889,-0.608413
4585,3678176,6,37,0.563145,176,3686759,-1,18500.0,5387361,5387367,1709185,6,65,11,True,True,6.277050000000001,-0.563145
4586,3678377,8869,256,0.213928,176,3686759,-1,128000.0,4673598,4682467,995221,8869,103,7,True,True,17971.46808888889,-0.21131799165405438
4587,3678440,12027,210,0.765708,176,3686759,-1,105000.0,5704469,5716496,2026029,12027,36,7,True,True,31992.304750000003,-0.7601162674010071
4588,3679211,14,64,0.926147,176,3686759,-1,32000.0,4309640,4309654,630429,14,124,1,True,True,9.518755555555554,-0.926147
4589,3679280,44,128,0.254089,176,3686759,-1,64000.0,5549163,5549207,1869883,44,54,9,True,True,40.44088888888889,-0.254089
4590,3679312,4,1,0.961652,176,3686759,-1,500.0,4616786,4616790,937474,4,108,0,True,True,0.039711111111111114,-0.961652
4591,3679372,7906,32,0.4475,176,3686759,-1,16000.0,5333361,5341267,1653989,7906,69,7,True,True,3262.166311111111,-0.44421740707776586
4592,3680172,1984,32,0.397091,176,3686759,-1,16000.0,4534967,4536951,854795,1984,114,6,True,True,801.1905333333334,-0.394446425047312
4593,3680281,13,14,0.726313,176,3686759,-1,7000.0,6041640,6041653,2361359,13,4,2,True,True,1.6374944444444444,-0.726313
4594,3680922,11742,86,0.982956,176,3686759,-1,43000.0,4483260,4495002,802338,11742,119,0,True,True,15767.017116666666,-0.9599904835784258
4595,3681024,1300,8,0.595763,176,3686759,-1,4000.0,4134359,4135659,453335,1300,142,12,True,True,109.73444444444443,-0.595763
4596,3681070,19,1,0.517609,176,3686759,-1,500.0,4218628,4218647,537558,19,136,9,True,True,0.2349402777777778,-0.517609
4597,3681095,23,32,0.993412,176,3686759,-1,16000.0,5715269,5715292,2034174,23,36,3,True,True,8.54168888888889,-0.993412
4598,3681213,5,32,0.301842,176,3686759,-1,16000.0,4047959,4047964,366746,5,145,8,True,True,2.374888888888889,-0.301842
4599,3681391,13,8,0.300334,176,3686759,-1,4000.0,5853183,5853196,2171792,13,19,1,True,True,3.1405111111111106,-0.300334
4600,3681904,3459,4,0.221887,176,3686759,-1,2000.0,4794554,4798013,1112650,3459,100,1,True,True,177.4238222222222,-0.2093653957736906
4601,3682096,13849,4,0.85572,176,3686759,-1,2000.0,4986954,5000803,1304858,13849,95,9,True,True,627.3144444444443,-0.8486068789988817
4602,3682167,19827,32,0.021701,176,3686759,-1,16000.0,5657030,5676857,1974863,19827,46,4,True,True,6963.525644444444,-0.02146929233859272
4603,3682283,6,1,0.82194,176,3686759,-1,500.0,4353660,4353666,671377,6,127,3,True,True,0.064,-0.82194
4604,3682525,22,32,0.689719,176,3686759,-1,16000.0,4822754,4822776,1140229,22,99,7,True,True,7.456533333333335,-0.689719
4605,3682574,13,1,0.275957,176,3686759,-1,500.0,5868398,5868411,2185824,13,14,1,True,True,0.23813472222222218,-0.275957
4606,3682589,3,4,0.553663,176,3686759,-1,2000.0,4341057,4341060,658468,3,135,1,True,True,0.08365,-0.553663
4607,3683826,2914,1,0.556323,176,3686759,-1,500.0,4203667,4206581,519841,2914,148,0,True,True,30.668577777777777,-0.5069313151635979
4608,3685104,2,1,0.925922,176,3686759,-1,500.0,5451161,5451163,1766057,2,65,2,True,True,0.02311388888888889,-0.925922
4609,3688341,561,1,0.154715,196,3697559,-1,500.0,4203667,4204228,515326,561,151,7,True,True,6.47955,-0.154715
4610,3688365,19295,64,0.037736,196,3697559,-1,32000.0,4798954,4818249,1110589,19295,103,0,True,True,13052.858577777777,-0.03748296584564966
4611,3688398,12603,8,0.355656,196,3697559,-1,4000.0,4341057,4353660,652659,12603,137,0,True,True,815.3213,-0.3279847294738022
4612,3688772,56,1,0.138408,196,3697559,-1,500.0,5771457,5771513,2082685,56,30,0,True,True,1.0981444444444444,-0.138408
4613,3688871,53,8,0.367083,196,3697559,-1,4000.0,3699759,3699812,10888,53,178,0,True,True,6.652088888888888,-0.367083
4614,3688977,11,8,0.582156,196,3697559,-1,4000.0,5779087,5779098,2090110,11,29,8,True,True,1.7706333333333335,-0.582156
4615,3689104,7367,16,0.232994,196,3697559,-1,8000.0,4774367,4781734,1085263,7367,113,7,True,True,1530.934511111111,-0.21829511844337318
4616,3689453,19,1,0.811074,196,3697559,-1,500.0,5231761,5231780,1542308,19,81,9,True,True,0.205675,-0.811074
4617,3690701,14513,16,0.091905,196,3697559,-1,8000.0,5553575,5568088,1862874,14513,58,7,True,True,2458.3222444444446,-0.08768649222486888
4618,3690792,149,32,0.399798,196,3697559,-1,16000.0,4287828,4287977,597036,149,149,0,True,True,34.468666666666664,-0.399798
4619,3690846,16952,256,0.917882,196,3697559,-1,128000.0,4578234,4595186,887388,16952,127,0,True,True,26345.774222222222,-0.826157945923087
4620,3690876,21615,64,0.734266,196,3697559,-1,32000.0,5446461,5468076,1755585,21615,70,10,True,True,17357.427733333334,-0.7278498411791278
4621,3690903,30,8,0.723581,196,3697559,-1,4000.0,5773657,5773687,2082754,30,31,7,True,True,4.706333333333333,-0.723581
4622,3691207,140,16,0.792904,196,3697559,-1,8000.0,5331161,5331301,1639954,140,81,8,True,True,30.333333333333332,-0.792904
4623,3691710,20607,32,0.172902,196,3697559,-1,16000.0,5209758,5230365,1518048,20607,90,8,True,True,7125.283466666666,-0.17158692344223953
4624,3691896,6844,35,0.825705,196,3697559,-1,17500.0,4976154,4982998,1284258,6844,107,11,True,True,2752.034833333333,-0.8013272138423141
4625,3692532,17,8,0.689595,196,3697559,-1,4000.0,4341040,4341057,648508,17,150,8,True,True,0.9480333333333333,-0.689595
4626,3692654,1207,32,0.576232,196,3697559,-1,16000.0,5600375,5601582,1907721,1207,58,11,True,True,320.36462222222224,-0.576232
4627,3692800,10,1,0.907656,196,3697559,-1,500.0,5782387,5782397,2089587,10,28,6,True,True,0.1868888888888889,-0.907656
4628,3692903,3,12,0.595231,196,3697559,-1,6000.0,4311840,4311843,618937,3,156,7,True,True,0.38244999999999996,-0.595231
4629,3693006,11,21,0.300393,196,3697559,-1,10500.0,5530763,5530774,1837757,11,67,8,True,True,2.1492625,-0.300393
4630,3699045,8653,32,0.730789,202,3699759,-1,16000.0,5684105,5692758,1985060,8653,48,8,True,True,3248.1340888888885,-0.7164428054747639
4631,3699066,22116,32,0.576284,202,3699759,-1,16000.0,6051040,6073156,2351974,22116,0,4,True,True,5366.542222222222,-0.5541160184279682
4632,3699271,21,1,0.078477,202,3699759,-1,500.0,5613830,5613851,1914559,21,60,7,True,True,0.15715,-0.078477
4633,3699282,111,18,0.055923,202,3699759,-1,9000.0,5711669,5711780,2012387,111,44,2,True,True,25.313550000000003,-0.055923
4634,3699352,13,4,0.770902,202,3699759,-1,2000.0,4309627,4309640,610275,13,163,7,True,True,0.5524277777777777,-0.770902
4635,3699478,11,4,0.34793,202,3699759,-1,2000.0,5640830,5640841,1941352,11,59,8,True,True,0.4135388888888889,-0.34793
4636,3699527,13020,12,0.817142,202,3699759,-1,6000.0,5210861,5223881,1511334,13020,96,1,True,True,1898.9082166666667,-0.8138761444801407
4637,3700163,6,11,0.416522,204,3710559,-1,5500.0,5098358,5098364,1398195,6,108,1,True,True,0.7602833333333333,-0.416522
4638,3701086,44,32,0.867831,204,3710559,-1,16000.0,4671398,4671442,970312,44,137,1,True,True,10.685155555555557,-0.867831
4639,3701224,130,1,0.869787,204,3710559,-1,500.0,4353660,4353790,652436,130,153,0,True,True,1.3866666666666665,-0.869787
4640,3701346,187,32,0.226718,204,3710559,-1,16000.0,5717469,5717656,2016123,187,42,6,True,True,76.83622222222223,-0.226718
4641,3712058,24,36,0.652779,238,3796959,-1,18000.0,4685767,4685791,973709,24,135,6,True,True,6.936,-0.652779
4642,3712151,13959,64,0.602302,238,3796959,-1,32000.0,5657030,5670989,1944879,13959,54,0,True,True,9501.965066666666,-0.5854689400054287
4643,3714914,7407,9,0.011434,238,3796959,-1,4500.0,4526460,4533867,811546,7407,152,0,True,True,860.398875,-0.011351918162239771
4644,3715223,18,16,0.777419,238,3796959,-1,8000.0,4285628,4285646,570405,18,177,10,True,True,2.9044,-0.777419
4645,3715324,18,16,0.382487,238,3796959,-1,8000.0,5836787,5836805,2121463,18,25,8,True,True,4.8839999999999995,-0.382487
4646,3715542,5,8,0.304783,238,3796959,-1,4000.0,5538363,5538368,1822821,5,74,8,True,True,0.25672222222222224,-0.304783
4647,3720730,18,16,0.041182,238,3796959,-1,8000.0,4989154,4989172,1268424,18,120,7,True,True,3.1944,-0.041182
4648,3720939,56,4,0.53993,238,3796959,-1,2000.0,5980208,5980264,2259269,56,11,12,True,True,2.096888888888889,-0.53993
4649,3721655,12,1,0.14958,238,3796959,-1,500.0,5220961,5220973,1499306,12,99,8,True,True,0.13526666666666667,-0.14958
4650,3723113,108,2,0.502402,238,3796959,-1,1000.0,4177559,4177667,454446,108,194,11,True,True,3.1104000000000003,-0.502402
4651,3723509,38,1,0.220797,238,3796959,-1,500.0,4796754,4796792,1073245,38,132,7,True,True,0.4805944444444445,-0.220797
4652,3723658,819,1,0.05052,238,3796959,-1,500.0,3955059,3955878,231401,819,202,0,True,True,11.6172875,-0.05052
4653,3723949,12732,20,0.731579,238,3796959,-1,10000.0,5702269,5715001,1978320,12732,50,9,True,True,3232.4801666666667,-0.7314752464166245
4654,3724018,394,4,0.392883,238,3796959,-1,2000.0,5482163,5482557,1758145,394,80,7,True,True,23.600599999999996,-0.392883
4655,3733006,4,16,0.445616,238,3796959,-1,8000.0,5098354,5098358,1365348,4,117,7,True,True,0.7372444444444444,-0.445616
4656,3733414,122,4,0.595132,238,3796959,-1,2000.0,5653430,5653552,1920016,122,60,0,True,True,5.8844666666666665,-0.595132
4657,3736777,71,3,0.504729,238,3796959,-1,1500.0,5678705,5678776,1941928,71,55,0,True,True,2.606291666666666,-0.504729
4658,3736867,291,2,0.222086,238,3796959,-1,1000.0,3999359,3999650,262492,291,204,6,True,True,8.636472222222222,-0.18431198210837582
4659,3737473,40,1,0.289783,238,3796959,-1,500.0,5454763,5454803,1717290,40,85,3,True,True,0.4592222222222222,-0.289783
4660,3737586,14,4,0.394322,238,3796959,-1,2000.0,5052954,5052968,1315368,14,122,7,True,True,0.9421222222222222,-0.394322
4661,3737606,16503,3,0.132189,238,3796959,-1,1500.0,5657030,5673533,1919424,16503,59,0,True,True,530.3424125,-0.13096985288674018
4662,3737796,274,12,0.082545,238,3796959,-1,6000.0,5601475,5601749,1863679,274,72,6,True,True,23.26155,-0.0704061035959783
4663,3740770,18193,1,0.571441,238,3796959,-1,500.0,3998259,4016452,257489,18193,209,8,True,True,340.42269722222227,-0.5633251068232911
4664,3740870,2,4,0.049311,238,3796959,-1,2000.0,5601475,5601477,1860605,2,72,0,True,True,0.06635555555555556,-0.049311
4665,3740946,4650,1,0.399191,238,3796959,-1,500.0,5748757,5753407,2007811,4650,39,7,True,True,95.05826666666667,-0.3852736508832774
4666,3741105,22,1,0.085079,238,3796959,-1,500.0,5210858,5210880,1469753,22,112,0,True,True,0.23662222222222223,-0.085079
4667,3741132,20,4,0.501823,238,3796959,-1,2000.0,4824954,4824974,1083822,20,139,7,True,True,0.9943333333333333,-0.501823
4668,3741765,21010,1,0.773825,238,3796959,-1,500.0,5872798,5893808,2131033,21010,14,7,True,True,312.93681666666674,-0.7565939617727249
4669,3741794,1379,32,0.130375,238,3796959,-1,16000.0,5012954,5014333,1271160,1379,132,10,True,True,420.50306666666665,-0.130375
4670,3741818,8052,16,0.134871,238,3796959,-1,8000.0,5210858,5218910,1469040,8052,116,6,True,True,1611.7292888888887,-0.1311593130543824
4671,3742130,11773,256,0.559296,238,3796959,-1,128000.0,5841410,5853183,2099280,11773,24,7,True,True,70706.1568,-0.5491961854992201
4672,3742226,27737,2,0.487861,238,3796959,-1,1000.0,5424861,5452598,1682635,27737,96,2,True,True,600.3071527777778,-0.47266165579158936
4673,3744910,24,1,0.652248,238,3796959,-1,500.0,4780167,4780191,1035257,24,154,2,True,True,0.3166333333333333,-0.652248
4674,3745166,37,4,0.196099,238,3796959,-1,2000.0,6045240,6045277,2300074,37,4,0,True,True,1.3428944444444444,-0.196099
4675,3745225,5,16,0.615997,238,3796959,-1,8000.0,5196358,5196363,1451133,5,124,11,True,True,0.7327777777777779,-0.615997
8402,6658550,8,1,0.126368,1,6658550,-1,500.0,6659967,6659658,1417,8,0,6,True,True,0.13603333333333334,-0.126368
8403,6659967,7085,8,0.378801,1,6659967,-1,4000.0,6661077,6668152,1110,7085,0,6,True,True,1879.9062666666666,-0.30585453202251944
8404,6661077,2266,32,0.735422,1,6661077,-1,16000.0,6666477,6668743,5400,2266,0,8,True,True,3040.5407999999998,-0.707617635256299
8405,6662693,92,1,0.052865,4,6666477,-1,500.0,6709677,6709769,46984,92,0,11,True,True,3.474533333333334,-0.052865
8406,6663607,6,2,0.725419,4,6666477,-1,1000.0,7977258,7977264,1313651,6,0,2,True,True,0.19278333333333336,-0.725419
8407,6663928,2959,64,0.9745,4,6666477,-1,32000.0,7430865,7433824,766937,2959,1,8,True,True,2452.682222222222,-0.9745
8408,6664109,6,4,0.707502,4,6666477,-1,2000.0,7389144,7389150,725035,6,2,0,True,True,0.3143666666666667,-0.707502
8409,6667408,18,2,0.249112,121,6709677,-1,1000.0,9009996,9010014,2342588,18,0,6,True,True,0.29755,-0.249112
8410,6667915,35,1,0.608703,121,6709677,-1,500.0,7190369,7190404,522454,35,4,12,True,True,0.40599999999999997,-0.608703
8411,6669820,3,1,0.706787,121,6709677,-1,500.0,7466824,7466827,797004,3,2,8,True,True,0.0357875,-0.706787
8412,6670131,6799,2,0.183105,121,6709677,-1,1000.0,7299914,7306713,629783,6799,5,1,True,True,186.50020277777776,-0.16654689765574252
8413,6670278,21978,2,0.986246,121,6709677,-1,1000.0,9061096,9083074,2390818,21978,0,0,True,True,320.66015,-0.8505704481827432
8414,6670422,210,2,0.798469,121,6709677,-1,1000.0,8388809,8389019,1718387,210,2,0,True,True,1.8538333333333334,-0.798469
8415,6670615,22390,152,0.502229,121,6709677,-1,76000.0,7092769,7115159,422154,22390,9,10,True,True,21066.674966666666,-0.45916468679241085
8416,6670823,31,18,0.275823,121,6709677,-1,9000.0,6885969,6886000,215146,31,10,7,True,True,4.4051,-0.275823
8417,6671262,315,2,0.427765,121,6709677,-1,1000.0,9217396,9217711,2546134,315,0,6,True,True,4.662875,-0.427765
8418,6671303,2,60,0.941677,121,6709677,-1,30000.0,8199962,8199964,1528659,2,4,1,True,True,0.6359999999999999,-0.941677
8419,6671362,5,8,0.881388,121,6709677,-1,4000.0,7196969,7196974,525607,5,10,7,True,True,0.7165555555555555,-0.881388
8420,6671435,8,2,0.814023,121,6709677,-1,1000.0,8170681,8170689,1499246,8,5,8,True,True,0.2007111111111111,-0.814023
8421,6672239,38,16,0.305187,121,6709677,-1,8000.0,7196969,7197007,524730,38,11,0,True,True,10.891644444444443,-0.305187
8422,6672376,65655,1,0.857921,121,6709677,-1,500.0,7302114,7367769,629738,65655,10,0,True,True,858.9247250000001,-0.8134377638884234
8423,6672527,16,32,0.947455,121,6709677,-1,16000.0,8685811,8685827,2013284,16,3,2,True,True,4.447288888888889,-0.947455
8424,6672602,19,2,0.406515,121,6709677,-1,1000.0,6883769,6883788,211167,19,18,0,True,True,0.2999888888888889,-0.406515
8425,6672621,10,1,0.312737,121,6709677,-1,500.0,7447065,7447075,774444,10,9,8,True,True,0.16029166666666667,-0.312737
8426,6672835,18979,2,0.090141,121,6709677,-1,1000.0,8078858,8097837,1406023,18979,7,7,True,True,334.91260555555556,-0.08691983804607681
8427,6673123,6401,32,0.079475,121,6709677,-1,16000.0,9032596,9038997,2359473,6401,2,0,True,True,1762.7967555555556,-0.07761417601167071
8428,6673156,13820,1,0.729953,121,6709677,-1,500.0,7071169,7084989,398013,13820,20,9,True,True,114.60099722222223,-0.6832051103608043
8429,6673287,12,1,0.944867,121,6709677,-1,500.0,7272269,7272281,598982,12,16,2,True,True,0.17493333333333333,-0.944867
8430,6677934,4116,8,0.165113,121,6709677,-1,4000.0,9205496,9209612,2527562,4116,1,11,True,True,268.6693333333334,-0.14064273342489533
8431,6677950,48,8,0.057412,121,6709677,-1,4000.0,7617324,7617372,939374,48,11,9,True,True,3.4197333333333337,-0.057412
8432,6684601,37,2,0.743409,121,6709677,-1,1000.0,9245075,9245112,2560474,37,0,6,True,True,0.4792527777777778,-0.743409
8433,6684784,14,16,0.55416,121,6709677,-1,8000.0,7935612,7935626,1250828,14,12,7,True,True,0.8082666666666667,-0.55416
8434,6685046,98,8,0.492851,121,6709677,-1,4000.0,7103969,7104067,418923,98,24,7,True,True,4.818333333333333,-0.492851
8435,6685053,82,8,0.874353,121,6709677,-1,4000.0,9058896,9058978,2373843,82,4,6,True,True,5.076711111111111,-0.874353
8436,6685090,5649,32,0.962166,121,6709677,-1,16000.0,8194481,8200130,1509391,5649,10,7,True,True,902.7236444444444,-0.9478460744334769
8437,6685291,41,1,0.423984,121,6709677,-1,500.0,7691224,7691265,1005933,41,15,7,True,True,0.2114916666666667,-0.423984
8438,6685422,9165,8,0.508682,121,6709677,-1,4000.0,8192281,8201446,1506859,9165,11,10,True,True,367.2322888888889,-0.4751166276084444
8439,6685437,42,16,0.730797,121,6709677,-1,8000.0,7436265,7436307,750828,42,20,8,True,True,9.946533333333333,-0.730797
8440,6685575,14349,256,0.479656,121,6709677,-1,128000.0,7447075,7461424,761500,14349,19,1,True,True,64594.52906666667,-0.46943259178938307
8441,6685967,370,4,0.515011,121,6709677,-1,2000.0,7976492,7976862,1290525,370,15,6,True,True,23.77661111111111,-0.515011
8442,6687864,3,1,0.997954,121,6709677,-1,500.0,8448209,8448212,1760345,3,8,8,True,True,0.0350875,-0.997954
8443,6688959,12,4,0.888081,121,6709677,-1,2000.0,8784844,8784856,2095885,12,7,0,True,True,0.2484,-0.888081
8444,6688970,7565,16,0.697882,121,6709677,-1,8000.0,9068296,9075861,2379326,7565,3,3,True,True,785.7892666666667,-0.6227474870833892
8445,6688989,65,2,0.405471,121,6709677,-1,1000.0,6889269,6889334,200280,65,37,7,True,True,1.2819444444444443,-0.405471
8446,6689034,2,4,0.616287,121,6709677,-1,2000.0,6866469,6866471,177435,2,40,6,True,True,0.09662222222222222,-0.616287
8447,6689145,10104,4,0.910886,121,6709677,-1,2000.0,6919869,6929973,230724,10104,37,8,True,True,288.7413666666667,-0.9105009766466372
8448,6690630,13444,15,0.745917,121,6709677,-1,7500.0,6920969,6934413,230339,13444,37,6,True,True,1638.1639791666666,-0.6261875293323059
8449,6690784,12,2,0.71416,121,6709677,-1,1000.0,8388809,8388821,1698025,12,12,10,True,True,0.10593333333333334,-0.71416
8450,6690805,12,4,0.702592,121,6709677,-1,2000.0,8332609,8332621,1641804,12,13,0,True,True,0.6000666666666667,-0.702592
8451,6690999,162,4,0.749668,121,6709677,-1,2000.0,8076658,8076820,1385659,162,19,6,True,True,6.678,-0.749668
8452,6691121,122,1,0.244226,121,6709677,-1,500.0,8367209,8367331,1676088,122,13,0,True,True,0.5893277777777779,-0.244226
8453,6691182,1384,6,0.738983,121,6709677,-1,3000.0,6887069,6888453,195887,1384,44,6,True,True,81.88666666666667,-0.738983
8454,6691260,20,2,0.950868,121,6709677,-1,1000.0,6910869,6910889,219609,20,43,0,True,True,0.21533333333333332,-0.950868
8455,6691976,2,1,0.823363,121,6709677,-1,500.0,8448209,8448211,1756233,2,10,0,True,True,0.023391666666666665,-0.823363
8456,6692023,180,4,0.880332,121,6709677,-1,2000.0,9010996,9011176,2318973,180,7,2,True,True,5.154,-0.880332
8457,6692104,26055,32,0.528111,121,6709677,-1,16000.0,8304158,8330213,1612054,26055,17,9,True,True,4031.467911111111,-0.5192756963199093
8458,6692240,2,32,0.609194,121,6709677,-1,16000.0,7394795,7394797,702555,2,34,1,True,True,0.8961777777777777,-0.609194
8459,6693041,7498,8,0.607374,121,6709677,-1,4000.0,7032269,7039767,339228,7498,45,12,True,True,746.5153333333334,-0.5718937221210421
8460,6693060,9,9,0.964647,121,6709677,-1,4500.0,7101769,7101778,408709,9,43,0,True,True,0.48993749999999997,-0.964647
8461,6693068,7871,1,0.674522,121,6709677,-1,500.0,7606524,7614395,913456,7871,29,1,True,True,65.23634444444444,-0.5373677521205413
8462,6693225,45,2,0.881931,121,6709677,-1,1000.0,7441665,7441710,748440,45,33,8,True,True,1.1320000000000001,-0.881931
8463,6693234,13127,128,0.523516,121,6709677,-1,64000.0,6865369,6878496,172135,13127,57,12,True,True,21157.476977777776,-0.5231415877207748
8464,6693334,20781,32,0.225069,121,6709677,-1,16000.0,8652409,8673190,1959075,20781,11,6,True,True,5772.912488888889,-0.22006437469775458
8465,6693490,146,1,0.075122,121,6709677,-1,500.0,8064758,8064904,1371268,146,25,12,True,True,1.7201638888888888,-0.075122
8466,6693495,5968,2,0.839409,121,6709677,-1,1000.0,7279469,7285437,585974,5968,42,2,True,True,272.5436805555555,-0.8393376634555718
8467,6693954,8839,2,0.513684,121,6709677,-1,1000.0,7606349,7615188,912395,8839,32,7,True,True,148.90044166666667,-0.42535512498226624
8468,6694487,18,2,0.952484,121,6709677,-1,1000.0,7922612,7922630,1228125,18,29,7,True,True,0.37460000000000004,-0.952484
8469,6694554,650,1,0.422722,121,6709677,-1,500.0,7661624,7662274,967070,650,31,10,True,True,7.567986111111111,-0.422722
8470,6694558,7636,16,0.379095,121,6709677,-1,8000.0,8891896,8899532,2197338,7636,9,2,True,True,598.9510222222223,-0.3770850026638163
8471,6694656,49,1,0.373284,121,6709677,-1,500.0,8672209,8672258,1977553,49,12,9,True,True,0.41901805555555555,-0.373284
8472,6694767,7,1,0.113234,121,6709677,-1,500.0,7855196,7855203,1160429,7,32,7,True,True,0.03678472222222222,-0.11136702031267406
8473,6694773,146,3,0.914045,121,6709677,-1,1500.0,7661624,7661770,966851,146,34,0,True,True,5.099658333333333,-0.914045
8474,6694882,45,16,0.249765,121,6709677,-1,8000.0,6943669,6943714,248787,45,59,10,True,True,9.846,-0.249765
8475,6694978,6,8,0.53912,121,6709677,-1,4000.0,8291154,8291160,1596176,6,21,0,True,True,0.24880000000000002,-0.53912
8476,6695010,8038,256,0.766414,121,6709677,-1,128000.0,7640024,7648062,945014,8038,37,6,True,True,32438.227199999998,-0.7210062715633146
8477,6695053,16759,64,0.117865,121,6709677,-1,32000.0,7753596,7770355,1058543,16759,34,7,True,True,8489.755644444444,-0.10651881105704755
8478,6695148,93,4,0.299178,121,6709677,-1,2000.0,7918212,7918305,1223064,93,33,8,True,True,2.8246166666666666,-0.299178
8479,6695180,58,128,0.293545,121,6709677,-1,64000.0,7410995,7411053,715815,58,49,8,True,True,84.44800000000001,-0.293545
8480,6695199,6,1,0.213066,121,6709677,-1,500.0,6731369,6731375,36170,6,74,10,True,True,0.036041666666666666,-0.213066
8481,6695238,25,4,0.738026,121,6709677,-1,2000.0,8075558,8075583,1380320,25,28,8,True,True,1.0305555555555554,-0.738026
8482,6695298,20,64,0.568842,121,6709677,-1,32000.0,7968172,7968192,1272874,20,32,6,True,True,15.525333333333334,-0.568842
8483,6695334,12654,92,0.217463,121,6709677,-1,46000.0,8729011,8741665,2033677,12654,11,11,True,True,4990.405705555556,-0.19219710855238087
8484,6695375,8,32,0.30482,121,6709677,-1,16000.0,8246846,8246854,1551471,8,23,6,True,True,1.7589333333333332,-0.30482
8485,6695418,8,2,0.933111,121,6709677,-1,1000.0,9032596,9032604,2337178,8,7,9,True,True,0.12128888888888889,-0.933111
8486,6695567,7916,256,0.642974,121,6709677,-1,128000.0,9233859,9241775,2538292,7916,1,8,True,True,9692.624355555554,-0.5978865986449294
8487,6695643,41,8,0.825727,121,6709677,-1,4000.0,7510024,7510065,814381,41,49,11,True,True,1.8445444444444445,-0.825727
8488,6696117,662,4,0.035429,121,6709677,-1,2000.0,8293358,8294020,1597241,662,24,7,True,True,13.725466666666666,-0.035429
8489,6696123,68,1,0.463057,121,6709677,-1,500.0,8367209,8367277,1671086,68,22,0,True,True,0.3284777777777778,-0.463057
8490,6696212,17714,8,0.617749,121,6709677,-1,4000.0,9058896,9076610,2362684,17714,6,0,True,True,984.8677555555557,-0.6004118970274356
8491,6696220,9492,4,0.488266,121,6709677,-1,2000.0,8491409,8500901,1795189,9492,18,11,True,True,768.6125388888889,-0.46096994293728305
8492,6696273,189,4,0.355744,121,6709677,-1,2000.0,9061096,9061285,2364823,189,6,7,True,True,5.588516666666667,-0.33980810054809196
8493,6696284,286,16,0.61553,121,6709677,-1,8000.0,7101769,7102055,405485,286,73,2,True,True,27.67844444444444,-0.61553
8494,6696298,22865,1,0.328552,121,6709677,-1,500.0,9160096,9182961,2463798,22865,4,8,True,True,138.45539166666666,-0.3214394000067718
8495,6696472,11783,4,0.353893,121,6709677,-1,2000.0,9288275,9300058,2591803,11783,0,11,True,True,569.2101777777777,-0.3518043108474857
8496,6696604,20,4,0.005154,121,6709677,-1,2000.0,7912812,7912832,1216208,20,47,8,True,True,0.6218888888888889,-0.005154
8497,6696658,25,8,0.890196,121,6709677,-1,4000.0,8649109,8649134,1952451,25,21,9,True,True,1.2966666666666666,-0.890196
8498,6698389,10136,2,0.186158,121,6709677,-1,1000.0,7852996,7863132,1154607,10136,50,7,True,True,112.61648888888888,-0.16944480290983602
8499,6698447,22,4,0.354532,121,6709677,-1,2000.0,7971792,7971814,1273345,22,44,1,True,True,1.158177777777778,-0.354532
8500,6698564,17,1,0.101338,121,6709677,-1,500.0,7053869,7053886,355305,17,82,10,True,True,0.1841902777777778,-0.101338
8501,6698630,1956,1,0.492046,121,6709677,-1,500.0,7422895,7424851,724265,1956,67,6,True,True,11.220077777777776,-0.4161774020228772
8502,6699954,9735,1,0.084744,121,6709677,-1,500.0,6735769,6745504,35815,9735,95,7,True,True,50.57635694444444,-0.08413742458457849
8503,6705235,25,1,0.514319,121,6709677,-1,500.0,8291154,8291179,1585919,25,33,6,True,True,0.12958333333333333,-0.514319
8504,6705489,19,22,0.153711,121,6709677,-1,11000.0,6709769,6709788,4280,19,98,1,True,True,15.786466666666668,-0.153711
8505,6705689,2302,8,0.123843,121,6709677,-1,4000.0,7268669,7270971,562980,2302,76,2,True,True,215.87644444444447,-0.123843
8506,6705986,4,1,0.487412,121,6709677,-1,500.0,8291154,8291158,1585168,4,32,0,True,True,0.020733333333333333,-0.487412
8507,6706134,41,16,0.15563,121,6709677,-1,8000.0,7275869,7275910,569735,41,76,2,True,True,14.765466666666667,-0.15563
8508,6706223,14224,2,0.656633,121,6709677,-1,1000.0,8399609,8413833,1693386,14224,25,9,True,True,467.11513333333335,-0.6245105287802392
8509,6706301,13442,8,0.226095,121,6709677,-1,4000.0,9298375,9311817,2592074,13442,0,8,True,True,1015.5641666666668,-0.20668728916584675
8510,6706308,37,1,0.395359,121,6709677,-1,500.0,8683009,8683046,1976701,37,20,8,True,True,0.2736972222222222,-0.395359
8511,6706394,30,8,0.299285,121,6709677,-1,4000.0,8290054,8290084,1583660,30,38,11,True,True,1.1836666666666666,-0.299285
8512,6706686,147,32,0.428341,121,6709677,-1,16000.0,7693690,7693837,987004,147,59,2,True,True,22.853599999999997,-0.428341
8513,6706712,3,4,0.182182,121,6709677,-1,2000.0,8877496,8877499,2170784,3,17,8,True,True,0.07861666666666667,-0.182182
8514,6706728,8,32,0.811544,121,6709677,-1,16000.0,6733569,6733577,26841,8,106,7,True,True,1.5907555555555557,-0.811544
8515,6706789,20,1,0.108695,121,6709677,-1,500.0,7405595,7405615,698806,20,77,8,True,True,0.23016666666666669,-0.108695
8516,6707123,32855,8,0.438572,121,6709677,-1,4000.0,6945869,6978724,238746,32855,96,7,True,True,4848.218077777778,-0.43181632315092167
8517,6707147,17258,8,0.839357,121,6709677,-1,4000.0,7265069,7282327,557922,17258,86,7,True,True,2147.9863111111113,-0.815718186951301
8518,6708435,4880,1,0.161834,121,6709677,-1,500.0,7747690,7752570,1039255,4880,60,9,True,True,42.97754166666667,-0.15950771279803994
8519,6708487,62,4,0.353738,121,6709677,-1,2000.0,9292975,9293037,2584488,62,1,0,True,True,2.942588888888889,-0.353738
8520,6708512,324,4,0.43396,121,6709677,-1,2000.0,7617324,7617648,908812,324,67,0,True,True,12.519200000000001,-0.2994879954135521
8521,6708732,57,1,0.359237,121,6709677,-1,500.0,7598624,7598681,889892,57,71,12,True,True,0.7567541666666667,-0.359237
8522,6708906,16,1,0.870514,121,6709677,-1,500.0,8784844,8784860,2075938,16,19,0,True,True,0.0828,-0.870514
8523,6708965,55,8,0.198465,121,6709677,-1,4000.0,7265069,7265124,556104,55,91,0,True,True,2.817222222222222,-0.198465
8524,6709526,98,16,0.189567,121,6709677,-1,8000.0,7604149,7604247,894623,98,72,8,True,True,19.279866666666667,-0.189567
8525,6709543,8202,2,0.040256,121,6709677,-1,1000.0,8677609,8685811,1968066,8202,24,8,True,True,118.70585,-0.037952967360571334
8526,6709545,284,16,0.394546,121,6709677,-1,8000.0,8442809,8443093,1733264,284,31,11,True,True,89.71875555555555,-0.394546
8527,6710014,9997,1,0.743924,167,6731369,-1,500.0,7939212,7949209,1229198,9997,57,2,True,True,55.64474999999999,-0.7284909109722412
8528,6710249,2100,8,0.900998,167,6731369,-1,4000.0,9008896,9010996,2298647,2100,17,9,True,True,137.12097777777777,-0.889735651168991
8529,6710726,20,2,0.160313,167,6731369,-1,1000.0,8201446,8201466,1490720,20,46,3,True,True,0.2292777777777778,-0.160313
8530,6710888,13426,42,0.198992,167,6731369,-1,21000.0,7309714,7323140,598826,13426,91,7,True,True,5582.462083333333,-0.1935220037571514
8531,6710908,15363,1,0.479295,167,6731369,-1,500.0,9218496,9233859,2507588,15363,5,6,True,True,96.80716666666666,-0.44856616753948464
8532,6711020,7021,21,0.665243,167,6731369,-1,10500.0,7935612,7942633,1224592,7021,61,0,True,True,740.5320416666667,-0.5646129630161015
8533,6711492,20210,4,0.2658,167,6731369,-1,2000.0,7307514,7327724,596022,20210,94,8,True,True,768.2707666666666,-0.230882393225249
8534,6711790,2644,1,0.421095,167,6731369,-1,500.0,7850796,7853440,1139006,2644,68,9,True,True,15.698155555555555,-0.3268178939449372
8535,6711902,21375,256,0.550124,167,6731369,-1,128000.0,7367769,7389144,655867,21375,94,6,True,True,113329.93920000001,-0.49911521345622295
8536,6712080,73,4,0.79982,167,6731369,-1,2000.0,7638924,7638997,926844,73,76,10,True,True,4.326061111111111,-0.79982
8537,6712146,42,71,0.714321,167,6731369,-1,35500.0,6731369,6731411,19223,42,129,0,True,True,17.912708333333335,-0.714321
8538,6712201,95,1,0.324888,167,6731369,-1,500.0,7750296,7750391,1038095,95,70,1,True,True,0.8807291666666667,-0.324888
8539,6712467,6,16,0.764393,167,6731369,-1,8000.0,7839996,7840002,1127529,6,69,12,True,True,1.5798666666666668,-0.764393
8540,6712772,33,1,0.881767,167,6731369,-1,500.0,8738011,8738044,2025239,33,23,0,True,True,0.12796666666666667,-0.881767
8541,6712792,8619,16,0.501859,167,6731369,-1,8000.0,7689024,7697643,976232,8619,76,7,True,True,723.8100666666667,-0.38627916974229104
8542,6713969,3251,1,0.923561,167,6731369,-1,500.0,8329358,8332609,1615389,3251,41,2,True,True,35.83289583333333,-0.8142771681606107
8543,6714465,81,5,0.843063,167,6731369,-1,2500.0,8199881,8199962,1485416,81,51,8,True,True,2.1464999999999996,-0.843063
8544,6714576,16,2,0.388849,167,6731369,-1,1000.0,7864196,7864212,1149620,16,69,8,True,True,0.22915555555555556,-0.388849
8545,6715167,3,1,0.109733,167,6731369,-1,500.0,7421795,7421798,706628,3,98,8,True,True,0.020345833333333334,-0.109733
8546,6715187,24,26,0.10788,167,6731369,-1,13000.0,6922069,6922093,206882,24,126,6,True,True,4.078533333333334,-0.10788
8547,6715308,98,8,0.021152,167,6731369,-1,4000.0,7262869,7262967,547561,98,114,6,True,True,6.459288888888889,-0.021152
8548,6715781,6502,8,0.155542,167,6731369,-1,4000.0,6910869,6917371,195088,6502,131,10,True,True,305.5772,-0.14771617537669163
8549,6715792,68,1,0.500001,167,6731369,-1,500.0,7598681,7598749,882889,68,89,1,True,True,0.9027944444444445,-0.500001
8550,6716171,15494,8,0.767385,167,6731369,-1,4000.0,8785696,8801190,2069525,15494,21,4,True,True,573.5616,-0.7498921557125998
8551,6716218,21849,2,0.236505,167,6731369,-1,1000.0,7296314,7318163,580096,21849,110,1,True,True,554.7648666666668,-0.22434090624519287
8552,6716224,39,8,0.67831,167,6731369,-1,4000.0,6733569,6733608,17345,39,142,0,True,True,1.9387333333333334,-0.67831
8553,6716336,323,16,0.342141,167,6731369,-1,8000.0,6778969,6779292,62633,323,141,11,True,True,57.65908888888888,-0.342141
8554,6716745,436,9,0.976439,167,6731369,-1,4500.0,8983696,8984132,2266951,436,19,12,True,True,17.39095,-0.976439
8555,6716958,10598,32,0.737432,167,6731369,-1,16000.0,7683224,7693822,966266,10598,82,10,True,True,2642.9594666666667,-0.7021064285942368
8556,6717398,25270,1,0.434329,167,6731369,-1,500.0,7400195,7425465,682797,25270,105,8,True,True,307.7457986111111,-0.40317233948670833
8557,6717678,379,4,0.289467,167,6731369,-1,2000.0,9216296,9216675,2498618,379,7,9,True,True,11.220505555555555,-0.289467
8558,6717855,52,3,0.485929,167,6731369,-1,1500.0,9057796,9057848,2339941,52,15,10,True,True,1.2072666666666667,-0.485929
8559,6717865,4,16,0.7609,167,6731369,-1,8000.0,7858796,7858800,1140931,4,74,2,True,True,0.34195555555555557,-0.7176225300318706
8560,6718881,47,64,0.247747,167,6731369,-1,32000.0,8332609,8332656,1613728,47,45,2,True,True,37.604177777777785,-0.247747
8561,6719183,5048,32,0.152496,167,6731369,-1,16000.0,7240169,7245217,520986,5048,125,11,True,True,1430.8426222222222,-0.14448520222377925
8562,6719217,1317,9,0.51124,167,6731369,-1,4500.0,6878369,6879686,159152,1317,147,9,True,True,132.406575,-0.5019363477229855
8563,6719376,16026,16,0.249467,167,6731369,-1,8000.0,7098169,7114195,378793,16026,132,0,True,True,1621.0293111111112,-0.21211964484599263
8564,6719543,6,16,0.766728,167,6731369,-1,8000.0,9064696,9064702,2345153,6,11,2,True,True,0.6689333333333334,-0.766728
8565,6719575,240,8,0.864167,167,6731369,-1,4000.0,8314958,8315198,1595383,240,48,9,True,True,8.605333333333334,-0.864167
8566,6719590,9,4,0.994257,167,6731369,-1,2000.0,8998096,8998105,2278506,9,22,1,True,True,0.23670000000000002,-0.994257
8567,6719804,143,8,0.247354,167,6731369,-1,4000.0,9162296,9162439,2442492,143,9,0,True,True,4.610955555555555,-0.247354
8568,6719831,1,3,0.820609,167,6731369,-1,1500.0,7920412,7920413,1200581,1,76,7,True,True,0.031216666666666667,-0.820609
8569,6719897,12,4,0.198412,167,6731369,-1,2000.0,8657809,8657821,1937912,12,36,0,True,True,0.37033333333333335,-0.198412
8570,6719987,93,8,0.706461,167,6731369,-1,4000.0,7864212,7864305,1144225,93,80,1,True,True,5.327866666666667,-0.706461
8571,6720322,860,8,0.809952,167,6731369,-1,4000.0,7944612,7945472,1224290,860,73,8,True,True,40.25235555555555,-0.7646541935058843
8572,6720698,28,32,0.701145,167,6731369,-1,16000.0,9299475,9299503,2578777,28,0,6,True,True,8.716088888888889,-0.701145
8573,6720775,10084,1,0.502334,167,6731369,-1,500.0,8551909,8561993,1831134,10084,40,6,True,True,171.34980000000002,-0.4980503550193246
8574,6724918,7775,1,0.181188,167,6731369,-1,500.0,7598749,7606524,873831,7775,106,1,True,True,91.01455694444445,-0.16782012521386636
8575,6750100,26,3,0.992552,197,6778969,-1,1500.0,6883769,6883795,133669,26,159,8,True,True,0.6157666666666667,-0.992552
8576,6753849,169,4,0.591196,197,6778969,-1,2000.0,7290269,7290438,536420,169,129,8,True,True,12.666549999999999,-0.591196
8577,6756623,10137,16,0.634477,197,6778969,-1,8000.0,8638309,8648446,1881686,10137,40,12,True,True,1139.8400888888889,-0.614745340585809
8578,6756733,11913,1,0.229384,197,6778969,-1,500.0,9292975,9304888,2536242,11913,3,2,True,True,130.9865763888889,-0.2239213985956804
8579,6757768,2,4,0.132296,197,6778969,-1,2000.0,8891896,8891898,2134128,2,27,0,True,True,0.03961111111111111,-0.132296
8580,6759208,10,8,0.038366,197,6778969,-1,4000.0,9036196,9036206,2276988,10,20,2,True,True,0.7816666666666666,-0.038366
8581,6759419,51,8,0.990399,197,6778969,-1,4000.0,8356409,8356460,1596990,51,54,7,True,True,2.1199,-0.990399
8582,6759463,20,32,0.929098,197,6778969,-1,16000.0,8202546,8202566,1443083,20,66,6,True,True,3.668444444444445,-0.929098
8583,6759475,9246,1,0.426303,197,6778969,-1,500.0,8076658,8085904,1317183,9246,74,0,True,True,71.47456666666666,-0.30974919887329383
8584,6759776,2755,1,0.616467,197,6778969,-1,500.0,7098169,7100924,338393,2755,152,8,True,True,15.380901388888889,-0.5690027365573084
8585,6760116,14,16,0.090935,197,6778969,-1,8000.0,7060369,7060383,300253,14,155,8,True,True,2.5028888888888887,-0.090935
8586,6760143,10204,8,0.050955,197,6778969,-1,4000.0,7192569,7202773,432426,10204,147,7,True,True,1462.5948888888888,-0.05066302899891101
8587,6760202,8,30,0.407297,197,6778969,-1,15000.0,8661409,8661417,1901207,8,40,3,True,True,1.8073333333333332,-0.407297
8588,6760727,12352,4,0.306446,197,6778969,-1,2000.0,7425465,7437817,664738,12352,124,2,True,True,527.6272666666666,-0.24190597463949579
8589,6760798,17,4,0.63331,197,6778969,-1,2000.0,8245746,8245763,1484948,17,67,11,True,True,0.46721666666666667,-0.63331
8590,6760809,91,32,0.231428,197,6778969,-1,16000.0,9162296,9162387,2401487,91,12,7,True,True,11.736977777777778,-0.231428
8591,6760837,5,8,0.336178,197,6778969,-1,4000.0,7261769,7261774,500932,5,148,10,True,True,0.32955555555555555,-0.336178
8592,6760951,309,32,0.479195,197,6778969,-1,16000.0,8784844,8785153,2023893,309,35,1,True,True,51.170399999999994,-0.479195
8593,6761259,15,1,0.509864,197,6778969,-1,500.0,8738016,8738031,1976757,15,36,2,True,True,0.05816666666666667,-0.509864
8594,6761321,23,2,0.643873,197,6778969,-1,1000.0,8165258,8165281,1403937,23,78,12,True,True,0.3704916666666667,-0.643873
8595,6761626,29,4,0.30429,197,6778969,-1,2000.0,7054969,7054998,293343,29,165,6,True,True,1.2568277777777779,-0.30429
8596,6761885,5,2,0.269246,197,6778969,-1,1000.0,8738011,8738016,1976126,5,37,0,True,True,0.03877777777777778,-0.269246
8597,6762086,24,1,0.280556,197,6778969,-1,500.0,7945472,7945496,1183386,24,89,1,True,True,0.12243333333333332,-0.280556
8598,6762107,17051,8,0.351025,197,6778969,-1,4000.0,7101769,7118820,339662,17051,161,0,True,True,1011.2789444444445,-0.3361086826380457
8599,6762250,951,16,0.418074,197,6778969,-1,8000.0,7751396,7752347,989146,951,106,6,True,True,121.60119999999999,-0.418074
8600,6762557,16076,1,0.319841,197,6778969,-1,500.0,7512224,7528300,749667,16076,125,0,True,True,91.79850555555555,-0.31325235625469916
8601,6762605,22,4,0.047556,197,6778969,-1,2000.0,8540009,8540031,1777404,22,50,11,True,True,0.6364111111111111,-0.047556
8602,6762689,13406,8,0.040889,197,6778969,-1,4000.0,7736890,7750296,974201,13406,110,11,True,True,1235.9043333333334,-0.039936728279989765
8603,6762751,645,1,0.052131,197,6778969,-1,500.0,7295669,7296314,532918,645,149,8,True,True,9.655291666666667,-0.052131
8604,6762947,4452,4,0.744755,197,6778969,-1,2000.0,8781244,8785696,2018297,4452,36,11,True,True,103.21102222222223,-0.7211024467534656
8605,6763239,643,2,0.211978,197,6778969,-1,1000.0,6914469,6915112,151230,643,182,2,True,True,7.294477777777779,-0.211978
8606,6763259,6866,64,0.472058,197,6778969,-1,32000.0,7686824,7693690,923565,6866,115,1,True,True,2984.7228444444445,-0.4389214800596038
8607,6763736,251,8,0.908482,197,6778969,-1,4000.0,7394544,7394795,630808,251,144,8,True,True,28.11757777777778,-0.908482
8608,6764066,118,32,0.100762,197,6778969,-1,16000.0,8291158,8291276,1527092,118,68,1,True,True,19.572266666666668,-0.100762
8609,6764140,11607,7,0.18484,197,6778969,-1,3500.0,9289375,9300982,2525235,11607,4,6,True,True,960.4770777777778,-0.1793193092892837
8610,6792760,455,1,0.948328,244,6865369,-1,500.0,8657809,8658264,1865049,455,48,8,True,True,3.4616847222222225,-0.9351539689870527
8611,6792892,89,2,0.363581,244,6865369,-1,1000.0,7512224,7512313,719332,89,133,7,True,True,1.001002777777778,-0.363581
8612,6792903,2,8,0.304357,244,6865369,-1,4000.0,6867569,6867571,74666,2,197,6,True,True,0.19324444444444444,-0.304357
8613,6792922,9391,8,0.096887,244,6865369,-1,4000.0,7284869,7294260,491947,9391,158,8,True,True,1512.2121444444444,-0.09159906196249672
8614,6792964,41,4,0.013662,244,6865369,-1,2000.0,9292975,9293016,2500011,41,2,0,True,True,1.9459055555555558,-0.013662
8615,6792988,13,8,0.551768,244,6865369,-1,4000.0,8872096,8872109,2079108,13,34,12,True,True,0.6577999999999999,-0.551768
8616,6793046,25,1,0.861974,244,6865369,-1,500.0,8330458,8330483,1537412,25,68,6,True,True,0.3125347222222222,-0.861974
8617,6793120,1,64,0.331212,244,6865369,-1,32000.0,7967072,7967073,1173952,1,97,10,True,True,0.7762666666666667,-0.331212
8618,6793359,12183,4,0.741292,244,6865369,-1,2000.0,7933412,7945595,1140053,12183,103,9,True,True,244.44543888888887,-0.6873181412958523
8619,6793507,94,2,0.361385,244,6865369,-1,1000.0,8897296,8897390,2103789,94,31,8,True,True,0.9230277777777779,-0.361385
8620,6793644,375,2,0.778808,244,6865369,-1,1000.0,7693690,7694065,900046,375,121,0,True,True,3.64375,-0.778808
8621,6793657,5,1,0.528862,244,6865369,-1,500.0,7101769,7101774,308112,5,181,0,True,True,0.030243055555555554,-0.528862
8622,6793690,13373,16,0.371592,244,6865369,-1,8000.0,8354209,8367582,1560519,13373,67,10,True,True,1415.2464,-0.37067013929436904
8623,6794425,36,1,0.650248,244,6865369,-1,500.0,7194769,7194805,400344,36,178,7,True,True,0.7084,-0.650248
8624,6794611,16,8,0.210033,244,6865369,-1,4000.0,9292975,9292991,2498364,16,3,0,True,True,1.5187555555555556,-0.210033
8625,6794650,8,1,0.384049,244,6865369,-1,500.0,9216296,9216304,2421646,8,12,0,True,True,0.05921111111111111,-0.384049
8626,6794882,6903,16,0.887194,244,6865369,-1,8000.0,9021796,9028699,2226914,6903,28,9,True,True,1086.4241777777777,-0.8865719916836503
8627,6794897,9,4,0.130485,244,6865369,-1,2000.0,8165281,8165290,1370384,9,92,1,True,True,0.28995000000000004,-0.130485
8628,6795119,4,1,0.742587,244,6865369,-1,500.0,8732611,8732615,1937492,4,47,1,True,True,0.015133333333333332,-0.742587
8629,6795199,30161,62,0.120354,244,6865369,-1,31000.0,8994496,9024657,2199297,30161,33,9,True,True,15107.345991666665,-0.11895639372955841
8630,6795317,113,1,0.586561,244,6865369,-1,500.0,7461424,7461537,666107,113,150,0,True,True,1.5320916666666669,-0.586561
8631,6795662,23,4,0.912177,244,6865369,-1,2000.0,7389144,7389167,593482,23,164,0,True,True,1.2050722222222223,-0.912177
8632,6795678,11543,4,0.654355,244,6865369,-1,2000.0,7302114,7313657,506436,11543,170,7,True,True,571.7568277777777,-0.6116305975676549
8633,6795730,72,16,0.190434,244,6865369,-1,8000.0,8399609,8399681,1603879,72,66,0,True,True,15.0336,-0.190434
8634,6795780,240,4,0.70466,244,6865369,-1,2000.0,8545409,8545649,1749629,240,61,8,True,True,6.037333333333334,-0.70466
8635,6796706,8,32,0.925501,244,6865369,-1,16000.0,8367209,8367217,1570503,8,73,9,True,True,1.2366222222222223,-0.925501
8636,6797232,9963,1,0.07488,244,6865369,-1,500.0,8246854,8256817,1449622,9963,88,1,True,True,83.04744861111111,-0.06906929806188739
8637,6797280,18,2,0.546579,244,6865369,-1,1000.0,8325758,8325776,1528478,18,80,9,True,True,0.16524999999999998,-0.546579
8638,6797293,62,8,0.342898,244,6865369,-1,4000.0,8496809,8496871,1699516,62,63,8,True,True,9.909666666666666,-0.342898
8639,6797647,13965,128,0.725351,244,6865369,-1,64000.0,9154696,9168661,2357049,13965,18,12,True,True,7239.010488888888,-0.7202701943692086
8640,6797758,1656,1,0.989645,244,6865369,-1,500.0,7416395,7418051,618637,1656,166,8,True,True,18.8784,-0.989645
8641,6797788,16,1,0.201999,244,6865369,-1,500.0,9243975,9243991,2446187,16,9,7,True,True,0.08884444444444443,-0.201999
8642,6797820,77,16,0.720769,244,6865369,-1,8000.0,9217396,9217473,2419576,77,12,0,True,True,9.118511111111111,-0.720769
8643,6797940,56,1,0.043811,244,6865369,-1,500.0,8888296,8888352,2090356,56,41,9,True,True,0.27727777777777773,-0.043811
8644,6801335,5109,64,0.191707,244,6865369,-1,32000.0,8070158,8075267,1268823,5109,110,8,True,True,3120.312,-0.17970956068901173
8645,6801695,17432,1,0.550496,244,6865369,-1,500.0,9061096,9078528,2259401,17432,23,0,True,True,118.23291111111112,-0.5212073347224941
8646,6801769,11,1,0.252526,244,6865369,-1,500.0,8738044,8738055,1936275,11,50,2,True,True,0.04265555555555556,-0.252526
8647,6801804,22853,35,0.877075,244,6865369,-1,17500.0,7978358,8001211,1176554,22853,114,6,True,True,10760.427659722222,-0.843526395036194
8648,6801841,23,32,0.853438,244,6865369,-1,16000.0,8550809,8550832,1748968,23,67,8,True,True,12.66328888888889,-0.853438
8649,6802457,5,2,0.906815,244,6865369,-1,1000.0,8738011,8738016,1935554,5,54,8,True,True,0.03877777777777778,-0.906815
8650,6802703,23827,1,0.975126,244,6865369,-1,500.0,8872096,8895923,2069393,23827,44,0,True,True,128.9886402777778,-0.9569111055355924
8651,6802844,5402,1,0.894913,244,6865369,-1,500.0,7907412,7912814,1104568,5402,133,11,True,True,31.734947222222225,-0.7063615304886638
8652,6808475,12039,1,0.448482,244,6865369,-1,500.0,7661624,7673663,853149,12039,152,0,True,True,108.44346944444445,-0.4331546237024068
8653,6808515,225,16,0.717326,244,6865369,-1,8000.0,7311914,7312139,503399,225,187,7,True,True,47.705,-0.717326
8654,6809122,42,1,0.910849,244,6865369,-1,500.0,8651309,8651351,1842187,42,66,7,True,True,0.39380833333333337,-0.910849
8655,6809142,3938,1,0.067708,244,6865369,-1,500.0,7975392,7979330,1166250,3938,121,2,True,True,58.127925000000005,-0.06321293887825348
8656,6809863,679,1,0.419004,244,6865369,-1,500.0,9241775,9242454,2431912,679,10,1,True,True,3.770336111111111,-0.419004
8657,6810153,9066,32,0.931332,244,6865369,-1,16000.0,7968192,7977258,1158039,9066,124,1,True,True,4048.0600000000004,-0.9215257274995057
6872,5320285,20178,32,0.782156,1,5320285,-1,16000.0,5331085,5351263,10800,20178,0,9,True,True,8344.345333333333,-0.7390446720788708
6873,5320299,5629,1,0.947383,31,5331085,-1,500.0,5710502,5716131,390203,5629,0,1,True,True,120.5850263888889,-0.9444981111676476
6874,5320322,43,1,0.82361,31,5331085,-1,500.0,6833717,6833760,1513395,43,0,11,True,True,0.5957888888888889,-0.82361
6875,5320330,6210,64,0.041969,31,5331085,-1,32000.0,5577518,5583728,257188,6210,2,7,True,True,6818.160355555556,-0.041313670530913296
6876,5320417,54,8,0.105411,31,5331085,-1,4000.0,5356303,5356357,35886,54,3,9,True,True,5.7636,-0.105411
6877,5320442,4531,11,0.629926,31,5331085,-1,5500.0,5453918,5458449,133476,4531,3,12,True,True,863.0347152777777,-0.619083297224495
6878,5320811,78,1,0.870869,31,5331085,-1,500.0,8383064,8383142,3062253,78,0,6,True,True,1.487741666666667,-0.870869
6879,5326366,3,16,0.910986,31,5331085,-1,8000.0,5334685,5334688,8319,3,6,2,True,True,0.5967333333333334,-0.910986
6880,5326406,82,2,0.157033,31,5331085,-1,1000.0,5357403,5357485,30997,82,5,6,True,True,2.678438888888889,-0.157033
6881,5326414,738,1,0.292123,31,5331085,-1,500.0,5936763,5937501,610349,738,2,0,True,True,15.299149999999997,-0.292123
6882,5326463,8,4,0.441518,31,5331085,-1,2000.0,5367518,5367526,41055,8,6,7,True,True,0.3839111111111111,-0.441518
6883,5326490,27824,32,0.505897,31,5331085,-1,16000.0,7937064,7964888,2610574,27824,1,0,True,True,19813.883733333336,-0.4987622972484501
6884,5326642,8,1,0.732552,31,5331085,-1,500.0,8293012,8293020,2966370,8,1,2,True,True,0.13367777777777778,-0.732552
6885,5326650,12078,75,0.099294,31,5331085,-1,37500.0,8058903,8070981,2732253,12078,2,9,True,True,21789.650625000002,-0.09743671421014005
6886,5326702,2168,1,0.647093,31,5331085,-1,500.0,7180839,7183007,1854137,2168,4,0,True,True,36.80501805555555,-0.5627908219524703
6887,5326733,123,16,0.334608,31,5331085,-1,8000.0,7301964,7302087,1975231,123,4,2,True,True,26.045933333333334,-0.334608
6888,5326785,41,64,0.137772,31,5331085,-1,32000.0,6873839,6873880,1547054,41,6,2,True,True,55.264355555555554,-0.137772
6889,5326885,9,21,0.848595,31,5331085,-1,10500.0,7839493,7839502,2512608,9,4,0,True,True,3.4298249999999997,-0.848595
6890,5327312,15,32,0.439108,31,5331085,-1,16000.0,5334688,5334703,7376,15,16,1,True,True,5.967333333333333,-0.439108
6891,5329574,6132,123,0.41575,31,5331085,-1,61500.0,5722863,5728995,393289,6132,10,6,True,True,17091.47525,-0.4153793260009743
6892,5329625,78,4,0.769033,31,5331085,-1,2000.0,7165639,7165717,1836014,78,7,9,True,True,3.9316333333333335,-0.769033
6893,5329685,3044,1,0.245316,31,5331085,-1,500.0,5698518,5701562,368833,3044,13,11,True,True,64.93849444444444,-0.22601030271343395
6894,5329717,4,1,0.809145,31,5331085,-1,500.0,8087103,8087107,2757386,4,2,6,True,True,0.09836111111111112,-0.809145
6895,5329743,52,16,0.34132,31,5331085,-1,8000.0,6281342,6281394,951599,52,11,1,True,True,8.095822222222223,-0.34132
6896,5329758,22,16,0.505023,31,5331085,-1,8000.0,7608064,7608086,2278306,22,6,0,True,True,4.172666666666666,-0.505023
6897,5329929,64,8,0.085234,31,5331085,-1,4000.0,5331085,5331149,1156,64,24,0,True,True,6.969600000000001,-0.085234
6898,5329953,19403,32,0.372436,31,5331085,-1,16000.0,6180442,6199845,850489,19403,13,12,True,True,11155.416533333333,-0.37098881519664845
6899,5329987,18,1,0.754845,31,5331085,-1,500.0,7727875,7727893,2397888,18,6,2,True,True,0.265225,-0.754845
6900,5330013,41,1,0.360643,31,5331085,-1,500.0,6879239,6879280,1549226,41,11,8,True,True,0.8296236111111112,-0.360643
6901,5330215,11785,4,0.664995,31,5331085,-1,2000.0,5358585,5370370,28370,11785,23,0,True,True,682.6559722222222,-0.6260441569261271
6902,5330225,41,4,0.151611,31,5331085,-1,2000.0,5357485,5357526,27260,41,24,1,True,True,2.678438888888889,-0.151611
6903,5330796,12039,128,0.753507,31,5331085,-1,64000.0,7928064,7940103,2597268,12039,5,8,True,True,35994.87466666666,-0.7470610373048671
6904,5331322,6,3,0.421722,42,5334685,-1,1500.0,5551118,5551124,219796,6,22,9,True,True,0.3593,-0.421722
6905,5331339,5,2,0.228182,42,5334685,-1,1000.0,5345503,5345508,14164,5,29,9,True,True,0.12508333333333335,-0.228182
6906,5331402,7,1,0.801769,42,5334685,-1,500.0,6064842,6064849,733440,7,17,10,True,True,0.12358888888888889,-0.801769
6907,5331500,12101,32,0.413409,42,5334685,-1,16000.0,8373853,8385954,3042353,12101,1,11,True,True,7633.001244444446,-0.4126327577636506
6908,5331724,2922,1,0.409309,42,5334685,-1,500.0,6270142,6273064,938418,2922,17,6,True,True,44.56644166666666,-0.32811242245938
6909,5332028,13055,64,0.458753,42,5334685,-1,32000.0,5936763,5949818,604735,13055,20,0,True,True,19801.64142222222,-0.45207309260106154
6910,5332161,81,32,0.85239,42,5334685,-1,16000.0,8381553,8381634,3049392,81,1,7,True,True,49.4388,-0.85239
6911,5332646,86,1,0.794607,42,5334685,-1,500.0,7062939,7063025,1730293,86,14,11,True,True,1.4559083333333334,-0.794607
6912,5332815,13,62,0.361774,42,5334685,-1,31000.0,7287168,7287181,1954353,13,12,8,True,True,10.80263888888889,-0.361774
6913,5332881,34,4,0.029763,42,5334685,-1,2000.0,5334703,5334737,1822,34,37,1,True,True,1.6907444444444446,-0.029763
6914,5333114,8162,1,0.145584,42,5334685,-1,500.0,8061103,8069265,2727989,8162,5,6,True,True,199.24309583333337,-0.14360023702625002
6915,5333205,8,1,0.009949,42,5334685,-1,500.0,8282971,8282979,2949766,8,4,3,True,True,0.13425555555555554,-0.009949
6916,5333254,19,1,0.806247,42,5334685,-1,500.0,7327164,7327183,1993910,19,13,1,True,True,0.27850833333333336,-0.806247
6917,5335249,15,1,0.943643,51,5345503,-1,500.0,5365318,5365333,30069,15,35,1,True,True,0.17995833333333333,-0.943643
6918,5335270,6733,64,0.084778,51,5345503,-1,32000.0,5358585,5365318,23315,6733,37,0,True,True,6428.148355555555,-0.07984349340554926
6919,5335279,3,32,0.314805,51,5345503,-1,16000.0,5960563,5960566,625284,3,26,7,True,True,1.9964,-0.314805
6920,5340417,383,2,0.981945,51,5345503,-1,1000.0,8267503,8267886,2927086,383,5,8,True,True,12.26663888888889,-0.981945
6921,5340511,14931,4,0.164325,51,5345503,-1,2000.0,7413564,7428495,2073053,14931,14,12,True,True,1117.17205,-0.15558479964778443
6922,5340780,110,6,0.061468,51,5345503,-1,3000.0,7281768,7281878,1940988,110,18,10,True,True,10.027416666666666,-0.061468
6923,5340881,12,1,0.759192,51,5345503,-1,500.0,7560464,7560476,2219583,12,14,12,True,True,0.21463333333333334,-0.759192
6924,5340988,39962,32,0.660176,51,5345503,-1,16000.0,6520817,6560779,1179829,39962,26,1,True,True,18624.62857777778,-0.6536995557660085
6925,5344910,8897,8,0.641466,51,5345503,-1,4000.0,7814293,7823190,2469383,8897,12,11,True,True,1047.9894555555557,-0.5917717322937055
6926,5344928,82,2,0.902511,51,5345503,-1,1000.0,7840593,7840675,2495665,82,11,6,True,True,2.9761444444444445,-0.902511
6927,5345018,18384,32,0.05781,51,5345503,-1,16000.0,6518599,6536983,1173581,18384,29,6,True,True,8762.753155555556,-0.056955646579162925
6928,5345307,137,1,0.631608,51,5345503,-1,500.0,7771093,7771230,2425786,137,14,11,True,True,2.1539444444444444,-0.631608
6929,5346560,21193,5,0.71337,64,5356303,-1,2500.0,8108703,8129896,2762143,21193,6,0,True,True,2318.0315069444446,-0.7017295214019216
6930,5346791,429,4,0.660362,64,5356303,-1,2000.0,7224039,7224468,1877248,429,24,11,True,True,33.640750000000004,-0.660362
6931,5347388,67,4,0.519778,64,5356303,-1,2000.0,7922664,7922731,2575276,67,12,11,True,True,7.399033333333333,-0.519778
6932,5347761,27299,2,0.295724,64,5356303,-1,1000.0,5362185,5389484,14424,27299,49,2,True,True,933.1823638888889,-0.28501106608998455
6933,5347929,6468,64,0.402003,64,5356303,-1,32000.0,8272903,8279371,2924974,6468,5,8,True,True,7861.648977777777,-0.40141070697152925
6934,5348178,7111,2,0.680871,64,5356303,-1,1000.0,5718163,5725274,369985,7111,43,6,True,True,308.58962777777776,-0.6532131753177408
6935,5348221,13489,128,0.55361,64,5356303,-1,64000.0,8377153,8390642,3028932,13489,2,7,True,True,32803.90933333334,-0.5353490525618696
6936,5348239,5,8,0.304323,64,5356303,-1,4000.0,5961663,5961668,613424,5,40,6,True,True,0.8302777777777778,-0.304323
6937,5351461,8142,14,0.742698,64,5356303,-1,7000.0,7224468,7232610,1873007,8142,27,1,True,True,2009.4631666666664,-0.6993002994970496
6938,5351872,9,16,0.909231,64,5356303,-1,8000.0,5358585,5358594,6713,9,57,6,True,True,2.3518000000000003,-0.909231
6939,5352215,331,1,0.007902,64,5356303,-1,500.0,7065139,7065470,1712924,331,31,7,True,True,5.430698611111111,-0.007902
6940,5352494,6,38,0.279781,64,5356303,-1,19000.0,7019739,7019745,1667245,6,33,0,True,True,2.8363833333333335,-0.279781
6941,5354007,20,4,0.527792,64,5356303,-1,2000.0,7254768,7254788,1900761,20,27,8,True,True,1.0544444444444445,-0.527792
6942,5354320,591,1,0.920451,64,5356303,-1,500.0,5540318,5540909,185998,591,54,12,True,True,10.9186375,-0.8774988233969663
6943,5365988,59,1,0.700295,58,5367518,-1,500.0,7608064,7608123,2242076,59,21,6,True,True,0.6993958333333333,-0.700295
6944,5366909,14,8,0.446189,58,5367518,-1,4000.0,6075642,6075656,708733,14,44,9,True,True,2.145422222222222,-0.446189
6945,5368060,28288,32,0.205134,126,5453918,-1,16000.0,7227768,7256056,1859708,28288,29,6,True,True,15359.206044444445,-0.1997612408174463
6946,5368628,29,4,0.544425,126,5453918,-1,2000.0,6513099,6513128,1144471,29,42,1,True,True,1.9351055555555554,-0.544425
6947,5368861,25820,32,0.788342,126,5453918,-1,16000.0,6507142,6532962,1138281,25820,43,12,True,True,12672.339466666665,-0.7869124971510009
6948,5369672,15,16,0.652037,126,5453918,-1,8000.0,8060003,8060018,2690331,15,11,6,True,True,5.816333333333334,-0.652037
6949,5370616,1305,1,0.697471,126,5453918,-1,500.0,6275542,6276847,904926,1305,46,8,True,True,13.4125,-0.697471
6950,5370641,67,16,0.887675,126,5453918,-1,8000.0,6924639,6924706,1553998,67,38,7,True,True,17.543577777777777,-0.887675
6951,5370673,44,32,0.781563,126,5453918,-1,16000.0,8082703,8082747,2712030,44,10,10,True,True,33.68835555555556,-0.781563
6952,5371268,13678,10,0.404506,126,5453918,-1,5000.0,8285812,8299490,2914544,13678,5,2,True,True,2513.6649166666666,-0.38137956886170005
6953,5372935,449,1,0.197296,126,5453918,-1,500.0,6266842,6267291,893907,449,51,12,True,True,8.938841666666667,-0.197296
6954,5373410,98,64,0.301531,126,5453918,-1,32000.0,5655318,5655416,281908,98,63,11,True,True,115.61386666666665,-0.301531
6955,5378120,396,13,0.03697,126,5453918,-1,6500.0,8262103,8262499,2883983,396,9,12,True,True,79.05754999999999,-0.03697
6956,5388412,6,1,0.334493,126,5453918,-1,500.0,6558317,6558323,1169905,6,45,6,True,True,0.07178333333333334,-0.334493
6957,5388565,8152,2,0.725099,126,5453918,-1,1000.0,7842793,7850945,2454228,8152,19,7,True,True,290.5716194444444,-0.6933572365893854
6958,5389569,16113,2,0.740052,126,5453918,-1,1000.0,7609164,7625277,2219595,16113,25,6,True,True,381.99960000000004,-0.7314520677697718
6959,5389584,10674,128,0.126006,126,5453918,-1,64000.0,8299484,8310158,2909900,10674,4,3,True,True,29641.91217777778,-0.12224995240584993
6960,5389601,1979,4,0.991924,126,5453918,-1,2000.0,8386364,8388343,2996763,1979,0,7,True,True,147.25675555555557,-0.9834609838863625
6961,5389650,26581,155,0.283928,126,5453918,-1,77500.0,8272903,8299484,2883253,26581,9,0,True,True,74749.72908333332,-0.2762435163189904
6962,5391038,45,1,0.09282,126,5453918,-1,500.0,8379353,8379398,2988315,45,3,0,True,True,0.8996875,-0.09282
6963,5391101,5394,8,0.551786,126,5453918,-1,4000.0,7835893,7841287,2444792,5394,26,10,True,True,761.7734777777778,-0.5184155266778292
6964,5391112,6,4,0.521336,126,5453918,-1,2000.0,6083242,6083248,692130,6,62,8,True,True,0.43026666666666674,-0.521336
6965,5391518,27437,32,0.757046,126,5453918,-1,16000.0,8384164,8411601,2992646,27437,1,6,True,True,15209.988977777777,-0.7285817831015691
6966,5391702,8,12,0.160027,126,5453918,-1,6000.0,8295212,8295220,2903510,8,8,7,True,True,2.2287999999999997,-0.160027
6967,5391780,16,1,0.027891,126,5453918,-1,500.0,5826563,5826579,434783,16,71,8,True,True,0.2627777777777778,-0.027891
6968,5391840,32318,256,0.796599,126,5453918,-1,128000.0,6420742,6453060,1028902,32318,59,11,True,True,110858.90133333333,-0.7861881401116246
6969,5391868,7,1,0.592504,126,5453918,-1,500.0,5567718,5567725,175850,7,79,2,True,True,0.12230555555555554,-0.592504
6970,5391915,8,16,0.24134,126,5453918,-1,8000.0,5715902,5715910,323987,8,75,0,True,True,2.716977777777778,-0.24134
6971,5391923,81,1,0.774158,126,5453918,-1,500.0,6324542,6324623,932619,81,60,11,True,True,0.9227249999999999,-0.774158
6972,5392042,21,8,0.726509,126,5453918,-1,4000.0,7606964,7606985,2214922,21,35,11,True,True,1.9915,-0.726509
6973,5394059,27,8,0.986955,126,5453918,-1,4000.0,7170039,7170066,1775980,27,47,6,True,True,2.9924999999999997,-0.986955
6974,5394249,11103,32,0.110442,126,5453918,-1,16000.0,7474064,7485167,2079815,11103,37,6,True,True,7686.413688888889,-0.10958380542023995
6975,5394560,7298,14,0.059946,126,5453918,-1,7000.0,6704117,6711415,1309557,7298,57,9,True,True,2163.5168916666667,-0.05848268178337431
6976,5394817,14571,2,0.372979,126,5453918,-1,1000.0,6277742,6292313,882925,14571,66,7,True,True,301.3573416666667,-0.3667474172684638
6977,5394829,50,2,0.62699,126,5453918,-1,1000.0,6027042,6027092,632213,50,74,7,True,True,1.618472222222222,-0.62699
6978,5394850,119,1,0.354473,126,5453918,-1,500.0,5958363,5958482,563513,119,77,10,True,True,2.4747041666666663,-0.354473
6979,5394947,10210,61,0.047733,126,5453918,-1,30500.0,8175703,8185913,2780756,10210,16,11,True,True,11685.651134722222,-0.04772868732722561
6980,5395042,13069,128,0.650962,126,5453918,-1,64000.0,6015042,6028111,620000,13069,76,2,True,True,24466.346844444444,-0.5591984044023782
6981,5395051,13,1,0.12475,126,5453918,-1,500.0,7440564,7440577,2045513,13,39,8,True,True,0.20716944444444443,-0.12475
6982,5404216,108,8,0.297961,126,5453918,-1,4000.0,7933464,7933572,2529248,108,24,0,True,True,20.0508,-0.297961
6983,5404231,12590,4,0.736859,126,5453918,-1,2000.0,6515299,6527889,1111068,12590,64,7,True,True,763.5258722222222,-0.7092267578273254
6984,5404251,19571,32,0.453147,126,5453918,-1,16000.0,8303653,8323224,2899402,19571,7,1,True,True,14289.35768888889,-0.4529695488371377
6985,5404355,423,1,0.982951,126,5453918,-1,500.0,8325253,8325676,2920898,423,7,10,True,True,5.788049999999999,-0.982951
6986,5404531,3,32,0.805388,126,5453918,-1,16000.0,8132503,8132506,2727972,3,19,7,True,True,2.1721333333333335,-0.805388
6987,5404663,8273,256,0.989,126,5453918,-1,128000.0,7711602,7719875,2306939,8273,37,12,True,True,26025.673955555558,-0.9373766841762595
6988,5404726,360,1,0.565597,126,5453918,-1,500.0,7299498,7299858,1894772,360,48,8,True,True,5.109500000000001,-0.565597
6989,5404883,1167,32,0.894339,126,5453918,-1,16000.0,6847206,6848373,1442323,1167,64,0,True,True,645.74,-0.894339
6990,5405062,5649,1,0.627744,126,5453918,-1,500.0,7260168,7265817,1855106,5649,51,8,True,True,84.85328750000001,-0.6047872097417873
6991,5405093,38,1,0.533289,126,5453918,-1,500.0,7618264,7618302,2213171,38,38,3,True,True,0.4197416666666667,-0.533289
6992,5405279,2611,6,0.595549,126,5453918,-1,3000.0,8379353,8381964,2974074,2611,5,7,True,True,306.7898083333333,-0.5833391612494978
6993,5405300,6178,1,0.350337,126,5453918,-1,500.0,7167839,7174017,1762539,6178,60,7,True,True,83.36874166666666,-0.34954647534191696
6994,5405341,13,32,0.284535,126,5453918,-1,16000.0,7562664,7562677,2157323,13,44,7,True,True,7.440622222222222,-0.284535
6995,5405392,6561,1,0.784789,126,5453918,-1,500.0,5710502,5717063,305110,6561,100,0,True,True,140.07689444444446,-0.7811117431854521
6996,5405421,11,5,0.714854,126,5453918,-1,2500.0,6094042,6094053,688621,11,86,9,True,True,1.1244444444444444,-0.714854
6997,5405739,13037,8,0.672434,126,5453918,-1,4000.0,7294098,7307135,1888359,13037,52,7,True,True,1406.8052888888888,-0.6690288834234575
6998,5405856,10708,4,0.714351,126,5453918,-1,2000.0,6533417,6544125,1127561,10708,74,0,True,True,624.6599555555556,-0.6936252978492328
6999,5406099,4,4,0.519667,126,5453918,-1,2000.0,8381964,8381968,2975865,4,3,2,True,True,0.3051777777777778,-0.519667
7000,5406479,9453,64,0.247633,126,5453918,-1,32000.0,6858006,6867459,1451527,9453,71,9,True,True,11563.477866666666,-0.24438077146732348
7001,5406487,7846,2,0.327847,126,5453918,-1,1000.0,6077842,6085688,671355,7846,92,7,True,True,283.13367222222223,-0.3265583889654264
7002,5406499,17137,16,0.582369,126,5453918,-1,8000.0,6509342,6526479,1102843,17137,81,7,True,True,4286.377066666667,-0.5793763983204534
7003,5407008,60,32,0.822843,126,5453918,-1,16000.0,6043242,6043302,636234,60,96,8,True,True,43.080000000000005,-0.822843
7004,5408337,30,1,0.361268,126,5453918,-1,500.0,5561918,5561948,153581,30,114,9,True,True,0.49745833333333334,-0.361268
7005,5408442,13751,4,0.097988,126,5453918,-1,2000.0,6269042,6282793,860600,13751,89,7,True,True,673.1025,-0.09038554583514352
7006,5408570,39,2,0.71164,126,5453918,-1,1000.0,6019442,6019481,610872,39,99,7,True,True,1.0967666666666667,-0.71164
7007,5408757,11264,1,0.828438,126,5453918,-1,500.0,6004863,6016127,596106,11264,101,0,True,True,211.2993513888889,-0.8264895536969302
7008,5408765,62,16,0.081947,126,5453918,-1,8000.0,6534517,6534579,1125752,62,76,6,True,True,15.086666666666666,-0.081947
7009,5408895,18,14,0.062194,126,5453918,-1,7000.0,6520799,6520817,1111904,18,79,7,True,True,3.6085000000000003,-0.062194
7010,5409161,8,71,0.888509,126,5453918,-1,35500.0,7621902,7621910,2212741,8,40,3,True,True,6.4523222222222225,-0.888509
7011,5420634,14037,16,0.476253,126,5453918,-1,8000.0,8289412,8303449,2868778,14037,14,2,True,True,4458.373688888889,-0.4597280741481648
7012,5422871,157,16,0.446164,126,5453918,-1,8000.0,7937064,7937221,2514193,157,30,2,True,True,59.86584444444445,-0.446164
7013,5422941,8321,16,0.369294,126,5453918,-1,8000.0,6847206,6855527,1424265,8321,76,6,True,True,2303.7059999999997,-0.3586699562248298
7014,5477459,2,8,0.526256,239,5540318,-1,4000.0,8083803,8083805,2606344,2,25,6,True,True,0.38282222222222223,-0.526256
7015,5477492,47,4,0.588239,239,5540318,-1,2000.0,7624102,7624149,2146610,47,43,0,True,True,2.135627777777778,-0.588239
7016,5477898,6728,1,0.518945,239,5540318,-1,500.0,5710502,5717230,232604,6728,119,0,True,True,143.43684166666668,-0.5159082434875605
7017,5477922,13,32,0.394782,239,5540318,-1,16000.0,6835917,6835930,1357995,13,79,7,True,True,5.763911111111111,-0.394782
7018,5478470,419,8,0.263694,239,5540318,-1,4000.0,8330653,8331072,2852183,419,9,8,True,True,44.358133333333335,-0.263694
7019,5478503,40,16,0.498827,239,5540318,-1,8000.0,5936763,5936803,458260,40,117,7,True,True,13.267555555555555,-0.498827
7020,5478704,24,15,0.423422,239,5540318,-1,7500.0,7879464,7879488,2400760,24,36,7,True,True,6.018000000000001,-0.423422
7021,5478751,62,2,0.44008,239,5540318,-1,1000.0,6533417,6533479,1054666,62,87,8,True,True,1.7909388888888889,-0.44008
7022,5479037,2589,2,0.931036,239,5540318,-1,1000.0,6841317,6843906,1362280,2589,81,8,True,True,79.19789999999999,-0.8728178544269728
7023,5479188,71,1,0.489541,239,5540318,-1,500.0,5564118,5564189,84930,71,132,0,True,True,1.2728722222222222,-0.489541
7024,5479215,588,8,0.973272,239,5540318,-1,4000.0,6843906,6844494,1364691,588,81,1,True,True,76.74706666666667,-0.973272
7025,5479876,5033,32,0.823812,239,5540318,-1,16000.0,6868806,6873839,1388930,5033,78,9,True,True,3226.5345777777775,-0.7991667577647839
7026,5479895,11349,1,0.144346,239,5540318,-1,500.0,6037842,6049191,557947,11349,113,9,True,True,226.61875,-0.14109661032228688
7027,5480199,37,3,0.127124,239,5540318,-1,1500.0,6535617,6535654,1055418,37,88,6,True,True,1.688125,-0.127124
7028,5480208,151,1,0.711151,239,5540318,-1,500.0,5710502,5710653,230294,151,131,0,True,True,3.266843055555556,-0.711151
7029,5480252,1035,2,0.129385,239,5540318,-1,1000.0,7608064,7609099,2127812,1035,50,0,True,True,24.538124999999997,-0.129385
7030,5480313,14,32,0.704525,239,5540318,-1,16000.0,6269042,6269056,788729,14,106,0,True,True,8.523822222222222,-0.704525
7031,5480362,4,1,0.863272,239,5540318,-1,500.0,6873506,6873510,1393144,4,79,2,True,True,0.08424444444444444,-0.863272
7032,5480469,3,4,0.118058,239,5540318,-1,2000.0,5912963,5912966,432494,3,128,12,True,True,0.24805000000000005,-0.118058
7033,5480759,566,16,0.212643,239,5540318,-1,8000.0,8303084,8303650,2822325,566,12,2,True,True,189.92444444444445,-0.212643
7034,5485254,131,2,0.473356,239,5540318,-1,1000.0,7722075,7722206,2236821,131,45,7,True,True,3.4936972222222225,-0.473356
7035,5485298,15703,245,0.746496,239,5540318,-1,122500.0,7724275,7739978,2238977,15703,45,7,True,True,53076.00749305556,-0.7370740243069522
7036,5485316,3332,8,0.94407,239,5540318,-1,4000.0,6377542,6380874,892226,3332,105,7,True,True,417.6022888888889,-0.9062118939590132
7037,5486882,13,5,0.369332,239,5540318,-1,2500.0,6024842,6024855,537960,13,123,8,True,True,1.0695208333333333,-0.369332
7038,5486925,10610,19,0.951822,239,5540318,-1,9500.0,8330653,8341263,2843728,10610,9,0,True,True,3457.881566666667,-0.7812250840095517
7039,5487043,7,26,0.6016,239,5540318,-1,13000.0,6846106,6846113,1359063,7,88,7,True,True,2.9693805555555555,-0.6016
7040,5487080,10179,3,0.40862,239,5540318,-1,1500.0,6004863,6015042,517783,10179,129,11,True,True,581.3428500000001,-0.40488993994040257
7041,5487115,84,1,0.120866,239,5540318,-1,500.0,5710418,5710502,223303,84,145,6,True,True,1.817316666666667,-0.120866
7042,5487163,45,6,0.571765,239,5540318,-1,3000.0,8279371,8279416,2792208,45,20,2,True,True,4.870875,-0.571765
7043,5487270,308,31,0.040282,239,5540318,-1,15500.0,5573118,5573426,85848,308,150,0,True,True,170.78984999999997,-0.040282
7044,5487342,177,4,0.153305,239,5540318,-1,2000.0,7226668,7226845,1739326,177,72,7,True,True,13.032116666666665,-0.153305
7045,5487359,26976,32,0.371467,239,5540318,-1,16000.0,7961703,7988679,2474344,26976,34,10,True,True,20965.0328,-0.3712759521247245
7046,5487843,2,1,0.99102,239,5540318,-1,500.0,5709318,5709320,221475,2,149,9,True,True,0.04164444444444444,-0.99102
7047,5490421,5,1,0.30326,239,5540318,-1,500.0,7614664,7614669,2124243,5,54,7,True,True,0.06005555555555556,-0.30326
7048,5490572,21,2,0.485926,239,5540318,-1,1000.0,5721763,5721784,231191,21,143,2,True,True,0.9330416666666667,-0.485926
7049,5490962,111,4,0.791204,239,5540318,-1,2000.0,8303449,8303560,2812487,111,13,1,True,True,9.311666666666667,-0.791204
7050,5491084,157,4,0.14214,239,5540318,-1,2000.0,6512942,6513099,1021858,157,109,1,True,True,10.476261111111112,-0.14214
7051,5491425,61,1,0.589624,239,5540318,-1,500.0,8130303,8130364,2638878,61,28,10,True,True,1.400288888888889,-0.589624
7052,5491435,11921,1,0.048651,239,5540318,-1,500.0,7462164,7474085,1970729,11921,65,10,True,True,253.8812111111111,-0.04556389983706424
7053,5491457,33,16,0.894253,239,5540318,-1,8000.0,6010263,6010296,518806,33,136,8,True,True,9.168866666666666,-0.894253
7054,5491562,13,16,0.889057,239,5540318,-1,8000.0,6083242,6083255,591680,13,126,0,True,True,3.728977777777778,-0.889057
7055,5491583,3979,4,0.215581,239,5540318,-1,2000.0,7066239,7070218,1574656,3979,84,6,True,True,238.99188333333333,-0.19917480062898055
7056,5491672,6016,16,0.819125,239,5540318,-1,8000.0,5612118,5618134,120446,6016,161,7,True,True,1808.891111111111,-0.7828000819431205
7057,5491709,6190,14,0.488794,239,5540318,-1,7000.0,6024842,6031032,533133,6190,135,0,True,True,1409.8698833333335,-0.4854014594065607
7058,5491949,14,16,0.122328,239,5540318,-1,8000.0,8082703,8082717,2590754,14,32,0,True,True,5.359511111111111,-0.122328
7059,5491967,22,5,0.348649,239,5540318,-1,2500.0,7249368,7249390,1757401,22,77,10,True,True,2.1624166666666667,-0.348649
7060,5491982,9,32,0.870427,239,5540318,-1,16000.0,7625202,7625211,2133220,9,54,6,True,True,3.2592000000000003,-0.870427
7061,5492093,656,13,0.417575,239,5540318,-1,6500.0,5934563,5935219,442470,656,151,10,True,True,158.92875555555557,-0.417575
7062,5492111,86,6,0.573059,239,5540318,-1,3000.0,7472964,7473050,1980853,86,67,9,True,True,12.380416666666667,-0.5730590000000001
7063,5492209,66,4,0.565764,239,5540318,-1,2000.0,6528017,6528083,1035808,66,111,4,True,True,4.0018,-0.565764
7064,5492297,16,2,0.900287,239,5540318,-1,1000.0,5609918,5609934,117621,16,169,10,True,True,0.6485777777777778,-0.900287
7065,5492396,13696,10,0.781349,239,5540318,-1,5000.0,7288268,7301964,1795872,13696,75,6,True,True,1871.1382777777778,-0.7765805923158047
7066,5492736,12909,32,0.475228,239,5540318,-1,16000.0,8272903,8285812,2780167,12909,22,0,True,True,7392.5008,-0.47452188839820814
7067,5492746,6972,4,0.720033,239,5540318,-1,2000.0,5575318,5582290,82572,6972,173,7,True,True,488.97648888888887,-0.7039520177166722
7068,5492762,7019,8,0.60571,239,5540318,-1,4000.0,7323564,7330583,1830802,7019,73,10,True,True,1027.8971333333334,-0.5226280877629569
7069,5492799,67,8,0.761951,239,5540318,-1,4000.0,6369942,6370009,877143,67,125,11,True,True,7.557599999999999,-0.761951
7070,5493423,5372,16,0.504764,239,5540318,-1,8000.0,7019739,7025111,1526316,5372,95,8,True,True,1087.4534444444444,-0.4984688997232158
7071,5493530,88,13,0.460936,239,5540318,-1,6500.0,5821163,5821251,327633,88,161,9,True,True,20.971906944444445,-0.43400923135838343
7072,5493769,13421,1,0.449929,239,5540318,-1,500.0,5564118,5577539,70349,13421,181,7,True,True,240.85065555555553,-0.44658682644668274
7073,5493787,13,8,0.449075,239,5540318,-1,4000.0,6869906,6869919,1376119,13,100,6,True,True,2.040711111111111,-0.449075
7074,5493820,8,4,0.866346,239,5540318,-1,2000.0,6693317,6693325,1199497,8,111,8,True,True,0.5177333333333333,-0.866346
7075,5498257,36,16,0.325216,239,5540318,-1,8000.0,8325253,8325289,2826996,36,11,0,True,True,7.8816,-0.325216
7076,5498524,6193,16,0.799812,239,5540318,-1,8000.0,8048103,8054296,2549579,6193,39,12,True,True,2466.214488888889,-0.7736954644881814
7077,5498578,7933,4,0.664502,239,5540318,-1,2000.0,7719875,7727808,2221297,7933,56,0,True,True,441.6056777777778,-0.6468775557326727
7078,5503043,45,2,0.409628,239,5540318,-1,1000.0,6017242,6017287,514199,45,153,7,True,True,1.0566250000000001,-0.409628
7079,5503055,41,4,0.232822,239,5540318,-1,2000.0,6375342,6375383,872287,41,131,8,True,True,2.3684333333333334,-0.232822
7080,5503068,48,18,0.395397,239,5540318,-1,9000.0,7013239,7013287,1510171,48,99,6,True,True,10.6584,-0.395397
7081,5503216,94,4,0.540994,239,5540318,-1,2000.0,7012139,7012233,1508923,94,100,12,True,True,5.650966666666666,-0.540994
7082,5503428,11,1,0.958079,239,5540318,-1,500.0,5723963,5723974,220535,11,171,6,True,True,0.24436805555555555,-0.958079
7083,5503584,37,1,0.890043,239,5540318,-1,500.0,6024842,6024879,521258,37,154,0,True,True,0.6088041666666667,-0.890043
7084,5503596,4,1,0.735913,239,5540318,-1,500.0,6687917,6687921,1184321,4,117,12,True,True,0.0713,-0.735913
7085,5503600,11,32,0.645917,239,5540318,-1,16000.0,5715902,5715913,212302,11,178,8,True,True,7.47168888888889,-0.645917
7086,5503641,4,4,0.865954,239,5540318,-1,2000.0,7618302,7618306,2114661,4,61,1,True,True,0.17673333333333333,-0.865954
7087,5503690,23431,64,0.707209,239,5540318,-1,32000.0,8086003,8109434,2582313,23431,33,7,True,True,36767.29448888889,-0.7064601283301843
7088,5503736,280,16,0.571995,239,5540318,-1,8000.0,6524417,6524697,1020681,280,126,4,True,True,68.00888888888889,-0.571995
7089,5503803,35,16,0.796159,239,5540318,-1,8000.0,7291898,7291933,1788095,35,82,1,True,True,7.281555555555556,-0.796159
7090,5504030,35,2,0.707399,239,5540318,-1,1000.0,8108703,8108738,2604673,35,31,0,True,True,1.6155416666666667,-0.707399
7091,5504142,9,2,0.561044,239,5540318,-1,1000.0,6922439,6922448,1418297,9,106,11,True,True,0.27747499999999997,-0.561044
7092,5504872,4,4,0.123782,239,5540318,-1,2000.0,7563764,7563768,2058892,4,71,6,True,True,0.31966666666666665,-0.123782
7093,5505288,30625,128,0.559353,239,5540318,-1,64000.0,7839493,7870118,2334205,30625,52,1,True,True,70088.61084444445,-0.5399051900639339
7094,5505382,7,2,0.192427,239,5540318,-1,1000.0,5573118,5573125,67736,7,200,8,True,True,0.25042499999999995,-0.192427
7095,5505403,262,33,0.618704,239,5540318,-1,16500.0,7300598,7300860,1795195,262,83,6,True,True,120.81565833333333,-0.6091370484526281
7096,5505919,8727,128,0.576856,239,5540318,-1,64000.0,7940103,7948830,2434184,8727,43,6,True,True,24138.046933333335,-0.568138132121994
7097,5506043,1264,1,0.052874,239,5540318,-1,500.0,6704117,6705381,1198074,1264,124,0,True,True,24.5532,-0.052874
7098,5506093,121,1,0.570244,239,5540318,-1,500.0,6533417,6533538,1027324,121,131,0,True,True,1.7476097222222222,-0.570244
7099,5507487,30,8,0.189396,239,5540318,-1,4000.0,7291868,7291898,1784381,30,88,1,True,True,3.1206666666666667,-0.189396
7100,5508181,351,2,0.475836,239,5540318,-1,1000.0,6790517,6790868,1282336,351,125,12,True,True,11.973,-0.475836
7101,5508235,556,16,0.896864,239,5540318,-1,8000.0,6925739,6926295,1417504,556,110,6,True,True,145.58551111111112,-0.896864
7102,5508271,117,32,0.120283,239,5540318,-1,16000.0,7168939,7169056,1660668,117,101,0,True,True,51.870000000000005,-0.120283
7103,5512274,9671,7,0.936182,239,5540318,-1,3500.0,6326742,6336413,814468,9671,152,7,True,True,866.816173611111,-0.8538562193727954
7104,5512317,6,1,0.179743,239,5540318,-1,500.0,7180839,7180845,1668522,6,100,9,True,True,0.088625,-0.179743
7105,5512777,20,7,0.018974,239,5540318,-1,3500.0,8108703,8108723,2595926,20,33,10,True,True,3.2310833333333333,-0.018974
7106,5513422,88,138,0.786757,239,5540318,-1,69000.0,6517499,6517587,1004077,88,145,7,True,True,190.52586666666667,-0.786757
7107,5513454,3,10,0.245287,239,5540318,-1,5000.0,8303650,8303653,2790196,3,14,2,True,True,0.6291666666666667,-0.245287
7108,5513708,7,2,0.705618,239,5540318,-1,1000.0,6557217,6557224,1043509,7,136,10,True,True,0.16749444444444445,-0.705618
7109,5517238,53,1,0.887656,239,5540318,-1,500.0,7152639,7152692,1635401,53,107,12,True,True,0.7947791666666666,-0.887656
7110,5519081,16744,4,0.444229,239,5540318,-1,2000.0,8374953,8391697,2855872,16744,8,6,True,True,1280.972938888889,-0.4391739417177321
7111,5519111,53,15,0.806921,239,5540318,-1,7500.0,7154839,7154892,1635728,53,108,7,True,True,11.830041666666666,-0.806921
7112,5519157,42120,185,0.606855,239,5540318,-1,92500.0,5588318,5630438,69161,42120,214,9,True,True,142688.18441666669,-0.6054467293529207
7113,5519879,144,4,0.401798,239,5540318,-1,2000.0,7727893,7728037,2208014,144,60,1,True,True,8.4872,-0.401798
7114,5522376,10914,32,0.044984,239,5540318,-1,16000.0,7611364,7622278,2088988,10914,72,7,True,True,4150.458755555555,-0.04405256171510854
7115,5524692,16121,8,0.861974,239,5540318,-1,4000.0,5810363,5826484,285671,16121,200,12,True,True,2473.7862555555557,-0.8242149769760192
7116,5525123,5,6,0.023263,239,5540318,-1,3000.0,7435164,7435169,1910041,5,85,10,True,True,0.4675,-0.023263
7117,5525158,6,13,0.437017,239,5540318,-1,6500.0,7612464,7612470,2087306,6,72,6,True,True,1.0194166666666666,-0.437017
7118,5525495,6,60,0.414936,239,5540318,-1,30000.0,6024842,6024848,499347,6,184,0,True,True,5.923500000000001,-0.414936
7119,5526245,9346,256,0.859648,239,5540318,-1,128000.0,7870118,7879464,2343873,9346,53,6,True,True,45670.23288888889,-0.8508739529366784
7120,5526393,11543,64,0.317382,239,5540318,-1,32000.0,7014339,7025882,1487946,11543,120,6,True,True,9221.256711111111,-0.31581713046825133
7121,5526548,25,1,0.257178,239,5540318,-1,500.0,8325253,8325278,2798705,25,13,0,True,True,0.3420833333333333,-0.257178
7122,5526694,11103,1,0.114645,239,5540318,-1,500.0,7933464,7944567,2406770,11103,51,8,True,True,249.74438750000002,-0.11255192836556162
7123,5526755,39,32,0.099334,239,5540318,-1,16000.0,6013863,6013902,487108,39,194,2,True,True,25.34306666666667,-0.099334
7124,5526871,12087,32,0.168156,239,5540318,-1,16000.0,5717063,5729150,190192,12087,213,4,True,True,8455.663644444445,-0.16557793447286787
7125,5526964,9,32,0.144034,239,5540318,-1,16000.0,6601517,6601526,1074553,9,146,11,True,True,4.41,-0.144034
7126,5529375,6075,128,0.255555,239,5540318,-1,64000.0,7624102,7630177,2094727,6075,71,7,True,True,8954.376355555556,-0.2509481167992139
7127,5529431,6,1,0.089629,239,5540318,-1,500.0,7168939,7168945,1639508,6,114,6,True,True,0.083125,-0.089629
1150,994133,154,1,0.052609,1,994133,-1,500.0,994202,994287,69,154,0,0,True,True,3.247261111111111,-0.052609
1151,994202,6763,2,0.15741,1,994202,-1,1000.0,1080602,1087365,86400,6763,0,12,True,True,189.9611361111111,-0.15720972349153198
1152,994284,10744,16,0.617838,9,1080602,-1,8000.0,1121002,1131746,126718,10744,0,7,True,True,3336.416488888889,-0.6091911541636409
1153,994848,30,1,0.673969,9,1080602,-1,500.0,2759662,2759692,1764814,30,0,6,True,True,0.44575000000000004,-0.673969
1154,994925,4132,128,0.272103,9,1080602,-1,64000.0,2833162,2837294,1838237,4132,0,8,True,True,7026.004266666667,-0.24137392606304695
1155,995038,72,1,0.661939,9,1080602,-1,500.0,1162112,1162184,167074,72,2,0,True,True,1.1237000000000001,-0.661939
1156,995070,14346,1,0.485662,9,1080602,-1,500.0,1086002,1100348,90932,14346,4,8,True,True,191.11778611111112,-0.4720151199515084
1157,995191,16,40,0.442044,9,1080602,-1,20000.0,1107602,1107618,112411,16,4,10,True,True,10.054222222222222,-0.442044
1158,995919,234,8,0.273167,9,1080602,-1,4000.0,2409520,2409754,1413601,234,2,2,True,True,28.34,-0.273167
1159,995960,21928,16,0.754943,9,1080602,-1,8000.0,1250412,1272340,254452,21928,3,0,True,True,5465.9128,-0.7307214019437017
1160,995966,8966,256,0.113818,9,1080602,-1,128000.0,3655734,3664700,2659768,8966,0,1,True,True,29958.063644444446,-0.11064159793296376
1161,1093171,1,5,0.429914,37,1107602,-1,2500.0,3386041,3386042,2292870,1,1,1,True,True,0.07814583333333333,-0.429914
1162,1093221,15556,64,0.283246,37,1107602,-1,32000.0,2805062,2820618,1711841,15556,3,7,True,True,14133.410311111113,-0.27433610528825597
1163,1093281,10,1,0.678486,37,1107602,-1,500.0,1126402,1126412,33121,10,8,8,True,True,0.19002777777777777,-0.678486
1164,1093299,23,1,0.486633,37,1107602,-1,500.0,2939505,2939528,1846206,23,2,11,True,True,0.2033902777777778,-0.486633
1165,1093712,4738,32,0.667133,37,1107602,-1,16000.0,1591808,1596546,498096,4738,7,0,True,True,2570.7209777777775,-0.6442723088364367
1166,1093772,12,8,0.045417,37,1107602,-1,4000.0,1702008,1702020,608236,12,7,10,True,True,1.2008,-0.045417
1167,1093777,14,8,0.395263,37,1107602,-1,4000.0,1426508,1426522,332731,14,9,0,True,True,1.7626,-0.395263
1168,1093910,16958,1,0.599325,37,1107602,-1,500.0,1182012,1198970,88102,16958,11,7,True,True,352.2540972222222,-0.5811100846190909
1169,1093937,63,1,0.007687,37,1107602,-1,500.0,1440608,1440671,346671,63,9,6,True,True,1.0929625,-0.007687
1170,1093970,6681,4,0.301419,37,1107602,-1,2000.0,3304875,3311556,2210905,6681,2,8,True,True,505.72113333333334,-0.3010940241506309
1171,1094413,13584,4,0.211234,37,1107602,-1,2000.0,1118802,1132386,24389,13584,17,2,True,True,1049.5139333333332,-0.2089756066739815
1172,1094762,81,1,0.137235,37,1107602,-1,500.0,3737100,3737181,2642338,81,0,0,True,True,0.9146249999999999,-0.137235
1173,1094806,4127,4,0.25552,37,1107602,-1,2000.0,3506192,3510319,2411386,4127,2,7,True,True,246.82403333333335,-0.25501974525624554
1174,1094913,15538,1,0.328122,37,1107602,-1,500.0,1126412,1141950,31499,15538,17,1,True,True,315.11745277777777,-0.32436198710903896
1175,1095007,5,6,0.00773,37,1107602,-1,3000.0,3516992,3516997,2421985,5,2,9,True,True,0.4590416666666667,-0.00773
1176,1095043,7568,1,0.747014,37,1107602,-1,500.0,1113002,1120570,17959,7568,22,8,True,True,138.0809111111111,-0.7336681199281583
1177,1095366,20494,2,0.175695,37,1107602,-1,1000.0,1172912,1193406,77546,20494,17,9,True,True,885.3906722222222,-0.17431776012013112
1178,1095385,18,16,0.380207,37,1107602,-1,8000.0,3634539,3634557,2539154,18,2,1,True,True,5.2076,-0.380207
1179,1095413,34,4,0.703671,37,1107602,-1,2000.0,3600596,3600630,2505183,34,3,0,True,True,2.1310444444444445,-0.703671
1180,1095456,22,2,0.500262,37,1107602,-1,1000.0,2882944,2882966,1787488,22,9,7,True,True,0.6679444444444445,-0.500262
1181,1095651,10565,1,0.833354,37,1107602,-1,500.0,1783808,1794373,688157,10565,14,11,True,True,198.1621347222222,-0.7998620222907998
1182,1095814,3,16,0.8062,37,1107602,-1,8000.0,1148012,1148015,52198,3,23,10,True,True,0.9477333333333333,-0.8062
1183,1095861,25,1,0.072075,37,1107602,-1,500.0,2233208,2233233,1137347,25,14,11,True,True,0.37027777777777776,-0.072075
1184,1095977,15240,7,0.861764,37,1107602,-1,3500.0,3229075,3244315,2133098,15240,8,10,True,True,2172.7396249999997,-0.855897579139497
1185,1095989,22,1,0.042302,37,1107602,-1,500.0,3709000,3709022,2613011,22,1,6,True,True,0.4665222222222223,-0.042302
1186,1096064,35,2,0.018742,37,1107602,-1,1000.0,2511380,2511415,1415316,35,15,6,True,True,1.443263888888889,-0.018742
1187,1097312,6379,2,0.921162,37,1107602,-1,1000.0,1740608,1746987,643296,6379,19,7,True,True,208.7364333333333,-0.9000295144893011
1188,1098703,9,1,0.86211,37,1107602,-1,500.0,3503992,3504001,2405289,9,7,7,True,True,0.1286875,-0.86211
1189,1102692,3,8,0.575759,37,1107602,-1,4000.0,2836762,2836765,1734070,3,13,1,True,True,0.3128,-0.575759
1190,1102770,8,2,0.5734,37,1107602,-1,1000.0,1115202,1115210,12432,8,35,7,True,True,0.2927111111111111,-0.5734
1191,1126168,9182,1,0.709499,33,1126402,-1,500.0,3113475,3122657,1987307,9182,11,12,True,True,185.01303333333334,-0.6959495247287752
1192,1126543,12,1,0.417694,45,1148012,-1,500.0,3400141,3400153,2273598,12,8,7,True,True,0.16418333333333335,-0.417694
1193,1126627,8,2,0.115173,45,1148012,-1,1000.0,1179812,1179820,53185,8,30,6,True,True,0.3611111111111111,-0.115173
1194,1127158,4722,32,0.020857,45,1148012,-1,16000.0,2747362,2752084,1620204,4722,19,0,True,True,2750.0207111111113,-0.01914381829386881
1195,1135592,103,36,0.324768,45,1148012,-1,18000.0,1203612,1203715,68020,103,30,10,True,True,74.82950000000001,-0.32476800000000006
1196,1135907,12,1,0.801322,45,1148012,-1,500.0,2697319,2697331,1561412,12,20,7,True,True,0.12378333333333333,-0.801322
1197,1137382,3744,8,0.618125,45,1148012,-1,4000.0,1176512,1180256,39130,3744,34,1,True,True,653.4336000000001,-0.6016946273132039
1198,1139349,9081,1,0.832026,45,1148012,-1,500.0,2187808,2196889,1048459,9081,24,7,True,True,153.8066236111111,-0.7831696773104123
1199,1146845,26,1,0.91977,45,1148012,-1,500.0,2190008,2190034,1043163,26,24,7,True,True,0.4690111111111111,-0.91977
1200,1146985,279,1,0.08813,45,1148012,-1,500.0,3207475,3207754,2060490,279,12,7,True,True,4.764272222222222,-0.08703206341638957
1201,1147010,5,23,0.844484,45,1148012,-1,11500.0,2698419,2698424,1551409,5,21,6,True,True,1.1862569444444446,-0.844484
1202,1147066,593,16,0.243316,45,1148012,-1,8000.0,1832408,1833001,685342,593,28,10,True,True,211.9250222222222,-0.243316
1203,1147188,25840,32,0.588871,45,1148012,-1,16000.0,1151612,1177452,4424,25840,42,2,True,True,14817.289244444444,-0.5543463045351765
1204,1147611,3,10,0.523963,45,1148012,-1,5000.0,1154912,1154915,7301,3,42,6,True,True,0.5104166666666666,-0.523963
1205,1148007,12000,2,0.395767,45,1148012,-1,1000.0,1148012,1160012,5,12000,44,0,True,True,400.1073666666667,-0.37103549596643043
1206,1149858,6,8,0.310275,49,1151612,-1,4000.0,1678208,1678214,528350,6,32,12,True,True,0.48846666666666666,-0.310275
1207,1149895,19,1,0.339513,49,1151612,-1,500.0,1158512,1158531,8617,19,43,4,True,True,0.29629444444444447,-0.339513
1208,1149959,40703,8,0.333069,49,1151612,-1,4000.0,3402792,3443495,2252833,40703,8,2,True,True,4755.141766666667,-0.3313367631213986
1209,1150623,31,1,0.168133,49,1151612,-1,500.0,3276775,3276806,2126152,31,12,6,True,True,0.4778736111111111,-0.168133
1210,1150917,11999,8,0.510483,49,1151612,-1,4000.0,1153812,1165811,2895,11999,47,7,True,True,1642.3279555555555,-0.49687640144008477
1211,1151265,945,1,0.114027,49,1151612,-1,500.0,3385096,3386041,2233831,945,11,6,True,True,14.769562500000001,-0.114027
1212,1151881,41,4,0.509952,53,1153812,-1,2000.0,3503992,3504033,2352111,41,7,0,True,True,2.3449722222222222,-0.509952
1213,1152096,5885,64,0.905923,53,1153812,-1,32000.0,1420861,1426746,268765,5885,40,12,True,True,7639.387288888889,-0.8852882275142628
1214,1152326,16,4,0.349375,53,1153812,-1,2000.0,3640339,3640355,2488013,16,3,4,True,True,0.9504,-0.349375
1215,1152376,78,1,0.727379,53,1153812,-1,500.0,1162112,1162190,9736,78,49,4,True,True,1.2173416666666668,-0.727379
1216,1152625,2691,32,0.818949,53,1153812,-1,16000.0,1266792,1269483,114167,2691,42,1,True,True,1492.2654666666667,-0.8115430114659593
1217,1154344,11288,256,0.815037,56,1154912,-1,128000.0,3620812,3632100,2466468,11288,5,9,True,True,48236.580977777776,-0.8103172060676389
1218,1154580,39231,21,0.236269,56,1154912,-1,10500.0,2584436,2623667,1429856,39231,29,8,True,True,12384.380108333335,-0.2286832318319626
1219,1154754,47,4,0.146444,56,1154912,-1,2000.0,3027028,3027075,1872274,47,20,12,True,True,2.7910166666666667,-0.146444
1220,1154807,20,1,0.197272,56,1154912,-1,500.0,1929608,1929628,774801,20,36,9,True,True,0.35775,-0.197272
1221,1155116,73,1,0.602399,66,1158512,-1,500.0,2521480,2521553,1366364,73,31,1,True,True,1.449861111111111,-0.602399
1222,1156885,275,32,0.760215,66,1158512,-1,16000.0,2495920,2496195,1339035,275,33,12,True,True,183.83444444444444,-0.760215
1223,1156930,21,16,0.655509,66,1158512,-1,8000.0,2595636,2595657,1438706,21,30,8,True,True,4.066533333333333,-0.655509
1224,1157013,250,16,0.177146,66,1158512,-1,8000.0,2837294,2837544,1680281,250,23,2,True,True,61.050000000000004,-0.177146
1225,1157242,3957,128,0.772848,66,1158512,-1,64000.0,1732608,1736565,575366,3957,44,10,True,True,10242.0576,-0.7721589865531409
1226,1157590,4,1,0.494117,66,1158512,-1,500.0,3522792,3522796,2365202,4,7,1,True,True,0.05040555555555556,-0.494117
1227,1157662,571,4,0.754446,66,1158512,-1,2000.0,1255812,1256383,98150,571,53,8,True,True,33.90153888888889,-0.754446
1228,1157674,47,22,0.759877,66,1158512,-1,11000.0,1433008,1433055,275334,47,50,6,True,True,15.413780555555558,-0.759877
1229,1157686,12145,27,0.448905,66,1158512,-1,13500.0,2547556,2559701,1389870,12145,34,9,True,True,5647.2652875,-0.4236819911754598
1230,1158062,1278,1,0.924154,66,1158512,-1,500.0,3501792,3503070,2343730,1278,12,10,True,True,18.227425,-0.9218175224373928
1231,1158132,9455,1,0.564492,66,1158512,-1,500.0,2720362,2729817,1562230,9455,31,10,True,True,132.04600833333333,-0.5557127980399916
1232,1159630,20,4,0.635298,68,1162112,-1,2000.0,2939528,2939548,1779898,20,23,1,True,True,0.7074444444444445,-0.635298
1233,1160181,12751,8,0.624522,68,1162112,-1,4000.0,3607812,3620563,2447631,12751,6,3,True,True,1630.0926444444444,-0.6048310568384282
1234,1160206,1405,23,0.864247,68,1162112,-1,11500.0,1591808,1593213,431602,1405,54,0,True,True,529.6069444444445,-0.864247
1235,1162444,17559,29,0.627217,109,1172912,-1,14500.0,2748462,2766021,1586018,17559,32,6,True,True,8127.148016666666,-0.6035169439525947
1236,1162633,10395,1,0.150957,109,1172912,-1,500.0,3392541,3402936,2229908,10395,16,8,True,True,164.8548125,-0.14719443262525134
1237,1162667,27183,1,0.068286,109,1172912,-1,500.0,2178008,2205191,1015341,27183,48,9,True,True,457.7547986111111,-0.06828258569932666
1238,1162881,1,1,0.442208,109,1172912,-1,500.0,2401708,2401709,1238827,1,45,10,True,True,0.01754722222222222,-0.442208
1239,1162899,378,16,0.30282,109,1172912,-1,8000.0,3604196,3604574,2441297,378,7,2,True,True,118.89359999999999,-0.30282
1240,1162909,8618,32,0.274674,109,1172912,-1,16000.0,2037608,2046226,874699,8618,51,11,True,True,5990.632,-0.2678398262902217
1241,1162924,907,61,0.056172,109,1172912,-1,30500.0,1178712,1179619,15788,907,71,7,True,True,1248.6996527777778,-0.056172
1242,1162981,3,2,0.507337,109,1172912,-1,1000.0,1918808,1918811,755827,3,53,12,True,True,0.10756666666666669,-0.507337
1243,1163064,15836,49,0.310408,109,1172912,-1,24500.0,2940628,2956464,1777564,15836,26,6,True,True,11486.73816111111,-0.29336136270224705
1244,1163448,240,4,0.451914,109,1172912,-1,2000.0,3275675,3275915,2112227,240,22,6,True,True,16.606666666666666,-0.451914
1245,1164035,54,2,0.05689,109,1172912,-1,1000.0,3714400,3714454,2550365,54,1,8,True,True,2.4933,-0.05689
1246,1164071,1339,2,0.831697,109,1172912,-1,1000.0,3633200,3634539,2469129,1339,6,6,True,True,48.42344722222222,-0.831697
1247,1165297,130,1,0.076731,109,1172912,-1,500.0,2758562,2758692,1593265,130,38,6,True,True,1.9315833333333332,-0.076731
1248,1165977,107,16,0.86425,109,1172912,-1,8000.0,2698762,2698869,1532785,107,42,2,True,True,17.659755555555556,-0.86425
1249,1166085,343,1,0.855293,109,1172912,-1,500.0,2698419,2698762,1532334,343,43,0,True,True,3.5381402777777775,-0.855293
1250,1166325,41,16,0.615008,109,1172912,-1,8000.0,1591808,1591849,425483,41,69,11,True,True,10.751111111111111,-0.615008
1251,1166467,320,4,0.507068,109,1172912,-1,2000.0,2362808,2363128,1196341,320,54,8,True,True,25.148444444444447,-0.507068
1252,1166489,16048,16,0.462712,109,1172912,-1,8000.0,3600596,3616644,2434107,16048,11,10,True,True,4420.588177777778,-0.45577557425583026
1253,1166504,6611,8,0.554316,109,1172912,-1,4000.0,1179812,1186423,13308,6611,81,0,True,True,1249.3234444444445,-0.5460657476505175
1254,1166548,6845,8,0.791818,109,1172912,-1,4000.0,2590236,2597081,1423688,6845,48,4,True,True,705.8489111111111,-0.7685308731252342
1255,1166563,8,5,0.895877,109,1172912,-1,2500.0,2890166,2890174,1723603,8,33,3,True,True,0.5777222222222222,-0.895877
1256,1166965,13672,32,0.449734,109,1172912,-1,16000.0,1707408,1721080,540443,13672,69,8,True,True,6527.847111111112,-0.4453090860286732
1257,1166983,17,1,0.809816,109,1172912,-1,500.0,2510280,2510297,1343297,17,54,0,True,True,0.3505069444444444,-0.809816
1258,1167043,5,2,0.651837,109,1172912,-1,1000.0,3274575,3274580,2107532,5,26,6,True,True,0.17298611111111112,-0.651837
1259,1167058,13082,32,0.321527,109,1172912,-1,16000.0,2517880,2530962,1350822,13082,54,8,True,True,8952.418133333334,-0.3145491417604382
1260,1167100,21,32,0.475629,109,1172912,-1,16000.0,3397941,3397962,2230841,21,20,8,True,True,12.271466666666667,-0.475629
1261,1167121,2163,1,0.150861,109,1172912,-1,500.0,2692956,2695119,1525835,2163,50,7,True,True,31.74502916666667,-0.150861
1262,1167209,4961,4,0.061874,109,1172912,-1,2000.0,3664700,3669661,2497491,4961,3,8,True,True,302.1848277777778,-0.06165805674038375
1263,1167268,1093,1,0.103502,109,1172912,-1,500.0,2523680,2524773,1356412,1093,56,7,True,True,26.4642625,-0.103502
1264,1167302,11886,27,0.899127,109,1172912,-1,13500.0,3519192,3531078,2351890,11886,14,7,True,True,4273.850475,-0.8800605944105693
1265,1167605,8344,4,0.343438,109,1172912,-1,2000.0,3480192,3488536,2312587,8344,20,10,True,True,624.1567555555555,-0.3381100829443111
1266,1167610,121,4,0.714316,109,1172912,-1,2000.0,3522796,3522917,2355186,121,13,1,True,True,6.0990722222222225,-0.714316
1267,1169111,2,8,0.504549,109,1172912,-1,4000.0,3311556,3311558,2142445,2,28,1,True,True,0.28742222222222225,-0.504549
1268,1169121,13195,173,0.172559,109,1172912,-1,86500.0,3642539,3655734,2473418,13195,5,7,True,True,31153.253241666665,-0.16595314737382724
1269,1169177,61,8,0.247744,109,1172912,-1,4000.0,2586636,2586697,1417459,61,59,0,True,True,8.02827777777778,-0.247744
1270,1169243,16,32,0.437758,109,1172912,-1,16000.0,3604196,3604212,2434953,16,11,0,True,True,10.065066666666667,-0.437758
1271,1169296,5,16,0.439422,109,1172912,-1,8000.0,2802862,2802867,1633566,5,48,11,True,True,1.2315555555555557,-0.439422
1272,1169303,8961,16,0.522748,109,1172912,-1,8000.0,3636739,3645700,2467436,8961,7,0,True,True,2086.9484222222222,-0.5174989273932445
1273,1169527,7861,44,0.158746,109,1172912,-1,22000.0,2536756,2544617,1367229,7861,65,0,True,True,5945.921361111111,-0.15824062381913692
1274,1169538,9,2,0.372852,109,1172912,-1,1000.0,2859144,2859153,1689606,9,45,10,True,True,0.210625,-0.372852
1275,1169590,7460,1,0.282894,109,1172912,-1,500.0,3632100,3639560,2462510,7460,10,6,True,True,124.70394444444443,-0.2607290710790235
1276,1170047,76,4,0.408769,109,1172912,-1,2000.0,1434108,1434184,264061,76,95,6,True,True,4.531711111111111,-0.408769
1277,1170344,75,1,0.338367,109,1172912,-1,500.0,2586636,2586711,1416292,75,65,7,True,True,1.2338541666666667,-0.338367
1278,1173850,14008,30,0.597886,120,1176512,-1,15000.0,3205275,3219283,2031425,14008,39,12,True,True,7548.2925000000005,-0.5846257412597966
1279,1174083,8200,16,0.789227,120,1176512,-1,8000.0,3310675,3318875,2136592,8200,33,7,True,True,2065.2144444444443,-0.7506737962609868
1280,1174102,3921,77,0.647305,120,1176512,-1,38500.0,1462208,1466129,288106,3921,97,10,True,True,6575.592955555556,-0.6366034957820631
1281,1174179,15452,16,0.065912,120,1176512,-1,8000.0,3299475,3314927,2125296,15452,35,10,True,True,4678.2426444444445,-0.06435804521889207
1282,1174239,1532,1,0.094506,120,1176512,-1,500.0,2597081,2598613,1422842,1532,65,3,True,True,18.541455555555558,-0.094506
1283,1174274,58,32,0.678379,120,1176512,-1,16000.0,3387141,3387199,2212867,58,30,6,True,True,29.007733333333334,-0.678379
1284,1174317,200,2,0.284147,120,1176512,-1,1000.0,3686300,3686500,2511983,200,3,10,True,True,6.696666666666666,-0.2527008955289951
1285,1174618,578,1,0.723734,120,1176512,-1,500.0,3242075,3242653,2067457,578,41,9,True,True,11.806452777777778,-0.723734
1286,1174663,23,35,0.656564,120,1176512,-1,17500.0,2512480,2512503,1337817,23,79,6,True,True,16.59753472222222,-0.656564
1287,1174775,16600,4,0.906343,120,1176512,-1,2000.0,1951208,1967808,776433,16600,91,10,True,True,1269.954488888889,-0.8916870097919252
1288,1174799,9673,32,0.87328,120,1176512,-1,16000.0,2407508,2417181,1232709,9673,84,6,True,True,4782.231911111111,-0.8442773885525601
1289,1174889,6527,4,0.333362,120,1176512,-1,2000.0,3308475,3315002,2133586,6527,36,2,True,True,440.03191111111107,-0.33281459750744485
1290,1176555,56,1,0.58274,130,1178712,-1,500.0,2124008,2124064,947453,56,92,12,True,True,1.3384,-0.58274
1291,1176646,63,32,0.141428,130,1178712,-1,16000.0,1261612,1261675,84966,63,114,0,True,True,27.034000000000002,-0.141428
1292,1176692,460,40,0.349821,130,1178712,-1,20000.0,3610012,3610472,2433320,460,13,7,True,True,393.12111111111113,-0.349821
1293,1176978,311,1,0.967697,130,1178712,-1,500.0,1439508,1439819,262530,311,110,8,True,True,5.369501388888889,-0.967697
1294,1177613,2086,2,0.69848,130,1178712,-1,1000.0,1426508,1428594,248895,2086,113,0,True,True,65.65685,-0.69848
1295,1177628,9,16,0.391958,130,1178712,-1,8000.0,2534480,2534489,1356852,9,78,8,True,True,2.3988,-0.391958
1296,1177643,65,1,0.595041,130,1178712,-1,500.0,1439508,1439573,261865,65,111,0,True,True,1.1222430555555554,-0.595041
1297,1178313,4026,32,0.938002,130,1178712,-1,16000.0,1334183,1338209,155870,4026,118,11,True,True,1720.6732000000002,-0.8862790084024348
1298,1178624,16454,256,0.309582,130,1178712,-1,128000.0,3738892,3755346,2560268,16454,0,3,True,True,58102.58133333333,-0.2969404894810448
1299,1178638,12363,256,0.376679,130,1178712,-1,128000.0,2565573,2577936,1386935,12363,77,7,True,True,66171.5232,-0.3744276467346413
1300,1178662,147,1,0.791662,130,1178712,-1,500.0,1424161,1424308,245499,147,119,6,True,True,3.2928,-0.791662
1301,1178718,6469,32,0.813185,130,1179812,-1,16000.0,3634300,3640769,2455582,6469,11,6,True,True,3289.406577777778,-0.769115949171189
1302,1183323,278,32,0.670116,175,1203612,-1,16000.0,1334183,1334461,150860,278,122,0,True,True,127.1016,-0.670116
1303,1183672,116,1,0.828959,175,1203612,-1,500.0,3737100,3737216,2553428,116,2,6,True,True,1.3098333333333332,-0.828959
1304,1183685,13339,8,0.738775,175,1203612,-1,4000.0,2882966,2896305,1699281,13339,56,1,True,True,1570.5887777777778,-0.7228782989204988
1305,1183718,6208,8,0.685414,175,1203612,-1,4000.0,1250412,1256620,66694,6208,130,1,True,True,755.9339555555555,-0.676614066179818
1306,1183767,10726,2,0.526393,175,1203612,-1,1000.0,2880744,2891470,1696977,10726,58,10,True,True,320.2205,-0.5175425439133172
1307,1183900,76,4,0.646025,175,1203612,-1,2000.0,1548608,1548684,364708,76,115,12,True,True,4.526644444444444,-0.646025
1308,1183938,4,8,0.423406,175,1203612,-1,4000.0,2406408,2406412,1222470,4,94,6,True,True,0.45217777777777773,-0.423406
1309,1184946,18041,8,0.361828,175,1203612,-1,4000.0,2577936,2595977,1392990,18041,81,6,True,True,2214.615577777778,-0.35893750317777967
1310,1185012,163,2,0.362598,175,1203612,-1,1000.0,2806162,2806325,1621150,163,63,6,True,True,4.833855555555556,-0.362598
1311,1185031,22,12,0.180263,175,1203612,-1,6000.0,2180208,2180230,995177,22,102,7,True,True,4.621833333333333,-0.180263
1312,1185212,4,1,0.214193,175,1203612,-1,500.0,1426508,1426512,241296,4,128,7,True,True,0.06295,-0.214193
1313,1185291,84,32,0.947668,175,1203612,-1,16000.0,1711008,1711092,525717,84,113,1,True,True,35.8624,-0.947668
1314,1185684,15,4,0.486271,175,1203612,-1,2000.0,3803692,3803707,2618008,15,0,10,True,True,0.9598333333333334,-0.486271
1315,1191642,84,1,0.226543,175,1203612,-1,500.0,3707900,3707984,2516258,84,6,10,True,True,1.6576000000000002,-0.226543
1316,1191737,2892,1,0.137565,175,1203612,-1,500.0,3736000,3738892,2544263,2892,4,10,True,True,32.58883333333333,-0.1372841591003047
1317,1191778,247,3,0.077165,175,1203612,-1,1500.0,2407508,2407755,1215730,247,98,0,True,True,10.470741666666665,-0.077165
1318,1191811,5636,8,0.844428,175,1203612,-1,4000.0,3247475,3253111,2055664,5636,49,8,True,True,931.0310111111112,-0.8426166708150044
1319,1192077,4,1,0.101141,175,1203612,-1,500.0,2896305,2896309,1704228,4,59,3,True,True,0.0533,-0.101141
1320,1192104,16915,256,0.770875,175,1203612,-1,128000.0,3027075,3043990,1834971,16915,55,0,True,True,71874.768,-0.731268328172055
1321,1192299,3,8,0.83512,175,1203612,-1,4000.0,2741962,2741965,1549663,3,76,10,True,True,0.4100666666666667,-0.83512
1322,1192348,269,64,0.883682,175,1203612,-1,32000.0,3383996,3384265,2191648,269,41,11,True,True,268.1099555555556,-0.880523341527431
1323,1194337,3071,8,0.037747,175,1203612,-1,4000.0,1265212,1268283,70875,3071,144,5,True,True,413.04414444444444,-0.03628953304168383
1324,1194394,48,8,0.336764,175,1203612,-1,4000.0,3644739,3644787,2450345,48,11,7,True,True,5.146666666666667,-0.336764
1325,1194454,28023,1,0.766308,175,1203612,-1,500.0,1246812,1274835,52358,28023,150,11,True,True,442.65892916666667,-0.7321885409756331
1326,1194499,48,16,0.131049,175,1203612,-1,8000.0,1250412,1250460,55913,48,148,0,True,True,12.162133333333333,-0.131049
1327,1194846,25,32,0.37672,175,1203612,-1,16000.0,3118875,3118900,1924029,25,56,8,True,True,16.737777777777776,-0.37672
1328,1194889,6967,256,0.162247,175,1203612,-1,128000.0,2271008,2277975,1076119,6967,110,10,True,True,32276.066133333334,-0.14945140296766912
1329,1195374,67,16,0.831345,175,1203612,-1,8000.0,1805408,1805475,610034,67,122,10,True,True,18.90293333333333,-0.831345
1330,1195475,6491,128,0.771098,175,1203612,-1,64000.0,1261612,1268103,66137,6491,150,7,True,True,13011.166755555556,-0.7093649566232478
1331,1195492,4762,4,0.809044,175,1203612,-1,2000.0,2510280,2515042,1314788,4762,103,6,True,True,410.19541111111107,-0.7887063934047266
1332,1195820,14,8,0.165539,175,1203612,-1,4000.0,1268283,1268297,72463,14,148,2,True,True,1.9586,-0.165539
1333,1195870,669,19,0.437673,175,1203612,-1,9500.0,1290983,1291652,95113,669,148,6,True,True,175.74722916666667,-0.437673
1334,1196468,8784,128,0.410859,175,1203612,-1,64000.0,2837544,2846328,1641076,8784,69,1,True,True,15896.247466666668,-0.40214902355862897
1335,1197052,6,8,0.676363,175,1203612,-1,4000.0,3329956,3329962,2132904,6,43,8,True,True,0.7356,-0.676363
1336,1197189,7288,36,0.23753,175,1203612,-1,18000.0,3329962,3337250,2132773,7288,43,1,True,True,3861.2146,-0.23102463369687856
1337,1197554,19,2,0.444199,175,1203612,-1,1000.0,1424308,1424327,226754,19,147,1,True,True,0.8512000000000001,-0.444199
1338,1197715,7726,184,0.284928,175,1203612,-1,92000.0,2886566,2894292,1688851,7726,67,2,True,True,21107.17053333333,-0.2795564308109522
1339,1197805,30512,128,0.748537,175,1203612,-1,64000.0,2379008,2409520,1181203,30512,114,8,True,True,71271.64586666666,-0.7451355347770579
1340,1197926,48,8,0.448928,175,1203612,-1,4000.0,3576796,3576844,2378870,48,26,11,True,True,6.677333333333334,-0.448928
1341,1198812,23,1,0.534011,175,1203612,-1,500.0,3782092,3782115,2583280,23,1,0,True,True,0.4991638888888889,-0.534011
1342,1198938,16,1,0.309468,175,1203612,-1,500.0,2401708,2401724,1202770,16,115,0,True,True,0.28075555555555554,-0.309468
1343,1198971,14212,2,0.808624,175,1203612,-1,1000.0,3277875,3292087,2078904,14212,52,0,True,True,454.121975,-0.7867062894414705
1344,1199693,30,8,0.469016,175,1203612,-1,4000.0,3324556,3324586,2124863,30,47,7,True,True,4.118333333333333,-0.469016
1345,1199930,7380,1,0.835113,175,1203612,-1,500.0,1259412,1266792,59482,7380,165,4,True,True,109.4256,-0.797171348689195
1346,1202155,74,8,0.367841,175,1203612,-1,4000.0,2827762,2827836,1625607,74,80,10,True,True,8.065999999999999,-0.367841
1347,1202424,36,2,0.94713,175,1203612,-1,1000.0,2536756,2536792,1334332,36,105,2,True,True,1.1994,-0.94713
1348,1202559,26,8,0.98444,175,1203612,-1,4000.0,3454992,3455018,2252433,26,37,2,True,True,3.5784666666666665,-0.98444
1349,1202714,24,7,0.46168,175,1203612,-1,3500.0,3340796,3340820,2138082,24,46,1,True,True,2.96835,-0.4465340317798221
1350,1203627,197,1,0.281772,230,1246812,-1,500.0,1918808,1919005,715181,197,135,0,True,True,3.5317722222222225,-0.281772
1351,1203673,4662,4,0.381872,230,1246812,-1,2000.0,2939505,2944167,1735832,4662,70,0,True,True,187.27318333333335,-0.372382896461755
1352,1203713,62,32,0.52746,230,1246812,-1,16000.0,2753862,2753924,1550149,62,89,8,True,True,41.23137777777777,-0.52746
1353,1203772,135,2,0.966268,230,1246812,-1,1000.0,2747362,2747497,1543590,135,92,8,True,True,4.527375,-0.966268
1354,1203872,57,32,0.816891,230,1246812,-1,16000.0,2896305,2896362,1692433,57,72,0,True,True,24.3048,-0.816891
1355,1203924,23275,43,0.801259,230,1246812,-1,21500.0,3445992,3469267,2242068,23275,38,11,True,True,17988.93575138889,-0.7809255085441135
1356,1205505,6,32,0.138399,230,1246812,-1,16000.0,2753862,2753868,1548357,6,91,0,True,True,3.9901333333333335,-0.138399
1357,1205783,9475,256,0.250003,230,1246812,-1,128000.0,2683481,2692956,1477698,9475,103,12,True,True,30882.774755555558,-0.22658961480988102
1358,1206862,128,32,0.641179,230,1246812,-1,16000.0,1810808,1810936,603946,128,145,8,True,True,70.59911111111111,-0.641179
1359,1223498,27,4,0.874117,230,1246812,-1,2000.0,1334461,1334488,110963,27,170,1,True,True,1.54305,-0.874117
1360,1223641,226,1,0.554541,230,1246812,-1,500.0,1433008,1433234,209367,226,163,0,True,True,3.3689694444444447,-0.554541
1361,1224041,21,1,0.10259,230,1246812,-1,500.0,3578996,3579017,2354955,21,27,7,True,True,0.41168750000000004,-0.10259
1362,1225226,28,16,0.845892,230,1246812,-1,8000.0,2405308,2405336,1180082,28,129,3,True,True,6.330488888888889,-0.845892
1363,1225273,21,4,0.851166,230,1246812,-1,2000.0,2244008,2244029,1018735,21,135,9,True,True,0.95235,-0.851166
1364,1227915,12,32,0.285063,230,1246812,-1,16000.0,3231275,3231287,2003360,12,63,7,True,True,8.087466666666666,-0.285063
1365,1228250,7654,8,0.763117,230,1246812,-1,4000.0,1707408,1715062,479158,7654,155,0,True,True,885.8664222222221,-0.7114372548124333
1366,1229002,48,16,0.272791,230,1246812,-1,8000.0,3782092,3782140,2553090,48,2,11,True,True,16.667733333333334,-0.272791
1367,1229105,220,16,0.905306,230,1246812,-1,8000.0,2509180,2509400,1280075,220,126,6,True,True,72.46755555555555,-0.9039588102023944
1368,1229713,20658,119,0.147349,230,1246812,-1,59500.0,2757462,2778120,1527749,20658,94,3,True,True,27440.968625000005,-0.12986146116339242
1369,1230193,7676,1,0.437473,230,1246812,-1,500.0,2529080,2536756,1298887,7676,120,8,True,True,126.48486666666666,-0.40438446099040387
1370,1230556,6,16,0.946413,230,1246812,-1,8000.0,2357408,2357414,1126852,6,139,12,True,True,1.7825333333333335,-0.946413
1371,1230732,17,8,0.222038,230,1246812,-1,4000.0,1431908,1431925,201176,17,175,8,True,True,2.0367888888888888,-0.222038
1372,1230788,599,1,0.451128,230,1246812,-1,500.0,3533596,3534195,2302808,599,30,9,True,True,7.410961111111111,-0.451128
1373,1230842,9605,4,0.349585,230,1246812,-1,2000.0,3506192,3515797,2275350,9605,35,0,True,True,576.58505,-0.3478680015916478
1374,1235051,23287,128,0.02667,230,1246812,-1,64000.0,3269075,3292362,2034024,23287,64,10,True,True,48408.93528888889,-0.026293349529138466
1375,1235300,14,8,0.053257,230,1246812,-1,4000.0,3642539,3642553,2407239,14,14,0,True,True,1.6632,-0.053257
1376,1235392,17,2,0.502007,230,1246812,-1,1000.0,2552956,2552973,1317564,17,120,0,True,True,0.6081277777777778,-0.502007
1377,1235511,454,1,0.235778,230,1246812,-1,500.0,1680408,1680862,444897,454,168,7,True,True,4.620080555555556,-0.235778
1378,1236012,295,4,0.994525,230,1246812,-1,2000.0,3451392,3451687,2215380,295,43,8,True,True,9.72188888888889,-0.994525
1379,1236187,17,4,0.374913,230,1246812,-1,2000.0,3277875,3277892,2041688,17,63,6,True,True,1.048238888888889,-0.374913
1380,1236211,51,4,0.028188,230,1246812,-1,2000.0,1289883,1289934,53672,51,194,10,True,True,2.820583333333333,-0.028188
1381,1236861,297,4,0.930826,230,1246812,-1,2000.0,2167208,2167505,930347,297,154,11,True,True,25.19385,-0.930826
1382,1236977,126,1,0.839176,230,1246812,-1,500.0,3458592,3458718,2221615,126,42,2,True,True,2.8490000000000006,-0.839176
1383,1237020,12617,1,0.649961,230,1246812,-1,500.0,2552956,2565573,1315936,12617,124,8,True,True,194.2036097222222,-0.6102364800057755
1384,1237041,19866,16,0.791381,230,1246812,-1,8000.0,1736208,1756074,499167,19866,168,1,True,True,5541.747333333333,-0.7794373155392005
1385,1237455,182,16,0.1376,230,1246812,-1,8000.0,3634539,3634721,2397084,182,18,0,True,True,52.65462222222222,-0.1376
1386,1237793,10471,1,0.286879,230,1246812,-1,500.0,2185608,2196079,947815,10471,155,8,True,True,180.8592763888889,-0.2776151473682125
1387,1237852,53,16,0.829762,230,1246812,-1,8000.0,2249408,2249461,1011556,53,151,8,True,True,9.011177777777778,-0.829762
1388,1237979,28,8,0.696072,230,1246812,-1,4000.0,2893766,2893794,1655787,28,86,3,True,True,3.4066666666666667,-0.696072
1389,1238030,25,4,0.138793,230,1246812,-1,2000.0,3604212,3604237,2366182,25,26,1,True,True,1.965833333333333,-0.138793
1390,1240035,15281,128,0.705536,230,1246812,-1,64000.0,3322356,3337637,2082321,15281,60,9,True,True,30406.11342222222,-0.6688256520303135
1391,1240185,56,1,0.448601,230,1246812,-1,500.0,3273475,3273531,2033290,56,71,7,True,True,0.9687222222222222,-0.448601
1392,1240201,34,2,0.005251,230,1246812,-1,1000.0,3271275,3271309,2031074,34,72,7,True,True,1.1236055555555555,-0.005251
1393,1240206,7860,256,0.079226,230,1246812,-1,128000.0,2501320,2509180,1261114,7860,144,8,True,True,39982.549333333336,-0.07777098557860015
1394,1240227,36,64,0.255924,230,1246812,-1,32000.0,2579036,2579072,1338809,36,127,6,True,True,43.1712,-0.255924
1395,1240251,222,10,0.834963,230,1246812,-1,5000.0,2379008,2379230,1138757,222,154,0,True,True,31.215666666666667,-0.834963
1396,1242062,7846,3,0.548804,230,1246812,-1,1500.0,2695119,2702965,1453057,7846,119,1,True,True,278.5367583333333,-0.48846933782977875
1397,1242109,31,1,0.727235,230,1246812,-1,500.0,1423061,1423092,180952,31,205,7,True,True,0.6944,-0.727235
1398,1242152,2651,8,0.527772,230,1246812,-1,4000.0,3400141,3402792,2157989,2651,49,0,True,True,287.7642777777778,-0.5234023754017854
1399,1242232,9941,12,0.111187,230,1246812,-1,6000.0,1994408,2004349,752176,9941,172,11,True,True,2042.711416666667,-0.11019296007928013
1400,1242481,46,41,0.288102,230,1246812,-1,20500.0,3322356,3322402,2079875,46,61,0,True,True,35.048166666666674,-0.288102
1401,1242829,8,1,0.301151,230,1246812,-1,500.0,2380108,2380116,1137279,8,157,6,True,True,0.13163333333333332,-0.301151
1402,1242973,34,8,0.047749,230,1246812,-1,4000.0,3636739,3636773,2393766,34,18,7,True,True,4.1325111111111115,-0.047749
1403,1243056,18345,1,0.419826,230,1246812,-1,500.0,1738408,1756753,495352,18345,185,7,True,True,314.1273652777778,-0.4031936654349894
1404,1243104,34,30,0.793899,230,1246812,-1,15000.0,3340762,3340796,2097658,34,59,9,True,True,14.965666666666666,-0.793899
1405,1243221,20017,4,0.457114,230,1246812,-1,2000.0,2373608,2393625,1130387,20017,162,9,True,True,1307.6059777777778,-0.45161746367137207
9512,7420904,105,2,0.730865,1,7420904,-1,1000.0,7423104,7423209,2200,105,0,7,True,True,2.8642583333333334,-0.5923350664709558
9513,7421140,3189,4,0.225831,1,7423104,-1,2000.0,7447663,7426398,26523,3189,0,1,True,True,234.42828888888891,-0.225831
9514,7447663,476,16,0.263812,1,7447663,-1,8000.0,7453063,7453539,5400,476,0,8,True,True,134.39066666666665,-0.263812
9515,7451106,21769,32,0.296234,4,7453063,-1,16000.0,9711614,9733383,2260508,21769,0,8,True,True,8116.999777777777,-0.29513451572766836
9516,7451300,22056,128,0.082794,4,7453063,-1,64000.0,7496263,7518319,44963,22056,1,11,True,True,31614.72373333334,-0.08128467543963151
9517,7451557,281,1,0.558515,4,7453063,-1,500.0,9475533,9475814,2023976,281,1,7,True,True,2.795169444444445,-0.558515
9518,7451869,38,64,0.872872,4,7453063,-1,32000.0,7633463,7633501,181594,38,2,12,True,True,24.657777777777778,-0.872872
9519,7453317,7620,1,0.659481,127,7496263,-1,500.0,8686825,8694445,1233508,7620,2,6,True,True,88.5050486111111,-0.6588448870150204
9520,7453877,29,2,0.735268,127,7496263,-1,1000.0,8685725,8685754,1231848,29,3,9,True,True,0.6257555555555556,-0.735268
9521,7453926,1089,32,0.205891,127,7496263,-1,16000.0,8619425,8620514,1165499,1089,4,0,True,True,191.2284,-0.205891
9522,7454242,9589,42,0.078017,127,7496263,-1,21000.0,9632414,9642003,2178172,9589,1,11,True,True,5550.950416666667,-0.06474858803105436
9523,7455218,114,4,0.971765,127,7496263,-1,2000.0,9199364,9199478,1744146,114,3,12,True,True,7.410000000000001,-0.971765
9524,7457507,7217,1,0.060267,127,7496263,-1,500.0,9231764,9238981,1774257,7217,3,10,True,True,72.64456527777779,-0.05752616606540447
9525,7457873,11752,130,0.013128,127,7496263,-1,65000.0,9088912,9100664,1631039,11752,5,8,True,True,25598.723222222223,-0.0129983392738411
9526,7458016,11,8,0.216135,127,7496263,-1,4000.0,8309302,8309313,851286,11,9,7,True,True,0.8512777777777779,-0.216135
9527,7458182,96,4,0.818511,127,7496263,-1,2000.0,8219802,8219898,761620,96,10,6,True,True,5.5296,-0.818511
9528,7458304,10277,71,0.187917,127,7496263,-1,35500.0,9107164,9117441,1648860,10277,5,6,True,True,11175.558468055555,-0.18503766484137926
9529,7458385,27,5,0.104535,127,7496263,-1,2500.0,7842419,7842446,384034,27,12,1,True,True,1.5541875,-0.104535
9530,7458487,184,4,0.208661,127,7496263,-1,2000.0,7844619,7844803,386132,184,12,7,True,True,8.398577777777778,-0.208661
9531,7458666,13,32,0.590523,127,7496263,-1,16000.0,9097912,9097925,1639246,13,6,2,True,True,6.63,-0.590523
9532,7458715,1395,2,0.527645,127,7496263,-1,1000.0,9991460,9992855,2532745,1395,0,12,True,True,36.66525,-0.527645
9533,7458727,46,1,0.858459,127,7496263,-1,500.0,9905014,9905060,2446287,46,1,11,True,True,0.8681222222222222,-0.858459
9534,7458977,37320,8,0.760488,127,7496263,-1,4000.0,7655119,7692439,196142,37320,17,1,True,True,3791.131611111111,-0.7529909802988377
9535,7459029,14846,1,0.311825,127,7496263,-1,500.0,8118086,8132932,659057,14846,15,8,True,True,196.0266333333333,-0.3118168300597309
9536,7459262,6908,16,0.454022,127,7496263,-1,8000.0,7838819,7845727,379557,6908,18,6,True,True,1312.342133333333,-0.4417322977528967
9537,7459573,3195,4,0.153999,127,7496263,-1,2000.0,8610425,8613620,1150852,3195,13,8,True,True,146.70744444444446,-0.14583338542621452
9538,7459790,12,8,0.504511,127,7496263,-1,4000.0,10089060,10089072,2629270,12,0,10,True,True,0.8710666666666667,-0.504511
9539,7460179,8139,16,0.914125,127,7496263,-1,8000.0,8323824,8331963,863645,8139,15,1,True,True,1048.8179333333333,-0.8812993994345348
9540,7460299,234,8,0.218785,127,7496263,-1,4000.0,8553054,8553288,1092755,234,15,1,True,True,25.4488,-0.218785
9541,7460340,6157,1,0.363644,127,7496263,-1,500.0,10142060,10148217,2681720,6157,0,6,True,True,84.06610277777779,-0.3624342490193502
9542,7462757,1,1,0.975065,127,7496263,-1,500.0,8021066,8021067,558309,1,21,6,True,True,0.012986111111111111,-0.975065
9543,7462847,46,3,0.867859,127,7496263,-1,1500.0,10150760,10150806,2687913,46,0,7,True,True,1.7458916666666668,-0.867859
9544,7462894,755,4,0.513464,127,7496263,-1,2000.0,9377237,9377992,1914343,755,8,0,True,True,39.90175,-0.513464
9545,7462915,17458,16,0.780021,127,7496263,-1,8000.0,9377237,9394695,1914322,17458,8,0,True,True,3605.1371999999997,-0.7712028632093717
9546,7463964,11,2,0.187953,127,7496263,-1,1000.0,7539463,7539474,75499,11,30,10,True,True,0.32010000000000005,-0.187953
9547,7464892,13,4,0.277838,127,7496263,-1,2000.0,10095560,10095573,2630668,13,2,0,True,True,0.4159277777777778,-0.277838
9548,7465082,6755,128,0.164196,127,7496263,-1,64000.0,8427624,8434379,962542,6755,21,0,True,True,13591.843911111111,-0.16414926345952952
9549,7465329,22,2,0.307147,127,7496263,-1,1000.0,8752732,8752754,1287403,22,16,1,True,True,0.6002333333333334,-0.307147
9550,7465376,7661,16,0.869831,127,7496263,-1,8000.0,10165960,10173621,2700584,7661,0,8,True,True,1412.0858444444443,-0.8613026566750742
9551,7465404,2698,32,0.648383,127,7496263,-1,16000.0,9745114,9747812,2279710,2698,7,9,True,True,1046.770311111111,-0.6471636500801721
9552,7465458,15,6,0.14729,127,7496263,-1,3000.0,7661619,7661634,196161,15,33,8,True,True,1.12525,-0.14729
9553,7465541,9,4,0.876196,127,7496263,-1,2000.0,8981732,8981741,1516191,9,18,11,True,True,0.5117499999999999,-0.876196
9554,7465580,45,4,0.745026,127,7496263,-1,2000.0,8851032,8851077,1385452,45,19,9,True,True,1.7072500000000002,-0.745026
9555,7465625,700,1,0.240562,127,7496263,-1,500.0,8414624,8415324,948999,700,27,0,True,True,8.702361111111111,-0.240562
9556,7465675,13,1,0.894098,127,7496263,-1,500.0,10318009,10318022,2852334,13,0,7,True,True,0.24533888888888886,-0.894098
9557,7465724,4622,8,0.18703,127,7496263,-1,4000.0,8112686,8117308,646962,4622,33,0,True,True,450.0499111111111,-0.18680978261028242
9558,7465781,102,4,0.028586,127,7496263,-1,2000.0,10044760,10044862,2578979,102,6,1,True,True,3.780233333333333,-0.028586
9559,7465790,1354,8,0.661886,127,7496263,-1,4000.0,7842419,7843773,376629,1354,37,0,True,True,124.7034,-0.661886
9560,7465971,63,32,0.452641,127,7496263,-1,16000.0,10315809,10315872,2849838,63,1,8,True,True,41.146,-0.452641
9561,7466592,21,2,0.265579,127,7496263,-1,1000.0,7544863,7544884,78271,21,44,8,True,True,0.669375,-0.265579
9562,7468178,56,2,0.926928,127,7496263,-1,1000.0,7655063,7655119,186885,56,43,10,True,True,1.6115555555555554,-0.926928
9563,7468182,484,16,0.084067,127,7496263,-1,8000.0,10410149,10410633,2941967,484,0,7,True,True,86.43164444444444,-0.084067
9564,7468203,10,8,0.431474,127,7496263,-1,4000.0,7837719,7837729,369516,10,42,6,True,True,1.027111111111111,-0.431474
9565,7468269,26,16,0.15062,127,7496263,-1,8000.0,8425424,8425450,957155,26,31,9,True,True,6.203022222222222,-0.15062
9566,7468381,1733,4,0.50219,127,7496263,-1,2000.0,10319109,10320842,2850728,1733,1,0,True,True,130.82224444444444,-0.50219
9567,7468392,9270,256,0.507927,127,7496263,-1,128000.0,8098016,8107286,629624,9270,39,9,True,True,32275.528533333334,-0.49495422127828137
9568,7469489,16453,1,0.053157,127,7496263,-1,500.0,10215507,10231960,2746018,16453,4,10,True,True,182.75684444444448,-0.05146045481758454
9569,7469646,52,2,0.272589,127,7496263,-1,1000.0,8565025,8565077,1095379,52,31,2,True,True,1.4773777777777777,-0.272589
9570,7469780,170,1,0.097813,127,7496263,-1,500.0,8273802,8273972,804022,170,38,9,True,True,1.5189027777777777,-0.097813
9571,7469818,11436,128,0.648622,127,7496263,-1,64000.0,8263002,8274438,793184,11436,39,10,True,True,12636.037333333334,-0.6337951561556835
9572,7470263,126,2,0.732002,127,7496263,-1,1000.0,9475814,9475940,2005551,126,16,1,True,True,2.5067000000000004,-0.732002
9573,7470324,19,8,0.422588,127,7496263,-1,4000.0,9377237,9377256,1906913,19,20,6,True,True,2.0082999999999998,-0.422588
9574,7470968,77,2,0.294006,127,7496263,-1,1000.0,8450324,8450401,979356,77,35,9,True,True,2.587413888888889,-0.294006
9575,7471047,5,8,0.402692,127,7496263,-1,4000.0,8328224,8328229,857177,5,39,7,True,True,0.4033888888888889,-0.402692
9576,7471089,262,1,0.594049,127,7496263,-1,500.0,8582325,8582587,1111236,262,33,0,True,True,3.1225319444444444,-0.5572905582554495
9577,7471439,140,32,0.529563,127,7496263,-1,16000.0,9243364,9243504,1771925,140,21,4,True,True,44.56355555555556,-0.529563
9578,7471767,213,1,0.493616,127,7496263,-1,500.0,8570425,8570638,1098658,213,35,8,True,True,2.7882291666666665,-0.493616
9579,7471808,102,11,0.433565,127,7496263,-1,5500.0,10191160,10191262,2719352,102,5,3,True,True,10.370708333333333,-0.433565
9580,7471834,10,4,0.681161,127,7496263,-1,2000.0,10410149,10410159,2938315,10,0,0,True,True,0.4464444444444445,-0.681161
9581,7471849,155,1,0.646345,127,7496263,-1,500.0,9112964,9113119,1641115,155,26,7,True,True,2.3133749999999997,-0.646345
9582,7471908,27,1,0.958972,127,7496263,-1,500.0,9235064,9235091,1763156,27,24,7,True,True,0.2538,-0.958972
9583,7471940,6347,32,0.21958,127,7496263,-1,16000.0,10187560,10193907,2715620,6347,7,10,True,True,1779.654311111111,-0.2142475231092024
9584,7472063,7103,16,0.053138,127,7496263,-1,8000.0,10148560,10155663,2676497,7103,10,8,True,True,1478.6304444444445,-0.05307573618531057
9585,7472164,321,1,0.035688,127,7496263,-1,500.0,9997960,9998281,2525796,321,15,8,True,True,3.713791666666667,-0.035688
9586,7472257,9092,64,0.266178,127,7496263,-1,32000.0,8414624,8423716,942367,9092,49,12,True,True,7808.932266666667,-0.2652937808910518
9587,7472310,34,4,0.065847,127,7496263,-1,2000.0,7895419,7895453,423109,34,60,11,True,True,1.3987222222222222,-0.065847
9588,7472367,260,2,0.101032,127,7496263,-1,1000.0,8112686,8112946,640319,260,58,0,True,True,6.297777777777777,-0.101032
9589,7472391,7,1,0.226465,127,7496263,-1,500.0,7547063,7547070,74672,7,71,7,True,True,0.09926388888888887,-0.226465
9590,7472466,44,16,0.620221,127,7496263,-1,8000.0,8645725,8645769,1173259,44,39,1,True,True,6.442577777777778,-0.620221
9591,7472913,203,5,0.715823,127,7496263,-1,2500.0,9763514,9763717,2290601,203,18,0,True,True,14.069027777777777,-0.715823
9592,7473068,4428,32,0.391908,127,7496263,-1,16000.0,10410633,10415061,2937565,4428,0,3,True,True,1573.3852,-0.3901096208731864
9593,7473076,9633,85,0.101304,127,7496263,-1,42500.0,9761314,9770947,2288238,9633,20,8,True,True,11443.455791666665,-0.093013234014398
9594,7473095,5,32,0.733924,127,7496263,-1,16000.0,9370737,9370742,1897642,5,29,8,True,True,1.8855555555555554,-0.733924
9595,7473646,211,1,0.879528,127,7496263,-1,500.0,7656219,7656430,182573,211,73,6,True,True,3.0360555555555555,-0.879528
9596,7474035,16855,220,0.268267,127,7496263,-1,110000.0,8461124,8477979,987089,16855,50,9,True,True,45890.92994444445,-0.2637325908588111
9597,7474304,116,32,0.205705,127,7496263,-1,16000.0,8147286,8147402,672982,116,62,9,True,True,67.36764444444444,-0.205705
9598,7475199,4,8,0.785728,127,7496263,-1,4000.0,8307102,8307106,831903,4,59,10,True,True,0.30493333333333333,-0.785728
9599,7475208,21,1,0.347633,127,7496263,-1,500.0,10310388,10310409,2835180,21,6,1,True,True,0.4658041666666667,-0.332346482823791
9600,7475834,57,16,0.287993,127,7496263,-1,8000.0,9641414,9641471,2165580,57,24,2,True,True,7.564533333333334,-0.287993
9601,7477326,23,1,0.596313,127,7496263,-1,500.0,9502814,9502837,2025488,23,26,8,True,True,0.2929305555555556,-0.596313
9602,7477372,2,32,0.733882,127,7496263,-1,16000.0,9734314,9734316,2256942,2,23,10,True,True,0.7680888888888888,-0.733882
9603,7478388,75,4,0.094243,127,7496263,-1,2000.0,10310409,10310484,2832021,75,6,2,True,True,6.24625,-0.094243
9604,7478403,4037,1,0.50324,127,7496263,-1,500.0,8570425,8574462,1092022,4037,52,0,True,True,52.40422638888889,-0.4996752934238429
9605,7478737,15613,25,0.700471,127,7496263,-1,12500.0,8983932,8999545,1505195,15613,43,7,True,True,4444.8313194444445,-0.6677287056539215
9606,7478932,12150,4,0.476758,127,7496263,-1,2000.0,8085866,8098016,606934,12150,75,0,True,True,708.8619555555555,-0.47640983423095595
9607,7479608,11987,1,0.305324,127,7496263,-1,500.0,8619425,8631412,1139817,11987,51,8,True,True,64.85287361111111,-0.2899013504171982
9608,7479731,23,16,0.906668,127,7496263,-1,8000.0,8620525,8620548,1140794,23,50,6,True,True,2.0194,-0.906668
9609,7480361,86,8,0.238619,127,7496263,-1,4000.0,9431656,9431742,1951295,86,31,7,True,True,19.453200000000002,-0.238619
9610,7480435,12668,237,0.315112,127,7496263,-1,118500.0,9076244,9088912,1595809,12668,44,7,True,True,49283.01766666667,-0.3109230031273967
9611,7480498,8452,1,0.069455,127,7496263,-1,500.0,10222707,10231159,2742209,8452,8,2,True,True,89.55694861111112,-0.06756963836076557
9612,7481026,93,3,0.187344,127,7496263,-1,1500.0,7769619,7769712,288593,93,88,10,True,True,3.5382625,-0.187344
9613,7481280,23947,247,0.899869,127,7496263,-1,123500.0,8938532,8962479,1457252,23947,48,12,True,True,86570.15074861111,-0.8879807071596976
9614,7481294,9,8,0.141834,127,7496263,-1,4000.0,10407949,10407958,2926655,9,3,2,True,True,0.8036,-0.141834
9615,7481416,4845,4,0.012735,127,7496263,-1,2000.0,8642125,8646970,1160709,4845,55,10,True,True,184.43391666666668,-0.0120676086109521
9616,7481427,46,20,0.474601,127,7496263,-1,10000.0,9761314,9761360,2279887,46,24,0,True,True,11.813055555555557,-0.474601
9617,7481465,14246,16,0.334054,127,7496263,-1,8000.0,9442456,9456702,1960991,14246,34,9,True,True,2486.5135999999998,-0.28831641932613467
9618,7481557,48,7,0.177515,127,7496263,-1,3500.0,7846819,7846867,365262,48,88,7,True,True,3.8341333333333334,-0.17751500000000003
9619,7481724,5912,64,0.263832,127,7496263,-1,32000.0,9070332,9076244,1588608,5912,49,12,True,True,4515.143822222222,-0.23652853070776822
9620,7482405,12589,32,0.076977,127,7496263,-1,16000.0,8605025,8617614,1122620,12589,63,6,True,True,4606.276133333334,-0.07516901912585744
9621,7482495,5781,4,0.679203,127,7496263,-1,2000.0,10138760,10144541,2656265,5781,17,11,True,True,305.3776555555556,-0.6694827803954514
9622,7483729,367,1,0.85309,127,7496263,-1,500.0,7661619,7661986,177890,367,98,0,True,True,4.588519444444445,-0.85309
9623,7483771,6,1,0.594005,127,7496263,-1,500.0,10090160,10090166,2606389,6,19,6,True,True,0.054441666666666666,-0.594005
9624,7483829,733,1,0.969542,127,7496263,-1,500.0,8241402,8242135,757573,733,83,9,True,True,7.955086111111111,-0.969542
9625,7484125,6337,128,0.583159,127,7496263,-1,64000.0,8646825,8653162,1162700,6337,59,6,True,True,7218.548088888889,-0.5700849493841091
9626,7485298,6441,64,0.488307,127,7496263,-1,32000.0,7998366,8004807,513068,6441,93,6,True,True,5977.906133333334,-0.4715266962873992
9627,7485400,6086,16,0.24751,127,7496263,-1,8000.0,7517863,7523949,32463,6086,111,10,True,True,1234.1708222222223,-0.24719333988834727
9628,7485441,42,4,0.109386,127,7496263,-1,2000.0,8564954,8564996,1079513,42,71,0,True,True,2.3865333333333334,-0.109386
9629,7485503,324,2,0.818926,127,7496263,-1,1000.0,10410149,10410473,2924646,324,2,0,True,True,7.232399999999999,-0.818926
9630,7485531,3,19,0.567267,127,7496263,-1,9500.0,8840232,8840235,1354701,3,57,12,True,True,0.7208916666666667,-0.567267
9631,7485881,968,16,0.990413,127,7496263,-1,8000.0,8653325,8654293,1167444,968,61,0,True,True,140.01582222222223,-0.990413
9632,7485930,30,16,0.835359,127,7496263,-1,8000.0,8553024,8553054,1067094,30,76,6,True,True,6.525333333333333,-0.835359
9633,7486024,1347,4,0.525269,127,7496263,-1,2000.0,7895419,7896766,409395,1347,99,0,True,True,55.41408333333333,-0.525269
9634,7486423,322,1,0.167305,127,7496263,-1,500.0,9763514,9763836,2277091,322,27,6,True,True,4.463277777777777,-0.167305
9635,7486522,39,8,0.146583,127,7496263,-1,4000.0,9256364,9256403,1769842,39,44,7,True,True,4.0113666666666665,-0.146583
9636,7486545,96,32,0.09391,127,7496263,-1,16000.0,8751625,8751721,1265080,96,61,11,True,True,41.9072,-0.09391
9637,7486552,12,1,0.304602,127,7496263,-1,500.0,10067460,10067472,2580908,12,22,6,True,True,0.10021666666666668,-0.304602
9638,7486563,517,8,0.736186,127,7496263,-1,4000.0,9365337,9365854,1878774,517,45,3,True,True,46.018744444444444,-0.736186
9639,7486797,12091,64,0.452616,127,7496263,-1,32000.0,9684614,9696705,2197817,12091,34,11,True,True,9384.4144,-0.4419722117363014
9640,7486842,462,1,0.734815,127,7496263,-1,500.0,9589214,9589676,2102372,462,37,12,True,True,3.1903666666666664,-0.734815
9641,7486887,589,32,0.989793,127,7496263,-1,16000.0,9992560,9993149,2505673,589,25,6,True,True,247.69413333333335,-0.989793
9642,7486917,28843,4,0.25734,127,7496263,-1,2000.0,9762414,9791257,2275497,28843,30,6,True,True,2045.312088888889,-0.2545083037070541
9643,7505496,7,2,0.486493,149,7517863,-1,1000.0,8752725,8752732,1247229,7,67,6,True,True,0.19098333333333334,-0.486493
9644,7505618,77,1,0.364289,149,7517863,-1,500.0,10193907,10193984,2688289,77,12,2,True,True,0.6187805555555556,-0.364289
9645,7505678,5,4,0.013561,149,7517863,-1,2000.0,8428724,8428729,923046,5,90,6,True,True,0.32625000000000004,-0.013561
9646,7505987,3,1,0.352626,149,7517863,-1,500.0,7815019,7815022,309032,3,119,10,True,True,0.03493333333333334,-0.352626
9647,7506481,10809,1,0.710157,149,7517863,-1,500.0,8553054,8563863,1046573,10809,86,0,True,True,158.22375416666665,-0.7020334875529995
9648,7507707,1443,16,0.891372,149,7517863,-1,8000.0,10152960,10154403,2645253,1443,16,7,True,True,309.1547333333333,-0.891372
9649,7508060,599,16,0.774526,149,7517863,-1,8000.0,8218702,8219301,710642,599,105,0,True,True,134.56,-0.7551664417547765
9650,7508335,25,32,0.856956,149,7517863,-1,16000.0,10407709,10407734,2899374,25,5,0,True,True,8.928888888888888,-0.856956
9651,7508355,439,16,0.902167,149,7517863,-1,8000.0,8563854,8564293,1055499,439,88,0,True,True,105.21366666666665,-0.902167
9652,7508810,41,1,0.595744,149,7517863,-1,500.0,8462224,8462265,953414,41,92,6,True,True,0.4225847222222222,-0.595744
9653,7509792,1361,1,0.112761,149,7517863,-1,500.0,10193360,10194721,2683568,1361,14,7,True,True,10.937147222222222,-0.112761
9654,7510285,49,1,0.685784,149,7517863,-1,500.0,9497414,9497463,1987129,49,45,10,True,True,0.5625472222222222,-0.685784
9655,7511158,181,4,0.728216,149,7517863,-1,2000.0,10310207,10310388,2799049,181,11,6,True,True,16.797805555555556,-0.728216
9656,7511337,264,4,0.020727,149,7517863,-1,2000.0,8285238,8285502,773901,264,107,9,True,True,6.206933333333334,-0.020727
9657,7511356,16631,256,0.978637,149,7517863,-1,128000.0,9456702,9473333,1945346,16631,49,7,True,True,51195.0336,-0.9763407492683165
9658,7511475,10,1,0.856266,149,7517863,-1,500.0,8840232,8840242,1328757,10,72,0,True,True,0.12647222222222224,-0.856266
9659,7514110,15957,32,0.659367,149,7517863,-1,16000.0,9106064,9122021,1591954,15957,64,8,True,True,7894.490533333334,-0.6583252307267328
9660,7514206,8830,6,0.141633,149,7517863,-1,3000.0,8107286,8116116,593080,8830,120,1,True,True,673.1466,-0.1412489899371336
9661,7515103,4,7,0.497832,149,7517863,-1,3500.0,7895419,7895423,380316,4,125,0,True,True,0.2879722222222222,-0.497832
9662,7515573,71,1,0.244368,149,7517863,-1,500.0,8564954,8565025,1049381,71,94,6,True,True,1.0085944444444443,-0.244368
9663,7516063,225,8,0.741012,149,7517863,-1,4000.0,9637814,9638039,2121751,225,43,8,True,True,19.51,-0.741012
9664,7516430,12454,64,0.973291,149,7517863,-1,32000.0,9238664,9251118,1722234,12454,60,4,True,True,7961.181155555556,-0.9639783168078483
9665,7516582,11,1,0.35942,149,7517863,-1,500.0,10405509,10405520,2888927,11,6,12,True,True,0.13022777777777778,-0.35942
9666,7523724,10082,16,0.744365,158,7539463,-1,8000.0,8708425,8718507,1184701,10082,81,10,True,True,1213.349688888889,-0.7442934342883215
9667,7524970,12360,8,0.193842,158,7539463,-1,4000.0,9361737,9374097,1836767,12360,59,1,True,True,1167.2763,-0.19245926485539502
9668,7525197,20221,4,0.954814,158,7539463,-1,2000.0,9502814,9523035,1977617,20221,47,0,True,True,1154.136611111111,-0.9415059975396266
9669,7525374,37,8,0.638734,158,7539463,-1,4000.0,8852132,8852169,1326758,37,77,6,True,True,2.807477777777778,-0.638734
9670,7526550,15363,1,0.965453,158,7539463,-1,500.0,8565025,8580388,1038475,15363,99,0,True,True,201.28074444444445,-0.9589409131546556
9671,7537641,10,8,0.877144,158,7539463,-1,4000.0,8019966,8019976,482325,10,133,10,True,True,0.9847777777777778,-0.877144
9672,7537765,8549,2,0.678802,158,7539463,-1,1000.0,8128886,8137435,591121,8549,126,9,True,True,217.87243055555555,-0.6770500653585205
9673,7537949,63,20,0.899221,158,7539463,-1,10000.0,8674925,8674988,1136976,63,87,10,True,True,10.417750000000002,-0.899221
9674,7538406,43480,111,0.449269,158,7539463,-1,55500.0,9210164,9253644,1671758,43480,66,9,True,True,56117.981400000004,-0.43902868830797404
9675,7538432,144,8,0.958306,158,7539463,-1,4000.0,8646825,8646969,1108393,144,90,0,True,True,10.5424,-0.958306
9676,7541236,118,1,0.526907,173,7544863,-1,500.0,8565025,8565143,1023789,118,103,0,True,True,1.6762555555555558,-0.526907
9677,7541612,16086,8,0.265309,173,7544863,-1,4000.0,10095560,10111646,2553948,16086,26,8,True,True,956.0128888888888,-0.26243917903278324
9678,7541791,407,4,0.679066,173,7544863,-1,2000.0,8563854,8564261,1022063,407,109,9,True,True,24.386083333333332,-0.679066
9679,7541852,19,58,0.887995,173,7544863,-1,29000.0,7836619,7836638,294767,19,151,10,True,True,13.54388611111111,-0.887995
9680,7542109,173,4,0.391026,173,7544863,-1,2000.0,9361564,9361737,1819455,173,62,1,True,True,6.976705555555555,-0.391026
9681,7542142,19,2,0.417294,173,7544863,-1,1000.0,8230602,8230621,688460,19,130,9,True,True,0.3807916666666667,-0.417294
9682,7542176,299,7,0.993944,173,7544863,-1,3500.0,10187560,10187859,2645384,299,18,0,True,True,18.075380555555554,-0.9939440000000003
9683,7542197,10425,8,0.309323,173,7544863,-1,4000.0,8652225,8662650,1110028,10425,93,8,True,True,808.6091666666666,-0.30908218925080866
9684,7542226,15,8,0.0411,173,7544863,-1,4000.0,9774314,9774329,2232088,15,36,9,True,True,2.3905000000000003,-0.0411
9685,7542506,5,1,0.520078,173,7544863,-1,500.0,9905060,9905065,2362554,5,35,1,True,True,0.09436111111111112,-0.520078
9686,7542518,10317,1,0.343274,173,7544863,-1,500.0,8147402,8157719,604884,10317,137,1,True,True,163.9880847222222,-0.32964810230698005
9687,7543012,8973,128,0.612367,173,7544863,-1,64000.0,8241402,8250375,698390,8973,133,0,True,True,12437.879466666665,-0.6062372023859919
9688,7543040,8227,32,0.43346,173,7544863,-1,16000.0,10432233,10440460,2889193,8227,0,10,True,True,1527.8193333333331,-0.4035852869790283
9689,7543055,5167,1,0.455028,173,7544863,-1,500.0,10219107,10224274,2676052,5167,15,1,True,True,59.29224444444444,-0.44471132897872484
9690,7543071,9,4,0.968153,173,7544863,-1,2000.0,7661619,7661628,118548,9,164,0,True,True,0.4501,-0.968153
9691,7543195,2172,1,0.792341,173,7544863,-1,500.0,9380856,9383028,1837661,2172,61,3,True,True,27.784949999999995,-0.7914370956500323
9692,7554084,9942,4,0.288409,247,7633463,-1,2000.0,7661619,7671561,107535,9942,165,0,True,True,485.8401666666666,-0.28729509914250656
9693,7554231,35,32,0.96947,247,7633463,-1,16000.0,8136486,8136521,582255,35,143,8,True,True,14.154,-0.96947
9694,7554406,43,32,0.498927,247,7633463,-1,16000.0,10160560,10160603,2606154,43,23,7,True,True,13.022311111111112,-0.498927
9695,7554775,2,8,0.685527,247,7633463,-1,4000.0,9755914,9755916,2201139,2,46,9,True,True,0.20271111111111112,-0.685527
9696,7554832,53,16,0.466317,247,7633463,-1,8000.0,7896766,7896819,341934,53,156,3,True,True,8.721444444444444,-0.466317
9697,7554839,40,55,0.150228,247,7633463,-1,27500.0,9755914,9755954,2201075,40,46,0,True,True,27.87277777777778,-0.150228
9698,7554850,1522,14,0.966671,247,7633463,-1,7000.0,8322302,8323824,767452,1522,134,9,True,True,114.11112222222224,-0.8584334964678951
9699,7554855,11313,128,0.623795,247,7633463,-1,64000.0,9353564,9364877,1798709,11313,72,9,True,True,14758.72408888889,-0.6085544600314385
9700,7554941,19250,16,0.66432,247,7633463,-1,8000.0,8326024,8345274,771083,19250,134,7,True,True,2636.9228444444448,-0.6252305676817741
9701,7555000,46,8,0.303646,247,7633463,-1,4000.0,9376137,9376183,1821137,46,68,8,True,True,4.8622,-0.303646
9702,7555030,5551,4,0.28826,247,7633463,-1,2000.0,9706214,9711765,2151184,5551,51,10,True,True,233.58843333333334,-0.2831098959969969
9703,7555576,9,3,0.799785,247,7633463,-1,1500.0,9861814,9861823,2306238,9,40,12,True,True,0.567525,-0.799785
9704,7555625,8,12,0.015592,247,7633463,-1,6000.0,8550824,8550832,995199,8,128,12,True,True,1.3050666666666666,-0.015592
9705,7555664,5,1,0.040953,247,7633463,-1,500.0,8551924,8551929,996260,5,128,0,True,True,0.06797222222222223,-0.040953
9706,7555997,5,3,0.283017,247,7633463,-1,1500.0,9094312,9094317,1538315,5,87,8,True,True,0.25235416666666666,-0.283017
9707,7556017,9121,32,0.593072,247,7633463,-1,16000.0,7748019,7757140,192002,9121,179,0,True,True,3546.4007111111114,-0.5852627768310346
9708,7556166,31,8,0.053193,247,7633463,-1,4000.0,8218702,8218733,662536,31,153,6,True,True,3.0256000000000003,-0.053193
9709,7556438,21446,1,0.305822,247,7633463,-1,500.0,8427624,8449070,871186,21446,136,7,True,True,336.9359722222222,-0.3057395163107418
9710,7556455,96,31,0.430323,247,7633463,-1,15500.0,9355764,9355860,1799309,96,75,0,True,True,29.4128,-0.430323
9711,7556597,36,2,0.660253,247,7633463,-1,1000.0,8571525,8571561,1014928,36,118,6,True,True,0.9425,-0.660253
9712,7556755,6,1,0.000642,247,7633463,-1,500.0,10140960,10140966,2584205,6,28,7,True,True,0.08255000000000001,-0.000642
9713,7556892,9528,32,0.251433,247,7633463,-1,16000.0,9473333,9482861,1916441,9528,64,6,True,True,3094.572888888889,-0.24481353779618853
9714,7556984,9,16,0.350218,247,7633463,-1,8000.0,9342764,9342773,1785780,9,79,12,True,True,1.5578,-0.350218
9715,7558656,58,8,0.283266,247,7633463,-1,4000.0,8217602,8217660,658946,58,160,0,True,True,5.6608,-0.283266
9716,7558728,21,2,0.859011,247,7633463,-1,1000.0,7997266,7997287,438538,21,174,12,True,True,0.5957583333333333,-0.859011
9717,7558783,39,32,0.665326,247,7633463,-1,16000.0,9444656,9444695,1885873,39,66,7,True,True,17.146133333333335,-0.665326
9718,7558912,32,32,0.768885,247,7633463,-1,16000.0,8582325,8582357,1023413,32,122,9,True,True,13.009066666666666,-0.768885
9719,7559187,7647,29,0.155037,247,7633463,-1,14500.0,8196002,8203649,636815,7647,163,11,True,True,1175.5696569444444,-0.15038351609212972
9720,7559722,9032,16,0.086003,247,7633463,-1,8000.0,8311502,8320534,751780,9032,151,7,True,True,960.2484888888888,-0.07112632464398284
9721,7559765,2,2,0.270669,247,7633463,-1,1000.0,9386256,9386258,1826491,2,69,8,True,True,0.050888888888888886,-0.270669
9722,7559900,26386,165,0.995914,247,7633463,-1,82500.0,10187560,10213946,2627660,26386,20,0,True,True,42083.67533333333,-0.9524171149428377
9723,7559976,9378,1,0.196727,247,7633463,-1,500.0,7910866,7920244,350890,9378,181,6,True,True,105.29760833333333,-0.18741577241445556
9724,7560136,28,13,0.585225,247,7633463,-1,6500.0,8131086,8131114,570950,28,170,7,True,True,4.734527777777778,-0.585225
9725,7560771,9,2,0.080718,247,7633463,-1,1000.0,8551924,8551933,991153,9,139,6,True,True,0.2447,-0.080718
9726,7560886,251,8,0.218858,247,7633463,-1,4000.0,8464424,8464675,903538,251,141,7,True,True,15.230122222222223,-0.218858
9727,7561424,240,8,0.473178,247,7633463,-1,4000.0,10407709,10407949,2846285,240,7,7,True,True,21.429333333333332,-0.473178
9728,7561428,10,2,0.354632,247,7633463,-1,1000.0,10310388,10310398,2748960,10,13,0,True,True,0.4640277777777778,-0.354632
9729,7561500,8311,8,0.811709,247,7633463,-1,4000.0,9235064,9243375,1673564,8311,88,0,True,True,627.5888666666667,-0.7976985111291693
9730,7561546,8018,128,0.637045,247,7633463,-1,64000.0,8274438,8282456,712892,8018,162,2,True,True,8293.928177777778,-0.6080533740315378
9731,7561575,499,8,0.422563,247,7633463,-1,4000.0,9355764,9356263,1794189,499,83,7,True,True,39.45426666666666,-0.422563
9732,7561780,114,32,0.966907,247,7633463,-1,16000.0,8042666,8042780,480886,114,185,10,True,True,65.22826666666667,-0.966907
9733,7561869,11828,123,0.098139,247,7633463,-1,61500.0,9377256,9389084,1815387,11828,74,1,True,True,18620.651566666664,-0.09721592842474129
9734,7561916,15,16,0.261261,247,7633463,-1,8000.0,7793419,7793434,231503,15,204,7,True,True,3.0283333333333333,-0.261261
9735,7561944,37,1,0.302023,247,7633463,-1,500.0,7907566,7907603,345622,37,192,9,True,True,0.47663194444444446,-0.302023
9736,7562063,148,64,0.310736,247,7633463,-1,32000.0,9100664,9100812,1538601,148,98,2,True,True,150.24746666666667,-0.30926932168874754
9737,7562097,26,32,0.563908,247,7633463,-1,16000.0,8614025,8614051,1051928,26,127,2,True,True,9.379644444444445,-0.563908
9738,7562119,700,13,0.678923,247,7633463,-1,6500.0,9254164,9254864,1692045,700,88,9,True,True,97.87555555555555,-0.678923
9739,7562305,3,2,0.32248,247,7633463,-1,1000.0,8603925,8603928,1041620,3,131,10,True,True,0.07556666666666667,-0.32248
9740,7562431,6273,8,0.578167,247,7633463,-1,4000.0,7748019,7754292,185588,6273,212,12,True,True,632.4888000000001,-0.5748751113872337
9741,7562440,4825,16,0.683321,247,7633463,-1,8000.0,10158360,10163185,2595920,4825,27,8,True,True,760.4368888888889,-0.6085150499815882
9742,7562457,999,4,0.199507,247,7633463,-1,2000.0,10143160,10144159,2580703,999,31,6,True,True,51.15990000000001,-0.199507
9743,7562624,42,1,0.135691,247,7633463,-1,500.0,10193360,10193402,2630736,42,20,0,True,True,0.3375166666666667,-0.135691
9744,7562724,6792,128,0.554284,247,7633463,-1,64000.0,8285502,8292294,722778,6792,170,1,True,True,5183.618133333333,-0.5302588842306347
9745,7562749,15,1,0.301062,247,7633463,-1,500.0,9774314,9774329,2211565,15,48,0,True,True,0.29881250000000004,-0.301062
9746,7562848,7025,2,0.085598,247,7633463,-1,1000.0,10309107,10316132,2746259,7025,16,12,True,True,296.9358472222222,-0.08207734800823538
9747,7562964,28,1,0.566665,247,7633463,-1,500.0,10066360,10066388,2503396,28,42,10,True,True,0.2338388888888889,-0.566665
9748,7562969,86,1,0.628319,247,7633463,-1,500.0,8085866,8085952,522897,86,197,11,True,True,1.2202444444444445,-0.628319
9749,7562995,13964,16,0.545831,247,7633463,-1,8000.0,9357964,9371928,1794969,13964,89,7,True,True,2477.527644444445,-0.516790855532027
9750,7563194,10781,20,0.375966,247,7633463,-1,10000.0,10319109,10329890,2755915,10781,10,6,True,True,3928.109388888889,-0.3695413242757873
9751,7563252,6624,2,0.875921,247,7633463,-1,1000.0,9775414,9782038,2212162,6624,51,6,True,True,251.85427222222225,-0.8525380310059478
9752,7563313,139,8,0.436893,247,7633463,-1,4000.0,7909766,7909905,346453,139,207,7,True,True,14.275300000000001,-0.436893
9753,7564405,6,1,0.13861,247,7633463,-1,500.0,7791219,7791225,226814,6,222,10,True,True,0.07570833333333334,-0.13861
9754,7564740,14547,1,0.441901,247,7633463,-1,500.0,8753832,8768379,1189092,14547,121,6,True,True,177.75054583333335,-0.43041785810161015
9755,7564774,6,16,0.31326,247,7633463,-1,8000.0,8439524,8439530,874750,6,164,9,True,True,1.4761333333333333,-0.31326
9756,7564834,20618,32,0.93488,247,7633463,-1,16000.0,9110764,9131382,1545930,20618,106,2,True,True,9836.472,-0.9119719485648159
9757,7564875,32,4,0.712599,247,7633463,-1,2000.0,9232864,9232896,1667989,32,102,6,True,True,1.4972444444444444,-0.712599
9758,7564880,13,8,0.468379,247,7633463,-1,4000.0,9239764,9239777,1674884,13,99,6,True,True,0.9526111111111111,-0.468379
9759,7565888,11,2,0.427669,247,7633463,-1,1000.0,8112686,8112697,546798,11,202,8,True,True,0.2664444444444445,-0.427669
9760,7565897,69,2,0.420506,247,7633463,-1,1000.0,8152802,8152871,586905,69,194,8,True,True,1.9538499999999999,-0.420506
9761,7565911,20256,128,0.410259,247,7633463,-1,64000.0,10041160,10061416,2475249,20256,45,11,True,True,22910.41422222222,-0.40834219373663766
9762,7566277,4590,1,0.027673,247,7633463,-1,500.0,7852219,7856809,285942,4590,221,8,True,True,49.00653055555555,-0.02767202909844544
9763,7566559,28,32,0.558909,247,7633463,-1,16000.0,8217602,8217630,651043,28,194,10,True,True,10.9312,-0.558909
9764,7566576,2,32,0.957492,247,7633463,-1,16000.0,10319109,10319111,2752533,2,9,0,True,True,1.2078222222222221,-0.957492
9765,7566639,79,4,0.420919,247,7633463,-1,2000.0,8653325,8653404,1086686,79,135,6,True,True,2.856727777777778,-0.420919
9766,7566742,64,5,0.755856,247,7633463,-1,2500.0,9712714,9712778,2145972,64,65,6,True,True,3.543111111111111,-0.755856
9767,7566922,8560,8,0.615209,247,7633463,-1,4000.0,9429456,9438016,1862534,8560,83,11,True,True,1398.3253333333334,-0.5663774026356171
7477,5838914,19466,16,0.616028,1,5838914,-1,8000.0,5849714,5869180,10800,19466,0,9,True,True,8367.862488888888,-0.6047615264693017
7478,5839417,118,8,0.189102,9,5849714,-1,4000.0,5865914,5866032,26497,118,0,9,True,True,26.163222222222227,-0.189102
7479,5839583,4,2,0.535468,9,5849714,-1,1000.0,5880314,5880318,40731,4,0,1,True,True,0.19855555555555554,-0.535468
7480,5839618,2272,4,0.789588,9,5849714,-1,2000.0,5883918,5886190,44300,2272,0,2,True,True,219.38452222222222,-0.7861421642028662
7481,5839644,34,8,0.327681,9,5849714,-1,4000.0,6107835,6107869,268191,34,0,11,True,True,6.28811111111111,-0.327681
7482,5839700,19967,1,0.053259,9,5849714,-1,500.0,5876714,5896681,37014,19967,3,9,True,True,469.4365861111111,-0.05256457887437233
7483,5839896,20,1,0.795612,9,5849714,-1,500.0,6195422,6195442,355526,20,0,1,True,True,0.6305555555555555,-0.795612
7484,5840012,82,4,0.872851,9,5849714,-1,2000.0,5880318,5880400,40306,82,3,0,True,True,8.140777777777778,-0.872851
7485,5840100,18,1,0.851503,9,5849714,-1,500.0,5855114,5855132,15014,18,7,8,True,True,0.462925,-0.851503
7486,5840188,107,1,0.968384,9,5849714,-1,500.0,8562736,8562843,2722548,107,0,11,True,True,1.6069319444444443,-0.968384
7487,5870614,11551,32,0.885834,7,5876714,-1,16000.0,5880318,5891869,9704,11551,5,1,True,True,8684.569244444443,-0.8716278127509004
7488,5880600,3,16,0.209238,10,5883918,-1,8000.0,8651336,8651339,2770736,3,0,12,True,True,0.9319333333333334,-0.209238
7489,5880962,15,2,0.081408,10,5883918,-1,1000.0,5889318,5889333,8356,15,4,8,True,True,0.6894166666666667,-0.081408
7490,5881100,68,4,0.470667,10,5883918,-1,2000.0,7062384,7062452,1181284,68,2,7,True,True,3.6625555555555556,-0.470667
7491,5881385,2,8,0.663502,10,5883918,-1,4000.0,7068830,7068832,1187445,2,2,6,True,True,0.27826666666666666,-0.663502
7492,5881622,112,17,0.064873,10,5883918,-1,8500.0,7220043,7220155,1338421,112,2,8,True,True,27.988799999999998,-0.064873
7493,5883158,1641,1,0.508614,10,5883918,-1,500.0,7452343,7453984,1569185,1641,2,7,True,True,35.60742083333333,-0.508614
7494,5883784,6,1,0.751308,10,5883918,-1,500.0,5891869,5891875,8085,6,8,2,True,True,0.13143333333333335,-0.751308
7495,5885585,1201,64,0.645072,15,5889318,-1,32000.0,5896586,5897787,11001,1201,8,1,True,True,1569.855288888889,-0.5955470528485595
7496,5887426,17,64,0.509159,15,5889318,-1,32000.0,5896569,5896586,9143,17,9,6,True,True,24.06897777777778,-0.509159
7497,5888353,2940,16,0.498588,15,5889318,-1,8000.0,7439343,7442283,1550990,2940,3,8,True,True,1747.387866666667,-0.4504340939714403
7498,5888516,102,4,0.464267,15,5889318,-1,2000.0,7989746,7989848,2101230,102,2,10,True,True,4.879566666666666,-0.464267
7499,5889002,20,8,0.321823,15,5889318,-1,4000.0,8281788,8281808,2392786,20,2,0,True,True,2.4164444444444446,-0.321823
7500,5889054,7028,1,0.373879,15,5889318,-1,500.0,5964086,5971114,75032,7028,11,2,True,True,147.97541111111113,-0.3683646849809803
7501,5890305,1107,1,0.69451,18,5891869,-1,500.0,5941986,5943093,51681,1107,12,11,True,True,18.905099999999997,-0.69451
7502,5890888,78,1,0.71565,18,5891869,-1,500.0,5895469,5895547,4581,78,15,2,True,True,1.7255333333333334,-0.71565
7503,5890994,2,64,0.494792,18,5891869,-1,32000.0,7473943,7473945,1582949,2,4,10,True,True,3.3363555555555555,-0.494792
7504,5891319,21,4,0.268335,18,5891869,-1,2000.0,6735625,6735646,844306,21,10,0,True,True,1.703566666666667,-0.268335
7505,5894446,38,1,0.400946,18,5895469,-1,500.0,7055784,7055822,1161338,38,10,1,True,True,0.43430833333333335,-0.400946
7506,5895769,6344,1,0.921185,20,5896569,-1,500.0,6829625,6835969,933856,6344,11,12,True,True,127.51536388888888,-0.9112885859424659
7507,5895801,14,16,0.583983,20,5896569,-1,8000.0,5898786,5898800,2985,14,17,7,True,True,4.492444444444445,-0.583983
7508,5896365,6,16,0.036604,20,5896569,-1,8000.0,5952886,5952892,56521,6,16,7,True,True,1.9926666666666666,-0.036604
7509,5897788,87,45,0.219526,20,5898786,-1,22500.0,6195335,6195422,297547,87,14,6,True,True,123.43124999999999,-0.219526
7510,5897835,22,1,0.203,20,5898786,-1,500.0,7115243,7115265,1217408,22,8,0,True,True,0.38854444444444447,-0.203
7511,5903646,2,16,0.863168,56,5941986,-1,8000.0,7212443,7212445,1308797,2,8,9,True,True,0.34084444444444445,-0.863168
7512,5903692,5511,16,0.3959,56,5941986,-1,8000.0,7597443,7602954,1693751,5511,4,9,True,True,1844.9977333333334,-0.3958243248753073
7513,5903830,14,1,0.305999,56,5941986,-1,500.0,5948486,5948500,44656,14,21,8,True,True,0.26318055555555553,-0.305999
7514,5903854,21512,256,0.888709,56,5941986,-1,128000.0,6931278,6952790,1027424,21512,14,8,True,True,51152.83768888889,-0.8817537612911683
7515,5903891,13741,32,0.57137,56,5941986,-1,16000.0,7039190,7052931,1135299,13741,14,12,True,True,3235.911511111111,-0.5036886575363209
7516,5903910,6463,1,0.935499,56,5941986,-1,500.0,6889425,6895888,985515,6463,16,10,True,True,86.97194166666667,-0.9250423828973091
7517,5904073,7,16,0.374107,56,5941986,-1,8000.0,7495543,7495550,1591470,7,5,10,True,True,3.268377777777778,-0.374107
7518,5904109,192,32,0.550552,56,5941986,-1,16000.0,6835025,6835217,930916,192,18,8,True,True,113.47626666666666,-0.550552
7519,5904173,54,29,0.13433,56,5941986,-1,14500.0,6920478,6920532,1016305,54,17,9,True,True,21.58905,-0.13433
7520,5904231,20,8,0.084028,56,5941986,-1,4000.0,6896625,6896645,992394,20,18,0,True,True,2.1546666666666665,-0.084028
7521,5904299,7667,1,0.444505,56,5941986,-1,500.0,5953986,5961653,49687,7667,27,6,True,True,169.77957361111112,-0.44356459784443913
7522,5904344,7,4,0.351575,56,5941986,-1,2000.0,5948486,5948493,44142,7,29,0,True,True,0.5263611111111111,-0.351575
7523,5904545,13,64,0.583962,56,5941986,-1,32000.0,6590825,6590838,686280,13,23,7,True,True,19.573955555555553,-0.583962
7524,5905986,11287,128,0.465253,56,5941986,-1,64000.0,6679425,6690712,773439,11287,23,11,True,True,26801.18328888889,-0.4602844374229669
7525,5906035,4050,67,0.621126,56,5941986,-1,33500.0,8040840,8044890,2134805,4050,3,8,True,True,8065.728000000001,-0.6042313728
7526,5906485,4656,2,0.426102,56,5941986,-1,1000.0,7968146,7972802,2061661,4656,5,9,True,True,192.39588333333333,-0.42375503552524846
7527,5906664,83,37,0.467551,56,5941986,-1,18500.0,6418422,6418505,511758,83,27,9,True,True,62.96829583333333,-0.467551
7528,5906719,25,1,0.408953,56,5941986,-1,500.0,5943086,5943111,36367,25,36,6,True,True,0.4269444444444444,-0.408953
7529,5906995,65,8,0.804504,56,5941986,-1,4000.0,6636225,6636290,729230,65,26,7,True,True,9.170777777777777,-0.804504
7530,5907080,18,4,0.31702,56,5941986,-1,2000.0,5969486,5969504,62406,18,32,8,True,True,1.5193,-0.31702
7531,5907182,677,2,0.382371,56,5941986,-1,1000.0,7995248,7995925,2088066,677,4,8,True,True,23.85611111111111,-0.3547859215872525
7532,5907513,29749,128,0.179566,56,5941986,-1,64000.0,5943086,5972835,35573,29749,39,0,True,True,79309.06382222222,-0.17771235364604063
7533,5908228,324,8,0.23379,56,5941986,-1,4000.0,8011525,8011849,2103297,324,4,2,True,True,53.7264,-0.23379
7534,5922727,807,2,0.645355,56,5941986,-1,1000.0,7064130,7064937,1141403,807,17,2,True,True,26.471841666666666,-0.645355
7535,5922836,12,1,0.359093,56,5941986,-1,500.0,7450143,7450155,1527307,12,12,9,True,True,0.2657,-0.359093
7536,5922893,56,8,0.082419,56,5941986,-1,4000.0,8156088,8156144,2233195,56,3,10,True,True,15.044711111111111,-0.082419
7537,5923043,9440,30,0.842603,56,5941986,-1,15000.0,6064635,6074075,141592,9440,37,8,True,True,4936.1677083333325,-0.8330800131016995
7538,5923741,6610,32,0.512791,56,5941986,-1,16000.0,7227643,7234253,1303902,6610,15,7,True,True,2217.192088888889,-0.46213137520575187
7539,5924008,267,32,0.643654,56,5941986,-1,16000.0,7201643,7201910,1277635,267,18,11,True,True,82.14106666666667,-0.643654
7540,5924145,828,2,0.785873,56,5941986,-1,1000.0,8127988,8128816,2203843,828,4,0,True,True,74.05353333333333,-0.781967397367853
7541,5937302,20,8,0.926606,56,5941986,-1,4000.0,7957346,7957366,2020044,20,10,0,True,True,3.247333333333333,-0.926606
7542,5937343,15455,1,0.098409,56,5941986,-1,500.0,8281788,8297243,2344445,15455,3,1,True,True,226.1050111111111,-0.09772848880902243
7543,5937364,22032,1,0.071349,56,5941986,-1,500.0,8084040,8106072,2146676,22032,6,11,True,True,565.5030333333333,-0.06939252575952752
7544,5937459,60,16,0.038281,56,5941986,-1,8000.0,6313222,6313282,375763,60,40,7,True,True,16.542666666666666,-0.038281
7545,5938122,17491,128,0.200307,56,5941986,-1,64000.0,8114340,8131831,2176218,17491,6,10,True,True,69728.53973333334,-0.1985665419392057
7546,5939596,10,1,0.196646,56,5941986,-1,500.0,6586425,6586435,646829,10,40,11,True,True,0.2711805555555556,-0.196646
7547,5940046,5,9,0.329241,56,5941986,-1,4500.0,7646043,7646048,1705997,5,14,10,True,True,0.7021250000000001,-0.329241
7548,5943944,43,16,0.302716,58,5948486,-1,8000.0,6952790,6952833,1008846,43,31,0,True,True,6.225444444444445,-0.302716
7549,5944054,4569,8,0.815565,58,5948486,-1,4000.0,6681625,6686194,737571,4569,39,7,True,True,727.8387111111111,-0.8151173451671253
7550,5944985,16221,32,0.683539,58,5948486,-1,16000.0,8495733,8511954,2550748,16221,2,11,True,True,8143.5450666666675,-0.6489756923804381
7551,5945227,20,1,0.274465,58,5948486,-1,500.0,6453105,6453125,507878,20,45,0,True,True,0.3722777777777778,-0.274465
7552,5945250,9156,1,0.705643,58,5948486,-1,500.0,5950686,5959842,5436,9156,56,7,True,True,198.67154166666666,-0.6987179779246638
7553,5949338,6946,1,0.997996,59,5950686,-1,500.0,8035440,8042386,2086102,6946,10,7,True,True,209.02765555555555,-0.9979067917220852
7554,5949610,9251,4,0.998405,59,5950686,-1,2000.0,5960486,5969737,10876,9251,55,6,True,True,787.6460055555556,-0.9857771403179275
7555,5950566,59,4,0.752383,59,5950686,-1,2000.0,8006825,8006884,2056259,59,12,7,True,True,2.966388888888889,-0.752383
7556,5950742,7103,32,0.739821,70,5952886,-1,16000.0,6266722,6273825,315980,7103,50,8,True,True,4087.7762222222227,-0.7272021890686389
7557,5950940,1359,8,0.912383,70,5952886,-1,4000.0,8116540,8117899,2165600,1359,7,7,True,True,292.72860000000003,-0.912383
7558,5951016,40,8,0.008534,70,5952886,-1,4000.0,6909678,6909718,958662,40,38,1,True,True,4.008000000000001,-0.008534
7559,5951084,22235,2,0.299474,70,5952886,-1,1000.0,5959386,5981621,8302,22235,60,8,True,True,913.8393777777777,-0.29617486181264474
7560,5951247,6,1,0.822309,70,5952886,-1,500.0,8440988,8440994,2489741,6,3,12,True,True,0.0955,-0.822309
7561,5951296,6,78,0.783128,70,5952886,-1,39000.0,6636225,6636231,684929,6,47,0,True,True,8.2537,-0.783128
7562,5951655,140,1,0.403811,70,5952886,-1,500.0,6896625,6896765,944970,140,41,2,True,True,1.8853333333333333,-0.403811
7563,5951854,12,1,0.405758,70,5952886,-1,500.0,5972835,5972847,20981,12,60,4,True,True,0.24673333333333333,-0.405758
7564,5951926,14,1,0.579954,70,5952886,-1,500.0,6588625,6588639,636699,14,51,6,True,True,0.3293694444444444,-0.579954
7565,5951995,14,28,0.655309,70,5952886,-1,14000.0,6453105,6453119,501110,14,54,9,True,True,7.2966444444444445,-0.655309
7566,5952001,11284,16,0.472004,70,5952886,-1,8000.0,8133388,8144672,2181387,11284,7,8,True,True,6430.973866666666,-0.44175701206786827
7567,5952197,8289,16,0.512647,70,5952886,-1,8000.0,7768152,7776441,1815955,8289,20,6,True,True,3190.6174,-0.5118730821531572
7568,5953161,12067,16,0.761161,70,5953986,-1,8000.0,8277088,8289155,2323927,12067,6,10,True,True,2894.0033777777776,-0.7583365881945228
7569,5955024,20,4,0.149281,74,5959386,-1,2000.0,7495543,7495563,1540519,20,24,0,True,True,2.3345555555555557,-0.149281
7570,5955318,15,1,0.397505,74,5959386,-1,500.0,6529125,6529140,573807,15,57,1,True,True,0.267625,-0.397505
7571,5955467,16,16,0.226926,74,5959386,-1,8000.0,6309922,6309938,354455,16,62,11,True,True,4.5568,-0.226926
7572,5955906,27,1,0.749137,74,5959386,-1,500.0,6059235,6059262,103329,27,68,12,True,True,0.4534125,-0.749137
7573,5956088,10745,1,0.474438,74,5959386,-1,500.0,6867825,6878570,911737,10745,47,7,True,True,126.87476388888889,-0.4723185087573524
7574,5961665,86,1,0.515825,73,5964086,-1,500.0,8015125,8015211,2053460,86,15,0,True,True,2.1773527777777777,-0.515825
7575,5969778,334,8,0.785975,74,5972835,-1,4000.0,6634025,6634359,664247,334,56,8,True,True,73.89935555555556,-0.785975
7576,5970831,20,1,0.757621,74,5972835,-1,500.0,6429305,6429325,458474,20,63,9,True,True,0.332,-0.757621
7577,5972158,9422,1,0.72251,74,5972835,-1,500.0,8651336,8660758,2679178,9422,0,0,True,True,175.8239638888889,-0.7199833040467618
7578,5972911,50,1,0.461401,93,6059235,-1,500.0,6418422,6418472,445511,50,65,0,True,True,1.0252083333333333,-0.461401
7579,5972972,7561,17,0.791915,93,6059235,-1,8500.0,7782346,7789907,1809374,7561,23,9,True,True,3040.714113888889,-0.7817894321887893
7580,5973042,2995,5,0.313075,93,6059235,-1,2500.0,8015840,8018835,2042798,2995,16,0,True,True,371.80309027777776,-0.30701825914027725
7581,5973569,43036,2,0.187847,93,6059235,-1,1000.0,8255488,8298524,2281919,43036,8,12,True,True,1329.1844555555556,-0.18683232779329131
7582,5975531,24,16,0.770131,93,6059235,-1,8000.0,7957346,7957370,1981815,24,24,0,True,True,7.7936000000000005,-0.770131
7583,5993285,22793,128,0.697941,93,6059235,-1,64000.0,6532425,6555218,539140,22793,65,7,True,True,67795.28391111111,-0.6926767392226673
7584,5995698,2,8,0.209585,93,6059235,-1,4000.0,8329388,8329390,2333690,2,5,7,True,True,0.2733555555555556,-0.209585
7585,5995748,7,4,0.449972,93,6059235,-1,2000.0,8018040,8018047,2022292,7,18,7,True,True,0.6837833333333334,-0.449972
7586,5995800,686,1,0.558447,93,6059235,-1,500.0,6865625,6866311,869825,686,56,10,True,True,7.6546166666666675,-0.558447
7587,5995817,602,1,0.3747,93,6059235,-1,500.0,7784546,7785148,1788729,602,28,7,True,True,13.944661111111111,-0.3747
7588,5995826,170,4,0.577508,93,6059235,-1,2000.0,6442305,6442475,446479,170,73,9,True,True,8.589722222222223,-0.577508
7589,5997313,37,6,0.128346,93,6059235,-1,3000.0,6530225,6530262,532912,37,70,6,True,True,3.96085,-0.128346
7590,5997397,69,8,0.943354,93,6059235,-1,4000.0,8031040,8031109,2033643,69,18,7,True,True,13.169033333333333,-0.943354
7591,5997607,47,16,0.009681,93,6059235,-1,8000.0,6476925,6476972,479318,47,73,7,True,True,17.81822222222222,-0.009681
7592,6010433,2573,2,0.810401,93,6059235,-1,1000.0,7315143,7317716,1304710,2573,40,6,True,True,67.1466138888889,-0.8102099505415994
7593,6010526,2,4,0.834299,93,6059235,-1,2000.0,6453125,6453127,442599,2,75,2,True,True,0.14891111111111113,-0.834299
7594,6010551,78,1,0.339822,93,6059235,-1,500.0,7667652,7667730,1657101,78,32,1,True,True,1.3950083333333334,-0.339822
7595,6010570,6486,32,0.419147,93,6059235,-1,16000.0,7212443,7218929,1201873,6486,44,0,True,True,2655.3941777777777,-0.37894363480970644
7596,6010615,23,1,0.685763,93,6059235,-1,500.0,6431505,6431528,420890,23,81,0,True,True,0.3385472222222223,-0.685763
7597,6011833,103,8,0.403369,93,6059235,-1,4000.0,6543225,6543328,531392,103,73,9,True,True,19.776,-0.403369
7598,6084405,10,1,0.778643,156,6107835,-1,500.0,6741025,6741035,656620,10,64,8,True,True,0.21243055555555554,-0.778643
7599,6084716,8396,8,0.537604,156,6107835,-1,4000.0,7496643,7505039,1411927,8396,35,6,True,True,1875.0795777777778,-0.5238241330637698
7600,6085683,12,4,0.32608,156,6107835,-1,2000.0,8040840,8040852,1955157,12,16,0,True,True,1.4754666666666667,-0.32608
7601,6085768,291,64,0.02324,156,6107835,-1,32000.0,6311022,6311313,225254,291,90,6,True,True,320.92773333333326,-0.02324
7602,6085843,31,32,0.785358,156,6107835,-1,16000.0,6260222,6260253,174379,31,93,11,True,True,18.485644444444443,-0.785358
7603,6085865,8087,26,0.922144,156,6107835,-1,13000.0,6194235,6202322,108370,8087,96,12,True,True,7137.167194444444,-0.917120142460145
7604,6093970,4,2,0.153691,156,6107835,-1,1000.0,7995925,7995929,1901955,4,25,2,True,True,0.1519111111111111,-0.153691
7605,6094137,1277,1,0.952638,156,6107835,-1,500.0,8089440,8090717,1995303,1277,15,8,True,True,34.127824999999994,-0.952638
7606,6094181,836,16,0.330251,156,6107835,-1,8000.0,6407622,6408458,313441,836,91,1,True,True,382.8027111111111,-0.28591054819889156
7607,6094592,4818,1,0.629839,156,6107835,-1,500.0,6474725,6479543,380133,4818,83,10,True,True,118.05653472222222,-0.606820181251125
7608,6094727,8,8,0.603003,156,6107835,-1,4000.0,6735625,6735633,640898,8,70,0,True,True,1.2979555555555558,-0.603003
7609,6094907,18787,2,0.607837,156,6107835,-1,1000.0,6840425,6859212,745518,18787,66,0,True,True,680.0918583333333,-0.6043415243433897
7610,6094978,10,4,0.866945,156,6107835,-1,2000.0,6360822,6360832,265844,10,95,0,True,True,0.676,-0.866945
7611,6095254,11,44,0.980172,156,6107835,-1,22000.0,6217022,6217033,121768,11,101,10,True,True,15.271544444444446,-0.9801720000000003
7612,6095273,34,1,0.204205,156,6107835,-1,500.0,6334822,6334856,239549,34,96,9,True,True,0.5782361111111112,-0.204205
7613,6095276,750,8,0.390636,156,6107835,-1,4000.0,8092740,8093490,1997464,750,15,6,True,True,185.74200000000002,-0.38604688434158024
7614,6095281,697,1,0.534491,156,6107835,-1,500.0,7756252,7756949,1660971,697,36,12,True,True,12.169426388888889,-0.534491
7615,6095288,87,1,0.188339,156,6107835,-1,500.0,6840425,6840512,745137,87,69,8,True,True,1.5852125,-0.188339
7616,6095300,5354,8,0.108638,156,6107835,-1,4000.0,8345588,8350942,2250288,5354,5,9,True,True,550.1541555555556,-0.10590216500739591
7617,6095363,19008,8,0.569515,156,6107835,-1,4000.0,6503925,6522933,408562,19008,88,8,True,True,3449.1875,-0.5497787911648953
7618,6095534,31,4,0.451535,156,6107835,-1,2000.0,7586643,7586674,1491109,31,41,11,True,True,2.3962999999999997,-0.451535
7619,6095582,113,2,0.894744,156,6107835,-1,1000.0,8452533,8452646,2356951,113,4,8,True,True,4.0271944444444445,-0.894744
7620,6095896,137,32,0.093242,156,6107835,-1,16000.0,6741025,6741162,645129,137,75,0,True,True,93.12955555555556,-0.093242
7621,6095972,9,2,0.104313,156,6107835,-1,1000.0,7667643,7667652,1571671,9,40,10,True,True,0.321925,-0.104313
7622,6095994,6961,17,0.552907,156,6107835,-1,8500.0,6636225,6643186,540231,6961,82,0,True,True,2190.659052777778,-0.5456668938709933
7623,6096053,39045,8,0.032059,156,6107835,-1,4000.0,7055784,7094829,959731,39045,61,0,True,True,5707.464800000001,-0.0318402246484884
7624,6096103,12315,4,0.689025,156,6107835,-1,2000.0,8003525,8015840,1907422,12315,29,7,True,True,907.5797777777777,-0.6308774256753178
7625,6096127,23680,2,0.488613,156,6107835,-1,1000.0,8015840,8039520,1919713,23680,26,3,True,True,1238.559111111111,-0.47167702119668736
7626,6096190,11,1,0.186692,156,6107835,-1,500.0,7624443,7624454,1528253,11,44,8,True,True,0.24270277777777782,-0.186692
7627,6096215,699,18,0.069491,156,6107835,-1,9000.0,8091640,8092339,1995425,699,18,7,True,True,336.2539499999999,-0.069491
7628,6096769,50,1,0.962995,156,6107835,-1,500.0,6107835,6107885,11066,50,121,0,True,True,1.1559027777777777,-0.962995
7629,6096778,13995,36,0.283818,156,6107835,-1,18000.0,8678336,8692331,2581558,13995,0,8,True,True,9256.828150000001,-0.2817226742003509
7630,6096933,51,1,0.233039,156,6107835,-1,500.0,6590825,6590876,493892,51,92,0,True,True,1.1998458333333333,-0.233039
7631,6096961,72,4,0.65957,156,6107835,-1,2000.0,6360822,6360894,263861,72,112,0,True,True,4.8672,-0.65957
7632,6097020,8852,128,0.069979,156,6107835,-1,64000.0,8119136,8127988,2022116,8852,16,2,True,True,35864.93582222222,-0.0661721805117673
7633,6097126,33,8,0.057453,156,6107835,-1,4000.0,8134488,8134521,2037362,33,14,6,True,True,10.149333333333335,-0.057453
7634,6097130,279,4,0.518532,156,6107835,-1,2000.0,8334788,8335067,2237658,279,8,8,True,True,13.525300000000001,-0.518532
7635,6097184,6985,8,0.171826,156,6107835,-1,4000.0,6893025,6900010,795841,6985,78,1,True,True,739.3276666666666,-0.16717924075377077
7636,6097211,410,4,0.859707,156,6107835,-1,2000.0,8133388,8133798,2036177,410,16,0,True,True,63.04888888888889,-0.859707
7637,6097271,3,8,0.410861,156,6107835,-1,4000.0,8517333,8517336,2420062,3,4,0,True,True,0.3538,-0.410861
7638,6097277,278,2,0.157035,156,6107835,-1,1000.0,6741025,6741303,643748,278,88,0,True,True,11.811138888888888,-0.157035
7639,6097332,23,4,0.110744,156,6107835,-1,2000.0,6335922,6335945,238590,23,121,6,True,True,1.564638888888889,-0.110744
7640,6097351,23,32,0.536453,156,6107835,-1,16000.0,7057984,7058007,960633,23,71,7,True,True,9.242933333333333,-0.536453
7641,6098046,203,8,0.478251,156,6107835,-1,4000.0,6347822,6348025,249776,203,122,9,True,True,23.47807777777778,-0.478251
7642,6098145,19,1,0.068763,156,6107835,-1,500.0,8519536,8519555,2421391,19,4,1,True,True,0.27813888888888894,-0.068763
7643,6098202,1062,2,0.955097,156,6107835,-1,1000.0,7044590,7045652,946388,1062,75,8,True,True,14.929816666666667,-0.9524537436007905
7644,6098431,6,1,0.865699,156,6107835,-1,500.0,6337022,6337028,238591,6,125,6,True,True,0.0984,-0.865699
7645,6098546,4961,16,0.129932,156,6107835,-1,8000.0,7543443,7548404,1444897,4961,55,11,True,True,1341.743311111111,-0.12583302863977242
7646,6098955,14,1,0.205677,156,6107835,-1,500.0,7225443,7225457,1126488,14,65,8,True,True,0.17494166666666666,-0.205677
7647,6100368,8,26,0.432201,156,6107835,-1,13000.0,8001325,8001333,1900957,8,39,8,True,True,4.096733333333333,-0.432201
7648,6100373,624,1,0.709672,156,6107835,-1,500.0,8040840,8041464,1940467,624,28,0,True,True,19.181066666666666,-0.709672
7649,6100434,3,2,0.47478,156,6107835,-1,1000.0,6607025,6607028,506591,3,106,8,True,True,0.10130833333333333,-0.47478
7650,6100512,20254,16,0.603709,156,6107835,-1,8000.0,7214643,7234897,1114131,20254,69,7,True,True,4093.745088888889,-0.6011595664114758
7651,6100987,28,2,0.939154,156,6107835,-1,1000.0,7669852,7669880,1568865,28,51,7,True,True,0.9123333333333333,-0.939154
7652,6101020,9091,128,0.587492,156,6107835,-1,64000.0,6418505,6427596,317485,9091,126,2,True,True,21938.218133333336,-0.5549505295400946
7653,6101026,128,16,0.502475,156,6107835,-1,8000.0,8764736,8764864,2663710,128,0,12,True,True,36.73031111111111,-0.502475
7654,6101073,7,1,0.684836,156,6107835,-1,500.0,8765964,8765971,2664891,7,0,6,True,True,0.12554305555555556,-0.684836
7655,6106453,89,16,0.275441,156,6107835,-1,8000.0,7336743,7336832,1230290,89,68,10,True,True,29.435466666666667,-0.26934403788332917
7656,6106775,9486,8,0.007443,156,6107835,-1,4000.0,6404022,6413508,297247,9486,133,11,True,True,2134.2116,-0.006217616963996626
7657,6106898,10,16,0.142692,156,6107835,-1,8000.0,7957346,7957356,1850448,10,49,0,True,True,3.247333333333333,-0.142692
7658,6107010,66,32,0.06397,156,6107835,-1,16000.0,6628625,6628691,521615,66,112,10,True,True,69.57866666666666,-0.06397
7659,6107212,15,1,0.399237,156,6107835,-1,500.0,8764736,8764751,2657524,15,1,0,True,True,0.2690208333333333,-0.399237
7660,6107349,5513,1,0.807566,156,6107835,-1,500.0,6350022,6355535,242673,5513,139,7,True,True,67.49243333333334,-0.7213518505220261
7661,6107760,42,4,0.525857,156,6107835,-1,2000.0,7771546,7771588,1663786,42,53,7,True,True,4.190433333333334,-0.525857
7662,6107783,6,4,0.910303,156,6107835,-1,2000.0,8015125,8015131,1907342,6,40,2,True,True,0.6076333333333334,-0.910303
7663,6108059,58,1,0.879239,224,6194235,-1,500.0,8004625,8004683,1896566,58,43,6,True,True,1.015,-0.879239
7664,6108112,537,1,0.460205,224,6194235,-1,500.0,7767052,7767589,1658940,537,57,9,True,True,12.255533333333332,-0.460205
7665,6108162,11,4,0.576133,224,6194235,-1,2000.0,7423143,7423154,1314981,11,74,12,True,True,1.2977555555555558,-0.576133
7666,6108299,73,1,0.737291,224,6194235,-1,500.0,6925878,6925951,817579,73,95,8,True,True,0.9040847222222221,-0.737291
7667,6109439,8251,8,0.287912,224,6194235,-1,4000.0,6692425,6700676,582986,8251,113,9,True,True,1123.0038444444444,-0.27211271645941726
7668,6110021,745,2,0.880994,224,6194235,-1,1000.0,8446388,8447133,2336367,745,11,8,True,True,27.304249999999996,-0.880994
7669,6110292,24,16,0.456307,224,6194235,-1,8000.0,6735625,6735649,625333,24,114,11,True,True,7.7877333333333345,-0.456307
7670,6110560,683,2,0.700317,224,6194235,-1,1000.0,7433943,7434626,1323383,683,75,9,True,True,47.10274722222223,-0.6886182387991303
7671,6110618,475,1,0.711648,224,6194235,-1,500.0,8127988,8128463,2017370,475,25,8,True,True,21.347291666666667,-0.711648
7672,6111648,10744,4,0.297449,224,6194235,-1,2000.0,7067730,7078474,956082,10744,89,2,True,True,840.2692222222222,-0.2805867115550572
7673,6111677,29494,4,0.613028,224,6194235,-1,2000.0,7158443,7187937,1046766,29494,87,11,True,True,1766.586238888889,-0.6094455599866494
7674,6112290,396,7,0.809985,224,6194235,-1,3500.0,8118740,8119136,2006450,396,27,7,True,True,69.55025,-0.809985
7675,6112402,206,1,0.175126,224,6194235,-1,500.0,8518433,8518639,2406031,206,8,6,True,True,3.0156111111111112,-0.175126
7676,6112602,13650,14,0.249135,224,6194235,-1,7000.0,6324022,6337672,211420,13650,159,9,True,True,3254.073938888889,-0.2474552176677445
7677,6112924,20785,193,0.899965,224,6194235,-1,96500.0,7771546,7792331,1658622,20785,59,0,True,True,95412.71975694444,-0.885617058100913
7678,6116203,5,8,0.733244,224,6194235,-1,4000.0,7496643,7496648,1380440,5,72,0,True,True,1.1672777777777779,-0.733244
7679,6116352,1695,8,0.457828,224,6194235,-1,4000.0,6601625,6603320,485273,1695,132,9,True,True,260.0058888888889,-0.4198618640089385
7680,6116390,8,4,0.910833,224,6194235,-1,2000.0,7957346,7957354,1840956,8,57,12,True,True,0.6494666666666666,-0.910833
7681,6116853,16547,64,0.183444,224,6194235,-1,32000.0,8519536,8536083,2402683,16547,7,0,True,True,17507.166577777778,-0.18069240616942198
7682,6117029,5,2,0.568615,224,6194235,-1,1000.0,7989746,7989751,1872717,5,53,0,True,True,0.11959722222222223,-0.568615
7683,6118255,11693,41,0.393551,224,6194235,-1,20500.0,7039190,7050883,920935,11693,104,0,True,True,3420.429954166667,-0.38885666921857603
7684,6118441,9726,24,0.945687,224,6194235,-1,12000.0,6844025,6853751,725584,9726,117,2,True,True,4312.428633333333,-0.9447342174922924
7685,6118880,394,1,0.239695,224,6194235,-1,500.0,7055390,7055784,936510,394,103,9,True,True,4.503091666666667,-0.239695
7686,6118914,18,1,0.87054,224,6194235,-1,500.0,6360822,6360840,241908,18,163,9,True,True,0.3042,-0.87054
7687,6118928,95,1,0.273776,224,6194235,-1,500.0,7619043,7619138,1500115,95,72,10,True,True,1.8543472222222221,-0.273776
7688,6119064,23817,2,0.628083,224,6194235,-1,1000.0,6525525,6549342,406461,23817,148,10,True,True,998.493975,-0.5938000434836701
7689,6119108,9,4,0.29189,224,6194235,-1,2000.0,6587525,6587534,468417,9,143,6,True,True,0.9762500000000001,-0.29189
7690,6123749,14,4,0.916296,224,6194235,-1,2000.0,6261322,6261336,137573,14,177,6,True,True,1.0461888888888888,-0.916296
7691,6123915,18,4,0.698044,224,6194235,-1,2000.0,8354588,8354606,2230673,18,15,8,True,True,1.0345,-0.698044
7692,6124059,81,1,0.722409,224,6194235,-1,500.0,6498525,6498606,374466,81,152,10,True,True,2.0431125,-0.722409
7693,6124598,92,2,0.217255,224,6194235,-1,1000.0,8678336,8678428,2553738,92,3,0,True,True,3.4050222222222226,-0.217255
7694,6124770,8,1,0.493488,224,6194235,-1,500.0,8033240,8033248,1908470,8,42,7,True,True,0.22705555555555554,-0.493488
7695,6125092,2,5,0.99239,224,6194235,-1,2500.0,7044590,7044592,919498,2,108,0,True,True,0.07048611111111111,-0.99239
7696,6125214,4,4,0.552824,224,6194235,-1,2000.0,8028840,8028844,1903626,4,44,9,True,True,0.3817111111111111,-0.552824
7697,6125511,10193,16,0.995316,224,6194235,-1,8000.0,8283988,8294181,2158477,10193,20,7,True,True,2389.0972888888887,-0.9937262690927923
7698,6125774,15531,128,0.076534,224,6194235,-1,64000.0,8278188,8293719,2152414,15531,23,6,True,True,29510.831999999995,-0.07589355021757084
7699,6126004,10,16,0.105225,224,6194235,-1,8000.0,8007925,8007935,1881921,10,53,6,True,True,2.011111111111111,-0.105225
7700,6126999,20414,256,0.766539,224,6194235,-1,128000.0,7094829,7115243,967830,20414,104,1,True,True,103628.23822222221,-0.7624020018718524
7701,6127255,15208,4,0.326013,224,6194235,-1,2000.0,7068832,7084040,941577,15208,105,1,True,True,1244.3329777777778,-0.32304899076843757
7702,6127551,151,16,0.450936,224,6194235,-1,8000.0,8158288,8158439,2030737,151,26,0,True,True,59.75573333333334,-0.450936
7703,6128779,3,1,0.252767,224,6194235,-1,500.0,6952790,6952793,824011,3,119,0,True,True,0.027145833333333338,-0.252767
7704,6128835,200,32,0.506065,224,6194235,-1,16000.0,8764864,8765064,2636029,200,1,2,True,True,114.78222222222222,-0.506065
7705,6128855,154,2,0.462167,224,6194235,-1,1000.0,8089440,8089594,1960585,154,40,0,True,True,8.2313,-0.462167
7706,6129010,26,32,0.073195,224,6194235,-1,16000.0,8327188,8327214,2198178,26,21,11,True,True,14.214488888888889,-0.073195
7707,6130829,3,5,0.694486,224,6194235,-1,2500.0,7314043,7314046,1183214,3,99,12,True,True,0.19368749999999998,-0.694486
7708,6132809,32539,37,0.749736,224,6194235,-1,18500.0,8349188,8381727,2216379,32539,18,1,True,True,18014.363180555556,-0.7424947555740526
7709,6133298,352,1,0.381156,224,6194235,-1,500.0,8517333,8517685,2384035,352,13,10,True,True,5.180330555555556,-0.3805143005614368
7710,6133568,34,106,0.745957,224,6194235,-1,53000.0,7060184,7060218,926616,34,117,7,True,True,48.52886111111111,-0.745957
7711,6133731,53,4,0.855773,224,6194235,-1,2000.0,6909625,6909678,775894,53,132,9,True,True,2.6553,-0.855773
7712,6133928,6435,4,0.396674,224,6194235,-1,2000.0,6743225,6749660,609297,6435,144,7,True,True,579.0435833333333,-0.39606837108536846
7713,6134348,3,8,0.010737,224,6194235,-1,4000.0,8519533,8519536,2385185,3,11,6,True,True,0.3513333333333334,-0.010737
7714,6134461,109,4,0.114683,224,6194235,-1,2000.0,6418422,6418531,283961,109,184,0,True,True,8.939816666666667,-0.114683
7715,6134542,144,8,0.917137,224,6194235,-1,4000.0,7989848,7989992,1855306,144,67,2,True,True,13.7776,-0.917137
7716,6157938,30,8,0.32711,224,6194235,-1,4000.0,7074232,7074262,916294,30,114,8,True,True,5.066333333333334,-0.32711
7717,6158059,72,1,0.748676,224,6194235,-1,500.0,6431505,6431577,273446,72,183,7,True,True,1.0598,-0.748676
7718,6158070,1194,32,0.484759,224,6194235,-1,16000.0,7768152,7769346,1610082,1194,79,0,True,True,909.0466666666666,-0.46238964578306646
7719,6158142,61,8,0.068237,224,6194235,-1,4000.0,8672936,8672997,2514794,61,6,10,True,True,8.500011111111112,-0.068237
7720,6166540,36,1,0.548429,224,6194235,-1,500.0,8169088,8169124,2002548,36,32,9,True,True,0.70545,-0.548429
7721,6166801,8740,64,0.242294,224,6194235,-1,32000.0,7055390,7064130,888589,8740,127,0,True,True,7418.245333333333,-0.22138069232184077
7722,6167111,15477,8,0.950018,224,6194235,-1,4000.0,8127988,8143465,1960877,15477,38,0,True,True,4381.973344444444,-0.8500002802893254
7723,6167127,12518,64,0.140256,224,6194235,-1,32000.0,8158288,8170806,1991161,12518,34,7,True,True,17158.466666666667,-0.13843094915410123
7724,6167151,6896,1,0.820427,224,6194235,-1,500.0,6898825,6905721,731674,6896,142,7,True,True,86.71575,-0.8180417141962733
7725,6167179,4606,42,0.841563,224,6194235,-1,21000.0,8564936,8569542,2397757,4606,9,7,True,True,2944.982016666667,-0.840278350645764
7726,6167293,35,32,0.170589,224,6194235,-1,16000.0,7646043,7646078,1478750,35,91,0,True,True,17.47511111111111,-0.170589
7727,6167321,2351,32,0.018066,224,6194235,-1,16000.0,8447133,8449484,2279812,2351,19,1,True,True,1374.0319111111112,-0.01800579221907642
7728,6167402,3,64,0.100515,224,6194235,-1,32000.0,8118740,8118743,1951338,3,45,0,True,True,4.817333333333334,-0.100515
7729,6168363,50,16,0.294145,224,6194235,-1,8000.0,7500243,7500293,1331880,50,100,2,True,True,21.18444444444444,-0.294145
7730,6170285,6,15,0.534654,224,6194235,-1,7500.0,7995248,7995254,1824963,6,73,0,True,True,1.471875,-0.534654
7731,6170812,28303,8,0.39085,224,6194235,-1,4000.0,7870946,7899249,1700134,28303,83,12,True,True,8738.356366666667,-0.382341389988436
7732,6170820,852,1,0.077585,224,6194235,-1,500.0,7769346,7770198,1598526,852,88,1,True,True,21.251483333333333,-0.077585
7714,6134461,109,4,0.114683,1,6134461,-1,2000.0,6134542,6134570,81,109,0,0,True,True,10.944205555555556,-0.114683
7715,6134542,144,8,0.917137,1,6134542,-1,4000.0,6157938,6135786,23396,144,0,6,True,True,21.296,-0.917137
7716,6157938,30,8,0.32711,1,6157938,-1,4000.0,6159038,6159068,1100,30,0,6,True,True,4.4366666666666665,-0.32711
7717,6158059,72,1,0.748676,3,6159038,-1,500.0,6180668,6180740,22609,72,0,10,True,True,1.4816999999999998,-0.748676
7718,6158070,1194,32,0.484759,3,6159038,-1,16000.0,6159038,6160232,968,1194,1,0,True,True,721.1201777777778,-0.47606886458478226
7719,6158142,61,8,0.068237,3,6159038,-1,4000.0,6159068,6159129,926,61,1,1,True,True,9.021222222222223,-0.068237
7720,6166540,36,1,0.548429,21,6180668,-1,500.0,8330524,8330560,2163984,36,0,9,True,True,0.6285499999999999,-0.548429
7721,6166801,8740,64,0.242294,21,6180668,-1,32000.0,6181840,6190580,15039,8740,1,6,True,True,12659.456,-0.24149459607004872
7722,6167111,15477,8,0.950018,21,6180668,-1,4000.0,6182940,6198417,15829,15477,1,6,True,True,2802.535233333333,-0.9419957590964966
7723,6167127,12518,64,0.140256,21,6180668,-1,32000.0,7865924,7878442,1698797,12518,1,1,True,True,10536.254577777778,-0.13729925274591975
7724,6167151,6896,1,0.820427,21,6180668,-1,500.0,7210811,7217707,1043660,6896,2,1,True,True,126.36324861111112,-0.8177067286069132
7725,6167179,4606,42,0.841563,21,6180668,-1,21000.0,8171324,8175930,2004145,4606,1,9,True,True,4013.30195,-0.8341537171603816
7726,6167293,35,32,0.170589,21,6180668,-1,16000.0,6180740,6180775,13447,35,6,1,True,True,23.048666666666666,-0.170589
7727,6167321,2351,32,0.018066,21,6180668,-1,16000.0,6645738,6648089,478417,2351,4,11,True,True,1336.5173777777777,-0.018066
7728,6167402,3,64,0.100515,21,6180668,-1,32000.0,7159159,7159162,991757,3,4,2,True,True,4.2912,-0.100515
7729,6168363,50,16,0.294145,21,6180668,-1,8000.0,6247489,6247539,79126,50,6,9,True,True,18.537777777777777,-0.294145
7730,6170285,6,15,0.534654,21,6180668,-1,7500.0,6848570,6848576,678285,6,5,7,True,True,1.5433750000000002,-0.534654
7731,6170812,28303,8,0.39085,21,6180668,-1,4000.0,8051724,8080027,1880912,28303,2,0,True,True,5530.123855555556,-0.3646023066616716
7732,6170820,852,1,0.077585,21,6180668,-1,500.0,7209959,7210811,1039139,852,5,7,True,True,23.453487499999998,-0.0772220636255387
7733,6171254,11,32,0.763589,21,6180668,-1,16000.0,7529726,7529737,1358472,11,4,0,True,True,3.1851111111111114,-0.763589
7734,6171266,6290,1,0.677383,21,6180668,-1,500.0,7248699,7254989,1077433,6290,5,0,True,True,130.0679736111111,-0.6472842595141179
7735,6171277,10237,3,0.153496,21,6180668,-1,1500.0,6190580,6200817,19303,10237,12,2,True,True,711.7611166666666,-0.1470641142742276
7736,6171329,8,10,0.358087,21,6180668,-1,5000.0,7150131,7150139,978802,8,9,0,True,True,1.4278888888888888,-0.358087
7737,6171796,29,4,0.216672,21,6180668,-1,2000.0,6252189,6252218,80393,29,12,1,True,True,2.6512444444444445,-0.216672
7738,6171947,8514,128,0.034445,21,6180668,-1,64000.0,8632812,8641326,2460865,8514,0,0,True,True,23745.11786666667,-0.03444086605293275
7739,6180587,10886,2,0.675044,21,6180668,-1,1000.0,6232977,6243863,52390,10886,15,7,True,True,685.812825,-0.6650989061757143
7740,6180626,47,1,0.216166,21,6180668,-1,500.0,7726205,7726252,1545579,47,5,0,True,True,0.5820166666666666,-0.216166
7741,6180674,58,1,0.696742,21,6180740,-1,500.0,6934970,6935028,754296,58,12,0,True,True,0.9802000000000001,-0.696742
7742,6180804,34,2,0.836501,23,6181840,-1,1000.0,6201380,6201414,20576,34,18,3,True,True,1.7570444444444444,-0.836501
7743,6180922,3,1,0.811512,23,6181840,-1,500.0,6236577,6236580,55655,3,17,2,True,True,0.10182083333333335,-0.811512
7744,6181531,14512,1,0.641012,23,6181840,-1,500.0,7335099,7349611,1153568,14512,7,11,True,True,207.62589027777776,-0.6162359699188767
7745,6181893,34,4,0.71641,37,6182940,-1,2000.0,6236633,6236667,54740,34,18,1,True,True,4.6158777777777775,-0.71641
7746,6181980,11445,16,0.89701,37,6182940,-1,8000.0,8733312,8744757,2551332,11445,0,0,True,True,4074.197,-0.7634656831650379
7747,6182070,10698,256,0.390618,37,6182940,-1,128000.0,7767157,7777855,1585087,10698,6,1,True,True,27682.82631111111,-0.3614436030586307
7748,6182223,59,2,0.308324,37,6182940,-1,1000.0,6805911,6805970,623688,59,17,10,True,True,4.281433333333334,-0.308324
7749,6182229,14021,8,0.052415,37,6182940,-1,4000.0,6759972,6773993,577743,14021,18,0,True,True,3268.8965777777776,-0.05060552825279735
7750,6182245,6,7,0.004666,37,6182940,-1,3500.0,7046331,7046337,864086,6,15,0,True,True,1.0515166666666667,-0.004666
7751,6182363,11,15,0.77241,37,6182940,-1,7500.0,8070524,8070535,1888161,11,4,7,True,True,4.613354166666667,-0.77241
7752,6182386,12,2,0.767114,37,6182940,-1,1000.0,7853557,7853569,1671171,12,7,12,True,True,0.2873,-0.767114
7753,6182528,13,32,0.928821,37,6182940,-1,16000.0,8039824,8039837,1857296,13,6,6,True,True,6.779066666666666,-0.928821
7754,6182662,527,8,0.374645,37,6182940,-1,4000.0,7410399,7410926,1227737,527,12,10,True,True,77.86717777777778,-0.374645
7755,6182694,1989,2,0.23854,37,6182940,-1,1000.0,6223877,6225866,41183,1989,30,2,True,True,75.60770277777777,-0.19095272937747257
7756,6182782,38,2,0.091386,37,6182940,-1,1000.0,6188340,6188378,5558,38,33,8,True,True,1.7752333333333334,-0.091386
7757,6182850,21,4,0.421683,37,6182940,-1,2000.0,8733312,8733333,2550462,21,1,0,True,True,2.820883333333333,-0.421683
7758,6182870,18,2,0.989291,37,6182940,-1,1000.0,6208280,6208298,25410,18,32,6,True,True,0.8513,-0.989291
7759,6182876,16473,21,0.337117,37,6182940,-1,10500.0,7565537,7582010,1382661,16473,12,7,True,True,4216.444983333333,-0.3275000533830691
7760,6183019,13368,6,0.192152,57,6188340,-1,3000.0,6197780,6211148,14761,13368,35,3,True,True,2014.8649333333333,-0.1906304994902212
7761,6183053,24,4,0.668949,57,6188340,-1,2000.0,7712537,7712561,1529484,24,12,6,True,True,1.3306666666666667,-0.668949
7762,6184878,28,1,0.220568,57,6188340,-1,500.0,7150131,7150159,965253,28,22,0,True,True,0.49976111111111104,-0.220568
7763,6186030,10651,4,0.882286,57,6188340,-1,2000.0,8057524,8068175,1871494,10651,6,3,True,True,772.616361111111,-0.717877074075378
7764,6186037,134,4,0.796924,57,6188340,-1,2000.0,6227177,6227311,41140,134,35,6,True,True,9.281733333333333,-0.796924
7765,6186291,7,1,0.830451,57,6188340,-1,500.0,6190540,6190547,4249,7,41,7,True,True,0.1567222222222222,-0.830451
7766,6186296,4,1,0.167883,57,6188340,-1,500.0,6194180,6194184,7884,4,40,1,True,True,0.08562777777777777,-0.167883
7767,6186359,9079,16,0.167047,57,6188340,-1,8000.0,6207180,6216259,20821,9079,38,2,True,True,3344.371044444444,-0.16496357502923067
7768,6186610,2,64,0.41568,57,6188340,-1,32000.0,8045224,8045226,1858614,2,8,8,True,True,2.4446222222222223,-0.41568
7769,6186646,12762,5,0.107684,57,6188340,-1,2500.0,8475512,8488274,2288866,12762,3,0,True,True,1366.1168194444447,-0.10287893975036275
7770,6186691,94,4,0.327141,57,6188340,-1,2000.0,6236689,6236783,49998,94,34,2,True,True,12.761544444444445,-0.327141
7771,6186720,10727,1,0.562054,57,6188340,-1,500.0,6255489,6266216,68769,10727,32,6,True,True,213.89795833333332,-0.5403484292364554
7772,6186760,4,16,0.189548,57,6188340,-1,8000.0,8050624,8050628,1863864,4,9,0,True,True,1.6681777777777778,-0.189548
7773,6187354,35732,16,0.207119,57,6188340,-1,8000.0,6401238,6436970,213884,35732,33,8,True,True,11526.36537777778,-0.1947290160333109
7774,6187374,16088,32,0.541703,57,6188340,-1,16000.0,6219080,6235168,31706,16088,43,9,True,True,12128.030222222224,-0.505293197604498
7775,6187428,7,4,0.938923,57,6188340,-1,2000.0,6395838,6395845,208410,7,34,12,True,True,0.5704611111111111,-0.938923
7776,6187452,40,4,0.120804,57,6188340,-1,2000.0,6236580,6236620,49128,40,40,0,True,True,5.430444444444444,-0.120804
7777,6187476,230,32,0.21378,57,6188340,-1,16000.0,6952331,6952561,764855,230,28,9,True,True,248.62488888888888,-0.21378
7778,6187562,4,1,0.356576,57,6188340,-1,500.0,6934970,6934974,747408,4,30,11,True,True,0.06760000000000001,-0.356576
7779,6187628,5482,64,0.173622,57,6188340,-1,32000.0,6835170,6840652,647542,5482,32,10,True,True,6522.059555555555,-0.1729121317474291
7780,6187688,7780,16,0.402139,57,6188340,-1,8000.0,6756372,6764152,568684,7780,35,6,True,True,2828.833866666667,-0.39841177130076005
7781,6196956,48,8,0.31624,59,6197780,-1,4000.0,7859357,7859405,1662401,48,13,2,True,True,5.279466666666667,-0.31624
7782,6197065,8715,64,0.389187,59,6197780,-1,32000.0,6602538,6611253,405473,8715,38,0,True,True,7332.8688,-0.38452891319725063
7783,6197309,20587,32,0.458776,59,6197780,-1,16000.0,6248589,6269176,51280,20587,43,6,True,True,13605.800711111111,-0.44580873273007027
7784,6197333,132,8,0.066016,59,6197780,-1,4000.0,8334556,8334688,2137223,132,4,2,True,True,19.006533333333334,-0.066016
7785,6197371,40,8,0.815085,59,6197780,-1,4000.0,6953431,6953471,756060,40,30,6,True,True,10.809777777777779,-0.815085
7786,6197433,8,4,0.649945,59,6197780,-1,2000.0,8051724,8051732,1854291,8,10,6,True,True,0.8340888888888889,-0.649945
7787,6198518,5,2,0.36898,66,6201380,-1,1000.0,7164559,7164564,966041,5,27,8,True,True,0.23526388888888888,-0.36898
7788,6198545,6037,1,0.067331,66,6201380,-1,500.0,8477885,8483922,2279340,6037,3,7,True,True,121.43150416666667,-0.05266260235132248
7789,6198567,13942,3,0.218561,66,6201380,-1,1500.0,7095031,7108973,896464,13942,32,7,True,True,820.8577791666667,-0.214960184789873
7790,6199325,12,4,0.301534,66,6201380,-1,2000.0,6733672,6733684,534347,12,43,1,True,True,1.6498666666666668,-0.301534
7791,6199601,9528,16,0.598869,66,6201380,-1,8000.0,8225324,8234852,2025723,9528,7,0,True,True,2379.1140444444445,-0.5914877764536348
7792,6199623,16060,128,0.983102,66,6201380,-1,64000.0,6678138,6694198,478515,16060,45,10,True,True,64732.95253333334,-0.9023173708514389
7793,6200106,14,3,0.101814,66,6201380,-1,1500.0,8339388,8339402,2139282,14,5,1,True,True,0.8310166666666666,-0.101814
7794,6200395,17,19,0.536182,66,6201380,-1,9500.0,6203580,6203597,3185,17,65,7,True,True,8.804441666666666,-0.536182
7795,6201790,98,3,0.990531,77,6203580,-1,1500.0,6656538,6656636,454748,98,47,9,True,True,3.4859416666666667,-0.990531
7796,6201992,13,32,0.850465,77,6203580,-1,16000.0,6236620,6236633,34628,13,58,1,True,True,14.119155555555555,-0.850465
7797,6202188,15248,8,0.171459,77,6203580,-1,4000.0,7338699,7353947,1136511,15248,26,2,True,True,1611.020188888889,-0.16511616901561688
7798,6202259,119,4,0.959035,77,6203580,-1,2000.0,6230777,6230896,28518,119,63,2,True,True,8.819222222222223,-0.959035
7799,6202348,13269,32,0.599867,77,6203580,-1,16000.0,6781572,6794841,579224,13269,44,10,True,True,13865.118800000002,-0.5892375989430637
7800,6202504,4977,8,0.981416,77,6203580,-1,4000.0,6848570,6853547,646066,4977,41,0,True,True,631.7254222222223,-0.9433852638172585
7801,6202738,9543,16,0.696315,77,6203580,-1,8000.0,8622012,8631555,2419274,9543,3,10,True,True,4117.584666666667,-0.6959541986201649
7802,6202784,3,4,0.677901,77,6203580,-1,2000.0,7531937,7531940,1329153,3,25,7,True,True,0.12166666666666667,-0.677901
7803,6202795,12009,1,0.972367,77,6203580,-1,500.0,8334688,8346697,2131893,12009,7,1,True,True,253.11893194444445,-0.9289633639268944
7804,6202868,670,1,0.693721,77,6203580,-1,500.0,7416326,7416996,1213458,670,28,8,True,True,12.207958333333334,-0.693721
7805,6203049,269,8,0.332047,77,6203580,-1,4000.0,8864012,8864281,2660963,269,0,6,True,True,31.01271111111111,-0.332047
7806,6203171,1197,3,0.635353,77,6203580,-1,1500.0,6222680,6223877,19509,1197,73,1,True,True,85.2613125,-0.635353
7807,6204006,19249,128,0.883967,80,6207180,-1,64000.0,6289089,6308338,85083,19249,60,7,True,True,50027.93173333334,-0.8725178737166713
7808,6204286,8237,4,0.317967,80,6207180,-1,2000.0,6309438,6317675,105152,8237,60,6,True,True,596.2312166666667,-0.29574636126278936
7809,6204343,16776,1,0.851554,80,6207180,-1,500.0,6842770,6859546,638427,16776,48,7,True,True,273.7997361111111,-0.8068655580323136
7810,6206461,119,16,0.48213,80,6207180,-1,8000.0,6279289,6279408,72828,119,63,10,True,True,39.67724444444444,-0.48213
7811,6207230,21,4,0.335105,84,6208280,-1,2000.0,8719212,8719233,2511982,21,3,12,True,True,3.399316666666667,-0.335105
7812,6207482,681,8,0.608533,84,6208280,-1,4000.0,8227524,8228205,2020042,681,12,7,True,True,84.3532,-0.608533
7813,6207629,10100,64,0.585037,84,6208280,-1,32000.0,7539537,7549637,1331908,10100,29,7,True,True,7878.943200000001,-0.5676734747294945
7814,6207858,109,32,0.382371,84,6208280,-1,16000.0,6236580,6236689,28722,109,75,1,True,True,118.3836888888889,-0.382371
7815,6207901,27,32,0.640592,84,6208280,-1,16000.0,6226077,6226104,18176,27,80,7,True,True,14.9616,-0.640592
7816,6208349,196,1,0.232425,94,6219080,-1,500.0,7095031,7095227,886682,196,43,0,True,True,3.76075,-0.232425
7817,6210331,11382,10,0.587469,94,6219080,-1,5000.0,8600412,8611794,2390081,11382,6,8,True,True,2948.82225,-0.5560044595853593
7818,6210539,12,2,0.988381,94,6219080,-1,1000.0,8160524,8160536,1949985,12,16,12,True,True,0.46286666666666676,-0.988381
7819,6210662,20824,32,0.232606,94,6219080,-1,16000.0,8819712,8840536,2609050,20824,1,12,True,True,11020.82168888889,-0.2323355794874978
7820,6210840,189,3,0.616349,94,6219080,-1,1500.0,8431212,8431401,2220372,189,10,1,True,True,16.344562500000002,-0.616349
7821,6210850,9410,4,0.896779,94,6219080,-1,2000.0,7855757,7865167,1644907,9410,28,7,True,True,506.07688333333334,-0.8928843397208452
7822,6211134,23,4,0.308849,94,6219080,-1,2000.0,6247489,6247512,36355,23,76,0,True,True,2.1318444444444444,-0.308849
7823,6211443,21,5,0.737913,94,6219080,-1,2500.0,8488685,8488706,2277242,21,8,9,True,True,2.061354166666667,-0.737913
7824,6212544,5,2,0.757246,94,6219080,-1,1000.0,6940388,6940393,727844,5,54,1,True,True,0.182,-0.757246
7825,6214784,7,16,0.619766,94,6219080,-1,8000.0,7529737,7529744,1314953,7,37,2,True,True,1.0134444444444446,-0.619766
7826,6214847,161,4,0.059923,94,6219080,-1,2000.0,6254389,6254550,39542,161,77,0,True,True,14.309322222222221,-0.059923
7827,6219088,11,1,0.374524,94,6222680,-1,500.0,6223780,6223791,4692,11,93,6,True,True,0.2611736111111111,-0.374524
7828,6223783,10,4,0.296615,93,6223877,-1,2000.0,6941531,6941541,717748,10,55,6,True,True,0.8247222222222222,-0.296615
7829,6224187,10232,4,0.151671,95,6226077,-1,2000.0,8313924,8324156,2089737,10232,16,12,True,True,463.1506888888889,-0.13049303297066067
7830,6225090,18531,100,0.204385,95,6226077,-1,50000.0,7561137,7579668,1336047,18531,36,10,True,True,22719.931666666664,-0.20269033302611522
7831,6225413,11946,113,0.037907,95,6226077,-1,56500.0,8053924,8065870,1828511,11946,23,7,True,True,28906.986394444448,-0.03625720653433125
7832,6226281,9339,64,0.923409,96,6227177,-1,32000.0,7739205,7748544,1512924,9339,34,6,True,True,7707.246933333333,-0.8949341234175117
7833,6226847,91,1,0.598075,96,6227177,-1,500.0,7095031,7095122,868184,91,54,0,True,True,1.7460625,-0.598075
7834,6232781,8,8,0.945876,95,6232977,-1,4000.0,8344788,8344796,2112007,8,12,8,True,True,1.4606222222222223,-0.945876
7835,6234484,38,64,0.739256,98,6236577,-1,32000.0,6940370,6940408,705886,38,63,8,True,True,44.2624,-0.739256
7836,6234645,5418,32,0.32869,98,6236577,-1,16000.0,6934970,6940388,700325,5418,65,0,True,True,3062.6751999999997,-0.32686083664262366
7837,6234774,319,4,0.278126,98,6236577,-1,2000.0,7711437,7711756,1476663,319,38,12,True,True,17.686777777777777,-0.278126
7838,6235408,28813,1,0.643602,98,6236577,-1,500.0,6308338,6337151,72930,28813,84,1,True,True,454.58371527777774,-0.6321053820323496
7839,6237416,7,8,0.760494,114,6247489,-1,4000.0,6254389,6254396,16973,7,89,7,True,True,1.2442888888888888,-0.760494
7840,6237461,1018,1,0.520873,114,6247489,-1,500.0,7443326,7444344,1205865,1018,45,8,True,True,11.359183333333334,-0.520873
7841,6237706,12201,1,0.977568,114,6247489,-1,500.0,8578385,8590586,2340679,12201,8,7,True,True,216.00737361111112,-0.8084686143336365
7842,6237799,10444,14,0.648046,114,6247489,-1,7000.0,8225324,8235768,1987525,10444,21,9,True,True,2290.2216555555556,-0.6435390183910469
7843,6237848,14170,2,0.288455,114,6247489,-1,1000.0,8732212,8746382,2494364,14170,4,9,True,True,646.8413611111112,-0.2633744329811596
7844,6239963,212,2,0.023693,114,6247489,-1,1000.0,8575085,8575297,2335122,212,10,12,True,True,8.18843611111111,-0.02323168990430991
7845,6240057,14,1,0.846935,114,6247489,-1,500.0,8578385,8578399,2338328,14,9,0,True,True,0.27574166666666666,-0.846935
7846,6240278,19618,2,0.33127,114,6247489,-1,1000.0,8864281,8883899,2624003,19618,0,1,True,True,580.7423444444445,-0.32981568721217563
7847,6241516,23,1,0.242249,114,6247489,-1,500.0,7952324,7952347,1710808,23,36,12,True,True,0.43562638888888894,-0.242249
7848,6242557,54,4,0.539312,114,6247489,-1,2000.0,6958831,6958885,716274,54,68,8,True,True,5.3757,-0.539312
7849,6242604,9233,64,0.906632,114,6247489,-1,32000.0,8335788,8345021,2093184,9233,19,6,True,True,12257.017511111113,-0.8183349423771538
7850,6242942,14832,119,0.665006,114,6247489,-1,59500.0,8319724,8334556,2076782,14832,23,2,True,True,28432.40423333333,-0.6226332073866122
7851,6244121,9,64,0.248338,114,6247489,-1,32000.0,8576185,8576194,2332064,9,12,6,True,True,11.344800000000001,-0.248338
7852,6244172,10,8,0.68735,114,6247489,-1,4000.0,6488738,6488748,244566,10,93,11,True,True,0.9015555555555556,-0.68735
7853,6244213,24,1,0.719502,114,6247489,-1,500.0,6402338,6402362,158125,24,94,0,True,True,0.3512,-0.719502
7854,6244275,3,8,0.608063,114,6247489,-1,4000.0,6299889,6299892,55614,3,99,9,True,True,0.4740333333333334,-0.608063
7855,6244781,5455,114,0.381486,114,6247489,-1,57000.0,6699738,6705193,454957,5455,89,10,True,True,25585.53965,-0.37793797900698717
7856,6245020,28567,1,0.321637,114,6247489,-1,500.0,8878681,8907248,2633661,28567,0,2,True,True,486.37117916666665,-0.319448713964087
7857,6245128,3,2,0.442361,114,6247489,-1,1000.0,7561137,7561140,1316009,3,51,0,True,True,0.0761,-0.442361
7858,6246233,8,3,0.006043,114,6247489,-1,1500.0,7563337,7563345,1317104,8,51,7,True,True,0.30439999999999995,-0.006043
7859,6246872,28,2,0.869867,114,6247489,-1,1000.0,6257689,6257717,10817,28,106,7,True,True,1.1495555555555557,-0.869867
7860,6247440,6376,4,0.069985,114,6247489,-1,2000.0,7625037,7631413,1377597,6376,50,0,True,True,240.85763333333335,-0.06750797960264629
7861,6247495,18,17,0.192465,113,6248589,-1,8500.0,7138231,7138249,890736,18,71,11,True,True,9.00235,-0.192465
7862,6249536,43,4,0.634367,125,6252189,-1,2000.0,6940388,6940431,690852,43,80,0,True,True,3.1304,-0.634367
7863,6249682,63,16,0.141532,125,6252189,-1,8000.0,6445538,6445601,195856,63,101,11,True,True,28.700000000000003,-0.141532
7864,6249698,7093,1,0.20422,125,6252189,-1,500.0,7572037,7579130,1322339,7093,51,8,True,True,85.25936666666668,-0.20088498189336826
7865,6249760,22807,32,0.091759,125,6252189,-1,16000.0,6959931,6982738,710171,22807,77,6,True,True,21692.939955555557,-0.08922315570464297
7866,6249915,15444,16,0.592631,125,6252189,-1,8000.0,7246499,7261943,996584,15444,66,8,True,True,5000.900666666666,-0.5724307488835911
7867,6249937,23254,64,0.831221,125,6252189,-1,32000.0,6402338,6425592,152401,23254,105,0,True,True,26142.088533333335,-0.8257156914581828
7868,6250937,20830,2,0.931813,125,6252189,-1,1000.0,6575138,6595968,324201,20830,103,12,True,True,569.8141888888889,-0.92293316145163
7869,6250948,49,2,0.23631,125,6252189,-1,1000.0,6602538,6602587,351590,49,103,6,True,True,1.344097222222222,-0.23631
7870,6251161,27,1,0.078165,125,6252189,-1,500.0,8594985,8595012,2343824,27,11,9,True,True,0.6593625000000001,-0.078165
7871,6251172,7,26,0.724989,125,6252189,-1,13000.0,8334124,8334131,2082952,7,25,2,True,True,3.2757472222222224,-0.724989
7872,6251927,99,4,0.311463,125,6252189,-1,2000.0,7207759,7207858,955832,99,71,11,True,True,10.95215,-0.311463
7873,6251990,5,1,0.721674,125,6252189,-1,500.0,8733312,8733317,2481322,5,6,6,True,True,0.16790972222222222,-0.721674
7874,6252113,2,4,0.244925,125,6252189,-1,2000.0,7092831,7092833,840718,2,81,6,True,True,0.1535,-0.244925
7875,6256781,23843,84,0.176436,124,6257689,-1,42000.0,7625037,7648880,1368256,23843,54,11,True,True,27665.884983333333,-0.16989392472922857
7876,6256847,10440,1,0.248969,124,6257689,-1,500.0,7091731,7102171,834884,10440,83,11,True,True,212.52853055555556,-0.23503159586235647
7877,6256880,29,1,0.285353,124,6257689,-1,500.0,6286889,6286918,30009,29,122,7,True,True,0.5985277777777778,-0.285353
7878,6260604,7213,16,0.448271,160,6279289,-1,8000.0,7225211,7232424,964607,7213,71,0,True,True,2255.520111111111,-0.43973448868364456
7879,6260611,2338,4,0.635604,160,6279289,-1,2000.0,7335099,7337437,1074488,2338,68,0,True,True,158.94141666666667,-0.6265777143674465
7880,6260754,18,16,0.271861,160,6279289,-1,8000.0,6940388,6940406,679634,18,93,0,True,True,5.2416,-0.271861
7881,6260898,10,4,0.781289,160,6279289,-1,2000.0,6601438,6601448,340540,10,114,2,True,True,0.516888888888889,-0.781289
7882,6261066,16,1,0.080016,160,6279289,-1,500.0,7566637,7566653,1305571,16,56,6,True,True,0.20346666666666668,-0.080016
7883,6261074,10,1,0.972555,160,6279289,-1,500.0,6811370,6811380,550296,10,104,8,True,True,0.2756805555555556,-0.972555
7884,6261097,13,2,0.398244,160,6279289,-1,1000.0,6597838,6597851,336741,13,117,0,True,True,0.33525555555555553,-0.398244
7885,6261328,12317,1,0.167766,160,6279289,-1,500.0,6848570,6860887,587242,12317,100,0,True,True,190.90365277777778,-0.1626829659178984
7886,6261346,12203,4,0.441376,160,6279289,-1,2000.0,7155559,7167762,894213,12203,79,0,True,True,1169.1763777777776,-0.439262348500261
7887,6261501,36,4,0.505293,160,6279289,-1,2000.0,7388799,7388835,1127298,36,68,1,True,True,2.507,-0.505293
7888,6261542,10,32,0.734928,160,6279289,-1,16000.0,8316124,8316134,2054582,10,29,7,True,True,3.0991111111111116,-0.734928
7889,6261575,49,8,0.760324,160,6279289,-1,4000.0,7341999,7342048,1080424,49,70,7,True,True,5.100355555555556,-0.760324
7890,6261599,12716,8,0.819604,160,6279289,-1,4000.0,8171324,8184040,1909725,12716,34,0,True,True,2105.188577777778,-0.8194645586129824
7891,6261631,6,1,0.793559,160,6279289,-1,500.0,8475512,8475518,2213881,6,20,6,True,True,0.172825,-0.793559
7892,6262442,10208,1,0.019811,160,6279289,-1,500.0,6597838,6608046,335396,10208,125,6,True,True,134.0250638888889,-0.019714443035993394
7893,6262462,277,4,0.381419,160,6279289,-1,2000.0,6279289,6279566,16827,277,138,0,True,True,23.089488888888887,-0.381419
7894,6262642,15546,8,0.854042,160,6279289,-1,4000.0,7740305,7755851,1477663,15546,52,6,True,True,1838.2554,-0.8060473093050382
7895,6262648,29052,128,0.758858,160,6279289,-1,64000.0,7738105,7767157,1475457,29052,54,9,True,True,56181.88106666666,-0.7574521396793701
7896,6262662,82,32,0.921532,160,6279289,-1,16000.0,6940431,6940513,677769,82,101,4,True,True,47.7568,-0.921532
7897,6262673,18,1,0.595183,160,6279289,-1,500.0,8160524,8160542,1897851,18,37,0,True,True,0.34715,-0.595183
7898,6262684,4772,32,0.152799,160,6279289,-1,16000.0,6840570,6845342,577886,4772,114,8,True,True,2780.9805333333334,-0.1508681871314944
7899,6262698,15738,128,0.726648,160,6279289,-1,64000.0,6596738,6612476,334040,15738,131,10,True,True,26333.122844444446,-0.7233045459265052
7900,6262737,401,2,0.257292,160,6279289,-1,1000.0,6848570,6848971,585833,401,111,0,True,True,13.753186111111111,-0.257292
7901,6263014,52,8,0.463651,160,6279289,-1,4000.0,6784311,6784363,521297,52,119,1,True,True,13.682355555555555,-0.463651
7902,6263982,24,1,0.453603,160,6279289,-1,500.0,7726205,7726229,1462223,24,57,8,True,True,0.2972,-0.453603
7903,6264048,132,8,0.375147,160,6279289,-1,4000.0,8632812,8632944,2368764,132,10,9,True,True,23.1968,-0.375147
7904,6264128,24339,1,0.606025,160,6279289,-1,500.0,6759972,6784311,495844,24339,124,1,True,True,759.2133208333333,-0.5933310168579892
7905,6264153,4789,16,0.07194,160,6279289,-1,8000.0,6805970,6810759,541817,4789,120,1,True,True,2464.625133333333,-0.06662084469896912
7906,6264206,6395,4,0.136656,160,6279289,-1,2000.0,7410926,7417321,1146720,6395,75,1,True,True,469.31472777777776,-0.13615681270279723
7907,6264222,10100,1,0.469258,160,6279289,-1,500.0,6575138,6585238,310916,10100,139,0,True,True,146.61222222222224,-0.4653622299545773
7908,6264833,3,16,0.154724,160,6279289,-1,8000.0,7437926,7437929,1173093,3,74,10,True,True,0.5702,-0.154724
7909,6264838,6470,8,0.189626,160,6279289,-1,4000.0,7864757,7871227,1599919,6470,50,8,True,True,708.8901222222222,-0.1874415197852306
7910,6265259,27,1,0.012834,160,6279289,-1,500.0,6402338,6402365,137079,27,145,0,True,True,0.3951,-0.012834
7911,6265407,245,2,0.5007,160,6279289,-1,1000.0,7150159,7150404,884752,245,93,2,True,True,8.745819444444443,-0.5007
7912,6265505,6010,176,0.725345,160,6279289,-1,88000.0,7155559,7161569,890054,6010,93,8,True,True,24306.44504444444,-0.6612622553093047
7913,6265684,16444,36,0.491454,160,6279289,-1,18000.0,8160524,8176968,1894840,16444,39,0,True,True,11760.5992,-0.48586559099328364
7914,6266486,10,32,0.925691,160,6279289,-1,16000.0,6284689,6284699,18203,10,158,8,True,True,6.542666666666667,-0.925691
7915,6293965,6405,256,0.940285,166,6299889,-1,128000.0,7240094,7246499,946129,6405,87,0,True,True,34960.623999999996,-0.9393647112887693
7916,6294014,47,2,0.970493,166,6299889,-1,1000.0,6402338,6402385,108324,47,152,6,True,True,1.3755333333333335,-0.970493
7917,6294183,8744,2,0.373145,166,6299889,-1,1000.0,7048531,7057275,754348,8744,105,7,True,True,437.16692777777774,-0.3622609501423318
7918,6294238,76,1,0.489551,166,6299889,-1,500.0,6596738,6596814,302500,76,145,0,True,True,0.9799777777777778,-0.489551
7919,6294258,12626,1,0.641049,166,6299889,-1,500.0,7248699,7261325,954441,12626,86,7,True,True,252.3194388888889,-0.6181899238669134
7920,6294397,5647,43,0.588309,166,6299889,-1,21500.0,6305289,6310936,10892,5647,160,8,True,True,4991.190480555556,-0.5876195508748872
7921,6294565,28479,256,0.408788,166,6299889,-1,128000.0,6705193,6733672,410628,28479,137,2,True,True,285933.8702222222,-0.40340713541894324
7922,6294966,67,8,0.038827,166,6299889,-1,4000.0,7865857,7865924,1570891,67,51,6,True,True,7.291833333333333,-0.038827
7923,6295829,7814,32,0.921603,166,6299889,-1,16000.0,7150131,7157945,854302,7814,101,6,True,True,4980.100399999999,-0.8605002296010861
7924,6298965,26663,64,0.384826,166,6299889,-1,32000.0,6846370,6873033,547405,26663,127,2,True,True,27929.05253333333,-0.3669270027845573
7925,6299872,10537,4,0.565609,166,6299889,-1,2000.0,7221611,7232148,921739,10537,91,9,True,True,810.6950777777779,-0.5648549729083876
7926,6300302,13,1,0.194228,178,6305289,-1,500.0,7717937,7717950,1417635,13,62,8,True,True,0.1766194444444444,-0.194228
7927,6300322,11,4,0.436298,178,6305289,-1,2000.0,6813570,6813581,513248,11,133,7,True,True,1.2129944444444445,-0.436298
7928,6300898,46,1,0.255258,178,6305289,-1,500.0,8595012,8595058,2294114,46,13,1,True,True,1.1233583333333335,-0.255258
7929,6300934,906,1,0.913086,178,6305289,-1,500.0,7720805,7721711,1419871,906,63,2,True,True,12.019599999999999,-0.913086
7930,6302260,33,1,0.722245,178,6305289,-1,500.0,7149031,7149064,846771,33,106,9,True,True,0.6006458333333334,-0.722245
7931,6302530,24,5,0.509608,178,6305289,-1,2500.0,8431188,8431212,2128658,24,24,12,True,True,3.5488333333333335,-0.4970492943062617
7932,6303072,4,32,0.488622,178,6305289,-1,16000.0,7339799,7339803,1036727,4,87,6,True,True,2.0917333333333334,-0.488622
7933,6303104,118,16,0.688489,178,6305289,-1,8000.0,7865924,7866042,1562820,118,52,0,True,True,25.988000000000003,-0.674248296660414
7934,6303782,4,2,0.696455,178,6305289,-1,1000.0,7529726,7529730,1225944,4,81,12,True,True,0.07238888888888889,-0.696455
7935,6303857,21992,1,0.650906,178,6305289,-1,500.0,7727305,7749297,1423448,21992,63,6,True,True,278.79649166666667,-0.6437746728403926
7936,6304128,4,2,0.926519,178,6305289,-1,1000.0,6755272,6755276,451144,4,150,10,True,True,0.15587777777777778,-0.926519
7937,6304268,3,4,0.735664,178,6305289,-1,2000.0,8875081,8875084,2570813,3,1,9,True,True,0.17918333333333336,-0.735664
7938,6304793,55,4,0.242353,178,6305289,-1,2000.0,6488738,6488793,183945,55,167,0,True,True,2.479277777777778,-0.242353
7939,6305356,7261,1,0.034508,181,6308338,-1,500.0,8721412,8728673,2416056,7261,9,7,True,True,275.9039569444445,-0.03332213754187656
7940,6306232,11,4,0.813126,181,6308338,-1,2000.0,7581837,7581848,1275605,11,74,7,True,True,0.5854444444444444,-0.813126
7941,6306483,18483,16,0.630953,181,6308338,-1,8000.0,7221611,7240094,915128,18483,102,0,True,True,5835.785733333334,-0.616216177700961
7942,6307347,18643,1,0.676426,181,6308338,-1,500.0,7853557,7872200,1546210,18643,60,0,True,True,249.04863472222223,-0.6737245644485175
7943,6312530,12644,19,0.697471,206,6395838,-1,9500.0,7577437,7590081,1264907,12644,76,8,True,True,3108.0461250000003,-0.6937381164905825
7944,6312649,6370,4,0.645334,206,6395838,-1,2000.0,7095031,7101401,782382,6370,120,0,True,True,529.3388444444445,-0.6413431612228107
7945,6312732,16236,8,0.261331,206,6395838,-1,4000.0,8475512,8491748,2162780,16236,24,0,True,True,2658.5823111111113,-0.2510329266042296
7946,6320189,19481,1,0.455471,206,6395838,-1,500.0,7385199,7404680,1065010,19481,95,11,True,True,383.39664027777775,-0.4535376058441516
7947,6322813,10286,1,0.681066,206,6395838,-1,500.0,8038724,8049010,1715911,10286,54,12,True,True,188.42012499999998,-0.6609051576244952
7948,6322961,88,1,0.254288,206,6395838,-1,500.0,8431188,8431276,2108227,88,27,0,True,True,2.5546555555555557,-0.243463809478598
7949,6324202,102,16,0.602149,206,6395838,-1,8000.0,8068324,8068426,1744122,102,48,9,True,True,45.630266666666664,-0.602149
7950,6324844,9561,1,0.951778,206,6395838,-1,500.0,6488738,6498299,163894,9561,178,0,True,True,101.89538472222223,-0.9366460660493033
7951,6325444,11804,128,0.841516,206,6395838,-1,64000.0,8074124,8085928,1748680,11804,47,2,True,True,40977.87377777778,-0.81566097362986
7952,6325959,19,4,0.012337,206,6395838,-1,2000.0,7625037,7625056,1299078,19,79,0,True,True,0.5825611111111111,-0.012337
7953,6325980,159,1,0.770972,206,6395838,-1,500.0,8581985,8582144,2256005,159,17,2,True,True,2.7825,-0.770972
7954,6326647,10527,1,0.644397,206,6395838,-1,500.0,6846370,6856897,519723,10527,152,0,True,True,165.86516527777778,-0.6005076186243924
7955,6326677,9368,16,0.916883,206,6395838,-1,8000.0,7711437,7720805,1384760,9368,78,0,True,True,2038.8999999999996,-0.9158704471019531
7956,6327300,4292,32,0.397667,206,6395838,-1,16000.0,6699738,6704030,372438,4292,170,0,True,True,5619.764266666667,-0.3896098568015751
7957,6327484,176,8,0.58616,206,6395838,-1,4000.0,7291899,7292075,964415,176,108,11,True,True,35.958755555555555,-0.58616
7958,6327837,11,1,0.900996,206,6395838,-1,500.0,8862912,8862923,2535075,11,4,11,True,True,0.16351805555555557,-0.900996
7959,6331957,33,10,0.518537,206,6395838,-1,5000.0,7579637,7579670,1247680,33,85,7,True,True,4.099333333333334,-0.518537
7960,6332001,17,128,0.188823,206,6395838,-1,64000.0,7537337,7537354,1205336,17,94,8,True,True,22.648533333333333,-0.188823
7961,6332054,26653,1,0.422945,206,6395838,-1,500.0,7046331,7072984,714277,26653,140,12,True,True,676.8008361111112,-0.4214491365940572
7962,6332099,123,2,0.82975,206,6395838,-1,1000.0,8214524,8214647,1882425,123,44,11,True,True,4.302608333333334,-0.82975
7963,6332200,1273,16,0.252871,206,6395838,-1,8000.0,8474412,8475685,2142212,1273,28,11,True,True,586.6832666666666,-0.252871
7964,6332235,9,16,0.30222,206,6395838,-1,8000.0,8475685,8475694,2143450,9,25,2,True,True,4.1478,-0.30222
7965,6332293,18787,128,0.967683,206,6395838,-1,64000.0,8050624,8069411,1718331,18787,60,8,True,True,54093.979199999994,-0.8958879545006433
7966,6332822,138,1,0.658486,206,6395838,-1,500.0,6840570,6840708,507748,138,165,0,True,True,2.483041666666667,-0.658486
7967,6333000,21997,128,0.382789,206,6395838,-1,64000.0,8584185,8606182,2251185,21997,18,7,True,True,65207.60248888889,-0.3711286857532145
7968,6333005,11747,64,0.307979,206,6395838,-1,32000.0,6891770,6903517,558765,11747,159,11,True,True,13046.79368888889,-0.30752739013164354
7969,6333011,11207,19,0.411609,206,6395838,-1,9500.0,7225211,7236418,892200,11207,122,2,True,True,4208.976926388888,-0.4045629601206485
1472,1293277,13,1,0.496203,1,1293277,-1,500.0,1294554,1293290,1277,13,0,0,True,True,0.2574722222222222,-0.496203
1473,1294554,6774,64,0.497523,1,1294554,-1,32000.0,1296754,1303528,2200,6774,0,7,True,True,7445.43608888889,-0.48378456284858457
1474,1294669,12239,3,0.92431,4,1296754,-1,1500.0,1318354,1330593,23685,12239,0,10,True,True,521.3456583333334,-0.8422094256955173
1475,1294737,112,2,0.519276,4,1296754,-1,1000.0,2081225,2081337,786488,112,0,6,True,True,2.0838222222222225,-0.519276
1476,1295058,292,16,0.801148,4,1296754,-1,8000.0,3842892,3843184,2547834,292,0,6,True,True,100.93466666666667,-0.801148
1477,1296674,31905,16,0.727081,4,1296754,-1,8000.0,1743354,1775259,446680,31905,2,10,True,True,12674.508399999999,-0.6733264984530883
1478,1298004,12956,1,0.078927,25,1318354,-1,500.0,3527376,3540332,2229372,12956,1,1,True,True,149.5513611111111,-0.07437983322403266
1479,1299053,5794,178,0.602453,25,1318354,-1,89000.0,2911937,2917731,1612884,5794,2,6,True,True,8312.600741666669,-0.49738016300078397
1480,1299172,10160,8,0.822341,25,1318354,-1,4000.0,1329154,1339314,29982,10160,5,9,True,True,2148.748866666667,-0.7810216869335875
1481,1300217,5981,128,0.545474,25,1318354,-1,64000.0,2473621,2479602,1173404,5981,3,9,True,True,6882.288355555555,-0.5370930564192684
1482,1300293,11,1,0.321211,25,1318354,-1,500.0,2768621,2768632,1468328,11,3,7,True,True,0.11730277777777778,-0.321211
1483,1300678,4,9,0.080069,25,1318354,-1,4500.0,2080100,2080104,779422,4,6,0,True,True,0.349,-0.080069
1484,1300931,8,4,0.660919,25,1318354,-1,2000.0,1334554,1334562,33623,8,8,8,True,True,0.8773333333333334,-0.660919
1485,1301041,7580,2,0.306496,25,1318354,-1,1000.0,3055499,3063079,1754458,7580,2,0,True,True,274.6186666666667,-0.2482883290837865
1486,1305566,17109,1,0.602622,25,1318354,-1,500.0,2839221,2856330,1533655,17109,4,3,True,True,194.10231249999998,-0.48923247664577
1487,1305714,670,1,0.426116,25,1318354,-1,500.0,2167625,2168295,861911,670,7,12,True,True,3.920430555555556,-0.426116
1488,1306220,46393,55,0.689765,25,1318354,-1,27500.0,2990942,3037335,1684722,46393,3,8,True,True,26562.71253472222,-0.6300445797953416
1489,1306545,14816,1,0.351547,25,1318354,-1,500.0,1318354,1333170,11809,14816,14,0,True,True,237.49343611111112,-0.29952755731419584
1490,1309878,42,2,0.042355,25,1318354,-1,1000.0,2056300,2056342,746422,42,11,8,True,True,1.7386833333333334,-0.042355
1491,1310397,16,8,0.870037,25,1318354,-1,4000.0,2203325,2203341,892928,16,8,6,True,True,0.9448888888888889,-0.870037
1492,1312556,496,64,0.352559,25,1318354,-1,32000.0,3780566,3781062,2468010,496,1,1,True,True,161.4976,-0.352559
1493,1313082,51,43,0.998151,25,1318354,-1,21500.0,4213475,4213526,2900393,51,0,0,True,True,11.333545833333334,-0.998151
1494,1313539,32,2,0.274555,25,1318354,-1,1000.0,4215675,4215707,2902136,32,0,7,True,True,0.34808888888888884,-0.274555
1495,1313662,8755,32,0.980027,25,1318354,-1,16000.0,4120475,4129230,2806813,8755,2,2,True,True,4157.9184444444445,-0.9061416624394875
1496,1314069,13,10,0.947904,25,1318354,-1,5000.0,2214221,2214234,900152,13,12,1,True,True,0.7236666666666666,-0.947904
1497,1315723,46,8,0.075041,25,1318354,-1,4000.0,1604654,1604700,288931,46,19,0,True,True,2.9547333333333334,-0.075041
1498,1316219,12086,8,0.637513,25,1318354,-1,4000.0,4014092,4026178,2697873,12086,3,7,True,True,1802.0954666666664,-0.6341832956900234
1499,1316353,12827,25,0.363311,25,1318354,-1,12500.0,1777664,1790491,461311,12827,19,10,True,True,7925.551701388889,-0.3176206680412057
1500,1319043,143,2,0.801096,41,1329154,-1,1000.0,3510564,3510707,2191521,143,7,2,True,True,3.5912861111111107,-0.801096
1501,1320593,9,2,0.679411,41,1329154,-1,1000.0,2874221,2874230,1553628,9,11,0,True,True,0.2661,-0.679411
1502,1320865,90,8,0.952789,41,1329154,-1,4000.0,2497421,2497511,1176556,90,14,2,True,True,10.43,-0.952789
1503,1322450,37,1,0.142779,41,1329154,-1,500.0,2914137,2914174,1591687,37,10,7,True,True,0.25062361111111114,-0.142779
1504,1322616,57,1,0.607573,41,1329154,-1,500.0,3109533,3109590,1786917,57,8,0,True,True,1.8029416666666669,-0.607573
1505,1323015,12743,2,0.781312,41,1329154,-1,1000.0,3281105,3293848,1958090,12743,8,8,True,True,163.6676388888889,-0.7730369587863647
1506,1323031,8047,37,0.034799,41,1329154,-1,18500.0,1423154,1431201,100123,8047,28,12,True,True,9626.976966666667,-0.03400120666039839
1507,1323428,727,4,0.067233,41,1329154,-1,2000.0,4210175,4210902,2886747,727,2,11,True,True,14.632894444444444,-0.067233
1508,1323517,392,1,0.778515,41,1329154,-1,500.0,1751354,1751746,427837,392,27,7,True,True,6.5229888888888885,-0.778515
1509,1323542,13448,128,0.366328,41,1329154,-1,64000.0,3048234,3061682,1724692,13448,12,1,True,True,35479.624888888895,-0.3623058048106612
1510,1323995,46337,4,0.382854,41,1329154,-1,2000.0,4110375,4156712,2786380,46337,4,0,True,True,4972.784883333334,-0.3692172133229082
1511,1324200,44,28,0.567245,41,1329154,-1,14000.0,2766421,2766465,1442221,44,20,12,True,True,14.712133333333336,-0.567245
1512,1327945,7659,16,0.605095,41,1329154,-1,8000.0,2080100,2087759,752155,7659,28,10,True,True,1122.3661555555555,-0.5856908261665242
1513,1327951,5,16,0.679062,41,1329154,-1,8000.0,3780561,3780566,2452610,5,8,10,True,True,0.40700000000000003,-0.679062
1514,1328512,20621,179,0.948824,41,1329154,-1,89500.0,3219384,3240005,1890872,20621,12,9,True,True,44828.11957777777,-0.8955282692360873
1515,1328728,11,2,0.372013,41,1329154,-1,1000.0,3270305,3270316,1941577,11,12,10,True,True,0.12439166666666668,-0.372013
1516,1328802,12,1,0.763084,41,1329154,-1,500.0,1336754,1336766,7952,12,38,7,True,True,0.34258333333333335,-0.763084
1517,1328814,5,1,0.573922,41,1329154,-1,500.0,4164775,4164780,2835961,5,3,11,True,True,0.15465972222222224,-0.573922
1518,1330137,7732,1,0.52946,63,1334554,-1,500.0,1809064,1816796,478927,7732,34,10,True,True,215.41056666666668,-0.5063124249022716
1519,1330153,7,16,0.398034,63,1334554,-1,8000.0,1604654,1604661,274501,7,38,0,True,True,0.8992666666666667,-0.398034
1520,1330385,43,2,0.649561,63,1334554,-1,1000.0,2477221,2477264,1146836,43,26,0,True,True,0.8211805555555556,-0.649561
1521,1330698,7,8,0.249612,63,1334554,-1,4000.0,2460621,2460628,1129923,7,28,6,True,True,1.4938777777777776,-0.249612
1522,1331059,8744,128,0.113449,63,1334554,-1,64000.0,4166975,4175719,2835916,8744,3,7,True,True,35277.83111111111,-0.1132808875636756
1523,1331092,33237,13,0.735675,63,1334554,-1,6500.0,2459521,2492758,1128429,33237,30,0,True,True,6241.192009722222,-0.7158462025168588
1524,1331191,443,16,0.499044,63,1334554,-1,8000.0,1633154,1633597,301963,443,42,10,True,True,121.05713333333334,-0.499044
1525,1331228,4,2,0.386987,63,1334554,-1,1000.0,3172860,3172864,1841632,4,16,7,True,True,0.0388,-0.386987
1526,1331306,21,32,0.561673,63,1334554,-1,16000.0,3055499,3055520,1724193,21,18,0,True,True,19.11466666666667,-0.561673
1527,1331604,25,1,0.261777,63,1334554,-1,500.0,3170660,3170685,1839056,25,17,8,True,True,0.11927083333333333,-0.261777
1528,1331611,39,1,0.26029,63,1334554,-1,500.0,1609354,1609393,277743,39,46,6,True,True,0.39124583333333335,-0.26029
1529,1331759,8757,200,0.446273,63,1334554,-1,100000.0,3109533,3118290,1777774,8757,19,1,True,True,46223.79666666667,-0.4109727587795738
1530,1331776,17,8,0.996365,63,1334554,-1,4000.0,1756064,1756081,424288,17,44,1,True,True,2.5598222222222224,-0.996365
1531,1331818,3,28,0.285577,63,1334554,-1,14000.0,1602454,1602457,270636,3,51,6,True,True,0.6744500000000001,-0.285577
1532,1331990,15,2,0.916479,63,1334554,-1,1000.0,2048700,2048715,716710,15,42,9,True,True,0.30254166666666665,-0.916479
1533,1332252,26,8,0.4912,63,1334554,-1,4000.0,3834566,3834592,2502314,26,9,8,True,True,4.263999999999999,-0.4912
1534,1333108,18,4,0.122637,63,1334554,-1,2000.0,2080125,2080143,747017,18,40,2,True,True,0.698,-0.122637
1535,1333163,16498,128,0.852826,63,1334554,-1,64000.0,3123690,3140188,1790527,16498,19,8,True,True,40033.45706666667,-0.7865565160874776
1536,1333242,867,1,0.452043,63,1334554,-1,500.0,2307221,2308088,973979,867,37,7,True,True,6.909329166666668,-0.44913514718734554
1537,1333786,19,32,0.898679,63,1334554,-1,16000.0,2169825,2169844,836039,19,40,7,True,True,3.5576444444444446,-0.898679
1538,1333912,5033,84,0.445111,63,1334554,-1,42000.0,2477221,2482254,1143309,5033,34,2,True,True,3882.879816666667,-0.44113790175849094
1539,1334006,872,8,0.087791,63,1334554,-1,4000.0,4042992,4043864,2708986,872,7,8,True,True,46.855466666666665,-0.087791
1540,1334127,58,12,0.681929,63,1334554,-1,6000.0,1721754,1721812,387627,58,55,12,True,True,29.29,-0.681929
1541,1334696,29,3,0.845521,65,1336754,-1,1500.0,3178284,3178313,1843588,29,18,2,True,True,0.4147,-0.845521
1542,1334724,2511,8,0.319588,65,1336754,-1,4000.0,3055499,3058010,1720775,2511,26,1,True,True,418.5493333333334,-0.23410083505077658
1543,1334768,8,36,0.347425,65,1336754,-1,18000.0,3178260,3178268,1843492,8,19,0,True,True,1.3728,-0.347425
1544,1337018,21038,1,0.064939,146,1423154,-1,500.0,3950892,3971930,2613874,21038,9,12,True,True,496.70817777777773,-0.06468393220055893
1545,1337084,10203,16,0.542171,146,1423154,-1,8000.0,3834592,3844795,2497508,10203,11,2,True,True,3470.335666666667,-0.5421572000229175
1546,1337224,459,3,0.891332,146,1423154,-1,1500.0,3246505,3246964,1909281,459,19,6,True,True,7.0992,-0.891332
1547,1337255,11,16,0.851362,146,1423154,-1,8000.0,2180625,2180636,843370,11,48,9,True,True,1.2412888888888889,-0.851362
1548,1337380,8,1,0.711809,146,1423154,-1,500.0,1908464,1908472,571084,8,57,12,True,True,0.05976666666666666,-0.711809
1549,1337421,5291,16,0.927324,146,1423154,-1,8000.0,3753670,3758961,2416249,5291,15,12,True,True,716.9479111111111,-0.8986276603870927
1550,1337520,59,16,0.6377,146,1423154,-1,8000.0,1994864,1994923,657344,59,58,0,True,True,4.320111111111112,-0.6377
1551,1337540,58,8,0.793696,146,1423154,-1,4000.0,4111475,4111533,2773935,58,6,6,True,True,8.907511111111111,-0.793696
1552,1337563,8260,2,0.508756,146,1423154,-1,1000.0,4212375,4220635,2874812,8260,2,7,True,True,89.32730555555554,-0.4921238165612161
1553,1337577,18561,16,0.121362,146,1423154,-1,8000.0,3601370,3619931,2263793,18561,18,11,True,True,1012.9292444444444,-0.10657162805623777
1554,1337629,12183,8,0.20098,146,1423154,-1,4000.0,3998492,4010675,2660863,12183,11,6,True,True,1796.7749111111111,-0.17323734247959133
1555,1337691,25,1,0.138877,146,1423154,-1,500.0,2670221,2670246,1332530,25,44,12,True,True,0.3676041666666667,-0.138877
1556,1337703,119,8,0.790373,146,1423154,-1,4000.0,1595954,1596073,258251,119,76,12,True,True,5.508377777777777,-0.790373
1557,1337729,7,16,0.026284,146,1423154,-1,8000.0,3420564,3420571,2082835,7,22,1,True,True,1.1185999999999998,-0.026284
1558,1338585,19622,32,0.554021,146,1423154,-1,16000.0,2180625,2200247,842040,19622,55,0,True,True,6284.135111111112,-0.5289170970671048
1559,1338629,64,1,0.368911,146,1423154,-1,500.0,4032892,4032956,2694263,64,10,7,True,True,0.6473777777777777,-0.368911
1560,1338983,182,16,0.803662,146,1423154,-1,8000.0,3055499,3055681,1716516,182,36,0,True,True,82.83022222222223,-0.803662
1561,1339153,4,71,0.551647,146,1423154,-1,35500.0,2957337,2957341,1618184,4,41,11,True,True,5.814899999999999,-0.551647
1562,1340956,9,8,0.611948,146,1423154,-1,4000.0,2483021,2483030,1142065,9,50,7,True,True,0.6163000000000001,-0.611948
1563,1341428,4,8,0.086215,146,1423154,-1,4000.0,3222984,3222988,1881556,4,27,1,True,True,0.573288888888889,-0.086215
1564,1343396,18753,128,0.309291,146,1423154,-1,64000.0,2437921,2456674,1094525,18753,57,12,True,True,49324.75555555555,-0.2917820563970562
1565,1343404,59,1,0.999595,146,1423154,-1,500.0,3066299,3066358,1722895,59,36,9,True,True,1.3220097222222225,-0.999595
1566,1343558,25529,16,0.71887,146,1423154,-1,8000.0,2674621,2700150,1331063,25529,50,0,True,True,9186.815266666668,-0.6992064080523187
1567,1343568,19,32,0.525696,146,1423154,-1,16000.0,1509554,1509573,165986,19,87,12,True,True,4.755066666666667,-0.525696
1568,1343589,9,4,0.769165,146,1423154,-1,2000.0,3205284,3205293,1861695,9,29,8,True,True,0.848,-0.769165
1569,1343888,11393,1,0.823339,146,1423154,-1,500.0,4024892,4036285,2681004,11393,11,9,True,True,93.70507222222221,-0.7924138075805623
1570,1344060,19979,128,0.073751,146,1423154,-1,64000.0,4049664,4069643,2705604,19979,9,0,True,True,69821.1928888889,-0.06854080234573835
1571,1344137,5,32,0.97238,146,1423154,-1,16000.0,2981137,2981142,1637000,5,46,10,True,True,2.028888888888889,-0.97238
1572,1344253,122,32,0.642339,146,1423154,-1,16000.0,3245405,3245527,1901152,122,29,8,True,True,20.127288888888888,-0.642339
1573,1363780,12229,38,0.449974,146,1423154,-1,19000.0,2486621,2498850,1122841,12229,58,2,True,True,5053.044194444444,-0.37736816298891934
1574,1364676,40,1,0.680109,146,1423154,-1,500.0,1749154,1749194,384478,40,85,0,True,True,0.7853333333333334,-0.680109
1575,1364795,22,16,0.344515,146,1423154,-1,8000.0,2583821,2583843,1219026,22,57,12,True,True,2.9255111111111116,-0.344515
1576,1366877,6679,32,0.87796,146,1423154,-1,16000.0,3206384,3213063,1839507,6679,32,6,True,True,4305.833377777778,-0.8076630818979355
1577,1367148,7834,13,0.780263,146,1423154,-1,6500.0,2860821,2868655,1493673,7834,53,10,True,True,1267.6380527777778,-0.758838480468969
1578,1367189,10,8,0.639794,146,1423154,-1,4000.0,1604654,1604664,237465,10,95,7,True,True,0.6423333333333334,-0.639794
1579,1367258,28,1,0.181963,146,1423154,-1,500.0,3838192,3838220,2470934,28,17,0,True,True,0.6032833333333333,-0.181963
1580,1367279,4,19,0.966265,146,1423154,-1,9500.0,4116875,4116879,2749596,4,7,8,True,True,1.5901944444444445,-0.966265
1581,1367491,70,1,0.432618,146,1423154,-1,500.0,1994864,1994934,627373,70,85,0,True,True,0.3203472222222222,-0.432618
1582,1369153,7330,4,0.910712,146,1423154,-1,2000.0,4011892,4019222,2642739,7330,15,7,True,True,596.4806666666667,-0.9045461935899503
1583,1371674,29978,16,0.055413,146,1423154,-1,8000.0,3418755,3448733,2047081,29978,29,0,True,True,3472.4241111111114,-0.048858479084479135
1584,1371746,7570,32,0.124161,146,1423154,-1,16000.0,3997392,4004962,2625646,7570,17,6,True,True,5353.0562666666665,-0.11884281796558453
1585,1371766,22985,1,0.153015,146,1423154,-1,500.0,3389105,3412090,2017339,22985,31,9,True,True,294.8742291666667,-0.14820948460303252
1586,1374454,11567,32,0.164657,146,1423154,-1,16000.0,3141460,3153027,1767006,11567,44,7,True,True,3703.3026666666665,-0.15472373736471892
1587,1376090,11,17,0.322661,146,1423154,-1,8500.0,2873121,2873132,1497031,11,60,8,True,True,2.764483333333333,-0.322661
1588,1381788,16620,8,0.709332,146,1423154,-1,4000.0,3139260,3155880,1757472,16620,45,7,True,True,1370.4233333333332,-0.6905485003054628
1589,1384832,10899,256,0.346023,146,1423154,-1,128000.0,3037335,3048234,1652503,10899,55,1,True,True,57640.208,-0.32723329134011436
1590,1385180,25,3,0.940904,146,1423154,-1,1500.0,2080100,2080125,694920,25,89,0,True,True,0.7270833333333333,-0.940904
1591,1385597,192,1,0.894926,146,1423154,-1,500.0,2985542,2985734,1599945,192,57,7,True,True,1.989066666666667,-0.894926
1592,1389857,6,1,0.845934,146,1423154,-1,500.0,3208584,3208590,1818727,6,38,7,True,True,0.11978333333333335,-0.845934
1593,1389978,10134,32,0.250605,146,1423154,-1,16000.0,2672421,2682555,1282443,10134,70,7,True,True,7748.090533333334,-0.24473701945306858
1594,1390228,10712,64,0.635057,146,1423154,-1,32000.0,4043864,4054576,2653636,10712,11,1,True,True,7207.580444444445,-0.45640475020527405
1595,1405595,74,1,0.550841,146,1423154,-1,500.0,2257421,2257495,851826,74,84,11,True,True,0.44276666666666664,-0.550841
1596,1405663,4790,256,0.12517,146,1423154,-1,128000.0,3240005,3244795,1834342,4790,37,0,True,True,6618.495999999999,-0.1251622002741775
1597,1406002,106,32,0.302825,146,1423154,-1,16000.0,3248705,3248811,1842703,106,35,6,True,True,14.642133333333332,-0.302825
1598,1406116,50,4,0.533478,146,1423154,-1,2000.0,3391305,3391355,1985189,50,32,7,True,True,2.467222222222222,-0.533478
1599,1406373,15161,64,0.502573,146,1423154,-1,32000.0,2050900,2066061,644527,15161,100,7,True,True,16997.463111111112,-0.49982697595184694
1600,1406442,14079,1,0.168636,146,1423154,-1,500.0,3645670,3659749,2239228,14079,27,10,True,True,65.09847916666666,-0.16074945216235997
1601,1406530,1,8,0.941607,146,1423154,-1,4000.0,1994923,1994924,588393,1,103,2,True,True,0.036611111111111115,-0.941607
1602,1406645,12,16,0.154194,146,1423154,-1,8000.0,4047464,4047476,2640819,12,11,2,True,True,1.3066666666666666,-0.154194
1603,1407095,154,32,0.658733,146,1423154,-1,16000.0,2261821,2261975,854726,154,89,7,True,True,31.162755555555556,-0.658733
1604,1407146,4350,4,0.720633,146,1423154,-1,2000.0,3864492,3868842,2457346,4350,21,10,True,True,87.7249,-0.7117079410267382
1605,1408195,10170,128,0.605139,146,1423154,-1,64000.0,3129090,3139260,1720895,10170,54,8,True,True,22042.090666666667,-0.5879165634071398
1606,1408412,53,9,0.84253,146,1423154,-1,4500.0,4003892,4003945,2595480,53,18,8,True,True,8.3653875,-0.84253
1607,1408478,13,16,0.563618,146,1423154,-1,8000.0,4036492,4036505,2628014,13,14,3,True,True,1.4941333333333333,-0.563618
1608,1408524,16770,21,0.825236,146,1423154,-1,10500.0,2308321,2325091,899797,16770,92,6,True,True,3154.0714625,-0.8179479834258465
1609,1408588,818,16,0.028373,146,1423154,-1,8000.0,3558170,3558988,2149582,818,33,6,True,True,93.28835555555555,-0.028373
1610,1408763,78,1,0.045462,146,1423154,-1,500.0,4221075,4221153,2812312,78,0,8,True,True,0.45749166666666663,-0.045462
1611,1408861,22648,16,0.641454,146,1423154,-1,8000.0,3053634,3076282,1644773,22648,67,8,True,True,6977.370755555556,-0.6220270569027642
1612,1409391,32,2,0.576771,146,1423154,-1,1000.0,2214189,2214221,804798,32,100,1,True,True,0.3562666666666667,-0.576771
1613,1409433,50,1,0.65113,146,1423154,-1,500.0,4049664,4049714,2640231,50,12,7,True,True,0.34027777777777773,-0.65113
1614,1419280,17420,1,0.766959,146,1423154,-1,500.0,1997123,2014543,577843,17420,115,7,True,True,94.00562500000001,-0.7527452224330465
1615,1419841,10,1,0.416587,146,1423154,-1,500.0,2030982,2030992,611141,10,115,6,True,True,0.09458333333333332,-0.416587
1616,1419867,10276,128,0.638991,146,1423154,-1,64000.0,3118290,3128566,1698423,10276,61,3,True,True,31159.39448888889,-0.6383290041771671
1617,1419942,13212,32,0.498038,146,1423154,-1,16000.0,3367505,3380717,1947563,13212,42,12,True,True,3238.178622222222,-0.38495911285896356
1618,1419965,3682,32,0.627164,146,1423154,-1,16000.0,1608254,1611936,188289,3682,132,4,True,True,1092.7014222222224,-0.5836026356937334
1619,1420003,3,32,0.289672,146,1423154,-1,16000.0,3378305,3378308,1958302,3,42,9,True,True,1.1177333333333335,-0.289672
1620,1420167,12298,141,0.95665,146,1423154,-1,70500.0,1604654,1616952,184487,12298,135,0,True,True,16117.614824999999,-0.8825085977102292
1621,1420244,56,2,0.482945,146,1423154,-1,1000.0,1601354,1601410,181110,56,139,8,True,True,0.9154444444444444,-0.482945
1622,1420284,9835,8,0.804688,146,1423154,-1,4000.0,1745554,1755389,325270,9835,129,7,True,True,1466.8397555555555,-0.6905802453375797
1623,1420302,31,1,0.684991,146,1423154,-1,500.0,3208584,3208615,1788282,31,52,0,True,True,0.6188805555555555,-0.684991
1624,1420306,8332,256,0.297434,146,1423154,-1,128000.0,4069643,4077975,2649337,8332,11,0,True,True,71131.7208888889,-0.2969340856174498
1625,1420347,34,16,0.072973,146,1423154,-1,8000.0,2480821,2480855,1060474,34,95,4,True,True,4.656488888888889,-0.072973
1626,1424591,1809,1,0.059913,199,1509554,-1,500.0,3418755,3420564,1994164,1809,41,10,True,True,23.977679166666668,-0.05389490259748482
1627,1424612,768,1,0.439605,199,1509554,-1,500.0,1749154,1749922,324542,768,133,1,True,True,14.114636111111112,-0.4115068314691877
1628,1426672,18,24,0.484251,199,1509554,-1,12000.0,2007923,2007941,581251,18,123,9,True,True,2.2068,-0.484251
1629,1427179,524,8,0.204023,199,1509554,-1,4000.0,3516364,3516888,2089185,524,38,1,True,True,43.71324444444444,-0.204023
1630,1432315,7,1,0.60666,199,1509554,-1,500.0,3622970,3622977,2190655,7,35,0,True,True,0.03205416666666666,-0.60666
1631,1432369,8,4,0.312582,199,1509554,-1,2000.0,3397155,3397163,1964786,8,44,7,True,True,0.48404444444444444,-0.312582
1632,1432443,52,16,0.718363,199,1509554,-1,8000.0,2462821,2462873,1030378,52,103,7,True,True,21.776444444444444,-0.718363
1633,1432465,5,2,0.7342,199,1509554,-1,1000.0,2983337,2983342,1550872,5,82,7,True,True,0.12680555555555556,-0.7342
1634,1432472,7933,197,0.860777,199,1509554,-1,98500.0,3785966,3793899,2353494,7933,31,8,True,True,19745.263212500002,-0.8124079597223878
1635,1432563,40,1,0.975374,199,1509554,-1,500.0,4009692,4009732,2577129,40,22,7,True,True,0.5010000000000001,-0.975374
1636,1432902,16297,1,0.130766,199,1509554,-1,500.0,2860821,2877118,1427919,16297,91,0,True,True,218.07162916666667,-0.12027018627982043
1637,1433882,10,1,0.37054,199,1509554,-1,500.0,1756054,1756064,322172,10,140,2,True,True,0.18822222222222224,-0.37054
1638,1434306,672,2,0.561651,199,1509554,-1,1000.0,4027092,4027764,2592786,672,19,7,True,True,11.767466666666667,-0.561651
1639,1434340,258,2,0.319116,199,1509554,-1,1000.0,1782064,1782322,347724,258,139,0,True,True,12.892116666666666,-0.319116
1640,1434383,83,41,0.466473,199,1509554,-1,20500.0,3199884,3199967,1765501,83,64,10,True,True,81.51130277777779,-0.466473
1641,1434752,30097,16,0.267472,199,1509554,-1,8000.0,2674621,2704718,1239869,30097,99,7,True,True,10934.053,-0.25951309992070687
1642,1435236,54,1,0.247919,199,1509554,-1,500.0,2957337,2957391,1522101,54,88,0,True,True,1.1056499999999998,-0.247919
1643,1435263,34,1,0.096812,199,1509554,-1,500.0,3109499,3109533,1674236,34,76,10,True,True,1.0754388888888888,-0.096812
1644,1435411,15,32,0.290212,199,1509554,-1,16000.0,3834566,3834581,2399155,15,32,0,True,True,9.84,-0.290212
1645,1435621,33,32,0.38415,199,1509554,-1,16000.0,1994864,1994897,559243,33,142,12,True,True,4.832666666666667,-0.38415
1646,1435683,2,2,0.615377,199,1509554,-1,1000.0,2864121,2864123,1428438,2,96,6,True,True,0.048666666666666664,-0.615377
1647,1435706,6918,1,0.24827,199,1509554,-1,500.0,2029882,2036800,594176,6918,138,1,True,True,63.036649999999995,-0.24718667089522275
1648,1435860,98,2,0.865308,199,1509554,-1,1000.0,2459521,2459619,1023661,98,117,10,True,True,5.228572222222222,-0.865308
1649,1435902,860,5,0.1597,199,1509554,-1,2500.0,2351521,2352381,915619,860,119,11,True,True,39.39875,-0.1597
1650,1435919,238,4,0.327436,199,1509554,-1,2000.0,3516364,3516602,2080445,238,43,0,True,True,9.927244444444444,-0.327436
1651,1436041,8762,16,0.577687,199,1509554,-1,8000.0,3757270,3766032,2321229,8762,37,2,True,True,960.1411555555555,-0.5078380563731165
1652,1436063,18,4,0.312715,199,1509554,-1,2000.0,3391355,3391373,1955292,18,51,1,True,True,0.8882,-0.312715
1653,1436085,79,1,0.763121,199,1509554,-1,500.0,3753670,3753749,2317585,79,38,0,True,True,0.7015638888888889,-0.763121
1654,1436093,26,28,0.498266,199,1509554,-1,14000.0,3087899,3087925,1651806,26,82,10,True,True,7.124288888888888,-0.4982659999999999
1655,1438443,13,1,0.514725,199,1509554,-1,500.0,3622970,3622983,2184527,13,42,10,True,True,0.05952916666666666,-0.514725
1656,1439228,3,2,0.49876,199,1509554,-1,1000.0,2036800,2036803,597572,3,145,2,True,True,0.05291666666666667,-0.49876
1657,1440078,14813,8,0.30854,199,1509554,-1,4000.0,3529576,3544389,2089498,14813,45,7,True,True,1293.9593888888887,-0.301306391217924
1658,1440364,46,2,0.023176,199,1509554,-1,1000.0,2036800,2036846,596436,46,146,0,True,True,0.8113888888888889,-0.023176
1659,1440682,10185,1,0.945233,199,1509554,-1,500.0,2490221,2500406,1049539,10185,115,2,True,True,121.45999027777778,-0.850864055044662
1660,1440832,120,64,0.505444,199,1509554,-1,32000.0,2959537,2959657,1518705,120,97,7,True,True,171.392,-0.505444
1661,1441739,12,1,0.966687,199,1509554,-1,500.0,3394955,3394967,1953216,12,54,2,True,True,0.18151666666666666,-0.966687
1662,1441788,212,1,0.215144,199,1509554,-1,500.0,3527164,3527376,2085376,212,47,9,True,True,2.898511111111111,-0.215144
1663,1442362,3461,128,0.352895,199,1509554,-1,64000.0,3667270,3670731,2224908,3461,40,10,True,True,1631.6040888888888,-0.337467028964653
1664,1442591,40,1,0.05054,199,1509554,-1,500.0,4037592,4037632,2595001,40,17,6,True,True,0.28733333333333333,-0.05054
1665,1442660,76316,128,0.494894,199,1509554,-1,64000.0,2835621,2911937,1392961,76316,112,7,True,True,114082.5104,-0.4761924863068758
1666,1450502,450,32,0.882339,199,1509554,-1,16000.0,2259621,2260071,809119,450,137,7,True,True,86.16,-0.882339
1667,1450575,102,2,0.65426,199,1509554,-1,1000.0,3109499,3109601,1658924,102,87,0,True,True,6.452633333333333,-0.65426
1668,1451480,778,32,0.470587,199,1509554,-1,16000.0,1787464,1788242,335984,778,167,8,True,True,533.4313777777778,-0.470587
1669,1451527,12814,32,0.536691,199,1509554,-1,16000.0,3829166,3841980,2377639,12814,35,11,True,True,8952.311288888888,-0.5269393868145706
1670,1451581,96,4,0.847172,199,1509554,-1,2000.0,3163060,3163156,1711479,96,81,10,True,True,2.4016,-0.847172
1671,1451844,30,16,0.430928,199,1509554,-1,8000.0,3953092,3953122,2501248,30,28,7,True,True,10.728666666666667,-0.430928
1672,1451875,16774,1,0.882456,199,1509554,-1,500.0,1822064,1838838,370189,16774,169,9,True,True,247.99331944444447,-0.8487821335652475
1673,1452049,27,1,0.727508,199,1509554,-1,500.0,3953092,3953119,2501043,27,28,0,True,True,0.6034875,-0.727508
1674,1452085,57,1,0.763857,199,1509554,-1,500.0,3048234,3048291,1596149,57,100,0,True,True,1.0050208333333335,-0.763857
1675,1452408,18768,1,0.365937,199,1509554,-1,500.0,2680021,2698789,1227613,18768,121,8,True,True,414.0761055555555,-0.3592153885220212
1676,1452615,52,16,0.400582,199,1509554,-1,8000.0,3506964,3507016,2054349,52,56,12,True,True,11.318666666666667,-0.400582
1677,1454614,8,1,0.570282,199,1509554,-1,500.0,1611554,1611562,156940,8,187,7,True,True,0.08025555555555557,-0.570282
1678,1454636,39,1,0.194655,199,1509554,-1,500.0,4121575,4121614,2666939,39,7,6,True,True,0.5385791666666667,-0.194655
1679,1456872,6712,86,0.553223,199,1509554,-1,43000.0,3950892,3957604,2494020,6712,31,0,True,True,12877.717877777779,-0.5316653104171774
1680,1596460,10681,32,0.073532,214,1601354,-1,16000.0,2835621,2846302,1239161,10681,121,0,True,True,4500.864577777777,-0.06213030943805833
1681,1596869,64,32,0.504256,214,1601354,-1,16000.0,2214125,2214189,617256,64,152,9,True,True,11.400533333333334,-0.504256
1682,1597436,24,10,0.764404,214,1601354,-1,5000.0,3178260,3178284,1580824,24,84,8,True,True,1.144,-0.764404
1683,1597484,939,2,0.279721,214,1601354,-1,1000.0,3758961,3759900,2161477,939,43,1,True,True,15.848233333333331,-0.279721
1684,1597521,994,8,0.989091,214,1601354,-1,4000.0,2035682,2036676,438161,994,170,2,True,True,70.13222222222221,-0.989091
1685,1597734,3,42,0.680399,214,1601354,-1,21000.0,2058500,2058503,460766,3,165,7,True,True,2.6080250000000005,-0.680399
1686,1597776,122,1,0.118811,214,1601354,-1,500.0,2790221,2790343,1192445,122,125,0,True,True,1.2987916666666668,-0.118811
1687,1597818,384,8,0.975083,214,1601354,-1,4000.0,2867721,2868105,1269903,384,119,4,True,True,38.318933333333334,-0.975083
1688,1597823,17302,18,0.393904,214,1601354,-1,9000.0,4007492,4024794,2409669,17302,26,3,True,True,5751.45345,-0.39385795080890007
1689,1598531,28,1,0.794897,214,1601354,-1,500.0,3247605,3247633,1649074,28,74,6,True,True,0.12086666666666665,-0.794897
1690,1598542,127,51,0.339085,214,1601354,-1,25500.0,3996292,3996419,2397750,127,30,11,True,True,148.42225416666668,-0.339085
1691,1598584,14,3,0.938949,214,1601354,-1,1500.0,1782064,1782078,183480,14,190,7,True,True,1.0493583333333332,-0.938949
1692,1598620,11847,3,0.754965,214,1601354,-1,1500.0,1752454,1764301,153834,11847,194,6,True,True,813.7553125000002,-0.6538766945969877
1693,1598714,12681,256,0.199058,214,1601354,-1,128000.0,3544389,3557070,1945675,12681,55,6,True,True,27226.5184,-0.19170320364104684
1694,1598776,6557,2,0.509123,214,1601354,-1,1000.0,1809064,1815621,210288,6557,188,0,True,True,372.7173833333333,-0.4902926494126474
1695,1598819,490,37,0.500078,214,1601354,-1,18500.0,3109533,3110023,1510714,490,99,0,True,True,573.4619722222221,-0.500078
1696,1598835,37,32,0.045303,214,1601354,-1,16000.0,2167625,2167662,568790,37,166,0,True,True,6.928044444444445,-0.045303
1697,1603039,14883,16,0.137036,216,1604654,-1,8000.0,3838192,3853075,2235153,14883,38,1,True,True,4299.972311111111,-0.13338486799800747
1698,1603587,160,1,0.333041,216,1604654,-1,500.0,2911937,2912097,1308350,160,122,0,True,True,1.32,-0.333041
1699,1603891,46,32,0.473744,216,1604654,-1,16000.0,4088775,4088821,2484884,46,12,9,True,True,43.17662222222222,-0.473744
1700,1604086,27,64,0.456989,216,1604654,-1,32000.0,1779864,1779891,175778,27,198,7,True,True,50.7792,-0.456989
1701,1605702,50,4,0.606261,227,1608254,-1,2000.0,1811264,1811314,205562,50,193,7,True,True,5.781944444444444,-0.606261
1702,1605723,93,1,0.515506,227,1608254,-1,500.0,1635354,1635447,29631,93,210,7,True,True,1.8601291666666666,-0.515506
1703,1605946,11059,128,0.327966,227,1608254,-1,64000.0,3841792,3852851,2235846,11059,38,4,True,True,24205.565511111112,-0.31563002073382623
1704,1606006,11257,64,0.613068,227,1608254,-1,32000.0,2493821,2505078,887815,11257,145,2,True,True,10735.82071111111,-0.5964461634044037
1705,1606043,41,1,0.162502,227,1608254,-1,500.0,2037900,2037941,431857,41,182,6,True,True,0.6769555555555555,-0.162502
1706,1606213,16,2,0.990616,227,1608254,-1,1000.0,2202225,2202241,596012,16,168,10,True,True,0.32755555555555554,-0.990616
1707,1606308,359,2,0.739319,227,1608254,-1,1000.0,2029523,2029882,423215,359,189,10,True,True,5.949427777777777,-0.739319
1708,1606337,1891,8,0.299234,227,1608254,-1,4000.0,2983342,2985233,1377005,1891,118,1,True,True,176.3654111111111,-0.275108846629709
1709,1606500,13621,1,0.336373,227,1608254,-1,500.0,3165260,3178881,1558760,13621,95,7,True,True,67.96313888888889,-0.325152124472427
1710,1606528,59,2,0.828289,227,1608254,-1,1000.0,3624070,3624129,2017542,59,54,6,True,True,0.5403416666666667,-0.828289
1711,1606786,19333,64,0.53234,227,1608254,-1,32000.0,3506964,3526297,1900178,19333,66,0,True,True,15150.621155555555,-0.5163798004900777
1712,1606809,112,64,0.70874,227,1608254,-1,32000.0,4110375,4110487,2503566,112,12,10,True,True,156.73031111111112,-0.70874
1713,1608097,518,2,0.299791,227,1608254,-1,1000.0,4222175,4222693,2614078,518,0,6,True,True,6.076427777777778,-0.299791
1714,1608200,15423,32,0.815749,227,1608254,-1,16000.0,4030692,4046115,2422492,15423,24,2,True,True,3874.6794666666665,-0.8144045083545385
1715,1608220,15378,1,0.368358,227,1608254,-1,500.0,2833421,2848799,1225201,15378,142,11,True,True,201.77247916666664,-0.3636431728692994
1716,1608688,1992,1,0.673806,228,1609354,-1,500.0,2032082,2034074,423394,1992,195,6,True,True,18.793722222222218,-0.6721152165843992
1717,1608889,7265,8,0.979898,228,1609354,-1,4000.0,3048234,3055499,1439345,7265,119,0,True,True,1307.7521111111112,-0.9247847372765927
1718,1611130,6,4,0.583702,231,1611554,-1,2000.0,3557070,3557076,1945940,6,62,8,True,True,0.17106666666666667,-0.583702
1719,1611158,29,32,0.796755,231,1611554,-1,16000.0,3622970,3622999,2011812,29,59,0,True,True,4.249466666666667,-0.796755
1720,1611488,390,32,0.725324,231,1611554,-1,16000.0,2305021,2305411,693533,390,172,11,True,True,100.10000000000001,-0.725324
1721,1611548,15,8,0.688044,231,1611554,-1,4000.0,4077975,4077990,2466427,15,15,0,True,True,3.9775,-0.688044
1722,1618229,16,1,0.026647,236,1633154,-1,500.0,2874221,2874237,1255992,16,138,6,True,True,0.23653333333333332,-0.026647
1723,1618309,13,2,0.47459,236,1633154,-1,1000.0,2863021,2863034,1244712,13,142,7,True,True,0.3163333333333333,-0.47459
1724,1618347,25525,16,0.967071,236,1633154,-1,8000.0,3512764,3538289,1894417,25525,71,7,True,True,4863.214733333333,-0.9474545668668214
1725,1618857,5,13,0.782904,236,1633154,-1,6500.0,4213475,4213480,2594618,5,4,6,True,True,0.33592361111111113,-0.782904
1726,1618870,2,8,0.776162,236,1633154,-1,4000.0,2790221,2790223,1171351,2,152,10,True,True,0.17033333333333334,-0.776162
1727,1618883,135,32,0.577634,236,1633154,-1,16000.0,3275705,3275840,1656822,135,87,8,True,True,23.826,-0.577634
4529,3668186,12,8,0.701314,1,3668186,-1,4000.0,3669286,3669298,1100,12,0,6,True,True,0.8990666666666668,-0.701314
4530,3668196,39839,1,0.255939,6,3669286,-1,500.0,5952794,5992633,2284598,39839,0,6,True,True,763.1510416666666,-0.2546100716005676
4531,3668426,38,4,0.366354,6,3669286,-1,2000.0,3669286,3669324,860,38,1,0,True,True,1.4235222222222224,-0.366354
4532,3668615,13,64,0.605954,6,3669286,-1,32000.0,4767931,4767944,1099316,13,1,1,True,True,24.491999999999997,-0.605954
4533,3668830,23991,4,0.070874,6,3669286,-1,2000.0,3755686,3779677,86856,23991,2,12,True,True,820.8073666666668,-0.0702022677723349
4534,3668847,12081,256,0.930211,6,3669286,-1,128000.0,4547264,4559345,878417,12081,2,11,True,True,62265.278577777775,-0.8794760649295841
4535,3668865,5,1,0.208738,6,3669286,-1,500.0,5777694,5777699,2108829,5,1,6,True,True,0.11154166666666668,-0.208738
4536,3669374,4541,184,0.491406,158,3755686,-1,92000.0,5660894,5665435,1991520,4541,2,6,True,True,16035.496755555558,-0.48424193903879637
4537,3669407,7819,4,0.889767,158,3755686,-1,2000.0,3843186,3851005,173779,7819,5,6,True,True,486.74325,-0.8732970559496149
4538,3669434,2,4,0.079957,158,3755686,-1,2000.0,6094548,6094550,2425114,2,0,11,True,True,0.1543,-0.079957
4539,3669546,5723,2,0.80102,158,3755686,-1,1000.0,4743864,4749587,1074318,5723,5,10,True,True,283.38598611111115,-0.7876315319242517
4540,3669588,33704,64,0.0607,158,3755686,-1,32000.0,4418501,4452205,748913,33704,7,6,True,True,35037.296533333334,-0.0599891768932526
4541,3669597,10,1,0.55802,158,3755686,-1,500.0,5430426,5430436,1760829,10,4,0,True,True,0.18902777777777777,-0.55802
4542,3670045,612,43,0.938244,158,3755686,-1,21500.0,4372001,4372613,701956,612,9,10,True,True,407.4594,-0.938244
4543,3670118,3,16,0.415953,158,3755686,-1,8000.0,5207528,5207531,1537410,3,5,8,True,True,0.8387333333333334,-0.415953
4544,3670126,12,8,0.369069,158,3755686,-1,4000.0,5773294,5773306,2103168,12,3,7,True,True,2.1053333333333337,-0.369069
4545,3670158,26577,128,0.708434,158,3755686,-1,64000.0,4133601,4160178,463443,26577,12,3,True,True,107475.7136,-0.6830571332753536
4546,3670351,9,2,0.823643,158,3755686,-1,1000.0,5246828,5246837,1576477,9,6,9,True,True,0.313925,-0.823643
4547,3670440,3747,1,0.265816,158,3755686,-1,500.0,5604694,5608441,1934254,3747,5,11,True,True,87.9325486111111,-0.2649656098276194
4548,3672786,28250,128,0.040653,158,3755686,-1,64000.0,6322105,6350355,2649319,28250,0,6,True,True,123265.31022222221,-0.03998642934040925
4549,3672822,13457,128,0.070388,158,3755686,-1,64000.0,6308648,6322105,2635826,13457,1,7,True,True,81455.27235555556,-0.0690356709000858
4550,3673201,21313,16,0.303905,158,3755686,-1,8000.0,5999294,6020607,2326093,21313,3,11,True,True,8102.929066666667,-0.2964082583344769
4551,3673565,89,1,0.944603,158,3755686,-1,500.0,5430337,5430426,1756772,89,10,6,True,True,1.6823472222222222,-0.944603
4552,3673625,16711,4,0.960587,158,3755686,-1,2000.0,4469301,4486012,795676,16711,16,7,True,True,1208.6725222222221,-0.9039227129344806
4553,3673741,75,2,0.097119,158,3755686,-1,1000.0,4760656,4760731,1086915,75,14,7,True,True,4.610833333333333,-0.097119
4554,3673762,201,1,0.725172,158,3755686,-1,500.0,4258201,4258402,584439,201,20,2,True,True,3.4965625,-0.725172
4555,3673920,5,1,0.531661,158,3755686,-1,500.0,6468305,6468310,2794385,5,0,11,True,True,0.12859027777777776,-0.531661
4556,3674946,25,1,0.18946,158,3755686,-1,500.0,4143001,4143026,468055,25,22,5,True,True,0.7373611111111111,-0.18946
4557,3674980,12598,32,0.526192,158,3755686,-1,16000.0,5246828,5259426,1571848,12598,12,0,True,True,6776.169422222222,-0.5210925028577285
4558,3675045,21116,45,0.248763,158,3755686,-1,22500.0,4139401,4160517,464356,21116,24,0,True,True,29473.108562500005,-0.24242788948920813
4559,3675284,288,3,0.625325,158,3755686,-1,1500.0,6468305,6468593,2793021,288,0,0,True,True,22.220399999999998,-0.625325
4560,3675406,1649,5,0.178898,158,3755686,-1,2500.0,5658694,5660343,1983288,1649,10,11,True,True,166.27622222222223,-0.16880888177015854
4561,3675425,101,1,0.749194,158,3755686,-1,500.0,3858833,3858934,183408,101,28,7,True,True,1.3999722222222222,-0.749194
4562,3675572,12,2,0.415185,158,3755686,-1,1000.0,4096079,4096091,420507,12,28,9,True,True,0.45456666666666673,-0.415185
4563,3675590,8667,16,0.105514,158,3755686,-1,8000.0,6309748,6318415,2634158,8667,3,6,True,True,6438.691822222222,-0.10264415930621479
4564,3675622,29,12,0.638624,158,3755686,-1,6000.0,4417401,4417430,741779,29,24,7,True,True,5.4539333333333335,-0.638624
4565,3675637,7754,128,0.357963,158,3755686,-1,64000.0,6043594,6051348,2367957,7754,6,6,True,True,22523.2832,-0.33244911451446063
4566,3675654,189,32,0.458721,158,3755686,-1,16000.0,3831286,3831475,155632,189,34,10,True,True,109.15799999999999,-0.458721
4567,3675688,10761,1,0.665242,158,3755686,-1,500.0,5273937,5284698,1598249,10761,16,6,True,True,170.77532083333335,-0.6481387810102239
4568,3675741,8744,4,0.882824,158,3755686,-1,2000.0,4887704,4896448,1211963,8744,20,1,True,True,665.4685777777777,-0.8548616046044415
4569,3675872,9308,1,0.166809,158,3755686,-1,500.0,5747294,5756602,2071422,9308,11,12,True,True,179.58648333333332,-0.16099475343042688
4570,3675903,11829,72,0.180397,158,3755686,-1,36000.0,4074479,4086308,398576,11829,35,10,True,True,18555.5452,-0.17655635230097277
4571,3676012,238,1,0.401557,158,3755686,-1,500.0,4118079,4118317,442067,238,34,2,True,True,5.404583333333333,-0.401557
4572,3676024,33,8,0.337513,158,3755686,-1,4000.0,6764305,6764338,3088281,33,0,12,True,True,4.592866666666667,-0.337513
4573,3676082,23,5,0.158176,158,3755686,-1,2500.0,4612064,4612087,935982,23,26,11,True,True,3.447125,-0.15817599999999998
4574,3676130,45,1,0.998434,158,3755686,-1,500.0,5819894,5819939,2143764,45,10,6,True,True,1.2306875000000002,-0.998434
4575,3676133,2356,2,0.443012,158,3755686,-1,1000.0,5774394,5776750,2098261,2356,12,0,True,True,105.11233333333334,-0.4429928943975372
4576,3676184,230,8,0.352324,158,3755686,-1,4000.0,4135801,4136031,459617,230,37,7,True,True,75.64699999999999,-0.352324
4577,3677867,53,45,0.315155,158,3755686,-1,22500.0,4977428,4977481,1299561,53,24,10,True,True,38.9715625,-0.315155
4578,3677893,32,1,0.991463,158,3755686,-1,500.0,5771094,5771126,2093201,32,14,7,True,True,0.7017777777777778,-0.991463
4579,3677973,1043,1,0.324654,158,3755686,-1,500.0,5799294,5800337,2121321,1043,11,0,True,True,44.02652638888889,-0.29938890088502845
4580,3677995,13208,38,0.37172,158,3755686,-1,19000.0,4930628,4943836,1252633,13208,27,1,True,True,9003.125511111113,-0.3640819795569497
4581,3678079,1889,4,0.764184,158,3755686,-1,2000.0,5776594,5778483,2098515,1889,13,7,True,True,167.8802,-0.7610940801925624
4582,3678090,14913,128,0.430588,158,3755686,-1,64000.0,6051348,6066261,2373258,14913,7,6,True,True,41620.414399999994,-0.4284754005264142
4583,3678108,13165,16,0.725868,158,3755686,-1,8000.0,4764331,4777496,1086223,13165,32,2,True,True,5555.152711111111,-0.6788741002532563
4584,3678125,7,4,0.608413,158,3755686,-1,2000.0,6290148,6290155,2612023,7,6,9,True,True,1.2793666666666668,-0.608413
4585,3678176,6,37,0.563145,158,3755686,-1,18500.0,5956094,5956100,2277918,6,11,7,True,True,4.251916666666667,-0.563145
4586,3678377,8869,256,0.213928,158,3755686,-1,128000.0,4749587,4758456,1071210,8869,36,0,True,True,62392.34737777778,-0.21036568726759355
4587,3678440,12027,210,0.765708,158,3755686,-1,105000.0,4906945,4918972,1228505,12027,32,8,True,True,44817.67325,-0.7376946646868267
4588,3679211,14,64,0.926147,158,3755686,-1,32000.0,4504064,4504078,824853,14,41,6,True,True,20.754844444444444,-0.926147
4589,3679280,44,128,0.254089,158,3755686,-1,64000.0,4027979,4028023,348699,44,54,10,True,True,71.01795555555556,-0.254089
4590,3679312,4,1,0.961652,158,3755686,-1,500.0,4934228,4934232,1254916,4,31,2,True,True,0.07154444444444444,-0.961652
4591,3679372,7906,32,0.4475,158,3755686,-1,16000.0,6323205,6331111,2643833,7906,3,0,True,True,12228.754977777779,-0.4389052666221593
4592,3680172,1984,32,0.397091,158,3755686,-1,16000.0,5799294,5801278,2119122,1984,16,10,True,True,2787.1838222222223,-0.38084550560010016
4593,3680281,13,14,0.726313,158,3755686,-1,7000.0,4168201,4168214,487920,13,50,2,True,True,3.5277666666666665,-0.726313
4594,3680922,11742,86,0.982956,158,3755686,-1,43000.0,5430436,5442178,1749514,11742,26,1,True,True,17278.79248333333,-0.9523729070335227
4595,3681024,1300,8,0.595763,158,3755686,-1,4000.0,5441636,5442936,1760612,1300,26,8,True,True,186.0588888888889,-0.595763
4596,3681070,19,1,0.517609,158,3755686,-1,500.0,5463236,5463255,1782166,19,26,10,True,True,0.30859166666666665,-0.517609
4597,3681095,23,32,0.993412,158,3755686,-1,16000.0,6323205,6323228,2642110,23,3,0,True,True,36.81942222222222,-0.993412
4598,3681213,5,32,0.301842,158,3755686,-1,16000.0,5275037,5275042,1593824,5,32,6,True,True,2.6322222222222225,-0.301842
4599,3681391,13,8,0.300334,158,3755686,-1,4000.0,6048994,6049007,2367603,13,11,0,True,True,2.198733333333333,-0.300334
4600,3681904,3459,4,0.221887,158,3755686,-1,2000.0,4793131,4796590,1111227,3459,43,10,True,True,253.9230666666667,-0.19866824253539644
4601,3682096,13849,4,0.85572,158,3755686,-1,2000.0,4926467,4940316,1244371,13849,41,6,True,True,1006.9425388888887,-0.8427503841442928
4602,3682167,19827,32,0.021701,158,3755686,-1,16000.0,6303148,6322975,2620981,19827,8,9,True,True,29823.24146666667,-0.02148416054254572
4603,3682283,6,1,0.82194,158,3755686,-1,500.0,3919177,3919183,236894,6,68,6,True,True,0.05333333333333334,-0.82194
4604,3682525,22,32,0.689719,158,3755686,-1,16000.0,5063828,5063850,1381303,22,39,12,True,True,7.949333333333334,-0.689719
4605,3682574,13,1,0.275957,158,3755686,-1,500.0,3913037,3913050,230463,13,70,6,True,True,0.16562361111111112,-0.275957
4606,3682589,3,4,0.553663,158,3755686,-1,2000.0,3849033,3849036,166444,3,72,1,True,True,0.18205000000000002,-0.553663
4607,3683826,2914,1,0.556323,158,3755686,-1,500.0,3831286,3834200,147460,2914,74,0,True,True,52.516152777777776,-0.5555032236539423
4608,3685104,2,1,0.925922,158,3755686,-1,500.0,3990877,3990879,305773,2,69,6,True,True,0.02197777777777778,-0.925922
4609,3688341,561,1,0.154715,158,3755686,-1,500.0,4930067,4930628,1241726,561,43,3,True,True,10.394862499999999,-0.154715
4610,3688365,19295,64,0.037736,158,3755686,-1,32000.0,3911937,3931232,223572,19295,73,7,True,True,12710.51617777778,-0.035314478332867244
4611,3688398,12603,8,0.355656,158,3755686,-1,4000.0,4423901,4436504,735503,12603,57,8,True,True,1718.5584222222224,-0.34955810274972776
4612,3688772,56,1,0.138408,158,3755686,-1,500.0,6764305,6764361,3075533,56,0,0,True,True,0.9742444444444445,-0.138408
4613,3688871,53,8,0.367083,158,3755686,-1,4000.0,6546105,6546158,2857234,53,2,10,True,True,17.2197,-0.367083
4614,3688977,11,8,0.582156,158,3755686,-1,4000.0,4415201,4415212,726224,11,62,11,True,True,1.2692777777777777,-0.582156
4615,3689104,7367,16,0.232994,158,3755686,-1,8000.0,3918077,3925444,228973,7367,76,1,True,True,1138.6392,-0.21889277844751337
4616,3689453,19,1,0.811074,158,3755686,-1,500.0,5434036,5434055,1744583,19,33,0,True,True,0.3056361111111111,-0.811074
4617,3690701,14513,16,0.091905,158,3755686,-1,8000.0,6764338,6778851,3073637,14513,0,2,True,True,4082.839311111111,-0.0896341771665113
4618,3690792,149,32,0.399798,158,3755686,-1,16000.0,5906294,5906443,2215502,149,20,12,True,True,114.1008888888889,-0.399798
4619,3690846,16952,256,0.917882,158,3755686,-1,128000.0,4486012,4502964,795166,16952,61,9,True,True,102800.52337777778,-0.9164265271512336
4620,3690876,21615,64,0.734266,158,3755686,-1,32000.0,4006379,4027994,315503,21615,78,6,True,True,18150.631555555556,-0.7249350021666122
4621,3690903,30,8,0.723581,158,3755686,-1,4000.0,5064928,5064958,1374025,30,44,6,True,True,2.71,-0.723581
4622,3691207,140,16,0.792904,158,3755686,-1,8000.0,3909737,3909877,218530,140,85,10,True,True,28.538222222222224,-0.792904
4623,3691710,20607,32,0.172902,158,3755686,-1,16000.0,6192948,6213555,2501238,20607,13,7,True,True,21067.164000000004,-0.17262032087703827
4624,3691896,6844,35,0.825705,158,3755686,-1,17500.0,5527994,5534838,1836098,6844,34,9,True,True,4252.968027777778,-0.8120530575393081
4625,3692532,17,8,0.689595,158,3755686,-1,4000.0,6326805,6326822,2634273,17,6,3,True,True,6.705933333333333,-0.689595
4626,3692654,1207,32,0.576232,158,3755686,-1,16000.0,3845386,3846593,152732,1207,91,0,True,True,598.8329333333334,-0.576232
4627,3692800,10,1,0.907656,158,3755686,-1,500.0,5246837,5246847,1554037,10,44,1,True,True,0.17440277777777777,-0.907656
4628,3692903,3,12,0.595231,158,3755686,-1,6000.0,5285837,5285840,1592934,3,42,0,True,True,0.55045,-0.595231
4629,3693006,11,21,0.300393,158,3755686,-1,10500.0,4914567,4914578,1221561,11,56,0,True,True,4.283766666666667,-0.300393
4630,3699045,8653,32,0.730789,158,3755686,-1,16000.0,4698464,4707117,999419,8653,65,12,True,True,4372.366266666666,-0.7021304872129873
4631,3699066,22116,32,0.576284,158,3755686,-1,16000.0,4127801,4149917,428735,22116,82,1,True,True,22042.695022222226,-0.5720109215226985
4632,3699271,21,1,0.078477,158,3755686,-1,500.0,6677905,6677926,2978634,21,3,6,True,True,0.5672916666666666,-0.078477
4633,3699282,111,18,0.055923,158,3755686,-1,9000.0,5434036,5434147,1734754,111,40,2,True,True,32.14005,-0.055923
4634,3699352,13,4,0.770902,158,3755686,-1,2000.0,3882737,3882750,183385,13,96,1,True,True,0.636711111111111,-0.770902
4635,3699478,11,4,0.34793,158,3755686,-1,2000.0,6764305,6764316,3064827,11,2,0,True,True,0.7654777777777778,-0.34793
4636,3699527,13020,12,0.817142,158,3755686,-1,6000.0,5659794,5672814,1960267,13020,35,6,True,True,2830.3332,-0.8096316765716304
4637,3700163,6,11,0.416522,158,3755686,-1,5500.0,5951694,5951700,2251531,6,24,7,True,True,1.3100999999999998,-0.416522
4638,3701086,44,32,0.867831,158,3755686,-1,16000.0,6185348,6185392,2484262,44,17,7,True,True,29.18862222222222,-0.867831
4639,3701224,130,1,0.869787,158,3755686,-1,500.0,4254601,4254731,553377,130,83,0,True,True,2.179847222222222,-0.869787
4640,3701346,187,32,0.226718,158,3755686,-1,16000.0,5285837,5286024,1584491,187,49,9,True,True,91.49702222222223,-0.226718
4641,3712058,24,36,0.652779,158,3755686,-1,18000.0,4502964,4502988,790906,24,76,0,True,True,20.5848,-0.652779
4642,3712151,13959,64,0.602302,158,3755686,-1,32000.0,5151328,5165287,1439177,13959,56,12,True,True,12912.122933333332,-0.5932425182759133
4643,3714914,7407,9,0.011434,158,3755686,-1,4500.0,5436236,5443643,1721322,7407,43,7,True,True,1153.3447125,-0.011095733350838506
4644,3715223,18,16,0.777419,158,3755686,-1,8000.0,6418605,6418623,2703382,18,8,8,True,True,9.7164,-0.777419
4645,3715324,18,16,0.382487,158,3755686,-1,8000.0,3858934,3858952,143610,18,107,1,True,True,3.992,-0.382487
4646,3715542,5,8,0.304783,158,3755686,-1,4000.0,3766486,3766491,50944,5,114,9,True,True,0.28011111111111114,-0.304783
4647,3720730,18,16,0.041182,158,3755686,-1,8000.0,3856633,3856651,135903,18,109,7,True,True,3.992,-0.041182
4648,3720939,56,4,0.53993,158,3755686,-1,2000.0,3848986,3849042,128047,56,111,0,True,True,3.3982666666666668,-0.53993
4649,3721655,12,1,0.14958,158,3755686,-1,500.0,6676805,6676817,2955150,12,5,6,True,True,0.3241666666666667,-0.14958
4650,3723113,108,2,0.502402,158,3755686,-1,1000.0,5511794,5511902,1788681,108,43,1,True,True,3.8181,-0.502402
4651,3723509,38,1,0.220797,158,3755686,-1,500.0,5953894,5953932,2230385,38,26,6,True,True,0.7543,-0.220797
4652,3723658,819,1,0.05052,158,3755686,-1,500.0,3831286,3832105,107628,819,118,0,True,True,14.7818125,-0.05052
4653,3723949,12732,20,0.731579,158,3755686,-1,10000.0,5774394,5787126,2050445,12732,36,6,True,True,5660.877166666667,-0.7232969362178634
4654,3724018,394,4,0.392883,158,3755686,-1,2000.0,6292348,6292742,2568330,394,17,7,True,True,72.01006666666667,-0.392883
4655,3733006,4,16,0.445616,158,3755686,-1,8000.0,4794231,4794235,1061225,4,74,6,True,True,1.3118222222222222,-0.445616
4656,3733414,122,4,0.595132,158,3755686,-1,2000.0,5468636,5468758,1735222,122,47,8,True,True,8.394955555555557,-0.595132
4657,3736777,71,3,0.504729,158,3755686,-1,1500.0,6096748,6096819,2359971,71,21,7,True,True,4.160008333333333,-0.504729
4658,3736867,291,2,0.222086,158,3755686,-1,1000.0,6413205,6413496,2676338,291,10,11,True,True,24.479566666666663,-0.222086
4659,3737473,40,1,0.289783,158,3755686,-1,500.0,5249037,5249077,1511564,40,62,7,True,True,0.6871666666666667,-0.289783
4660,3737586,14,4,0.394322,158,3755686,-1,2000.0,4797690,4797704,1060104,14,78,6,True,True,0.8489444444444445,-0.394322
4661,3737606,16503,3,0.132189,158,3755686,-1,1500.0,6304248,6320751,2566642,16503,17,6,True,True,2312.0495,-0.13163272841264415
4662,3737796,274,12,0.082545,158,3755686,-1,6000.0,4029079,4029353,291283,274,110,0,True,True,41.94483333333333,-0.082545
4663,3740770,18193,1,0.571441,158,3755686,-1,500.0,4914545,4932738,1173775,18193,77,8,True,True,347.0682277777778,-0.5708508666559684
4664,3740870,2,4,0.049311,158,3755686,-1,2000.0,3967077,3967079,226207,2,115,6,True,True,0.08585555555555555,-0.049311
4665,3740946,4650,1,0.399191,158,3755686,-1,500.0,5517194,5521844,1776248,4650,49,8,True,True,79.24155277777777,-0.38148520409028513
4666,3741105,22,1,0.085079,158,3755686,-1,500.0,5202128,5202150,1461023,22,69,8,True,True,0.3628166666666667,-0.085079
4667,3741132,20,4,0.501823,158,3755686,-1,2000.0,3965977,3965997,224845,20,118,1,True,True,0.8585555555555555,-0.501823
4668,3741765,21010,1,0.773825,158,3755686,-1,500.0,6183148,6204158,2441383,21010,23,12,True,True,489.83109999999994,-0.7188629444059433
4669,3741794,1379,32,0.130375,158,3755686,-1,16000.0,4771531,4772910,1029737,1379,86,2,True,True,1331.0107999999998,-0.130375
4670,3741818,8052,16,0.134871,158,3755686,-1,8000.0,4909145,4917197,1167327,8052,81,7,True,True,2315.2696444444446,-0.1338284452926765
4671,3742130,11773,256,0.559296,158,3755686,-1,128000.0,5500021,5511794,1757891,11773,52,2,True,True,50502.89564444444,-0.5270886215015874
4672,3742226,27737,2,0.487861,158,3755686,-1,1000.0,5399637,5427374,1657411,27737,62,1,True,True,1021.1609777777777,-0.4808123912837124
4673,3744910,24,1,0.652248,158,3755686,-1,500.0,5430426,5430450,1685516,24,61,1,True,True,0.45366666666666666,-0.652248
4674,3745166,37,4,0.196099,158,3755686,-1,2000.0,3882734,3882771,137568,37,131,10,True,True,1.8121777777777777,-0.196099
4675,3745225,5,16,0.615997,158,3755686,-1,8000.0,4261801,4261806,516576,5,108,2,True,True,1.4997777777777777,-0.615997
4676,3745556,5180,2,0.735668,158,3755686,-1,1000.0,4031279,4036459,285723,5180,120,7,True,True,133.7878,-0.7302875064489681
4677,3745892,345,7,0.246246,158,3755686,-1,3500.0,6279348,6279693,2533456,345,21,0,True,True,51.56025,-0.246246
4678,3745926,7556,18,0.071644,158,3755686,-1,9000.0,3989777,3997333,243851,7556,126,10,True,True,1597.517575,-0.0698909817441738
4679,3746126,1346,1,0.776772,158,3755686,-1,500.0,5232428,5233774,1486302,1346,73,7,True,True,19.1805,-0.776772
4680,3746157,12869,5,0.323412,158,3755686,-1,2500.0,5615494,5628363,1869337,12869,49,9,True,True,1941.5366875,-0.30079142258608316
4681,3746241,9785,64,0.924138,158,3755686,-1,32000.0,5490236,5500021,1743995,9785,55,10,True,True,11740.01528888889,-0.9227562742745117
4682,3746249,7103,1,0.089595,158,3755686,-1,500.0,4350401,4357504,604152,7103,112,12,True,True,117.04815555555555,-0.08371565289072147
4683,3755003,82,3,0.671748,158,3755686,-1,1500.0,4760731,4760813,1005728,82,97,1,True,True,7.561766666666666,-0.671748
4684,3755163,75,16,0.423541,158,3755686,-1,8000.0,5806894,5806969,2051731,75,37,8,True,True,44.459999999999994,-0.423541
4685,3755216,149,15,0.348308,158,3755686,-1,7500.0,6419705,6419854,2664489,149,9,6,True,True,85.84572916666667,-0.348308
4686,3755303,664,1,0.320738,158,3755686,-1,500.0,6370005,6370669,2614702,664,12,11,True,True,11.699311111111111,-0.320738
4687,3755563,12,7,0.593877,158,3755686,-1,3500.0,4797704,4797716,1042141,12,94,1,True,True,1.2734166666666669,-0.593877
4688,3755616,5197,2,0.024207,158,3755686,-1,1000.0,6048994,6054191,2293378,5197,31,8,True,True,217.39299166666666,-0.024106878562295323
4689,3755685,162,1,0.304819,158,3755686,-1,500.0,3990879,3991041,235194,162,135,1,True,True,1.7802,-0.304819
4690,3755779,25,4,0.987652,185,3766486,-1,2000.0,4164601,4164626,408822,25,123,10,True,True,3.03375,-0.987652
4691,3755886,133,1,0.616221,185,3766486,-1,500.0,5403237,5403370,1647351,133,70,2,True,True,2.4689972222222223,-0.616221
4692,3756006,65,1,0.990159,185,3766486,-1,500.0,3854433,3854498,98427,65,152,0,True,True,0.9068402777777778,-0.990159
4693,3756031,311,16,0.44221,185,3766486,-1,8000.0,5768894,5769205,2012863,311,49,10,True,True,101.77993333333335,-0.44221
4694,3756055,4751,128,0.145818,185,3766486,-1,64000.0,4467101,4471852,711046,4751,115,11,True,True,9890.658666666666,-0.13826569474312483
4695,3756222,13626,35,0.044878,185,3766486,-1,17500.0,4758456,4772082,1002234,13626,106,6,True,True,14211.050874999999,-0.04462672942591607
4696,3756261,33,32,0.818172,185,3766486,-1,16000.0,3861134,3861167,104873,33,152,7,True,True,14.346933333333332,-0.818172
4697,3756506,69,2,0.199685,185,3766486,-1,1000.0,5272837,5272906,1516331,69,77,0,True,True,2.249975,-0.199685
4698,3756759,40,8,0.373821,185,3766486,-1,4000.0,4114479,4114519,357720,40,135,9,True,True,8.550222222222223,-0.373821
4699,3756843,17162,1,0.757734,185,3766486,-1,500.0,5561494,5578656,1804651,17162,56,6,True,True,305.7843472222222,-0.7454798890503105
4700,3756862,6542,32,0.852764,185,3766486,-1,16000.0,3962377,3968919,205515,6542,148,11,True,True,2289.8343111111108,-0.805741244876131
4701,3756895,3,1,0.112372,185,3766486,-1,500.0,3809686,3809689,52791,3,168,11,True,True,0.061804166666666674,-0.112372
4702,3756915,8,32,0.054538,185,3766486,-1,16000.0,4925367,4925375,1168452,8,94,2,True,True,4.966755555555555,-0.054538
4703,3757054,179,8,0.948941,185,3766486,-1,4000.0,4085279,4085458,328225,179,139,0,True,True,32.24386666666667,-0.948941
4704,3757085,210,1,0.92673,185,3766486,-1,500.0,5801494,5801704,2044409,210,41,0,True,True,9.612458333333333,-0.92673
4705,3762278,398,1,0.868752,185,3766486,-1,500.0,5425937,5426335,1663659,398,73,10,True,True,8.186638888888888,-0.868752
4706,3762315,1072,16,0.820134,185,3766486,-1,8000.0,5270637,5271709,1508322,1072,81,10,True,True,279.64906666666667,-0.820134
4707,3762596,873,2,0.013733,185,3766486,-1,1000.0,6279348,6280221,2516752,873,24,12,True,True,37.2771,-0.013733
4708,3762738,3561,13,0.693795,185,3766486,-1,6500.0,6632505,6636066,2869767,3561,6,12,True,True,1386.7493791666666,-0.6564288619844256
4709,3763357,38,8,0.111278,185,3766486,-1,4000.0,6323205,6323243,2559848,38,17,6,True,True,15.208022222222223,-0.111278
4710,3763829,30,16,0.450062,185,3766486,-1,8000.0,5560394,5560424,1796565,30,61,9,True,True,9.003333333333334,-0.450062
4711,3763901,3,1,0.022748,185,3766486,-1,500.0,5196728,5196731,1432827,3,93,10,True,True,0.054,-0.022748
4712,3764374,127,1,0.20901,185,3766486,-1,500.0,5818794,5818921,2054420,127,43,6,True,True,3.473273611111111,-0.20901
4713,3764568,25,1,0.538005,185,3766486,-1,500.0,5175128,5175153,1410560,25,95,7,True,True,0.4194791666666666,-0.538005
4714,3765006,404,1,0.203801,185,3766486,-1,500.0,5817694,5818098,2052688,404,44,8,True,True,11.04883888888889,-0.203801
4715,3765081,180,8,0.523266,185,3766486,-1,4000.0,5404337,5404517,1639256,180,80,6,True,True,26.59,-0.523266
4716,3765135,8,64,0.258658,185,3766486,-1,32000.0,4700664,4700672,935529,8,124,7,True,True,11.095466666666667,-0.258658
4717,3765185,10,13,0.483026,185,3766486,-1,6500.0,5428137,5428147,1662952,10,79,7,True,True,2.674027777777778,-0.483026
4718,3766817,15506,16,0.729924,251,3809686,-1,8000.0,5812294,5827800,2045477,15506,45,0,True,True,6455.9904,-0.6913132504225246
4719,3767495,22743,32,0.141347,251,3809686,-1,16000.0,4254601,4277344,487106,22743,144,12,True,True,12083.701288888888,-0.13901486660007317
4720,3767621,8118,85,0.698755,251,3809686,-1,42500.0,3854433,3862551,86812,8118,179,8,True,True,9495.207979166666,-0.6932397744599362
4721,3767629,340,11,0.018389,251,3809686,-1,5500.0,5429237,5429577,1661608,340,80,6,True,True,70.69638888888888,-0.018389
4722,3767677,4,1,0.583005,251,3809686,-1,500.0,6519105,6519109,2751428,4,8,11,True,True,0.08745,-0.583005
4723,3767719,4,16,0.663528,251,3809686,-1,8000.0,4005279,4005283,237560,4,163,9,True,True,0.8799111111111111,-0.663528
4724,3767753,19427,32,0.043482,251,3809686,-1,16000.0,5660894,5680321,1893141,19427,59,0,True,True,10981.452800000001,-0.04262857851738077
4725,3770600,21,4,0.17032,251,3809686,-1,2000.0,4921767,4921788,1151167,21,112,3,True,True,1.6538666666666666,-0.17032
4726,3770711,12818,8,0.284014,251,3809686,-1,4000.0,6524505,6537323,2753794,12818,8,8,True,True,2241.916422222222,-0.27890208896491636
4727,3770842,8241,4,0.789188,251,3809686,-1,2000.0,4722264,4730505,951422,8241,131,10,True,True,515.4468666666667,-0.6210734565108834
4728,3771034,6679,3,0.617965,251,3809686,-1,1500.0,4103679,4110358,332645,6679,160,7,True,True,435.1380291666667,-0.6010759226933919
4729,3771114,4923,32,0.053085,251,3809686,-1,16000.0,5812294,5817217,2041180,4923,48,8,True,True,4711.562622222222,-0.05020991925820519
4730,3773534,8,2,0.654758,251,3809686,-1,1000.0,5272837,5272845,1499303,8,95,7,True,True,0.2608666666666667,-0.654758
4731,3773691,23,2,0.008334,251,3809686,-1,1000.0,4139401,4139424,365710,23,157,2,True,True,1.2808444444444445,-0.008334
4732,3775251,3,3,0.388645,251,3809686,-1,1500.0,3882734,3882737,107483,3,184,0,True,True,0.11019999999999999,-0.388645
4733,3775256,74203,8,0.27131,251,3809686,-1,4000.0,4127801,4202004,352545,74203,160,0,True,True,15874.101211111112,-0.2653078768109147
4734,3775461,22,8,0.852083,251,3809686,-1,4000.0,4914545,4914567,1139084,22,117,0,True,True,3.2638222222222226,-0.852083
4735,3775465,484,16,0.6601,251,3809686,-1,8000.0,5949494,5949978,2174029,484,43,11,True,True,161.89262222222223,-0.6601
4736,3775529,23,11,0.864282,251,3809686,-1,5500.0,4085279,4085302,309750,23,169,9,True,True,5.696716666666667,-0.864282
4737,3775548,21509,8,0.019078,251,3809686,-1,4000.0,4101479,4122988,325931,21509,167,8,True,True,3846.5462999999995,-0.018868868295332315
4738,3775801,117,16,0.86741,251,3809686,-1,8000.0,6306448,6306565,2530647,117,23,7,True,True,85.8156,-0.86741
4739,3775807,8667,128,0.649411,251,3809686,-1,64000.0,5774394,5783061,1998587,8667,58,0,True,True,24482.1056,-0.6485440601755539
4740,3775814,295,1,0.231169,251,3809686,-1,500.0,4029079,4029374,253265,295,176,6,True,True,3.763298611111111,-0.231169
4741,3775877,598,8,0.380701,251,3809686,-1,4000.0,4796590,4797188,1020713,598,127,2,True,True,72.52411111111111,-0.380701
4742,3775944,10,16,0.976612,251,3809686,-1,8000.0,6425105,6425115,2649161,10,12,8,True,True,3.3146666666666667,-0.976612
4743,3780875,22841,128,0.099604,251,3809686,-1,64000.0,4884104,4906945,1103229,22841,126,12,True,True,51764.682311111115,-0.09598777545577644
4744,3780907,14592,1,0.315456,251,3809686,-1,500.0,4052879,4067471,271972,14592,177,10,True,True,292.91435277777776,-0.31072539029957125
4745,3780940,7,32,0.866773,251,3809686,-1,16000.0,4127801,4127808,346861,7,168,0,True,True,6.430977777777778,-0.866773
4746,3780982,152,8,0.531561,251,3809686,-1,4000.0,3848986,3849138,68004,152,207,3,True,True,18.447733333333336,-0.531561
4747,3781726,10507,128,0.186417,251,3809686,-1,64000.0,3968177,3978684,186451,10507,188,6,True,True,18806.261333333336,-0.18464879487827437
4748,3781779,44,1,0.500651,251,3809686,-1,500.0,3989777,3989821,207998,44,187,0,True,True,0.48351111111111117,-0.500651
4749,3782028,63,7,0.457986,251,3809686,-1,3500.0,5208628,5208691,1426600,63,106,6,True,True,7.705862500000001,-0.457986
4750,3782175,100,16,0.92635,251,3809686,-1,8000.0,4130001,4130101,347826,100,168,7,True,True,52.595555555555556,-0.92635
4751,3782239,4,45,0.021488,251,3809686,-1,22500.0,5172928,5172932,1390689,4,111,10,True,True,3.2075000000000005,-0.021488
4752,3782343,24,4,0.247392,251,3809686,-1,2000.0,4918167,4918191,1135824,24,122,4,True,True,1.8609333333333333,-0.247392
4753,3782371,14628,1,0.529415,251,3809686,-1,500.0,3842086,3856714,59715,14628,216,9,True,True,220.4060972222222,-0.5242199524727912
4754,3782770,17,1,0.33357,251,3809686,-1,500.0,5393837,5393854,1611067,17,94,12,True,True,0.29610694444444446,-0.33357
4755,3782813,3755,4,0.3934,251,3809686,-1,2000.0,3916637,3920392,133824,3755,200,3,True,True,134.48367777777779,-0.3413478260688786
4756,3782901,7,4,0.157005,251,3809686,-1,2000.0,6473705,6473712,2690804,7,10,8,True,True,0.7779722222222223,-0.157005
4757,3784680,5380,32,0.34678,251,3809686,-1,16000.0,6475905,6481285,2691225,5380,10,7,True,True,4742.896444444445,-0.3446289105994844
4758,3784760,79,2,0.351913,251,3809686,-1,1000.0,5230228,5230307,1445468,79,109,10,True,True,2.311627777777778,-0.351913
4759,3786043,6140,12,0.625231,251,3809686,-1,6000.0,3911937,3918077,125894,6140,205,0,True,True,777.7449833333333,-0.5610081539490059
4760,3786103,4836,2,0.236205,251,3809686,-1,1000.0,5236028,5240864,1449925,4836,108,2,True,True,141.9926888888889,-0.23564962747141563
4761,3786136,12503,32,0.978244,251,3809686,-1,16000.0,5307437,5319940,1521301,12503,97,10,True,True,7820.0380444444445,-0.9720296697050804
4762,3786949,7853,25,0.501251,251,3809686,-1,12500.0,6042494,6050347,2255545,7853,42,10,True,True,4584.321041666667,-0.47982656267708457
4763,3787888,41,1,0.811893,251,3809686,-1,500.0,4955828,4955869,1167940,41,123,10,True,True,0.6369236111111111,-0.811893
4764,3787929,5991,4,0.625792,251,3809686,-1,2000.0,3994479,4000470,206550,5991,197,2,True,True,291.72630000000004,-0.6021631324676543
4765,3788206,36,16,0.878677,251,3809686,-1,8000.0,5801494,5801530,2013288,36,57,7,True,True,26.3656,-0.878677
4766,3793189,15235,1,0.890402,251,3809686,-1,500.0,4914545,4929780,1121356,15235,134,0,True,True,292.7335277777778,-0.8903766745017363
4767,3793296,24,32,0.814859,251,3809686,-1,16000.0,3845386,3845410,52090,24,228,7,True,True,11.9072,-0.814859
4768,3793755,43,8,0.029466,251,3809686,-1,4000.0,4264001,4264044,470246,43,169,7,True,True,6.182922222222222,-0.029466
4769,3794963,722,4,0.554939,251,3809686,-1,2000.0,4127079,4127801,332116,722,185,8,True,True,82.91367777777778,-0.554939
4770,3795019,219,1,0.280194,251,3809686,-1,500.0,6020894,6021113,2225875,219,43,10,True,True,5.8035000000000005,-0.280194
4771,3795036,1550,1,0.151708,251,3809686,-1,500.0,6524505,6526055,2729469,1550,8,0,True,True,34.39277777777778,-0.151708
4772,3795334,47,8,0.897175,251,3809686,-1,4000.0,3848986,3849033,53652,47,229,0,True,True,5.704233333333334,-0.897175
4773,3795560,19937,23,0.656932,251,3809686,-1,11500.0,5232428,5252365,1436868,19937,114,0,True,True,7268.5687708333335,-0.6567189553602757
4774,3795585,72,64,0.087795,251,3809686,-1,32000.0,4568864,4568936,773279,72,160,10,True,True,147.4112,-0.087795
4775,3795959,6636,4,0.382207,251,3809686,-1,2000.0,6322105,6328741,2526146,6636,24,0,True,True,1317.729927777778,-0.38178675373448634
4776,3796892,6712,4,0.960606,251,3809686,-1,2000.0,5175128,5181840,1378236,6712,122,0,True,True,439.65506666666664,-0.9506053771886581
4777,3797073,6565,5,0.612448,251,3809686,-1,2500.0,5396037,5402602,1598964,6565,101,7,True,True,606.2299652777778,-0.6101683900772465
4778,3797479,5880,31,0.625525,251,3809686,-1,15500.0,6675705,6681585,2878226,5880,6,11,True,True,4699.197645833334,-0.6148142598997209
4779,3797575,40203,16,0.227428,251,3809686,-1,8000.0,5818794,5858997,2021219,40203,55,0,True,True,12987.638333333332,-0.2237127886813277
4780,3798522,3,3,0.240361,251,3809686,-1,1500.0,5492436,5492439,1693914,3,86,7,True,True,0.17502500000000001,-0.240361
4781,3798552,43,1,0.152749,251,3809686,-1,500.0,4121679,4121722,323127,43,196,2,True,True,0.9373402777777777,-0.152749
4782,3799182,12567,128,0.970537,251,3809686,-1,64000.0,3888137,3900704,88955,12567,228,8,True,True,24988.85048888889,-0.9224440578515619
4783,3799324,9878,1,0.909735,251,3809686,-1,500.0,6190748,6200626,2391424,9878,37,8,True,True,216.65803888888888,-0.8305758794440954
4784,3799843,8419,64,0.329285,251,3809686,-1,32000.0,5549594,5558013,1749751,8419,83,10,True,True,10523.0792,-0.31327068928620266
3774,2907987,14250,1,0.700882,1,2907987,-1,500.0,2908151,2922237,164,14250,0,0,True,True,218.3030125,-0.6328940970167574
3775,2908151,9396,2,0.072589,1,2908151,-1,1000.0,2911601,2917547,3450,9396,0,0,True,True,292.3559722222222,-0.07151766015561922
3776,2911601,7,16,0.928048,1,2911601,-1,8000.0,2915201,2915208,3600,7,0,2,True,True,2.000288888888889,-0.928048
3777,2911671,19274,1,0.106136,5,2915201,-1,500.0,3046416,3065690,134745,19274,0,0,True,True,170.40885000000003,-0.10360576694154071
3778,2911700,18,20,0.786892,5,2915201,-1,10000.0,2949501,2949519,37801,18,1,2,True,True,2.5765000000000002,-0.7868920000000003
3779,2911760,8450,1,0.301351,5,2915201,-1,500.0,2942301,2950751,30541,8450,2,0,True,True,67.80826388888889,-0.29276799917318774
3780,2914905,17422,33,0.086505,5,2915201,-1,16500.0,3292734,3310156,377829,17422,0,7,True,True,4454.249891666666,-0.07878009108729
3781,2915106,14,1,0.765274,5,2915201,-1,500.0,2917401,2917415,2295,14,4,7,True,True,0.2185361111111111,-0.765274
3782,2915277,18716,128,0.437676,9,2917401,-1,64000.0,2939001,2957717,23724,18716,4,10,True,True,19327.839822222224,-0.4246669551395602
3783,2915536,5,8,0.395113,9,2917401,-1,4000.0,2917401,2917406,1865,5,5,0,True,True,0.6243888888888889,-0.395113
3784,2916128,12127,2,0.660723,9,2917401,-1,1000.0,2942301,2954428,26173,12127,4,6,True,True,189.48967499999998,-0.6451471898373694
3785,2916370,2,16,0.473988,9,2917401,-1,8000.0,5379991,5379993,2463621,2,0,0,True,True,0.16977777777777778,-0.473988
3786,2916683,5,1,0.533468,9,2917401,-1,500.0,2941201,2941206,24518,5,6,7,True,True,0.044812500000000005,-0.533468
3787,2921047,3,1,0.136381,15,2939001,-1,500.0,2992701,2992704,71654,3,3,10,True,True,0.028212499999999998,-0.136381
3788,2921059,7959,32,0.390993,15,2939001,-1,16000.0,3073433,3081392,152374,7959,2,0,True,True,5637.979600000001,-0.38650985338414023
3789,2921234,330,8,0.797485,15,2939001,-1,4000.0,2939001,2939331,17767,330,9,0,True,True,21.629666666666665,-0.797485
3790,2921365,13007,16,0.545724,15,2939001,-1,8000.0,3073433,3086440,152068,13007,3,8,True,True,4795.520644444444,-0.5235446575889672
3791,2921446,78,16,0.960134,15,2939001,-1,8000.0,3907313,3907391,985867,78,1,0,True,True,17.026533333333333,-0.960134
3792,2922343,10,16,0.144076,15,2939001,-1,8000.0,2945901,2945911,23558,10,8,3,True,True,1.2704444444444445,-0.144076
3793,2922366,529,2,0.677289,15,2939001,-1,1000.0,2993804,2994333,71438,529,6,6,True,True,9.949608333333332,-0.677289
3794,2928592,5647,2,0.914169,15,2939001,-1,1000.0,2971101,2976748,42509,5647,8,10,True,True,94.869375,-0.9093550302224268
3795,2944405,473,1,0.795017,11,2945901,-1,500.0,3068033,3068506,123628,473,5,9,True,True,4.653794444444444,-0.795017
3796,2961339,17,8,0.729325,27,2971101,-1,4000.0,3046416,3046433,85077,17,6,0,True,True,0.9138444444444445,-0.729325
3797,2961560,20,32,0.373131,27,2971101,-1,16000.0,4903320,4903340,1941760,20,1,2,True,True,7.272888888888889,-0.373131
3798,2961635,16139,4,0.949465,27,2971101,-1,2000.0,4997177,5013316,2035542,16139,1,8,True,True,766.9144722222222,-0.9420835466563535
3799,2962058,6,2,0.553524,27,2971101,-1,1000.0,4949948,4949954,1987890,6,2,8,True,True,0.14513333333333334,-0.553524
3800,2962145,51,11,0.55507,27,2971101,-1,5500.0,5227993,5228044,2265848,51,1,1,True,True,7.031199999999999,-0.5550700000000001
3801,2962163,751,16,0.123235,27,2971101,-1,8000.0,3726926,3727677,764763,751,6,1,True,True,46.91246666666667,-0.123235
3802,2963700,1749,1,0.00503,27,2971101,-1,500.0,3736026,3737775,772326,1749,6,7,True,True,4.8069541666666655,-0.004862535786378593
3803,2964106,1,8,0.596655,27,2971101,-1,4000.0,3116633,3116634,152527,1,9,11,True,True,0.1599888888888889,-0.596655
3804,2964339,17,3,0.537152,27,2971101,-1,1500.0,3795713,3795730,831374,17,6,7,True,True,0.6291416666666667,-0.537152
3805,2964729,13132,56,0.946979,27,2971101,-1,28000.0,3290534,3303666,325805,13132,10,6,True,True,6620.658644444444,-0.9340387030891362
3806,2964774,9175,20,0.304691,27,2971101,-1,10000.0,5273393,5282568,2308619,9175,1,11,True,True,3014.461722222222,-0.2979454568766566
3807,2964873,338,32,0.748297,27,2971101,-1,16000.0,2992704,2993042,27831,338,19,1,True,True,101.71546666666666,-0.748297
3808,2965028,10775,16,0.903546,27,2971101,-1,8000.0,3771913,3782688,806885,10775,8,6,True,True,1327.9802444444445,-0.825444109427212
3809,2966203,5734,7,0.343852,27,2971101,-1,3500.0,3053633,3059367,87430,5734,17,2,True,True,401.46233750000005,-0.32993814222520035
3810,2966671,7,4,0.412654,27,2971101,-1,2000.0,5494370,5494377,2527699,7,0,1,True,True,0.3919222222222222,-0.412654
3811,2969763,1412,32,0.645932,27,2971101,-1,16000.0,3046416,3047828,76653,1412,21,7,True,True,303.6113777777778,-0.645932
3812,2970284,1812,19,0.512553,27,2971101,-1,9500.0,3042404,3044216,72120,1812,22,8,True,True,306.83955,-0.512553
3813,2970596,7173,2,0.160954,27,2971101,-1,1000.0,5518741,5525914,2548145,7173,0,7,True,True,220.67016666666666,-0.1450017151895636
3814,2971170,3,32,0.220788,30,2992701,-1,16000.0,5194997,5195000,2223827,3,5,1,True,True,0.7586666666666667,-0.220788
3815,2971241,3,1,0.834748,30,2992701,-1,500.0,3073433,3073436,102192,3,17,0,True,True,0.044112500000000006,-0.834748
3816,2971336,7275,2,0.194326,30,2992701,-1,1000.0,3037004,3044279,65668,7275,26,11,True,True,131.78589722222222,-0.18597844978978714
3817,2972083,34,46,0.181358,30,2992701,-1,23000.0,5223293,5223327,2251210,34,5,1,True,True,14.888411111111113,-0.181358
3818,3033384,13,4,0.79966,30,3037004,-1,2000.0,3044216,3044229,10832,13,26,1,True,True,0.46345,-0.79966
3819,3036042,28,16,0.852251,30,3037004,-1,8000.0,3170634,3170662,134592,28,17,8,True,True,5.349866666666666,-0.852251
3820,3036207,8369,2,0.851388,30,3037004,-1,1000.0,5194997,5203366,2158790,8369,6,0,True,True,128.01512222222223,-0.7613245456540516
3821,3038912,116,8,0.93237,34,3042404,-1,4000.0,5200800,5200916,2161888,116,6,7,True,True,6.100311111111111,-0.93237
3822,3038993,36,4,0.994313,34,3042404,-1,2000.0,4347453,4347489,1308460,36,12,0,True,True,2.841,-0.994313
3823,3040549,21,16,0.461265,34,3042404,-1,8000.0,3057233,3057254,16684,21,26,1,True,True,3.9802000000000004,-0.461265
3824,3041375,20,8,0.549665,34,3042404,-1,4000.0,4108313,4108333,1066938,20,13,9,True,True,0.6851111111111111,-0.549665
3825,3041510,8394,32,0.290653,34,3042404,-1,16000.0,4944548,4952942,1903038,8394,11,6,True,True,2760.900888888889,-0.2717358899134383
3826,3042985,748,1,0.067363,34,3044216,-1,500.0,3046433,3047181,3448,748,30,1,True,True,5.026144444444445,-0.067363
3827,3044963,18059,128,0.098202,41,3046416,-1,64000.0,4814211,4832270,1769248,18059,13,0,True,True,40599.1216,-0.09252917727002404
3828,3045113,16,128,0.725589,41,3046416,-1,64000.0,3050033,3050049,4920,16,31,3,True,True,13.206755555555555,-0.725589
3829,3045224,60,4,0.48719,41,3046416,-1,2000.0,3445566,3445626,400342,60,21,12,True,True,5.039333333333333,-0.48719
3830,3045578,8846,9,0.330851,41,3046416,-1,4500.0,3314466,3323312,268888,8846,22,4,True,True,699.7119,-0.2826638019707069
3831,3045763,297,1,0.128215,41,3046416,-1,500.0,4809379,4809676,1763616,297,14,7,True,True,3.0728722222222222,-0.0932282265045115
3832,3046090,5,1,0.655473,41,3046416,-1,500.0,4200053,4200058,1153963,5,16,12,True,True,0.09053472222222222,-0.655473
3833,3046231,21291,1,0.100045,41,3046416,-1,500.0,3073433,3094724,27202,21291,31,0,True,True,486.47585694444444,-0.09861998092372212
3834,3046353,13320,1,0.619516,41,3046416,-1,500.0,4907720,4921040,1861367,13320,12,6,True,True,172.66605555555557,-0.6182254398809174
3835,3046421,243,16,0.900119,39,3046433,-1,8000.0,3116634,3116877,70213,243,29,1,True,True,77.75460000000001,-0.900119
3836,3046471,28,8,0.317786,40,3050033,-1,4000.0,4930420,4930448,1883949,28,12,10,True,True,2.4269777777777777,-0.317786
3837,3046776,105,2,0.450646,40,3050033,-1,1000.0,5484950,5485055,2438174,105,2,6,True,True,1.7406666666666666,-0.450646
3838,3051388,6907,40,0.616342,40,3053633,-1,20000.0,4905520,4912427,1854132,6907,15,7,True,True,3193.1765555555553,-0.6055629558739501
3839,3076161,6213,28,0.305675,61,3116633,-1,14000.0,4234653,4240866,1158492,6213,20,7,True,True,3855.6378,-0.2910730573793639
3840,3076310,9327,256,0.58417,61,3116633,-1,128000.0,4982450,4991777,1906140,9327,11,0,True,True,17851.631644444446,-0.5227704447647508
3841,3076349,116,1,0.565552,61,3116633,-1,500.0,5420391,5420507,2344042,116,3,0,True,True,1.33545,-0.565552
3842,3076398,1137,16,0.364493,61,3116633,-1,8000.0,3726926,3728063,650528,1137,29,0,True,True,71.0246,-0.364493
3843,3076422,11420,11,0.316333,61,3116633,-1,5500.0,5224393,5235813,2147971,11420,7,6,True,True,1669.3772333333332,-0.26971329933101457
3844,3078387,151,1,0.428307,61,3116633,-1,500.0,4003113,4003264,924726,151,26,12,True,True,0.8131875,-0.38847698689438825
3845,3078425,648,2,0.004832,61,3116633,-1,1000.0,4883420,4884068,1804995,648,20,10,True,True,12.009599999999999,-0.004832
3846,3078695,7,16,0.246175,61,3116633,-1,8000.0,4347453,4347460,1268758,7,24,1,True,True,2.2096666666666667,-0.246175
3847,3078713,5,32,0.221526,61,3116633,-1,16000.0,5194992,5194997,2116279,5,12,1,True,True,1.2644444444444445,-0.221526
3848,3078777,9,1,0.739816,61,3116633,-1,500.0,4360053,4360062,1281276,9,24,4,True,True,0.21563749999999998,-0.739816
3849,3078809,68,32,0.436124,61,3116633,-1,16000.0,3717926,3717994,639117,68,37,10,True,True,11.052266666666666,-0.436124
3850,3078843,30,1,0.84011,61,3116633,-1,500.0,4448653,4448683,1369810,30,24,7,True,True,0.20149999999999998,-0.84011
3851,3078987,14413,2,0.134306,61,3116633,-1,1000.0,4343853,4358266,1264866,14413,28,7,True,True,615.5877444444444,-0.13233783030691312
3852,3079000,49,1,0.732973,61,3116633,-1,500.0,5132177,5132226,2053177,49,13,8,True,True,0.27671388888888887,-0.732973
3853,3079028,18,2,0.877886,61,3116633,-1,1000.0,4812979,4812997,1733951,18,24,3,True,True,0.51225,-0.877886
3854,3079202,45,8,0.462848,61,3116633,-1,4000.0,3795713,3795758,716511,45,36,0,True,True,4.441,-0.462848
3855,3079221,11740,130,0.358742,61,3116633,-1,65000.0,4097513,4109253,1018292,11740,34,0,True,True,4067.2720833333333,-0.3207602718071337
3856,3079456,9793,128,0.305472,61,3116633,-1,64000.0,3165234,3175027,85778,9793,49,8,True,True,15722.825244444444,-0.2954611592862592
3857,3079657,6,2,0.551672,61,3116633,-1,1000.0,5040377,5040383,1960720,6,14,11,True,True,0.06421666666666667,-0.551672
3858,3079762,52,32,0.17577,61,3116633,-1,16000.0,3159834,3159886,80072,52,51,11,True,True,34.24142222222222,-0.17577
3859,3079785,16,1,0.606628,61,3116633,-1,500.0,3729126,3729142,649341,16,42,7,True,True,0.06246666666666666,-0.606628
3860,3079804,24,32,0.841793,61,3116633,-1,16000.0,3733826,3733850,654022,24,42,3,True,True,2.0192,-0.841793
3861,3079891,14948,1,0.858714,61,3116633,-1,500.0,3257034,3271982,177143,14948,51,12,True,True,206.7400638888889,-0.8192937930025905
3862,3084371,19121,4,0.140002,61,3116633,-1,2000.0,4011113,4030234,926742,19121,36,7,True,True,278.07734999999997,-0.1329699120186964
3863,3084438,7516,16,0.538618,61,3116633,-1,8000.0,3913113,3920629,828675,7516,38,2,True,True,1383.5833777777777,-0.47676604057473576
3864,3085236,6,1,0.263235,61,3116633,-1,500.0,5411391,5411397,2326155,6,4,6,True,True,0.049975000000000006,-0.263235
3865,3085260,127,1,0.886336,61,3116633,-1,500.0,5223166,5223293,2137906,127,10,8,True,True,1.2089694444444445,-0.886336
3866,3115127,186,2,0.076462,61,3116633,-1,1000.0,5376393,5376579,2261266,186,6,8,True,True,2.223733333333333,-0.076462
3867,3116699,37,1,0.0754,136,3159834,-1,500.0,3749213,3749250,632514,37,46,1,True,True,0.11177083333333333,-0.0754
3868,3117087,32,1,0.01863,136,3159834,-1,500.0,3344766,3344798,227679,32,54,6,True,True,0.47671111111111114,-0.01863
3869,3117246,44,1,0.507178,136,3159834,-1,500.0,5176477,5176521,2059231,44,16,10,True,True,0.6851777777777779,-0.507178
3870,3117543,16767,8,0.031194,136,3159834,-1,4000.0,5481650,5498417,2364107,16767,3,11,True,True,1395.3681111111111,-0.026666476048448594
3871,3117657,16541,16,0.58189,136,3159834,-1,8000.0,4341653,4358194,1223996,16541,37,8,True,True,5610.28648888889,-0.5757940944638855
3872,3117832,9,4,0.405134,136,3159834,-1,2000.0,4356453,4356462,1238621,9,34,8,True,True,0.8046500000000001,-0.405134
3873,3117984,70,2,0.590036,136,3159834,-1,1000.0,5505170,5505240,2387186,70,1,8,True,True,1.7101388888888889,-0.590036
3874,3119439,12175,8,0.906304,136,3159834,-1,4000.0,3307266,3319441,187827,12175,61,4,True,True,657.9757444444444,-0.7368948901868758
3875,3119671,13017,256,0.551594,136,3159834,-1,128000.0,5425433,5438450,2305762,13017,5,3,True,True,51381.904355555555,-0.531423936882344
3876,3121027,22596,101,0.543469,136,3159834,-1,50500.0,3730226,3752822,609199,22596,55,6,True,True,6714.669375,-0.5347674100551851
3877,3121239,24557,16,0.998728,136,3159834,-1,8000.0,3723326,3747883,602087,24557,59,8,True,True,1290.8972666666668,-0.9603314883786148
3878,3121554,144,1,0.472104,136,3159834,-1,500.0,3561326,3561470,439772,144,61,11,True,True,0.8952,-0.472104
3879,3124725,9503,1,0.775197,136,3159834,-1,500.0,4859620,4869123,1734895,9503,31,6,True,True,74.26655,-0.7452560620985516
3880,3124877,70,16,0.365819,136,3159834,-1,8000.0,4883420,4883490,1758543,70,30,0,True,True,10.378666666666666,-0.365819
3881,3125037,15,1,0.223307,136,3159834,-1,500.0,5194977,5194992,2069940,15,19,9,True,True,0.11854166666666666,-0.223307
3882,3125139,15384,4,0.772145,136,3159834,-1,2000.0,4943448,4958832,1818309,15384,27,9,True,True,573.0892,-0.7550186257338478
3883,3125742,295,4,0.733227,136,3159834,-1,2000.0,4113653,4113948,987911,295,47,7,True,True,5.9622777777777785,-0.733227
3884,3125821,5,32,0.290999,136,3159834,-1,16000.0,3729126,3729131,603305,5,61,0,True,True,0.6246666666666667,-0.290999
3885,3126121,9,1,0.464701,136,3159834,-1,500.0,4713480,4713489,1587359,9,38,6,True,True,0.104175,-0.464701
3886,3127312,16009,4,0.510412,136,3159834,-1,2000.0,4807179,4823188,1679867,16009,38,0,True,True,873.0639777777777,-0.495876701935024
3887,3127546,188,2,0.396785,136,3159834,-1,1000.0,3907313,3907501,779767,188,56,0,True,True,5.129788888888889,-0.396785
3888,3128217,30,4,0.502167,136,3159834,-1,2000.0,3806513,3806543,678296,30,57,9,True,True,1.1341666666666665,-0.502167
3889,3128359,23189,256,0.662678,136,3159834,-1,128000.0,4776390,4799579,1648031,23189,39,6,True,True,34557.47306666667,-0.6097539720429328
3890,3128551,4,32,0.847982,136,3159834,-1,16000.0,5394091,5394095,2265540,4,8,9,True,True,0.7340444444444444,-0.847982
3891,3128842,15010,1,0.80654,136,3159834,-1,500.0,4761380,4776390,1632538,15010,41,0,True,True,116.55211111111112,-0.7884653630988281
3892,3129140,11442,1,0.614036,136,3159834,-1,500.0,4668080,4679522,1538940,11442,43,7,True,True,100.96735277777778,-0.585218453601634
3893,3129548,51,3,0.165844,136,3159834,-1,1500.0,4446453,4446504,1316905,51,45,12,True,True,1.02765,-0.165844
3894,3130495,1041,8,0.514137,136,3159834,-1,4000.0,3730226,3731267,599731,1041,69,0,True,True,26.8578,-0.514137
3895,3130726,102,2,0.44622,136,3159834,-1,1000.0,4982348,4982450,1851622,102,26,10,True,True,1.1722222222222223,-0.41720358923230316
3896,3133786,7064,16,0.179145,136,3159834,-1,8000.0,5490770,5497834,2356984,7064,3,7,True,True,1372.0693333333334,-0.14467448995340895
3897,3138149,8107,8,0.948712,136,3159834,-1,4000.0,4960748,4968855,1822599,8107,28,9,True,True,408.3369666666666,-0.9221186362569768
3898,3138585,45,4,0.659413,136,3159834,-1,2000.0,5508840,5508885,2370255,45,1,2,True,True,2.7065,-0.659413
3899,3141174,50,1,0.967736,136,3159834,-1,500.0,5178677,5178727,2037503,50,23,7,True,True,0.6369444444444444,-0.967736
3900,3141629,7049,1,0.73592,136,3159834,-1,500.0,4897520,4904569,1755891,7049,38,9,True,True,78.11338611111111,-0.7015176960161064
3901,3141729,9477,2,0.483503,136,3159834,-1,1000.0,4886720,4896197,1744991,9477,39,7,True,True,201.0390888888889,-0.4740587765713171
3902,3141837,630,1,0.358796,136,3159834,-1,500.0,4109253,4109883,967416,630,62,2,True,True,2.6976249999999995,-0.358796
3903,3141844,9584,128,0.218819,136,3159834,-1,64000.0,3739626,3749210,597782,9584,75,2,True,True,3652.3605333333335,-0.21715486529744418
3904,3141861,17134,3,0.487642,136,3159834,-1,1500.0,5195000,5212134,2053139,17134,19,1,True,True,430.55383333333333,-0.48102477024444856
3905,3141872,22292,32,0.062861,136,3159834,-1,16000.0,5198600,5220892,2056728,22292,19,2,True,True,6167.571911111111,-0.06036260798119292
3906,3142446,49,71,0.369435,136,3159834,-1,35500.0,4760280,4760329,1617834,49,51,11,True,True,27.464772222222223,-0.369435
3907,3142634,5,1,0.042808,136,3159834,-1,500.0,3696326,3696331,553692,5,89,10,True,True,0.042118055555555554,-0.042808
3908,3142888,15142,1,0.206774,136,3159834,-1,500.0,5410291,5425433,2267403,15142,10,8,True,True,169.04579166666667,-0.1777665237544632
3909,3143000,19,21,0.907726,136,3159834,-1,10500.0,3907313,3907332,764313,19,72,0,True,True,5.443579166666667,-0.9077260000000003
3910,3143277,10,1,0.361251,136,3159834,-1,500.0,4459453,4459463,1316176,10,55,9,True,True,0.23519444444444446,-0.361251
3911,3143287,19,2,0.469674,136,3159834,-1,1000.0,5230193,5230212,2086906,19,15,7,True,True,0.47626666666666667,-0.469674
3912,3143655,266,16,0.454643,136,3159834,-1,8000.0,4712380,4712646,1568725,266,55,6,True,True,47.69164444444444,-0.4401393394086367
3913,3143818,18,119,0.046437,136,3159834,-1,59500.0,4711280,4711298,1567462,18,56,11,True,True,14.274049999999999,-0.046437
3914,3145238,13,8,0.98059,136,3159834,-1,4000.0,3907313,3907326,762075,13,79,9,True,True,1.4188777777777777,-0.98059
3915,3145257,67,1,0.324071,136,3159834,-1,500.0,5505240,5505307,2359983,67,2,1,True,True,0.8184236111111111,-0.324071
3916,3145276,11371,64,0.703736,136,3159834,-1,32000.0,5499770,5511141,2354494,11371,4,8,True,True,10275.650311111112,-0.6582570151366787
3917,3145286,124,6,0.521373,136,3159834,-1,3000.0,3165234,3165358,19948,124,108,0,True,True,11.6467,-0.521373
3918,3145601,23651,128,0.829647,136,3159834,-1,64000.0,3296334,3319985,150733,23651,104,2,True,True,22020.334755555556,-0.7327588227099124
3919,3145641,4022,1,0.834872,136,3159834,-1,500.0,4242253,4246275,1096612,4022,69,8,True,True,86.76671666666667,-0.8339049047328009
3920,3145833,13,32,0.263316,136,3159834,-1,16000.0,5179777,5179790,2033944,13,29,6,True,True,5.299377777777777,-0.263316
3921,3145957,16943,4,0.54435,136,3159834,-1,2000.0,5184177,5201120,2038220,16943,29,6,True,True,642.2601388888888,-0.5425871932258112
3922,3145988,5980,1,0.17385,136,3159834,-1,500.0,4836920,4842900,1690932,5980,51,10,True,True,106.69152777777778,-0.16219814539835903
3923,3154183,25685,64,0.653675,136,3159834,-1,32000.0,4232453,4258138,1078270,25685,74,10,True,True,30860.696888888884,-0.6229110222754244
3924,3154227,15680,1,0.365297,136,3159834,-1,500.0,3267834,3283514,113607,15680,112,9,True,True,227.16823333333335,-0.3518931559678212
3925,3154964,3,64,0.653337,136,3159834,-1,32000.0,3749210,3749213,594246,3,92,2,True,True,0.5800000000000001,-0.653337
3926,3154982,17819,1,0.835469,136,3159834,-1,500.0,3896513,3914332,741531,17819,87,1,True,True,241.4562625,-0.8322716324695498
3927,3155084,46368,4,0.516663,136,3159834,-1,2000.0,4005313,4051681,850229,46368,81,7,True,True,758.8439111111112,-0.48952808970427536
3928,3155158,50,2,0.376329,136,3159834,-1,1000.0,4804979,4805029,1649821,50,56,0,True,True,0.7666666666666667,-0.376329
3929,3155276,17218,16,0.907242,136,3159834,-1,8000.0,5379991,5397209,2224715,17218,15,2,True,True,1561.5018666666665,-0.9037280015750315
3930,3155303,8295,1,0.516372,136,3159834,-1,500.0,3793513,3801808,638210,8295,94,10,True,True,112.69738472222221,-0.4959701046079763
3931,3155323,13,6,0.352898,136,3159834,-1,3000.0,4930448,4930461,1775125,13,43,1,True,True,0.8451083333333335,-0.352898
3932,3155807,14557,16,0.867719,136,3159834,-1,8000.0,4341653,4356210,1185846,14557,74,0,True,True,4900.764,-0.843178474516297
3933,3155869,18,4,0.486862,136,3159834,-1,2000.0,5203366,5203384,2047497,18,23,3,True,True,0.7089,-0.486862
3934,3155965,191,8,0.48211,136,3159834,-1,4000.0,5483850,5484041,2327885,191,8,7,True,True,12.665422222222222,-0.48211
3935,3156106,9,1,0.604211,136,3159834,-1,500.0,3512626,3512635,356520,9,115,10,True,True,0.284675,-0.604211
3936,3156253,9884,23,0.501837,136,3159834,-1,11500.0,4813111,4822995,1656858,9884,57,0,True,True,3294.328333333333,-0.48327278824503117
3937,3156525,23,32,0.138968,136,3159834,-1,16000.0,5154877,5154900,1998352,23,36,6,True,True,16.566133333333333,-0.138968
3938,3156593,11878,64,0.165606,136,3159834,-1,32000.0,3319866,3331744,163273,11878,120,8,True,True,6488.710933333333,-0.16037651875361128
3939,3156607,13568,16,0.077088,136,3159834,-1,8000.0,3892913,3906481,736306,13568,97,12,True,True,2933.113533333333,-0.07651151269019042
3940,3156819,25737,128,0.643477,136,3159834,-1,64000.0,4336253,4361990,1179434,25737,80,8,True,True,77289.2544,-0.6244160919866297
3941,3156879,8983,2,0.211517,136,3159834,-1,1000.0,4807179,4816162,1650300,8983,61,0,True,True,226.55769444444445,-0.20620533127188037
3942,3156951,13,8,0.186906,136,3159834,-1,4000.0,4244453,4244466,1087502,13,82,7,True,True,2.2468333333333335,-0.186906
3943,3158636,83,3,0.362223,136,3159834,-1,1500.0,3343666,3343749,185030,83,124,7,True,True,3.3078958333333337,-0.36222299999999996
3944,3171252,8,7,0.717303,218,3257034,-1,3500.0,4804979,4804987,1633727,8,64,8,True,True,0.42933333333333334,-0.717303
3945,3172221,502,64,0.11833,218,3257034,-1,32000.0,3770813,3771315,598592,502,107,10,True,True,96.42862222222223,-0.11833
3946,3172267,19,1,0.230346,218,3257034,-1,500.0,5511141,5511160,2338874,19,1,2,True,True,0.28568611111111114,-0.230346
3947,3172413,40,8,0.811173,218,3257034,-1,4000.0,4807179,4807219,1634766,40,64,7,True,True,2.8835555555555556,-0.811173
3948,3172710,24,128,0.720256,218,3257034,-1,64000.0,4884520,4884544,1711810,24,54,6,True,True,28.467200000000002,-0.720256
3949,3172807,24672,16,0.481517,218,3257034,-1,8000.0,3303534,3328206,130727,24672,133,2,True,True,3101.0785333333333,-0.46090604919308265
3950,3173805,31,1,0.478815,218,3257034,-1,500.0,4330853,4330884,1157048,31,86,12,True,True,0.8895708333333334,-0.478815
3951,3174689,1629,2,0.210704,218,3257034,-1,1000.0,5282393,5284022,2107704,1629,19,8,True,True,37.49415,-0.210704
3952,3174838,26,4,0.161246,218,3257034,-1,2000.0,3913113,3913139,738275,26,100,0,True,True,1.4148333333333334,-0.161246
3953,3175208,2575,4,0.833365,218,3257034,-1,2000.0,5179777,5182352,2004569,2575,35,0,True,True,145.14566666666667,-0.8085883783074654
3954,3175685,734,1,0.022446,218,3257034,-1,500.0,3355566,3356300,179881,734,132,9,True,True,14.727913888888889,-0.022446
3955,3175739,8,9,0.043144,218,3257034,-1,4500.0,4991777,4991785,1816038,8,43,7,True,True,0.7981999999999999,-0.043144
3956,3213193,40,32,0.573487,218,3257034,-1,16000.0,4360053,4360093,1146860,40,81,0,True,True,30.668444444444443,-0.573487
3957,3213292,7,32,0.161129,218,3257034,-1,16000.0,5516541,5516548,2303249,7,1,8,True,True,3.9031999999999996,-0.161129
3958,3213707,12027,8,0.62954,218,3257034,-1,4000.0,4610653,4622680,1396946,12027,79,11,True,True,510.6146444444444,-0.5789330131274086
3959,3214079,7848,16,0.039191,218,3257034,-1,8000.0,3355566,3363414,141487,7848,136,0,True,True,2579.6833333333334,-0.03782511880885007
3960,3214664,8,4,0.572269,218,3257034,-1,2000.0,5284593,5284601,2069929,8,20,7,True,True,0.3682666666666667,-0.572269
3961,3215048,5,1,0.055912,218,3257034,-1,500.0,4210853,4210858,995805,5,98,9,True,True,0.07180555555555557,-0.055912
3962,3215258,6398,32,0.25826,218,3257034,-1,16000.0,3489926,3496324,274668,6398,137,0,True,True,2228.4288,-0.24541666916169505
3963,3215295,3413,2,0.180038,218,3257034,-1,1000.0,3341466,3344879,126171,3413,143,10,True,True,92.22628888888889,-0.16328539193251457
3964,3215375,4547,22,0.958238,218,3257034,-1,11000.0,5394091,5398638,2178716,4547,16,0,True,True,561.8368861111111,-0.9467384120399992
3965,3215389,12527,8,0.599358,218,3257034,-1,4000.0,3647726,3660253,432337,12527,136,12,True,True,440.95509999999996,-0.5845404168464913
3966,3215507,23,8,0.563605,218,3257034,-1,4000.0,3310866,3310889,95359,23,148,4,True,True,0.9450444444444445,-0.563605
3967,3216620,813,1,0.01862,218,3257034,-1,500.0,5206966,5207779,1990346,813,29,3,True,True,6.938729166666667,-0.01862
3968,3216752,5278,1,0.719547,218,3257034,-1,500.0,5154877,5160155,1938125,5278,43,0,True,True,120.44736527777776,-0.7189659135398858
3969,3216902,6,8,0.661745,218,3257034,-1,4000.0,3445566,3445572,228664,6,142,0,True,True,1.0078666666666667,-0.661745
3970,3216985,24,32,0.283455,218,3257034,-1,16000.0,3514826,3514850,297841,24,140,7,True,True,19.16586666666667,-0.283455
3971,3217098,6,1,0.085749,218,3257034,-1,500.0,5488570,5488576,2271472,6,9,1,True,True,0.047475,-0.085749
3972,3218348,9722,16,0.449203,218,3257034,-1,8000.0,5273393,5283115,2055045,9722,24,0,True,True,2512.290311111111,-0.4359406601995441
3973,3218367,3,5,0.992776,218,3257034,-1,2500.0,5394091,5394094,2175724,3,17,0,True,True,0.08602083333333332,-0.992776
3974,3218489,203,4,0.867302,218,3257034,-1,2000.0,5404891,5405094,2186402,203,17,9,True,True,4.958838888888889,-0.867302
3975,3218788,14762,64,0.170567,218,3257034,-1,32000.0,4883420,4898182,1664632,14762,68,0,True,True,9683.977955555556,-0.16999818784264245
3976,3218960,20,4,0.830364,218,3257034,-1,2000.0,5488550,5488570,2269590,20,10,2,True,True,0.633,-0.830364
3977,3219242,5551,4,0.600839,218,3257034,-1,2000.0,3916713,3922264,697471,5551,116,3,True,True,237.40532777777779,-0.5331157337093008
3978,3223294,128,6,0.794616,218,3257034,-1,3000.0,5276993,5277121,2053699,128,27,2,True,True,12.578133333333332,-0.7946159999999999
3979,3225540,754,2,0.820453,218,3257034,-1,1000.0,4097513,4098267,871973,754,114,12,True,True,3.587783333333333,-0.820453
3980,3226332,13412,1,0.181884,218,3257034,-1,500.0,3771913,3785325,545581,13412,131,0,True,True,115.11264861111113,-0.1589250970201324
3981,3226397,15893,32,0.659649,218,3257034,-1,16000.0,4813111,4829004,1586714,15893,76,2,True,True,8385.854266666667,-0.6137370323360795
3982,3226436,332,2,0.264521,218,3257034,-1,1000.0,4567453,4567785,1341017,332,92,10,True,True,20.538811111111112,-0.264521
3983,3226743,4441,256,0.724187,218,3257034,-1,128000.0,4622680,4627121,1395937,4441,91,9,True,True,6696.908444444444,-0.7173887568079763
3984,3226844,722,25,0.342671,218,3257034,-1,12500.0,4814211,4814933,1587367,722,75,6,True,True,245.2042361111111,-0.342671
3985,3226926,8998,128,0.45347,218,3257034,-1,64000.0,5370993,5379991,2144067,8998,25,12,True,True,7142.817777777777,-0.3793695818002809
3986,3227019,1061,1,0.590596,218,3257034,-1,500.0,4351053,4352114,1124034,1061,102,4,True,True,24.34995,-0.590596
3987,3227040,6,1,0.229814,218,3257034,-1,500.0,3299934,3299940,72894,6,171,1,True,True,0.04465,-0.229814
3988,3227155,17147,13,0.385462,218,3257034,-1,6500.0,4906620,4923767,1679465,17147,65,6,True,True,2916.7647527777776,-0.3797078512097489
3989,3227187,12,1,0.10857,218,3257034,-1,500.0,5516541,5516553,2289354,12,1,0,True,True,0.2091,-0.10857
3990,3227201,2,8,0.202349,218,3257034,-1,4000.0,5382191,5382193,2154990,2,23,7,True,True,0.0894,-0.202349
3991,3227619,4377,16,0.859592,218,3257034,-1,8000.0,3491026,3495403,263407,4377,161,6,True,True,772.8358444444444,-0.8539950021026956
3992,3227639,42,4,0.50436,218,3257034,-1,2000.0,5126777,5126819,1899138,42,55,12,True,True,0.9263333333333335,-0.50436
3993,3227955,27,8,0.419795,218,3257034,-1,4000.0,3909513,3909540,681558,27,131,7,True,True,2.9469,-0.419795
3994,3228020,9,1,0.149561,218,3257034,-1,500.0,5153777,5153786,1925757,9,54,10,True,True,0.202575,-0.149561
3995,3228272,12686,117,0.096299,218,3257034,-1,58500.0,4008913,4021599,780641,12686,127,1,True,True,4146.237712499999,-0.07599154908318657
3996,3228293,20,32,0.475869,218,3257034,-1,16000.0,5420391,5420411,2192098,20,17,2,True,True,7.368,-0.475869
3997,3228695,243,1,0.614748,218,3257034,-1,500.0,4799579,4799822,1570884,243,92,1,True,True,1.7303625000000002,-0.614748
3998,3230542,15,32,0.039037,218,3257034,-1,16000.0,3303666,3303681,73124,15,180,1,True,True,4.058666666666666,-0.039037
3999,3230614,9,8,0.783868,218,3257034,-1,4000.0,3489926,3489935,259312,9,169,11,True,True,0.7046,-0.783868
4000,3230652,178,18,0.503329,218,3257034,-1,9000.0,4111453,4111631,880801,178,124,7,True,True,16.1891,-0.503329
4001,3230740,8,16,0.117516,218,3257034,-1,8000.0,3446726,3446734,215986,8,171,6,True,True,2.6876444444444445,-0.117516
4002,3230930,8191,8,0.482241,218,3257034,-1,4000.0,4545853,4554044,1314923,8191,103,12,True,True,2657.2968333333333,-0.4621724343052292
4003,3230950,15,4,0.130329,218,3257034,-1,2000.0,4717080,4717095,1486130,15,96,2,True,True,0.9195833333333333,-0.130329
4004,3230965,13,16,0.603475,218,3257034,-1,8000.0,4908820,4908833,1677855,13,69,6,True,True,2.3512666666666666,-0.603475
4005,3232271,10541,85,0.827522,218,3257034,-1,42500.0,3806513,3817054,574242,10541,146,0,True,True,12162.872770833332,-0.6804948397103187
4006,3233206,180,32,0.896969,218,3257034,-1,16000.0,3289434,3289614,56228,180,193,10,True,True,70.76,-0.896969
4007,3233353,17432,1,0.77487,218,3257034,-1,500.0,3669326,3686758,435973,17432,168,10,True,True,101.27271944444446,-0.7725083498706412
4008,3233362,25,32,0.649232,218,3257034,-1,16000.0,5416791,5416816,2183429,25,18,8,True,True,8.648888888888889,-0.649232
4009,3233466,312,1,0.522044,218,3257034,-1,500.0,4899720,4900032,1666254,312,75,7,True,True,3.705,-0.522044
4010,3233513,5867,64,0.370377,218,3257034,-1,32000.0,4858520,4864387,1625007,5867,83,10,True,True,2965.3235555555557,-0.3566926179427496
4011,3233675,21233,1,0.043438,218,3257034,-1,500.0,4861820,4883053,1628145,21233,82,7,True,True,165.34068888888888,-0.04095277979698701
4012,3233900,15,16,0.529817,218,3257034,-1,8000.0,5180877,5180892,1946977,15,50,6,True,True,3.4856666666666665,-0.529817
4013,3233915,129,11,0.229486,218,3257034,-1,5500.0,4665880,4666009,1431965,129,107,11,True,True,13.425316666666667,-0.229486
4014,3234031,323,1,0.8023,218,3257034,-1,500.0,5438450,5438773,2204419,323,15,0,True,True,5.875459722222222,-0.8023
4015,3234059,24779,2,0.789556,218,3257034,-1,1000.0,3674726,3699505,440667,24779,175,8,True,True,318.13589999999994,-0.7673644335287726
4016,3234226,6230,8,0.381236,218,3257034,-1,4000.0,4236853,4243083,1002627,6230,129,7,True,True,1052.009922222222,-0.345803204197068
4017,3234243,12,4,0.589048,218,3257034,-1,2000.0,3518126,3518138,283883,12,180,7,True,True,1.3099333333333334,-0.589048
4018,3234606,47,1,0.741394,218,3257034,-1,500.0,4761380,4761427,1526774,47,102,6,True,True,0.3710388888888889,-0.741394
4019,3237061,2,16,0.761539,218,3257034,-1,8000.0,5183077,5183079,1946016,2,51,7,True,True,0.46475555555555553,-0.761539
4020,3237080,18897,16,0.696708,218,3257034,-1,8000.0,4815320,4834217,1578240,18897,89,1,True,True,5496.471888888888,-0.687737148486386
4021,3237244,9,32,0.097717,218,3257034,-1,16000.0,5383291,5383300,2146047,9,26,6,True,True,1.6092,-0.097717
4022,3237380,132,16,0.133883,218,3257034,-1,8000.0,4812979,4813111,1575599,132,95,0,True,True,30.052,-0.133883
4023,3237475,10306,32,0.477141,218,3257034,-1,16000.0,4713480,4723786,1476005,10306,109,0,True,True,4337.692088888889,-0.476673303921091
4024,3237506,11946,16,0.232513,218,3257034,-1,8000.0,3445626,3457572,208120,11946,193,2,True,True,3911.9976,-0.21223451494441536
4025,3237550,36,53,0.859053,218,3257034,-1,26500.0,3359166,3359202,121616,36,196,2,True,True,39.0663,-0.859053
4026,3237567,54,4,0.283267,218,3257034,-1,2000.0,4932648,4932702,1695081,54,72,7,True,True,2.3844,-0.283267
4027,3237605,3,1,0.876766,218,3257034,-1,500.0,5217766,5217769,1980161,3,42,9,True,True,0.025420833333333333,-0.876766
4028,3237639,57,1,0.408647,218,3257034,-1,500.0,3515926,3515983,278287,57,189,6,True,True,1.4224666666666668,-0.408647
4029,3237648,9,8,0.189021,218,3257034,-1,4000.0,4815311,4815320,1577663,9,93,6,True,True,0.9781000000000001,-0.189021
9049,7067964,113,2,0.771941,1,7067964,-1,1000.0,7073364,7073477,5400,113,0,8,True,True,5.044822222222223,-0.771941
9050,7067978,16,16,0.257944,4,7073364,-1,8000.0,7074464,7074480,6486,16,0,6,True,True,5.31591111111111,-0.257944
9051,7068000,5846,32,0.473261,4,7073364,-1,16000.0,8180170,8186016,1112170,5846,0,6,True,True,3475.254844444444,-0.4689099546563521
9052,7072488,40,16,0.256026,4,7073364,-1,8000.0,8515170,8515210,1442682,40,0,6,True,True,6.827555555555556,-0.256026
9053,7072656,13729,98,0.876658,4,7073364,-1,49000.0,7076664,7090393,4008,13729,2,7,True,True,25659.327477777777,-0.8205615111739699
9054,7073592,28,4,0.650292,7,7074464,-1,2000.0,8979375,8979403,1905783,28,0,0,True,True,1.3197333333333334,-0.650292
9055,7073635,11342,32,0.140447,7,7074464,-1,16000.0,7138264,7149606,64629,11342,3,6,True,True,5539.616088888889,-0.1290097369420674
9056,7073725,13964,1,0.123966,7,7074464,-1,500.0,8609570,8623534,1535845,13964,1,10,True,True,339.6108972222222,-0.11807487604938964
9057,7073777,19272,1,0.568733,7,7074464,-1,500.0,7088564,7107836,14787,19272,5,9,True,True,260.03493333333336,-0.5620731834607804
9058,7074702,11235,77,0.039593,12,7076664,-1,38500.0,7093964,7105199,19262,11235,5,8,True,True,12045.75754861111,-0.03917735239511504
9059,7074723,299,11,0.859003,12,7076664,-1,5500.0,7076664,7076963,1941,299,7,0,True,True,68.2969986111111,-0.859003
9060,7074773,12,1,0.400939,12,7076664,-1,500.0,7137164,7137176,62391,12,5,11,True,True,0.15421666666666667,-0.400939
9061,7074936,384,1,0.857001,12,7076664,-1,500.0,9327643,9328027,2252707,384,0,0,True,True,12.914666666666667,-0.857001
9062,7075408,4299,84,0.91714,12,7076664,-1,42000.0,7077764,7082063,2356,4299,9,6,True,True,7453.560916666666,-0.8938574980174828
9063,7075631,4,32,0.128984,12,7076664,-1,16000.0,8741780,8741784,1666149,4,2,8,True,True,2.9457777777777774,-0.128984
9064,7077889,9841,1,0.366732,15,7088564,-1,500.0,9830365,9840206,2752476,9841,0,10,True,True,372.67686249999997,-0.36404608712867953
9065,7078039,10,3,0.844836,15,7088564,-1,1500.0,8874728,8874738,1796689,10,3,10,True,True,0.463875,-0.844836
9066,7084626,842,32,0.952045,15,7088564,-1,16000.0,9117775,9118617,2033149,842,2,7,True,True,462.8754666666667,-0.952045
9067,7086232,13575,8,0.373683,15,7088564,-1,4000.0,7159864,7173439,73632,13575,9,10,True,True,1854.7455333333332,-0.3720700805912649
9068,7086472,105,1,0.682201,15,7088564,-1,500.0,8988775,8988880,1902303,105,3,0,True,True,2.1360208333333333,-0.682201
9069,7086917,641,1,0.505942,15,7088564,-1,500.0,9247375,9248016,2160458,641,2,0,True,True,24.123856944444444,-0.505942
9070,7089332,130,2,0.262827,16,7093964,-1,1000.0,7393133,7393263,303801,130,11,1,True,True,3.2976666666666663,-0.262827
9071,7093090,2160,2,0.875536,16,7093964,-1,1000.0,8410270,8412430,1317180,2160,10,12,True,True,73.068,-0.875536
9072,7106775,4,1,0.682556,93,7137164,-1,500.0,8928175,8928179,1821400,4,6,0,True,True,0.048716666666666665,-0.682556
9073,7107032,28,1,0.620614,93,7137164,-1,500.0,8438370,8438398,1331338,28,11,6,True,True,0.4123777777777778,-0.620614
9074,7107248,22,9,0.643867,93,7137164,-1,4500.0,9391443,9391465,2284195,22,1,0,True,True,1.9934749999999999,-0.643867
9075,7107275,19759,32,0.741043,93,7137164,-1,16000.0,7385869,7405628,278594,19759,16,0,True,True,8118.3714222222225,-0.6670384654437936
9076,7109502,7380,8,0.244817,93,7137164,-1,4000.0,7534185,7541565,424683,7380,15,10,True,True,1321.6155,-0.23753842698948405
9077,7109724,215,1,0.821235,93,7137164,-1,500.0,8876928,8877143,1767204,215,8,0,True,True,3.3244375,-0.821235
9078,7111029,2112,5,0.007943,93,7137164,-1,2500.0,9144775,9146887,2033746,2112,4,8,True,True,267.872,-0.007943
9079,7112093,69,16,0.85306,93,7137164,-1,8000.0,9841165,9841234,2729072,69,0,9,True,True,34.355866666666664,-0.85306
9080,7112485,34284,1,0.290661,93,7137164,-1,500.0,7337064,7371348,224579,34284,21,7,True,True,336.28215000000006,-0.28833609715447484
9081,7112504,34188,128,0.158206,93,7137164,-1,64000.0,7723962,7758150,611458,34188,18,11,True,True,17793.089066666664,-0.14805025852191286
9082,7112573,555,8,0.39928,93,7137164,-1,4000.0,8646380,8646935,1533807,555,13,0,True,True,55.80833333333334,-0.39928
9083,7112578,194,2,0.072979,93,7137164,-1,1000.0,9722171,9722365,2609593,194,2,1,True,True,2.981672222222222,-0.072979
9084,7113672,7824,128,0.388223,93,7137164,-1,64000.0,7237664,7245488,123992,7824,25,10,True,True,18861.718755555554,-0.37121674654271886
9085,7113827,11316,37,0.462279,93,7137164,-1,18500.0,9661906,9673222,2548079,11316,3,0,True,True,13544.859175000001,-0.46201927419083083
9086,7114504,1157,32,0.093503,93,7137164,-1,16000.0,9654306,9655463,2539802,1157,4,10,True,True,1207.266088888889,-0.09284854960847858
9087,7114587,17747,32,0.465878,93,7137164,-1,16000.0,8888828,8906575,1774241,17747,13,6,True,True,6803.976088888889,-0.4027157994291251
9088,7114913,86,1,0.642484,93,7137164,-1,500.0,8736380,8736466,1621467,86,17,12,True,True,1.9017944444444446,-0.642484
9089,7114996,9,32,0.900127,93,7137164,-1,16000.0,9247643,9247652,2132647,9,7,1,True,True,10.8388,-0.900127
9090,7115168,217,4,0.464853,93,7137164,-1,2000.0,8317370,8317587,1202202,217,24,6,True,True,16.701766666666664,-0.464853
9091,7117993,60,4,0.085823,93,7137164,-1,2000.0,8634781,8634841,1516788,60,20,0,True,True,5.226666666666667,-0.085823
9092,7118079,105,1,0.731778,93,7137164,-1,500.0,7912471,7912576,794392,105,27,1,True,True,1.5577916666666667,-0.731778
9093,7118118,1402,1,0.91746,93,7137164,-1,500.0,8906575,8907977,1788457,1402,14,1,True,True,23.30825,-0.91746
9094,7118204,16,16,0.922491,93,7137164,-1,8000.0,8572770,8572786,1454566,16,23,9,True,True,2.3505777777777777,-0.922491
9095,7118234,9,4,0.768217,93,7137164,-1,2000.0,7385869,7385878,267635,9,34,0,True,True,0.28255,-0.768217
9096,7118410,13,8,0.199471,93,7137164,-1,4000.0,9249843,9249856,2131433,13,7,0,True,True,3.1478777777777776,-0.199471
9097,7118430,11342,32,0.328721,93,7137164,-1,16000.0,7901162,7912504,782732,11342,31,12,True,True,3390.590933333333,-0.32045748993906015
9098,7118548,12493,143,0.317285,93,7137164,-1,71500.0,9585613,9598106,2467065,12493,5,11,True,True,29731.664859722223,-0.313432779452872
9099,7118583,6223,2,0.996438,93,7137164,-1,1000.0,8161770,8167993,1043187,6223,31,3,True,True,113.76343055555557,-0.9688492816177089
9100,7119045,14,4,0.486295,93,7137164,-1,2000.0,9674271,9674285,2555226,14,3,6,True,True,1.2096777777777779,-0.486295
9101,7119078,11505,64,0.702291,93,7137164,-1,32000.0,9247375,9258880,2128297,11505,11,0,True,True,20293.3,-0.6325378002791395
9102,7119093,205,8,0.476219,93,7137164,-1,4000.0,8481570,8481775,1362477,205,29,11,True,True,24.924555555555557,-0.44837554637336263
9103,7120629,13,3,0.278375,93,7137164,-1,1500.0,9001775,9001788,1881146,13,15,7,True,True,0.5066208333333334,-0.278375
9104,7120844,9,8,0.038282,93,7137164,-1,4000.0,9695871,9695880,2575027,9,3,10,True,True,0.8254000000000001,-0.038282
9105,7120858,1,16,0.155741,93,7137164,-1,8000.0,8903328,8903329,1782470,1,21,2,True,True,0.3566666666666667,-0.155741
9106,7120917,6726,4,0.469968,93,7137164,-1,2000.0,8736380,8743106,1615463,6726,26,0,True,True,621.4136666666667,-0.4677459919523655
9107,7122370,25,7,0.640216,93,7137164,-1,3500.0,8177970,8177995,1055600,25,38,8,True,True,4.653055555555555,-0.640216
9108,7122396,14,4,0.320187,93,7137164,-1,2000.0,8540370,8540384,1417974,14,32,1,True,True,0.44022222222222224,-0.320187
9109,7123755,233,2,0.031323,93,7137164,-1,1000.0,7810362,7810595,686607,233,43,12,True,True,5.832119444444444,-0.031323
9110,7123774,21286,32,0.601077,93,7137164,-1,16000.0,7385869,7407155,262095,21286,49,8,True,True,8944.105155555557,-0.5708659027452799
9111,7123901,75,32,0.380285,93,7137164,-1,16000.0,7360864,7360939,236963,75,50,10,True,True,21.07,-0.380285
9112,7123916,2,32,0.93646,93,7137164,-1,16000.0,8988775,8988777,1864859,2,18,7,True,True,1.3019555555555555,-0.93646
9113,7123947,113,16,0.361493,93,7137164,-1,8000.0,8852028,8852141,1728081,113,26,8,True,True,41.47853333333334,-0.361493
9114,7124055,10574,32,0.43011,93,7137164,-1,16000.0,9236575,9247149,2112520,10574,14,12,True,True,12160.602355555555,-0.42606854296351715
9115,7124427,388,39,0.47341,93,7137164,-1,19500.0,7906606,7906994,782179,388,45,8,True,True,103.44403333333332,-0.47340999999999994
9116,7124495,22,1,0.054078,93,7137164,-1,500.0,7553262,7553284,428767,22,49,9,True,True,0.2138277777777778,-0.054078
9117,7124616,44,5,0.868021,93,7137164,-1,2500.0,8743893,8743937,1619277,44,28,2,True,True,5.063055555555556,-0.868021
9118,7124801,7,32,0.952645,93,7137164,-1,16000.0,9667371,9667378,2542570,7,5,2,True,True,7.392311111111112,-0.952645
9119,7124812,19,1,0.683671,93,7137164,-1,500.0,9659706,9659725,2534894,19,7,8,True,True,0.5881555555555555,-0.683671
9120,7124848,23,1,0.269848,93,7137164,-1,500.0,9002875,9002898,1878027,23,19,6,True,True,0.2987763888888889,-0.269848
9121,7124867,5,66,0.635687,93,7137164,-1,33000.0,8887728,8887733,1762861,5,28,9,True,True,3.5310000000000006,-0.635687
9122,7125076,17378,8,0.083591,93,7137164,-1,4000.0,7512585,7529963,387509,17378,56,7,True,True,2726.5103222222224,-0.08076281593824607
9123,7125353,8,1,0.069259,93,7137164,-1,500.0,7680762,7680770,555409,8,54,7,True,True,0.09792222222222222,-0.069259
9124,7125590,6757,1,0.405068,93,7137164,-1,500.0,7389469,7396226,263879,6757,59,4,True,True,85.59546944444445,-0.35604363004994516
9125,7125614,3678,1,0.298337,93,7137164,-1,500.0,9670971,9674649,2545357,3678,5,2,True,True,103.15160833333334,-0.2613944222925087
9126,7125662,32562,128,0.712207,93,7137164,-1,64000.0,7923271,7955833,797609,32562,50,9,True,True,54531.958222222216,-0.6551068546221511
9127,7125680,178,8,0.871289,93,7137164,-1,4000.0,7361964,7362142,236284,178,65,6,True,True,16.14462222222222,-0.8241415871105499
9128,7126585,3522,8,0.524778,93,7137164,-1,4000.0,7194464,7197986,67879,3522,69,10,True,True,396.4885777777778,-0.44807954053598514
9129,7126867,11,56,0.669644,93,7137164,-1,28000.0,8438370,8438381,1311503,11,44,0,True,True,9.072311111111112,-0.669644
9130,7126915,64,2,0.259447,93,7137164,-1,1000.0,7393069,7393133,266154,64,62,4,True,True,1.6234666666666666,-0.259447
9131,7131804,6,36,0.830549,93,7137164,-1,18000.0,8978275,8978281,1846471,6,25,2,True,True,2.9658,-0.830549
9132,7131838,13,1,0.092441,93,7137164,-1,500.0,7678562,7678575,546724,13,59,6,True,True,0.17454305555555555,-0.092441
9133,7131896,178,6,0.901642,93,7137164,-1,3000.0,9386043,9386221,2254147,178,12,10,True,True,9.5141,-0.901642
9134,7132443,7,1,0.342019,93,7137164,-1,500.0,8577170,8577177,1444727,7,42,7,True,True,0.054745833333333334,-0.342019
9135,7132562,60,1,0.753176,93,7137164,-1,500.0,8491370,8491430,1358808,60,46,7,True,True,1.12625,-0.753176
9136,7132627,24738,7,0.164533,93,7137164,-1,3500.0,9391443,9416181,2258816,24738,12,8,True,True,3408.437841666667,-0.16349047280836485
9137,7132730,6994,4,0.349276,93,7137164,-1,2000.0,8974675,8981669,1841945,6994,28,7,True,True,359.8085888888889,-0.30131075604781976
9138,7132808,95,4,0.419101,93,7137164,-1,2000.0,7505985,7506080,373177,95,68,8,True,True,6.935527777777779,-0.4165335229919831
9139,7132911,5,4,0.475499,93,7137164,-1,2000.0,7966471,7966476,833560,5,57,11,True,True,0.26805555555555555,-0.475499
9140,7132920,5350,1,0.68883,93,7137164,-1,500.0,8172570,8177920,1039650,5350,56,9,True,True,126.77651388888889,-0.6550539123785691
9141,7132949,22,18,0.160689,93,7137164,-1,9000.0,9842265,9842287,2709316,22,0,6,True,True,12.3233,-0.160689
9142,7135100,719,1,0.69669,93,7137164,-1,500.0,8887728,8888447,1752628,719,34,0,True,True,7.51326388888889,-0.6803862866065279
9143,7135118,16046,32,0.354692,93,7137164,-1,16000.0,7655862,7671908,520744,16046,69,8,True,True,7999.731377777777,-0.3521518162659629
9144,7135521,26,64,0.692901,93,7137164,-1,32000.0,8889928,8889954,1754407,26,33,6,True,True,11.430755555555555,-0.692901
9145,7135638,30,13,0.389138,93,7137164,-1,6500.0,9673171,9673201,2537533,30,6,7,True,True,12.433308333333333,-0.3848591419018484
9146,7135868,11419,94,0.009932,93,7137164,-1,47000.0,8846628,8858047,1710760,11419,41,8,True,True,24749.497088888886,-0.009844486450548487
9147,7135905,14386,8,0.783072,93,7137164,-1,4000.0,9003975,9018361,1868070,14386,24,6,True,True,950.6965555555555,-0.7375687815450219
9148,7136048,8,6,0.597129,93,7137164,-1,3000.0,8159071,8159079,1023023,8,64,2,True,True,0.3754,-0.597129
9149,7136179,18,32,0.077809,93,7137164,-1,16000.0,8646380,8646398,1510201,18,48,0,True,True,7.24,-0.077809
9150,7137518,161,8,0.667962,95,7138264,-1,4000.0,8928175,8928336,1790657,161,33,10,True,True,15.686766666666665,-0.667962
9151,7137677,35,1,0.616512,95,7138264,-1,500.0,8836893,8836928,1699216,35,44,6,True,True,0.7833680555555556,-0.616512
9152,7138185,323,1,0.323733,95,7138264,-1,500.0,8415670,8415993,1277485,323,61,8,True,True,5.201197222222222,-0.323733
9153,7138782,8253,1,0.986368,142,7159864,-1,500.0,8155471,8163724,1016689,8253,69,1,True,True,79.85954861111111,-0.8892092694735676
9154,7138878,10,16,0.938969,142,7159864,-1,8000.0,7372764,7372774,233886,10,90,0,True,True,1.2362222222222223,-0.938969
9155,7138938,9704,64,0.742836,142,7159864,-1,32000.0,8986575,8996279,1847637,9704,29,2,True,True,10773.997422222223,-0.7184308609181372
9156,7138958,14911,32,0.736719,142,7159864,-1,16000.0,8895328,8910239,1756370,14911,37,8,True,True,7290.220711111111,-0.6196177200934461
9157,7139006,14452,32,0.316515,142,7159864,-1,16000.0,7395333,7409785,256327,14452,86,7,True,True,7145.287600000001,-0.2996430746508089
9158,7139240,23347,128,0.150506,142,7159864,-1,64000.0,9414843,9438190,2275603,23347,13,2,True,True,25447.21155555556,-0.14337363932900343
9159,7139285,12,1,0.458659,142,7159864,-1,500.0,9115575,9115587,1976290,12,25,10,True,True,0.20615,-0.458659
9160,7139307,18,16,0.147487,142,7159864,-1,8000.0,8266570,8266588,1127263,18,68,12,True,True,4.8348,-0.147487
9161,7139721,6,32,0.864301,142,7159864,-1,16000.0,8561970,8561976,1422249,6,59,10,True,True,2.1130666666666666,-0.864301
9162,7139796,465,4,0.113607,142,7159864,-1,2000.0,7912006,7912471,772210,465,79,8,True,True,27.595166666666668,-0.113607
9163,7139815,33807,64,0.969976,142,7159864,-1,32000.0,9670971,9704778,2531156,33807,7,0,True,True,34501.21146666667,-0.9160893830220147
9164,7140040,275,8,0.406387,142,7159864,-1,4000.0,9603506,9603781,2463466,275,13,8,True,True,22.216944444444444,-0.406387
9165,7140102,3,4,0.520692,142,7159864,-1,2000.0,9093975,9093978,1953873,3,28,11,True,True,0.255,-0.520692
9166,7140866,346,4,0.003677,142,7159864,-1,2000.0,9603506,9603852,2462640,346,13,0,True,True,13.976477777777776,-0.003677
9167,7141294,11097,10,0.450559,142,7159864,-1,5000.0,7377169,7388266,235875,11097,102,1,True,True,938.4733611111111,-0.44017598613679476
9168,7141690,3596,256,0.832511,142,7159864,-1,128000.0,7574862,7578458,433172,3596,91,10,True,True,10418.4512,-0.8018546045328142
9169,7141900,30,8,0.125717,142,7159864,-1,4000.0,8889928,8889958,1748028,30,44,0,True,True,1.6486666666666667,-0.125717
9170,7143944,103,8,0.449329,142,7159864,-1,4000.0,9327643,9327746,2183699,103,21,10,True,True,27.712722222222222,-0.449329
9171,7143981,7296,158,0.969458,142,7159864,-1,79000.0,9542413,9549709,2398432,7296,16,2,True,True,9920.446944444444,-0.8990709275476555
9172,7143987,78,16,0.097446,142,7159864,-1,8000.0,8896428,8896506,1752441,78,45,6,True,True,8.892,-0.097446
9173,7144695,42,4,0.218623,142,7159864,-1,2000.0,7172864,7172906,28169,42,114,2,True,True,2.864866666666667,-0.218623
9174,7147554,19,1,0.979032,142,7159864,-1,500.0,7216064,7216083,68510,19,113,10,True,True,0.3190152777777778,-0.979032
9175,7147640,49,1,0.420176,142,7159864,-1,500.0,9001775,9001824,1854135,49,34,0,True,True,0.6365236111111111,-0.420176
9176,7147674,11,35,0.546086,142,7159864,-1,17500.0,8634770,8634781,1487096,11,65,1,True,True,8.384444444444446,-0.546086
9177,7148673,29,8,0.166101,142,7159864,-1,4000.0,8646380,8646409,1497707,29,64,2,True,True,2.916111111111111,-0.166101
9178,7148736,9465,32,0.377557,142,7159864,-1,16000.0,8437270,8446735,1288534,9465,77,0,True,True,3987.076,-0.36351485389167876
9179,7148820,116,32,0.348086,142,7159864,-1,16000.0,7334864,7334980,186044,116,116,12,True,True,41.6208,-0.348086
9180,7149228,9,1,0.952377,142,7159864,-1,500.0,9605706,9605715,2456478,9,13,6,True,True,0.0577375,-0.952377
9181,7149429,13,6,0.971745,142,7159864,-1,3000.0,8853128,8853141,1703699,13,56,6,True,True,1.7676749999999999,-0.971745
9182,7149513,14084,1,0.576836,142,7159864,-1,500.0,9529624,9543708,2380111,14084,18,0,True,True,107.29539444444444,-0.5106246941133424
9183,7149817,41,1,0.014371,142,7159864,-1,500.0,8833593,8833634,1683776,41,61,12,True,True,0.8850875,-0.014371
9184,7149890,17,1,0.813779,142,7159864,-1,500.0,9050775,9050792,1900885,17,34,9,True,True,0.47151388888888884,-0.813779
9185,7150081,4900,36,0.016191,142,7159864,-1,18000.0,8972475,8977375,1822394,4900,45,11,True,True,2613.65,-0.015565325889852172
9186,7150250,9583,32,0.896655,142,7159864,-1,16000.0,7194464,7204047,44214,9583,125,0,True,True,4661.156622222222,-0.8565615327546919
9187,7150693,31580,2,0.502085,142,7159864,-1,1000.0,8649980,8681560,1499287,31580,68,4,True,True,1194.9714999999999,-0.49653587724409387
9188,7150700,672,8,0.867758,142,7159864,-1,4000.0,9340643,9341315,2189943,672,23,7,True,True,96.23786666666666,-0.867758
9189,7154274,8,1,0.699317,142,7159864,-1,500.0,7248464,7248472,94190,8,125,9,True,True,0.12998888888888888,-0.699317
9190,7154312,9,1,0.648912,142,7159864,-1,500.0,7607262,7607271,452950,9,107,10,True,True,0.15278750000000002,-0.648912
9191,7154448,15210,8,0.455997,142,7159864,-1,4000.0,8631170,8646380,1476722,15210,75,9,True,True,2106.844666666667,-0.43014835678703356
9192,7154533,7486,8,0.410387,142,7159864,-1,4000.0,8835793,8843279,1681260,7486,64,0,True,True,1374.6118555555554,-0.4024935467278715
9193,7158859,538,1,0.352211,142,7159864,-1,500.0,8587970,8588508,1429111,538,78,9,True,True,3.488033333333333,-0.352211
9194,7158910,10206,4,0.542467,142,7159864,-1,2000.0,7163464,7173670,4554,10206,135,1,True,True,707.7966888888889,-0.5408298236644864
9195,7159012,38,3,0.52317,142,7159864,-1,1500.0,8309770,8309808,1150758,38,92,11,True,True,2.2959916666666667,-0.52317
9196,7159053,7,8,0.765081,142,7159864,-1,4000.0,7650462,7650469,491409,7,111,11,True,True,0.8042222222222223,-0.765081
9197,7159623,5,4,0.11338,142,7159864,-1,2000.0,8634781,8634786,1475158,5,75,1,True,True,0.4355555555555556,-0.11338
9198,7159669,206,12,0.175814,142,7159864,-1,6000.0,9604606,9604812,2444937,206,14,6,True,True,24.433366666666668,-0.17207851621483405
9199,7159767,103,1,0.428384,142,7159864,-1,500.0,7510385,7510488,350618,103,119,0,True,True,1.7273958333333335,-0.428384
9200,7159820,5750,32,0.176895,142,7159864,-1,16000.0,8161770,8167520,1001950,5750,99,0,True,True,1702.805777777778,-0.1716695216955193
9201,7160054,37473,32,0.594892,151,7163464,-1,16000.0,9402243,9439716,2242189,37473,21,0,True,True,13749.336133333334,-0.5199066795451748
9202,7160100,414,8,0.542763,151,7163464,-1,4000.0,9364443,9364857,2204343,414,25,10,True,True,31.4272,-0.542763
9203,7160164,15,1,0.381563,151,7163464,-1,500.0,9303843,9303858,2143679,15,29,10,True,True,0.20089583333333336,-0.381563
9204,7160343,14002,5,0.845092,151,7163464,-1,2500.0,9722365,9736367,2562022,14002,3,1,True,True,1997.4617916666666,-0.8201052828214415
9205,7160436,135,1,0.688551,151,7163464,-1,500.0,7169264,7169399,8828,135,145,2,True,True,2.4624375,-0.688551
9206,7160647,6502,3,0.437494,151,7163464,-1,1500.0,8489170,8495672,1328523,6502,91,7,True,True,299.6268416666667,-0.4267801684334914
9207,7160727,498,9,0.283248,151,7163464,-1,4500.0,9670971,9671469,2510244,498,8,0,True,True,144.47602500000002,-0.283248
9208,7162746,14808,8,0.620376,151,7163464,-1,4000.0,7165664,7180472,2918,14808,148,7,True,True,1891.1399111111114,-0.5959350519365192
9209,7162966,1,5,0.925136,151,7163464,-1,2500.0,9150175,9150176,1987209,1,37,8,True,True,0.13355555555555557,-0.925136
9210,7162997,11,64,0.856997,151,7163464,-1,32000.0,8744993,8745004,1581996,11,73,6,True,True,15.665955555555556,-0.856997
9211,7163649,2114,1,0.995363,157,7165664,-1,500.0,9405843,9407957,2242194,2114,23,0,True,True,37.48525138888889,-0.9526066403991594
9212,7163720,4028,4,0.80594,157,7165664,-1,2000.0,9605706,9609734,2441986,4028,15,0,True,True,137.8839111111111,-0.5654614699170569
9213,7164050,224,7,0.103812,157,7165664,-1,3500.0,7500585,7500809,336535,224,132,0,True,True,26.780133333333332,-0.103812
9214,7164332,124,9,0.649625,157,7165664,-1,4500.0,8899728,8899852,1735396,124,60,7,True,True,17.1399,-0.649625
9215,7164528,34,1,0.61626,157,7165664,-1,500.0,9717471,9717505,2552943,34,5,10,True,True,0.21401111111111112,-0.61626
9216,7165397,739,32,0.41128,157,7165664,-1,16000.0,8841228,8841967,1675831,739,74,2,True,True,554.2870222222223,-0.3994023244545271
9217,7165501,74,64,0.496405,157,7165664,-1,32000.0,9611106,9611180,2445605,74,16,8,True,True,61.02204444444445,-0.496405
9218,7166578,7417,1,0.751727,157,7169264,-1,500.0,9718571,9725988,2551993,7417,5,6,True,True,97.72622777777778,-0.6066801667107184
9219,7170295,121,4,0.927229,157,7172864,-1,2000.0,7372764,7372885,202469,121,147,9,True,True,4.1414333333333335,-0.8906270063703623
9220,7172868,21,5,0.099702,186,7194464,-1,2500.0,8876928,8876949,1704060,21,72,7,True,True,1.6235625,-0.099702
9221,7173828,18,18,0.444103,186,7194464,-1,9000.0,7677462,7677480,503634,18,129,10,True,True,4.35015,-0.444103
9222,7173913,321,1,0.581234,186,7194464,-1,500.0,9540424,9540745,2366511,321,25,9,True,True,1.6491375000000001,-0.581234
9223,7184070,13,16,0.032636,186,7194464,-1,8000.0,8060071,8060084,876001,13,120,2,True,True,0.9611333333333334,-0.032636
9224,7184899,1013,4,0.289904,186,7194464,-1,2000.0,8742880,8743893,1557981,1013,84,6,True,True,93.25227777777778,-0.289904
9225,7185016,16239,4,0.420641,186,7194464,-1,2000.0,8056471,8072710,871455,16239,122,1,True,True,728.1168388888889,-0.40031135421612096
9226,7186069,16,6,0.222879,186,7194464,-1,3000.0,7411985,7412001,225916,16,144,7,True,True,1.5892,-0.22287900000000005
9227,7186102,2263,4,0.45463,186,7194464,-1,2000.0,8587970,8590233,1401868,2263,97,0,True,True,67.99926666666667,-0.33610623878752177
9228,7186416,8496,64,0.38108,186,7194464,-1,32000.0,8903329,8911825,1716913,8496,63,1,True,True,10537.635555555555,-0.36167202950734406
9229,7187747,5,8,0.19556,186,7194464,-1,4000.0,9139375,9139380,1951628,5,45,10,True,True,1.0883333333333334,-0.19556
9230,7187993,11,4,0.469574,186,7194464,-1,2000.0,7379369,7379380,191376,11,155,7,True,True,0.4279,-0.469574
9231,7188234,11,5,0.124441,186,7194464,-1,2500.0,7414185,7414196,225951,11,147,7,True,True,0.8380625,-0.124441
9232,7189561,526,8,0.967616,186,7194464,-1,4000.0,8514070,8514596,1324509,526,106,6,True,True,44.89117777777778,-0.967616
9233,7189749,30690,64,0.914029,186,7194464,-1,32000.0,7510385,7541075,320636,30690,146,7,True,True,40282.02,-0.905507139463448
9234,7189791,17197,128,0.412935,186,7194464,-1,64000.0,9598106,9615303,2408315,17197,23,0,True,True,21086.617599999998,-0.40737277440484243
9235,7190455,12,1,0.820418,186,7194464,-1,500.0,7814762,7814774,624307,12,134,7,True,True,0.1454666666666667,-0.820418
9236,7191158,93,1,0.703835,186,7194464,-1,500.0,8310870,8310963,1119712,93,117,6,True,True,1.8730458333333333,-0.703835
9237,7191735,12789,2,0.741153,186,7194464,-1,1000.0,9529624,9542413,2337889,12789,28,12,True,True,200.44466388888887,-0.7316181282383509
9238,7192149,12,32,0.007605,186,7194464,-1,16000.0,7901206,7901218,709057,12,135,1,True,True,2.1525333333333334,-0.007605
9239,7192320,16,32,0.374644,186,7194464,-1,16000.0,9661906,9661922,2469586,16,15,7,True,True,15.849244444444444,-0.374644
9240,7192416,30,1,0.223937,186,7194464,-1,500.0,8982975,8983005,1790559,30,60,3,True,True,0.513,-0.223937
9241,7192636,115,1,0.283604,186,7194464,-1,500.0,9007575,9007690,1814939,115,53,2,True,True,0.8773541666666665,-0.283604
9242,7192923,2,3,0.879607,186,7194464,-1,1500.0,8736380,8736382,1543457,2,93,0,True,True,0.13268333333333332,-0.879607
9243,7192945,38,12,0.264499,186,7194464,-1,6000.0,9039975,9040013,1847030,38,53,8,True,True,8.782433333333334,-0.264499
9244,7193263,44,1,0.838484,186,7194464,-1,500.0,7901162,7901206,707899,44,141,0,True,True,0.24664444444444444,-0.838484
9245,7193967,9,32,0.795138,186,7194464,-1,16000.0,8645581,8645590,1451614,9,101,9,True,True,3.62,-0.795138
9246,7194119,5,8,0.414717,186,7194464,-1,4000.0,9808765,9808770,2614646,5,3,12,True,True,0.7987777777777778,-0.414717
9247,7194371,1835,1,0.241554,186,7194464,-1,500.0,8835793,8837628,1641422,1835,90,0,True,True,41.07086805555556,-0.241554
9248,7194423,7,1,0.900187,186,7194464,-1,500.0,8897528,8897535,1703105,7,74,6,True,True,0.049874999999999996,-0.900187
9249,7194433,1000,4,0.414557,186,7194464,-1,2000.0,9306043,9307043,2111610,1000,41,7,True,True,101.7,-0.414557
9250,7195265,56,39,0.01553,239,7216064,-1,19500.0,9542413,9542469,2347148,56,27,0,True,True,11.220300000000002,-0.01553
9251,7195429,2,16,0.153375,239,7216064,-1,8000.0,8323870,8323872,1128441,2,128,8,True,True,0.7089333333333333,-0.153375
9252,7196751,143,16,0.374406,239,7216064,-1,8000.0,8999575,8999718,1802824,143,62,0,True,True,33.9768,-0.374406
9253,7200934,5663,2,0.816707,239,7216064,-1,1000.0,8999575,9005238,1798641,5663,63,9,True,True,134.4808,-0.684231604256078
9254,7201056,70,1,0.820034,239,7216064,-1,500.0,8410270,8410340,1209214,70,129,0,True,True,1.1839722222222222,-0.820034
9255,7201163,33,1,0.599946,239,7216064,-1,500.0,7339264,7339297,138101,33,185,7,True,True,0.2673916666666667,-0.599946
9256,7201177,268,4,0.33509,239,7216064,-1,2000.0,9247375,9247643,2046198,268,48,9,True,True,40.34442222222222,-0.33509
9257,7201192,24047,1,0.959161,239,7216064,-1,500.0,8837628,8861675,1636436,24047,94,2,True,True,559.1917430555554,-0.9566489136405022
9258,7201286,7837,32,0.992829,239,7216064,-1,16000.0,7812562,7820399,611276,7837,156,7,True,True,2804.0806666666667,-0.9680043982608169
9259,7201325,14831,4,0.241831,239,7216064,-1,2000.0,7508185,7523016,306860,14831,171,7,True,True,1037.1410777777778,-0.23179858091962796
9260,7201383,13,8,0.97349,239,7216064,-1,4000.0,9249843,9249856,2048460,13,45,7,True,True,3.1478777777777776,-0.97349
9261,7201427,10394,8,0.19266,239,7216064,-1,4000.0,8052871,8063265,851444,10394,148,12,True,True,674.0909555555556,-0.1400113782930037
9262,7201607,11188,2,0.644434,239,7216064,-1,1000.0,8536770,8547958,1335163,11188,123,10,True,True,182.35431666666668,-0.6192581296737792
9263,7202871,7099,1,0.82855,239,7216064,-1,500.0,8179070,8186169,976199,7099,141,6,True,True,133.40320972222221,-0.6792684166109212
9264,7203063,5,18,0.801332,239,7216064,-1,9000.0,7377164,7377169,174101,5,189,7,True,True,0.87525,-0.801332
9265,7203165,11669,8,0.577854,239,7216064,-1,4000.0,8979375,8991044,1776210,11669,71,6,True,True,1590.424,-0.548061943830053
9266,7204406,19788,1,0.12887,239,7216064,-1,500.0,8512970,8532758,1308564,19788,127,10,True,True,298.48236944444443,-0.12761848938829193
9267,7204441,44,1,0.636273,239,7216064,-1,500.0,9411243,9411287,2206802,44,33,8,True,True,0.7113944444444444,-0.636273
9268,7204550,13130,64,0.977356,239,7216064,-1,32000.0,8486970,8500100,1282420,13130,131,8,True,True,12604.653333333334,-0.9185974436785529
9269,7204562,171,1,0.173717,239,7216064,-1,500.0,8318470,8318641,1113908,171,140,6,True,True,3.2903249999999997,-0.173717
9270,7204763,49,4,0.904171,239,7216064,-1,2000.0,9667322,9667371,2462559,49,15,8,True,True,6.468272222222223,-0.904171
9271,7204775,8028,1,0.517277,239,7216064,-1,500.0,9443224,9451252,2238449,8028,33,10,True,True,64.95064444444445,-0.5033231488568596
9272,7204795,58272,4,0.437402,239,7216064,-1,2000.0,8905529,8963801,1700734,58272,81,7,True,True,4767.098111111111,-0.42373059300227617
9273,7204807,11697,256,0.099578,239,7216064,-1,128000.0,7541565,7553262,336758,11697,179,2,True,True,45960.54613333334,-0.08465577869218716
9274,7207802,4,4,0.801172,239,7216064,-1,2000.0,9260643,9260647,2052841,4,47,9,True,True,0.2882888888888889,-0.801172
9275,7208040,42,4,0.504257,239,7216064,-1,2000.0,8159071,8159113,951031,42,155,0,True,True,1.3139,-0.504257
9276,7208206,7328,1,0.631441,239,7216064,-1,500.0,8747193,8754521,1538987,7328,106,7,True,True,175.5769263888889,-0.6232362406728875
9277,7208246,81,16,0.784281,239,7216064,-1,8000.0,8316270,8316351,1108024,81,147,8,True,True,24.937199999999997,-0.784281
9278,7209531,110,1,0.843031,239,7216064,-1,500.0,9282243,9282353,2072712,110,47,10,True,True,1.1873888888888888,-0.843031
9279,7209617,635,32,0.627318,239,7216064,-1,16000.0,9405843,9406478,2196226,635,37,3,True,True,376.4844444444445,-0.627318
9280,7209643,25,1,0.26023,239,7216064,-1,500.0,9667322,9667347,2457679,25,15,0,True,True,0.8250347222222222,-0.26023
9281,7209667,9,8,0.552906,239,7216064,-1,4000.0,7810362,7810371,600695,9,176,0,True,True,0.9011,-0.552906
9282,7209674,336,32,0.9487,239,7216064,-1,16000.0,8835793,8836129,1626119,336,108,7,True,True,240.6506666666667,-0.9487
9283,7209685,26645,16,0.203763,239,7216064,-1,8000.0,9029175,9055820,1819490,26645,66,10,True,True,10228.14677777778,-0.19953173166996588
9284,7209720,15299,64,0.093265,239,7216064,-1,32000.0,8146471,8161770,936751,15299,165,12,True,True,11857.464977777778,-0.08909199964135403
9285,7209776,26,1,0.437421,239,7216064,-1,500.0,8929275,8929301,1719499,26,83,6,True,True,0.3166583333333333,-0.437421
9286,7210165,12871,16,0.628894,239,7216064,-1,8000.0,8437270,8450141,1227105,12871,147,10,True,True,2726.744355555556,-0.5869673468165415
9287,7210313,11079,64,0.593288,239,7216064,-1,32000.0,8928175,8939254,1717862,11079,85,0,True,True,11432.431733333333,-0.46625023448918224
9288,7210375,5745,32,0.027818,239,7216064,-1,16000.0,9402243,9407988,2191868,5745,40,9,True,True,3470.7665333333334,-0.025031141027899436
9289,7210382,28,16,0.707576,239,7216064,-1,8000.0,9632706,9632734,2422324,28,21,10,True,True,3.0911999999999997,-0.707576
9290,7210418,167,32,0.920594,239,7216064,-1,16000.0,8620370,8620537,1409952,167,132,9,True,True,117.90942222222223,-0.920594
9291,7210473,1381,32,0.078773,239,7216064,-1,16000.0,9420243,9421624,2209770,1381,36,8,True,True,498.77279999999996,-0.07317457561616647
9292,7210951,22437,1,0.382405,239,7216064,-1,500.0,8634781,8657218,1423830,22437,129,0,True,True,333.00826944444447,-0.3590583820486434
9293,7211068,2274,1,0.74234,239,7216064,-1,500.0,9342843,9345117,2131775,2274,47,7,True,True,35.938675,-0.74234
9294,7211177,56,22,0.130548,239,7216064,-1,11000.0,9034575,9034631,1823398,56,70,8,True,True,29.212088888888886,-0.130548
9295,7212319,6,8,0.453706,239,7216064,-1,4000.0,8574970,8574976,1362651,6,141,7,True,True,0.44073333333333337,-0.453706
9296,7212722,1338,4,0.631502,239,7216064,-1,2000.0,7585662,7587000,372940,1338,199,9,True,True,77.19516666666665,-0.631502
9297,7212780,4929,4,0.358121,239,7216064,-1,2000.0,8151871,8156800,939091,4929,176,8,True,True,250.48550555555556,-0.3399326105457302
9298,7212857,57,8,0.239722,239,7216064,-1,4000.0,9661922,9661979,2449065,57,17,1,True,True,14.115733333333335,-0.239722
9299,7212939,2,8,0.897909,239,7216064,-1,4000.0,7500585,7500587,287646,2,212,12,True,True,0.27326666666666666,-0.897909
9300,7213145,15255,32,0.296923,239,7216064,-1,16000.0,7374964,7390219,161819,15255,225,7,True,True,4161.299288888888,-0.29138843855248225
9301,7213246,15842,225,0.535417,239,7216064,-1,112500.0,7409785,7425627,196539,15842,215,4,True,True,49325.3296875,-0.5233046698761171
9302,7214147,27,1,0.245254,239,7216064,-1,500.0,9338443,9338470,2124296,27,50,9,True,True,0.4833374999999999,-0.245254
9303,7214162,3,4,0.780029,239,7216064,-1,2000.0,9421624,9421627,2207462,3,37,1,True,True,0.11205000000000001,-0.780029
9304,7214384,351,2,0.786048,239,7216064,-1,1000.0,7380469,7380820,166085,351,225,6,True,True,5.72715,-0.786048
6365,4996152,288,8,0.943162,1,4996152,-1,4000.0,4996383,4996440,231,288,0,0,True,True,29.9232,-0.943162
6366,4996383,9,1,0.724234,1,4996383,-1,500.0,5017983,5017992,21600,9,0,10,True,True,0.241925,-0.724234
6367,4996738,11299,256,0.14056,27,5017983,-1,128000.0,5418844,5430143,422106,11299,0,9,True,True,33491.79875555556,-0.1370397473114163
6368,4996862,19,8,0.111932,27,5017983,-1,4000.0,6864737,6864756,1867875,19,0,0,True,True,2.3433333333333333,-0.111932
6369,4997024,11651,2,0.73448,27,5017983,-1,1000.0,5030218,5041869,33194,11651,2,6,True,True,588.0487833333333,-0.7186548213270835
6370,4998240,68,32,0.932935,27,5017983,-1,16000.0,7060237,7060305,2061997,68,0,0,True,True,29.844444444444445,-0.932935
6371,4998380,9,2,0.521958,27,5017983,-1,1000.0,5021518,5021527,23138,9,4,1,True,True,0.484,-0.521958
6372,5001282,11,1,0.828982,27,5017983,-1,500.0,7070405,7070416,2069123,11,0,2,True,True,0.16215833333333335,-0.828982
6373,5001393,8013,2,0.949675,27,5017983,-1,1000.0,6495113,6503126,1493720,8013,3,0,True,True,401.8638305555556,-0.935003303036602
6374,5003634,1429,2,0.931556,27,5017983,-1,1000.0,5162498,5163927,158864,1429,5,6,True,True,48.25653611111111,-0.931556
6375,5003672,396,11,0.251808,27,5017983,-1,5500.0,5029118,5029514,25446,396,7,7,True,True,112.45853055555557,-0.2498347562866455
6376,5003800,518,4,0.884565,27,5017983,-1,2000.0,6817837,6818355,1814037,518,3,0,True,True,34.74053333333334,-0.884565
6377,5003985,4,16,0.238077,27,5017983,-1,8000.0,6864737,6864741,1860752,4,3,8,True,True,0.9866666666666667,-0.238077
6378,5004083,382,8,0.122277,27,5017983,-1,4000.0,7120412,7120794,2116329,382,0,1,True,True,45.895177777777775,-0.122277
6379,5004332,179,1,0.806687,27,5017983,-1,500.0,6275395,6275574,1271063,179,7,2,True,True,3.3221902777777776,-0.806687
6380,5004346,342,1,0.329286,27,5017983,-1,500.0,7065705,7066047,2061359,342,2,0,True,True,5.00365,-0.329286
6381,5004375,7617,128,0.584326,27,5017983,-1,64000.0,5971197,5978814,966822,7617,9,0,True,True,29785.05013333333,-0.5115580438575166
6382,5004770,7207,53,0.389951,27,5017983,-1,26500.0,6854937,6862144,1850167,7207,6,9,True,True,5762.0652625,-0.38470924640470006
6383,5008217,92,1,0.748374,27,5017983,-1,500.0,5021426,5021518,13209,92,16,6,True,True,2.473777777777778,-0.748374
6384,5008449,72,16,0.235938,27,5017983,-1,8000.0,5073418,5073490,64969,72,13,11,True,True,22.104000000000003,-0.235938
6385,5008526,6200,16,0.422869,27,5017983,-1,8000.0,6171921,6178121,1163395,6200,10,7,True,True,1909.8147777777776,-0.387731419362904
6386,5008573,5,8,0.144278,27,5017983,-1,4000.0,7228684,7228689,2220111,5,0,9,True,True,0.6875,-0.144278
6387,5009035,112,4,0.175154,27,5017983,-1,2000.0,5026918,5027030,17883,112,18,8,True,True,11.216177777777776,-0.175154
6388,5009187,92,16,0.969923,27,5017983,-1,8000.0,5731059,5731151,721872,92,13,0,True,True,20.816533333333332,-0.969923
6389,5011695,36736,16,0.439475,27,5017983,-1,8000.0,5382108,5418844,370413,36736,15,6,True,True,10696.838666666667,-0.43894604091011674
6390,5012350,143,32,0.254306,27,5017983,-1,16000.0,5020183,5020326,7833,143,23,7,True,True,123.04355555555554,-0.254306
6391,5012445,12,8,0.589481,27,5017983,-1,4000.0,5613507,5613519,601062,12,14,4,True,True,1.2056,-0.589481
6392,5013079,28,4,0.490359,27,5017983,-1,2000.0,5020326,5020354,7247,28,24,1,True,True,3.0115555555555553,-0.490359
6393,5013666,39,64,0.374705,27,5017983,-1,32000.0,6180854,6180893,1167188,39,11,2,True,True,55.07146666666667,-0.374705
6394,5035595,4,1,0.948711,169,5073418,-1,500.0,5750659,5750663,715064,4,14,7,True,True,0.04152222222222222,-0.948711
6395,5035616,49,1,0.31649,169,5073418,-1,500.0,5609858,5609907,574242,49,17,1,True,True,0.5600291666666667,-0.31649
6396,5035632,6541,32,0.423781,169,5073418,-1,16000.0,5114598,5121139,78966,6541,21,9,True,True,6066.912177777777,-0.41704639188700227
6397,5035672,13689,1,0.682738,169,5073418,-1,500.0,7228877,7242566,2193205,13689,0,0,True,True,249.58182361111113,-0.6809265954647395
6398,5035701,48,4,0.963315,169,5073418,-1,2000.0,6822537,6822585,1786836,48,9,6,True,True,3.048,-0.963315
6399,5038555,27,25,0.879434,169,5073418,-1,12500.0,5165798,5165825,127243,27,22,6,True,True,11.3971875,-0.879434
6400,5039384,9,8,0.936972,169,5073418,-1,4000.0,5626507,5626516,587123,9,18,9,True,True,1.2522,-0.936972
6401,5039437,4609,128,0.362998,169,5073418,-1,64000.0,5664359,5668968,624922,4609,18,2,True,True,11617.334577777778,-0.34124496789112796
6402,5039447,15719,8,0.715671,169,5073418,-1,4000.0,5832755,5848474,793308,15719,16,7,True,True,1666.1459444444445,-0.7049036352231768
6403,5039464,2,1,0.821365,169,5073418,-1,500.0,5192130,5192132,152666,2,25,1,True,True,0.035272222222222226,-0.821365
6404,5039486,489,1,0.021074,169,5073418,-1,500.0,7228877,7229366,2189391,489,1,0,True,True,8.517429166666666,-0.021074
6405,5039769,60,1,0.966805,169,5073418,-1,500.0,6178121,6178181,1138352,60,15,1,True,True,1.3238333333333334,-0.966805
6406,5039891,10,4,0.605815,169,5073418,-1,2000.0,7060305,7060315,2020414,10,6,2,True,True,0.5486111111111112,-0.605815
6407,5039964,11,2,0.841473,169,5073418,-1,1000.0,7049437,7049448,2009473,11,8,6,True,True,0.3902555555555556,-0.841473
6408,5040154,8196,8,0.662223,169,5073418,-1,4000.0,5743059,5751255,702905,8196,22,7,True,True,821.8013000000001,-0.6385168248467072
6409,5040184,9272,1,0.940848,169,5073418,-1,500.0,5300630,5309902,260446,9272,30,7,True,True,201.17636666666667,-0.9258575523441652
6410,5040190,24297,78,0.690682,169,5073418,-1,39000.0,6169721,6194018,1129531,24297,19,8,True,True,35024.18800833334,-0.6703514251708819
6411,5040213,572,8,0.788803,169,5073418,-1,4000.0,5693159,5693731,652946,572,25,2,True,True,63.428444444444445,-0.788803
6412,5040272,2900,64,0.239676,169,5073418,-1,32000.0,5204030,5206930,163758,2900,33,6,True,True,3521.894222222222,-0.23495575151135775
6413,5040327,32,2,0.552728,169,5073418,-1,1000.0,7120380,7120412,2080053,32,4,9,True,True,0.9611555555555555,-0.552728
6414,5040396,7193,1,0.309269,169,5073418,-1,500.0,7066805,7073998,2026409,7193,6,6,True,True,104.26926666666667,-0.3092660834009062
6415,5040423,9,8,0.958484,169,5073418,-1,4000.0,5164698,5164707,124275,9,38,7,True,True,1.2157,-0.958484
6416,5040900,48,4,0.362855,169,5073418,-1,2000.0,5956355,5956403,915455,48,23,8,True,True,4.185333333333333,-0.362855
6417,5040909,7,64,0.81225,169,5073418,-1,32000.0,5760255,5760262,719346,7,25,2,True,True,4.934844444444445,-0.81225
6418,5041154,752,8,0.122054,169,5073418,-1,4000.0,5765755,5766507,724601,752,25,7,True,True,64.39626666666666,-0.122054
6419,5041162,10,1,0.866953,169,5073418,-1,500.0,6495113,6495123,1453951,10,17,12,True,True,0.2777638888888889,-0.866953
6420,5041194,39,32,0.857647,169,5073418,-1,16000.0,6613326,6613365,1572132,39,16,0,True,True,27.4144,-0.857647
6421,5046220,1,16,0.388471,169,5073418,-1,8000.0,5626516,5626517,580296,1,34,1,True,True,0.27826666666666666,-0.388471
6422,5046284,15625,4,0.909789,169,5073418,-1,2000.0,5756655,5772280,710371,15625,29,8,True,True,674.4965,-0.8677562446686216
6423,5046317,3,1,0.392976,169,5073418,-1,500.0,6164321,6164324,1118004,3,24,8,True,True,0.05887916666666667,-0.392976
6424,5046332,6729,4,0.977993,169,5073418,-1,2000.0,5357208,5363937,310876,6729,42,10,True,True,446.89395,-0.9742080194457476
6425,5046363,260,1,0.255534,169,5073418,-1,500.0,5731059,5731319,684696,260,34,10,True,True,4.095151388888889,-0.22794483502834775
6426,5046749,11,9,0.09025,169,5073418,-1,4500.0,6296995,6297006,1250246,11,19,0,True,True,0.9587875,-0.09025
6427,5046809,257,1,0.822708,169,5073418,-1,500.0,5314008,5314265,267199,257,45,7,True,True,4.430751388888889,-0.822708
6428,5046913,11,32,0.23546,169,5073418,-1,16000.0,5357208,5357219,310295,11,44,0,True,True,6.0412,-0.23546
6429,5047043,14,4,0.210386,169,5073418,-1,2000.0,5335608,5335622,288565,14,46,10,True,True,0.6400333333333333,-0.210386
6430,5047140,22571,16,0.890247,169,5073418,-1,8000.0,5967597,5990168,920457,22571,27,0,True,True,11037.168088888888,-0.8724149288033786
6431,5047202,6,8,0.915891,169,5073418,-1,4000.0,5635916,5635922,588714,6,39,2,True,True,1.0586666666666669,-0.915891
6432,5047254,11,12,0.631353,169,5073418,-1,6000.0,6156721,6156732,1109467,11,26,7,True,True,2.7611833333333338,-0.631353
6433,5048161,10364,23,0.879467,169,5073418,-1,11500.0,6857137,6867501,1808976,10364,13,7,True,True,3680.629465277778,-0.871755620099167
6434,5048205,473,2,0.766741,169,5073418,-1,1000.0,6063397,6063870,1015192,473,28,7,True,True,24.57103611111111,-0.766741
6435,5048623,20,54,0.406289,169,5073418,-1,27000.0,6505326,6505346,1456703,20,18,7,True,True,22.5405,-0.406289
6436,5048678,9806,32,0.033882,169,5073418,-1,16000.0,7109580,7119386,2060902,9806,5,3,True,True,5020.551022222222,-0.03324501652070759
6437,5049119,1583,2,0.866445,169,5073418,-1,1000.0,6870137,6871720,1821018,1583,12,8,True,True,54.51236388888889,-0.866445
6438,5049130,11094,128,0.823198,169,5073418,-1,64000.0,6622043,6633137,1572913,11094,19,1,True,True,27755.11377777778,-0.7934306263414559
6439,5049135,11,80,0.940495,169,5073418,-1,40000.0,5857955,5857966,808820,11,36,10,True,True,11.222444444444445,-0.940495
6440,5049317,7704,256,0.471091,169,5073418,-1,128000.0,7217884,7225588,2168567,7704,3,6,True,True,35542.36302222221,-0.464147561078061
6441,5049589,6,8,0.412961,169,5073418,-1,4000.0,5474482,5474488,424893,6,53,0,True,True,0.6243333333333334,-0.412961
6442,5049619,15133,8,0.841163,169,5073418,-1,4000.0,7094307,7109440,2044688,15133,7,10,True,True,1971.8322666666668,-0.8347779110026241
6443,5049809,7295,16,0.717386,169,5073418,-1,8000.0,5609907,5617202,560098,7295,53,1,True,True,1438.2108222222223,-0.680426240494802
6444,5050464,16097,1,0.876761,169,5073418,-1,500.0,6821437,6837534,1770973,16097,20,3,True,True,251.89434305555557,-0.8638392712259694
6445,5050620,3608,128,0.820241,169,5073418,-1,64000.0,5636911,5640519,586291,3608,50,0,True,True,9846.402488888887,-0.792983623009768
6446,5050703,99,4,0.824401,169,5073418,-1,2000.0,5114598,5114697,63895,99,70,0,True,True,10.48025,-0.824401
6447,5050777,49,2,0.698482,169,5073418,-1,1000.0,5950955,5951004,900178,49,39,7,True,True,2.2254166666666664,-0.698482
6448,5050915,24920,64,0.506335,169,5073418,-1,32000.0,6250475,6275395,1199560,24920,29,1,True,True,26450.072,-0.49195612365281344
6449,5051602,7919,2,0.351856,169,5073418,-1,1000.0,5103798,5111717,52196,7919,74,2,True,True,425.18382777777776,-0.3511587076176767
6450,5051620,4940,16,0.602116,169,5073418,-1,8000.0,6719537,6724477,1667917,4940,22,0,True,True,1622.3671111111112,-0.591137214150911
6451,5051644,11891,128,0.813428,169,5073418,-1,64000.0,5836355,5848246,784711,11891,43,2,True,True,20638.156444444445,-0.8036893503152414
6452,5051662,10,32,0.737786,169,5073418,-1,16000.0,7228689,7228699,2177027,10,2,0,True,True,5.5,-0.737786
6453,5051696,12002,128,0.453262,169,5073418,-1,64000.0,6505326,6517328,1453630,12002,26,0,True,True,31992.412088888887,-0.45070163793639395
6454,5051826,9,28,0.027351,169,5073418,-1,14000.0,6347795,6347804,1295969,9,30,8,True,True,6.32415,-0.027351
6455,5051887,12955,4,0.052099,169,5073418,-1,2000.0,6286195,6299150,1234308,12955,32,9,True,True,509.45899999999995,-0.05169102180583803
6456,5051994,549,1,0.641593,169,5073418,-1,500.0,5604888,5605437,552894,549,65,7,True,True,4.0015374999999995,-0.6100792669704359
6457,5052030,7192,8,0.630156,169,5073418,-1,4000.0,5695359,5702551,643329,7192,56,7,True,True,770.7338555555555,-0.6287063943364254
6458,5052093,9,1,0.791019,169,5073418,-1,500.0,5078818,5078827,26725,9,83,8,True,True,0.19,-0.791019
6459,5053167,300,16,0.136092,169,5073418,-1,8000.0,5706159,5706459,652992,300,56,9,True,True,59.44,-0.136092
6460,5053192,11523,32,0.400662,169,5073418,-1,16000.0,6177721,6189244,1124529,11523,37,3,True,True,7046.0088,-0.3991858564346729
6461,5053311,60,4,0.628296,169,5073418,-1,2000.0,5761355,5761415,708044,60,51,6,True,True,2.643666666666667,-0.628296
6462,5053321,42,1,0.313722,169,5073418,-1,500.0,5958555,5958597,905234,42,45,0,True,True,0.8388916666666667,-0.313722
6463,5053390,9387,32,0.082232,169,5073418,-1,16000.0,7065705,7075092,2012315,9387,12,8,True,True,4364.036,-0.08140178327143233
6464,5053409,409,1,0.157822,169,5073418,-1,500.0,6619826,6620235,1566417,409,26,6,True,True,9.091729166666667,-0.157822
6465,5053471,669,40,0.516366,169,5073418,-1,20000.0,5079918,5080587,26447,669,89,6,True,True,552.1851666666666,-0.516366
6466,5053478,1370,4,0.969665,169,5073418,-1,2000.0,5608488,5609858,555010,1370,72,2,True,True,57.9345,-0.8969409636074307
6467,5053524,4,1,0.830621,169,5073418,-1,500.0,6069897,6069901,1016373,4,44,8,True,True,0.09854444444444445,-0.830621
6468,5053546,607,1,0.763163,169,5073418,-1,500.0,6120221,6120828,1066675,607,44,1,True,True,9.02322361111111,-0.763163
6469,5053558,18448,160,0.84696,169,5073418,-1,80000.0,5645911,5664359,592353,18448,67,8,True,True,59246.44222222222,-0.8275773820104066
6470,5053616,14,16,0.685753,169,5073418,-1,8000.0,5103718,5103732,50102,14,93,7,True,True,5.811555555555556,-0.685753
6471,5053649,94,1,0.792642,169,5073418,-1,500.0,6503126,6503220,1449477,94,30,0,True,True,2.2182694444444446,-0.792642
6472,5053681,194,8,0.319399,169,5073418,-1,4000.0,6296995,6297189,1243314,194,34,0,True,True,15.03068888888889,-0.319399
6473,5053696,1791,8,0.478365,169,5073418,-1,4000.0,5430182,5431973,376486,1791,80,1,True,True,177.3488,-0.478365
6474,5054011,14447,128,0.735172,169,5073418,-1,64000.0,6870137,6884584,1816126,14447,16,0,True,True,33270.36355555555,-0.7346681354887707
6475,5054052,7887,29,0.26068,169,5073418,-1,14500.0,7228877,7236764,2174825,7887,2,1,True,True,4122.832004166667,-0.2548546424465706
6476,5054099,10840,32,0.687467,169,5073418,-1,16000.0,6248254,6259094,1194155,10840,41,7,True,True,5229.409511111111,-0.6726029206445496
6477,5054492,21,8,0.826769,169,5073418,-1,4000.0,6250454,6250475,1195962,21,41,7,True,True,2.4231666666666665,-0.826769
6478,5055358,13301,128,0.799529,169,5073418,-1,64000.0,5948755,5962056,893397,13301,58,12,True,True,38382.450844444444,-0.7139355812090212
6479,5055377,15508,140,0.198664,169,5073418,-1,70000.0,6076874,6092382,1021497,15508,51,2,True,True,46438.30061111111,-0.19739533504410814
6480,5055439,17,16,0.414496,169,5073418,-1,8000.0,6622026,6622043,1566587,17,28,7,True,True,5.4702222222222225,-0.414496
6481,5055712,8,16,0.181889,169,5073418,-1,8000.0,6219054,6219062,1163342,8,44,2,True,True,2.0903111111111112,-0.181889
6482,5055757,3,8,0.87639,169,5073418,-1,4000.0,6215454,6215457,1159697,3,45,8,True,True,0.39020000000000005,-0.87639
6483,5055783,1034,4,0.944757,169,5073418,-1,2000.0,5357208,5358242,301425,1034,92,0,True,True,70.9841,-0.944757
6484,5056411,109,2,0.884341,169,5073418,-1,1000.0,6098474,6098583,1042063,109,54,10,True,True,3.918247222222222,-0.884341
6485,5056458,266,9,0.224487,169,5073418,-1,4500.0,5733259,5733525,676801,266,73,7,True,True,42.270725,-0.224487
6486,5056472,345,8,0.948109,169,5073418,-1,4000.0,5207630,5207975,151158,345,100,2,True,True,53.42516666666667,-0.948109
6487,5056902,18,10,0.923112,169,5073418,-1,5000.0,5170498,5170516,113596,18,103,6,True,True,5.237,-0.9231120000000003
6488,5057043,9038,32,0.647107,169,5073418,-1,16000.0,6319695,6328733,1262652,9038,37,6,True,True,6655.243422222222,-0.6460337312525953
6489,5058075,16,1,0.626627,169,5073418,-1,500.0,7048337,7048353,1990262,16,17,8,True,True,0.2695777777777778,-0.626627
6490,5058146,12,7,0.906845,169,5073418,-1,3500.0,5474482,5474494,416336,12,93,6,True,True,1.0925833333333335,-0.906845
6491,5058434,553,4,0.974128,169,5073418,-1,2000.0,5381008,5381561,322574,553,97,7,True,True,45.674727777777775,-0.974128
6492,5058632,386,1,0.198266,169,5073418,-1,500.0,6210054,6210440,1151422,386,48,7,True,True,5.9599472222222225,-0.198266
6493,5058801,18,16,0.701261,169,5073418,-1,8000.0,6384895,6384913,1326094,18,37,10,True,True,4.8584,-0.701261
6494,5058827,10593,1,0.168756,169,5073418,-1,500.0,6833337,6843930,1774510,10593,24,9,True,True,159.78108749999998,-0.1683011749111007
6495,5058866,27,16,0.401035,169,5073418,-1,8000.0,6098474,6098501,1039608,27,59,0,True,True,7.7646,-0.401035
6496,5058919,16733,1,0.428903,169,5073418,-1,500.0,5602688,5619421,543769,16733,96,9,True,True,177.60569305555555,-0.42612753152601945
6497,5058961,39,1,0.260158,169,5073418,-1,500.0,5430143,5430182,371182,39,100,0,True,True,0.48273333333333335,-0.260158
6498,5059497,36,30,0.089061,169,5073418,-1,15000.0,7042937,7042973,1983440,36,18,12,True,True,18.8715,-0.089061
6499,5059573,159,16,0.36792,169,5073418,-1,8000.0,6956537,6956696,1896964,159,19,12,True,True,43.604866666666666,-0.36792
6500,5059943,270,8,0.947244,169,5073418,-1,4000.0,6272075,6272345,1212132,270,47,2,True,True,39.141,-0.947244
6501,5059974,12,1,0.117351,169,5073418,-1,500.0,6618726,6618738,1558752,12,34,8,True,True,0.26675000000000004,-0.117351
6502,5060092,437,64,0.718583,169,5073418,-1,32000.0,5640511,5640948,580419,437,91,1,True,True,591.445511111111,-0.718583
6503,5060119,11,3,0.435159,169,5073418,-1,1500.0,5378808,5378819,318689,11,109,10,True,True,0.6814041666666666,-0.435159
6504,5060145,147,4,0.919989,169,5073418,-1,2000.0,6120074,6120221,1059929,147,63,10,True,True,8.740783333333333,-0.919989
6505,5060291,12470,16,0.453708,169,5073418,-1,8000.0,7060237,7072707,1999946,12470,16,0,True,True,2857.878288888889,-0.4503618277492483
6506,5060401,102,1,0.67361,169,5073418,-1,500.0,5566688,5566790,506287,102,104,7,True,True,1.3607083333333332,-0.67361
6507,5060515,81,1,0.118512,169,5073418,-1,500.0,5609858,5609939,549343,81,100,0,True,True,0.9257625,-0.118512
6508,5064225,9,1,0.713564,169,5073418,-1,500.0,6359695,6359704,1295470,9,43,8,True,True,0.1294375,-0.713564
6509,5064232,10831,16,0.190544,169,5073418,-1,8000.0,5202930,5213761,138698,10831,123,9,True,True,3357.445955555556,-0.18708662682357022
6510,5064330,156,2,0.861937,169,5073418,-1,1000.0,7228721,7228877,2164391,156,3,2,True,True,5.398005555555555,-0.8561593139804006
6511,5064361,26471,64,0.782122,169,5073418,-1,32000.0,6073497,6099968,1009136,26471,70,2,True,True,36309.53742222222,-0.7737944234104209
6512,5064423,8,16,0.287962,169,5073418,-1,8000.0,7108407,7108415,2043984,8,10,7,True,True,2.0869333333333335,-0.287962
6513,5064462,9,1,0.494168,169,5073418,-1,500.0,5169398,5169407,104936,9,129,2,True,True,0.19435,-0.494168
6514,5064563,1019,21,0.130199,169,5073418,-1,10500.0,5740859,5741878,676296,1019,89,0,True,True,393.41467083333333,-0.130199
6515,5064589,14234,128,0.856338,169,5073418,-1,64000.0,5748459,5762693,683870,14234,88,8,True,True,18314.840177777776,-0.7859245566985144
6516,5064614,13897,4,0.600083,169,5073418,-1,2000.0,6408713,6422610,1344099,13897,44,7,True,True,1860.2616500000001,-0.549708197146773
6517,5064685,14,8,0.995207,169,5073418,-1,4000.0,5958597,5958611,893912,14,77,1,True,True,2.2370444444444444,-0.995207
6518,5064931,36,2,0.282967,169,5073418,-1,1000.0,6500913,6500949,1435982,36,42,2,True,True,1.6946,-0.282967
6519,5064959,9070,16,0.677189,169,5073418,-1,8000.0,5708359,5717429,643400,9070,97,7,True,True,1807.6715555555554,-0.6766657697853729
6520,5065030,92,1,0.418331,169,5073418,-1,500.0,5859055,5859147,794025,92,83,6,True,True,1.1732555555555555,-0.418331
6521,5065053,8649,5,0.408524,169,5073418,-1,2500.0,5118198,5126847,53145,8649,140,2,True,True,1173.9965208333335,-0.3857062638381278
6522,5065866,10726,1,0.145943,169,5073418,-1,500.0,6817837,6828563,1751971,10726,33,9,True,True,173.3015611111111,-0.1436682365673159
6523,5066942,114,32,0.290193,169,5073418,-1,16000.0,5209830,5209944,142888,114,132,7,True,True,71.96186666666668,-0.290193
6524,5067190,7978,1,0.261799,169,5073418,-1,500.0,5296230,5304208,229040,7978,132,12,True,True,176.33923055555556,-0.25859787073164225
6525,5067817,271,1,0.61768,169,5073418,-1,500.0,6348895,6349166,1281078,271,49,6,True,True,6.800970833333333,-0.61768
6526,5067939,8,2,0.907328,169,5073418,-1,1000.0,6296995,6297003,1229056,8,54,9,True,True,0.15495555555555557,-0.907328
6527,5068033,7742,128,0.369638,169,5073418,-1,64000.0,5474488,5482230,406455,7742,120,1,True,True,13007.287111111113,-0.36409136590631846
6528,5068245,1090,16,0.684267,169,5073418,-1,8000.0,5862355,5863445,794110,1090,86,6,True,True,219.91355555555555,-0.684267
6529,5068303,4704,1,0.458164,169,5073418,-1,500.0,7095407,7100111,2027104,4704,11,6,True,True,77.38673055555554,-0.45264898605706594
6530,5068311,8315,32,0.01032,169,5073418,-1,16000.0,6268475,6276790,1200164,8315,59,9,True,True,4785.108666666667,-0.010190772626581298
6531,5068393,5,1,0.133205,169,5073418,-1,500.0,5962197,5962202,893804,5,83,3,True,True,0.1435486111111111,-0.133205
6532,5068451,6988,8,0.323246,169,5073418,-1,4000.0,5473382,5480370,404931,6988,127,11,True,True,743.7562222222223,-0.32073448135504584
6533,5068510,404,1,0.693024,169,5073418,-1,500.0,5384308,5384712,315798,404,131,7,True,True,7.812911111111112,-0.693024
6534,5068560,16577,16,0.686852,169,5073418,-1,8000.0,5604888,5621465,536328,16577,121,0,True,True,3123.175311111111,-0.6367352767267629
6535,5070297,55,8,0.713336,169,5073418,-1,4000.0,6805937,6805992,1735640,55,35,12,True,True,7.356555555555555,-0.713336
6536,5070488,21,16,0.708453,169,5073418,-1,8000.0,5311808,5311829,241320,21,142,6,True,True,6.655600000000001,-0.708453
6537,5070530,24,64,0.736104,169,5073418,-1,32000.0,5735459,5735483,664929,24,103,7,True,True,29.058133333333338,-0.736104
6538,5070562,127,3,0.256226,169,5073418,-1,1500.0,5632316,5632443,561754,127,116,1,True,True,8.042804166666667,-0.256226
6539,5070647,163,16,0.095279,169,5073418,-1,8000.0,5101518,5101681,30871,163,162,10,True,True,67.66311111111112,-0.095279
6540,5070842,18,2,0.058752,169,5073418,-1,1000.0,7228877,7228895,2158035,18,1,0,True,True,0.62705,-0.058752
6541,5071043,9435,128,0.332863,169,5073418,-1,64000.0,6354295,6363730,1283252,9435,52,8,True,True,18767.645333333334,-0.3300436015418736
6542,5071157,12,2,0.234841,169,5073418,-1,1000.0,6319695,6319707,1248538,12,55,0,True,True,0.4748666666666667,-0.234841
6543,5071348,14173,32,0.908227,169,5073418,-1,16000.0,7095407,7109580,2024059,14173,12,0,True,True,7373.313955555555,-0.8981592739844579
6544,5075723,4,5,0.996739,178,5078818,-1,2500.0,5626516,5626520,550793,4,121,0,True,True,0.3478333333333333,-0.996739
6545,5075965,6144,4,0.939322,178,5078818,-1,2000.0,7206812,7212956,2130847,6144,8,12,True,True,466.4326,-0.9312154285317134
6546,5075987,14922,11,0.96721,178,5078818,-1,5500.0,5170516,5185438,94529,14922,158,1,True,True,5162.669600000001,-0.950355309666575
6547,5076045,16635,1,0.598232,178,5078818,-1,500.0,6342395,6359030,1266350,16635,57,6,True,True,358.14811111111106,-0.5673780120512598
6548,5076650,191,16,0.748242,178,5078818,-1,8000.0,6153421,6153612,1076771,191,80,3,True,True,63.97226666666667,-0.748242
6549,5077402,8956,1,0.045512,178,5078818,-1,500.0,5685959,5694915,608557,8956,118,10,True,True,127.13825416666666,-0.04479262460655708
6550,5077548,1352,24,0.253657,178,5078818,-1,12000.0,5298430,5299782,220882,1352,155,7,True,True,710.4794666666667,-0.24403015299181816
6551,5077564,570,1,0.619658,178,5078818,-1,500.0,6061197,6061767,983633,570,89,12,True,True,16.438958333333332,-0.619658
6552,5077611,21,1,0.302507,178,5078818,-1,500.0,6254075,6254096,1176464,21,67,2,True,True,0.32911666666666667,-0.302507
6553,5078099,8601,32,0.394697,178,5078818,-1,16000.0,5310708,5319309,232609,8601,156,6,True,True,4922.0887999999995,-0.38849781697360664
6554,5080001,6699,16,0.370901,205,5101518,-1,8000.0,7210412,7217111,2130411,6699,8,1,True,True,1968.1320666666666,-0.3602979192033384
6555,5080498,12679,4,0.968058,205,5101518,-1,2000.0,6859337,6872016,1778839,12679,32,7,True,True,812.6091611111111,-0.9643162829809185
6556,5080698,22,8,0.55956,205,5101518,-1,4000.0,5649511,5649533,568813,22,124,1,True,True,3.2736,-0.55956
6557,5080742,9657,4,0.580487,205,5101518,-1,2000.0,5709459,5719116,628717,9657,118,6,True,True,480.0567333333333,-0.5789353151252652
6558,5080766,5194,9,0.260292,205,5101518,-1,4500.0,6257675,6262869,1176909,5194,69,3,True,True,764.6142625,-0.2588133161825152
6559,5080810,21,1,0.503747,205,5101518,-1,500.0,7215812,7215833,2135002,21,8,8,True,True,0.3844458333333334,-0.503747
6560,5080885,14224,7,0.930327,205,5101518,-1,3500.0,5971197,5985421,890312,14224,96,2,True,True,2922.287277777778,-0.8565840715507183
6561,5080936,29582,64,0.877897,205,5101518,-1,32000.0,5430143,5459725,349207,29582,152,7,True,True,23929.20524444444,-0.8724158090305862
6562,5081138,12826,2,0.13192,205,5101518,-1,1000.0,6384913,6397739,1303775,12826,55,1,True,True,549.6539194444445,-0.1213737194196627
6563,5081581,2,1,0.317317,205,5101518,-1,500.0,6174121,6174123,1092540,2,82,7,True,True,0.03903888888888889,-0.317317
6564,5082006,14,128,0.530424,205,5101518,-1,64000.0,5192116,5192130,110110,14,175,10,True,True,31.60391111111111,-0.530424
6565,5083355,53,1,0.141796,205,5101518,-1,500.0,6406513,6406566,1323158,53,55,10,True,True,1.6954847222222222,-0.141796
6566,5085337,14785,1,0.116842,205,5101518,-1,500.0,5763555,5778340,678218,14785,113,0,True,True,183.69813194444444,-0.1087890570536622
6567,5086109,6977,1,0.044162,205,5101518,-1,500.0,6069897,6076874,983788,6977,95,0,True,True,187.9078027777778,-0.043832407512201035
6568,5089938,60780,1,0.127871,205,5101518,-1,500.0,6120074,6180854,1030136,60780,90,0,True,True,1166.760863888889,-0.12759861141347137
6569,5090018,12981,16,0.87168,205,5101518,-1,8000.0,7228689,7241670,2138671,12981,5,0,True,True,3780.575,-0.8657158350450733
6570,5091684,9524,128,0.834804,205,5101518,-1,64000.0,6064497,6074021,972813,9524,99,6,True,True,30296.47271111111,-0.7735330371557037
6571,5094406,6929,64,0.747823,205,5101518,-1,32000.0,5114598,5121527,20192,6929,189,0,True,True,12865.88551111111,-0.7366904554845793
6572,5095444,3,1,0.926237,205,5101518,-1,500.0,7060237,7060240,1964793,3,26,9,True,True,0.04114583333333333,-0.926237
6573,5095553,8195,223,0.282926,205,5101518,-1,111500.0,5628716,5636911,533163,8195,143,7,True,True,38395.25047777778,-0.27949604190270244
6574,5096599,12262,1,0.876936,205,5101518,-1,500.0,6613326,6625588,1516727,12262,50,12,True,True,261.52278333333334,-0.872566337880999
6575,5096743,32,8,0.612932,205,5101518,-1,4000.0,7228689,7228721,2131946,32,7,1,True,True,4.4,-0.612932
6576,5097070,5,32,0.761564,205,5101518,-1,16000.0,5967597,5967602,870527,5,108,8,True,True,5.259555555555556,-0.761564
6577,5100341,7807,1,0.263758,205,5101518,-1,500.0,6186254,6194061,1085913,7807,84,8,True,True,129.4035736111111,-0.250461819948466
6578,5100628,80,2,0.31301,205,5101518,-1,1000.0,5103718,5103798,3090,80,199,0,True,True,4.151111111111112,-0.31301
6579,5100698,194,1,0.892672,205,5101518,-1,500.0,6719537,6719731,1618839,194,46,12,True,True,4.107141666666667,-0.892672
6580,5100889,10353,16,0.315543,205,5101518,-1,8000.0,6363295,6373648,1262406,10353,63,2,True,True,2272.655022222222,-0.3114391747803195
6581,5100985,72,32,0.994565,205,5101518,-1,16000.0,6122421,6122493,1021436,72,96,7,True,True,34.2496,-0.994565
6582,5101113,67,1,0.763675,205,5101518,-1,500.0,6341295,6341362,1240182,67,69,0,True,True,1.5519805555555555,-0.763675
6583,5101574,67,1,0.151265,207,5103718,-1,500.0,5787355,5787422,685781,67,125,10,True,True,0.7100138888888888,-0.151265
6584,5101901,4297,16,0.853034,207,5103718,-1,8000.0,5830555,5834852,728654,4297,125,11,True,True,828.6381777777779,-0.8444930933953079
6585,5102944,20125,156,0.657419,207,5103718,-1,78000.0,5161398,5181523,58454,20125,200,11,True,True,81386.56045,-0.6081313513228209
6586,5128242,32,1,0.79822,235,5161398,-1,500.0,6149821,6149853,1021579,32,97,1,True,True,0.6292,-0.79822
6587,5128271,14108,1,0.053222,235,5161398,-1,500.0,5478088,5492196,349817,14108,167,2,True,True,161.73575555555558,-0.05010391608531722
6588,5128407,7,4,0.148621,235,5161398,-1,2000.0,5615707,5615714,487300,7,158,7,True,True,0.35163333333333335,-0.148621
6589,5130887,635,3,0.229861,235,5161398,-1,1500.0,6246054,6246689,1115167,635,84,10,True,True,25.5031875,-0.22986100000000007
6590,5130920,8067,4,0.035862,235,5161398,-1,2000.0,6158921,6166988,1028001,8067,96,7,True,True,653.5143055555557,-0.03504737361747254
6591,5131077,16965,3,0.260224,235,5161398,-1,1500.0,5958555,5975520,827478,16965,120,7,True,True,1552.1829375,-0.2583376252858789
6592,5131166,38503,256,0.705963,235,5161398,-1,128000.0,6633137,6671640,1501971,38503,47,6,True,True,240233.63022222221,-0.682779989946661
6593,5131444,11072,64,0.43643,235,5161398,-1,32000.0,7206812,7217884,2075368,11072,12,0,True,True,13235.245155555556,-0.43325757233758116
6594,5131824,305,8,0.995202,235,5161398,-1,4000.0,6341295,6341600,1209471,305,72,10,True,True,56.51988888888889,-0.995202
6595,5131858,6,2,0.927206,235,5161398,-1,1000.0,6503126,6503132,1371268,6,58,2,True,True,0.28318333333333334,-0.927206
6596,5132001,31,1,0.040792,235,5161398,-1,500.0,5751255,5751286,619254,31,140,2,True,True,0.3217972222222222,-0.040792
6597,5132627,12,2,0.35652,235,5161398,-1,1000.0,5689559,5689571,556932,12,154,1,True,True,0.33483333333333337,-0.35652
6598,5132646,11,32,0.709029,235,5161398,-1,16000.0,5591888,5591899,459242,11,176,1,True,True,2.5314666666666668,-0.709029
6599,5132768,63,4,0.4852,235,5161398,-1,2000.0,7072707,7072770,1939939,63,21,2,True,True,3.7149000000000005,-0.4852
6600,5137437,8,32,0.492989,235,5161398,-1,16000.0,5740859,5740867,603422,8,146,8,True,True,4.706488888888889,-0.492989
6601,5137751,372,4,0.845838,235,5161398,-1,2000.0,6224454,6224826,1086703,372,90,8,True,True,24.242,-0.845838
6602,5137821,23,16,0.866879,235,5161398,-1,8000.0,5304208,5304231,166387,23,201,1,True,True,8.183911111111112,-0.866879
6603,5138159,13620,64,0.123654,235,5161398,-1,32000.0,6807037,6820657,1668878,13620,46,6,True,True,14419.637599999998,-0.12296094671772366
6604,5138310,12092,4,0.093578,235,5161398,-1,2000.0,6844137,6856229,1705827,12092,41,9,True,True,702.2470388888889,-0.09285952992064528
6605,5138315,44,8,0.868173,235,5161398,-1,4000.0,5763555,5763599,625240,44,141,7,True,True,3.8773777777777783,-0.868173
6606,5138352,14077,1,0.180655,235,5161398,-1,500.0,5588288,5602365,449936,14077,183,10,True,True,106.9436361111111,-0.17530383061406277
6607,5138365,14606,4,0.168295,235,5161398,-1,2000.0,6146221,6160827,1007856,14606,108,10,True,True,1186.4783,-0.1662482617446613
6608,5138746,14222,1,0.508738,235,5161398,-1,500.0,5861255,5875477,722509,14222,134,7,True,True,182.8617111111111,-0.4984679211006789
6609,5138845,10425,128,0.272792,235,5161398,-1,64000.0,7106207,7116632,1967362,10425,18,9,True,True,21745.407288888888,-0.27237340357870105
6610,5138867,11468,128,0.890895,235,5161398,-1,64000.0,6124621,6136089,985754,11468,110,7,True,True,26966.702222222222,-0.8679752981017355
6611,5138915,3,51,0.585677,235,5161398,-1,25500.0,5564488,5564491,425573,3,189,12,True,True,2.03575,-0.585677
6612,5138991,9793,86,0.583547,235,5161398,-1,43000.0,5309608,5319401,170617,9793,210,8,True,True,15253.986027777779,-0.5454829063081412
6613,5139051,14,8,0.971627,235,5161398,-1,4000.0,6318595,6318609,1179544,14,80,10,True,True,2.2160444444444445,-0.971627
6614,5139119,21313,8,0.526015,235,5161398,-1,4000.0,6207854,6229167,1068735,21313,98,10,True,True,2797.4699333333333,-0.518223441481307
6615,5139199,13858,1,0.570788,235,5161398,-1,500.0,5974797,5988655,835598,13858,126,4,True,True,393.09204027777776,-0.5663272065165672
6616,5139261,25,2,0.416419,235,5161398,-1,1000.0,6154521,6154546,1015260,25,109,6,True,True,1.0466666666666666,-0.416419
6617,5139386,84,16,0.076835,235,5161398,-1,8000.0,6497313,6497397,1357927,84,64,7,True,True,37.33146666666667,-0.076835
6618,5139411,23,2,0.768253,235,5161398,-1,1000.0,6063397,6063420,923986,23,126,0,True,True,1.194786111111111,-0.768253
6619,5139460,37,1,0.676909,235,5161398,-1,500.0,6526926,6526963,1387466,37,59,10,True,True,0.7573694444444444,-0.676909
6620,5140670,18710,8,0.887368,235,5161398,-1,4000.0,5164698,5183408,24028,18710,232,0,True,True,4227.640333333334,-0.8710772049018036
8062,6358221,342,32,0.360206,1,6358221,-1,16000.0,6360421,6360763,2200,342,0,7,True,True,136.5112,-0.360206
8063,6358266,92,20,0.045754,9,6360421,-1,10000.0,6385321,6385413,27055,92,0,10,True,True,16.43988888888889,-0.045754
8064,6358282,6,2,0.807558,9,6360421,-1,1000.0,6362621,6362627,4339,6,1,7,True,True,0.1586,-0.807558
8065,6358418,23,9,0.325525,9,6360421,-1,4500.0,6363721,6363744,5303,23,1,0,True,True,2.73585,-0.325525
8066,6358437,80,1,0.444306,9,6360421,-1,500.0,6363721,6363801,5284,80,2,6,True,True,1.0573333333333332,-0.444306
8067,6358476,4851,256,0.606763,9,6360421,-1,128000.0,7646807,7651658,1288331,4851,0,7,True,True,39242.356977777774,-0.6037329499777485
8068,6360282,60,1,0.400165,9,6360421,-1,500.0,7389312,7389372,1029030,60,1,0,True,True,1.3412499999999998,-0.400165
8069,6360357,119,32,0.612592,9,6360421,-1,16000.0,6390721,6390840,30364,119,2,8,True,True,32.19875555555556,-0.612592
8070,6360389,6848,16,0.081369,9,6360421,-1,8000.0,8531115,8537963,2170726,6848,0,2,True,True,1799.3445777777779,-0.07319563601879162
8071,6360402,49,8,0.427916,9,6360421,-1,4000.0,6475770,6475819,115368,49,3,2,True,True,4.970777777777777,-0.427916
8072,6360462,15084,128,0.931483,17,6362621,-1,64000.0,6456970,6472054,96508,15084,4,10,True,True,32789.64551111111,-0.825759799915442
8073,6360498,7,1,0.930845,17,6362621,-1,500.0,8323704,8323711,1963206,7,1,10,True,True,0.15778194444444443,-0.930845
8074,6360556,11,8,0.986871,17,6362621,-1,4000.0,6955493,6955504,594937,11,4,9,True,True,1.7707555555555556,-0.986871
8075,6360573,29,16,0.8571,17,6362621,-1,8000.0,7631484,7631513,1270911,29,3,0,True,True,17.824688888888886,-0.8571
8076,6360604,29,1,0.905203,17,6362621,-1,500.0,7179221,7179250,818617,29,5,7,True,True,0.09449166666666667,-0.905203
8077,6361175,6398,8,0.734278,17,6362621,-1,4000.0,8567915,8574313,2206740,6398,0,3,True,True,541.3594333333333,-0.6673526462859912
8078,6361220,21,4,0.293863,17,6362621,-1,2000.0,7435872,7435893,1074652,21,5,0,True,True,1.6572500000000001,-0.293863
8079,6361398,70,10,0.195077,17,6362621,-1,5000.0,8781840,8781910,2420442,70,0,0,True,True,13.521666666666668,-0.195077
8080,6361540,15,1,0.143161,17,6362621,-1,500.0,6459170,6459185,97630,15,11,0,True,True,0.3560416666666667,-0.143161
8081,6366417,26,8,0.520054,49,6385321,-1,4000.0,8222104,8222130,1855687,26,4,8,True,True,1.174622222222222,-0.520054
8082,6366489,53,2,0.571893,49,6385321,-1,1000.0,7716003,7716056,1349514,53,5,7,True,True,0.6323194444444444,-0.571893
8083,6366594,21937,8,0.856803,49,6385321,-1,4000.0,6459170,6481107,92576,21937,14,7,True,True,2511.014055555556,-0.8085432049303032
8084,6368106,42,1,0.504637,49,6385321,-1,500.0,6620870,6620912,252764,42,12,10,True,True,0.8863166666666666,-0.504637
8085,6368627,17831,40,0.127861,49,6385321,-1,20000.0,7841524,7859355,1472897,17831,5,6,True,True,6183.931222222223,-0.12470665028529716
8086,6368649,17,16,0.796821,49,6385321,-1,8000.0,7895353,7895370,1526704,17,5,11,True,True,2.451022222222222,-0.796821
8087,6368969,47,8,0.301348,49,6385321,-1,4000.0,6433921,6433968,64952,47,19,11,True,True,5.601355555555556,-0.301348
8088,6369032,435,8,0.673062,49,6385321,-1,4000.0,6998693,6999128,629661,435,13,0,True,True,47.3425,-0.673062
8089,6369063,6,16,0.548747,49,6385321,-1,8000.0,7389312,7389318,1020249,6,12,3,True,True,2.146,-0.548747
8090,6369358,62,16,0.874786,49,6385321,-1,8000.0,8195104,8195166,1825746,62,5,9,True,True,17.8932,-0.874786
8091,6369380,5642,2,0.168053,49,6385321,-1,1000.0,7391572,7397214,1022192,5642,12,7,True,True,211.28337222222223,-0.16448026154120693
8092,6369945,13,1,0.446287,49,6385321,-1,500.0,6435370,6435383,65425,13,23,1,True,True,0.19366388888888889,-0.446287
8093,6370044,10,4,0.115679,49,6385321,-1,2000.0,6678470,6678480,308426,10,18,1,True,True,0.4424444444444445,-0.115679
8094,6370359,41,4,0.662642,49,6385321,-1,2000.0,8564315,8564356,2193956,41,2,7,True,True,2.1773277777777778,-0.662642
8095,6370436,80,1,0.240902,49,6385321,-1,500.0,8571515,8571595,2201079,80,1,1,True,True,0.9836666666666667,-0.240902
8096,6370648,4,64,0.211641,49,6385321,-1,32000.0,7063493,7063497,692845,4,18,10,True,True,2.030222222222222,-0.211641
8097,6370678,7258,32,0.753253,49,6385321,-1,16000.0,7501884,7509142,1131206,7258,13,0,True,True,4556.640355555555,-0.7318645430104085
8098,6370994,8385,8,0.659745,49,6385321,-1,4000.0,7848553,7856938,1477559,8385,9,6,True,True,571.1173555555556,-0.6542476866413139
8099,6371303,23,8,0.089432,49,6385321,-1,4000.0,6433921,6433944,62618,23,30,0,True,True,2.741088888888889,-0.089432
8100,6371759,2185,2,0.434893,49,6385321,-1,1000.0,6550670,6552855,178911,2185,25,3,True,True,72.9768888888889,-0.43001662540045765
8101,6376479,24,8,0.715765,49,6385321,-1,4000.0,8617537,8617561,2241058,24,1,8,True,True,1.7402666666666669,-0.715765
8102,6376561,701,25,0.160235,49,6385321,-1,12500.0,8633745,8634446,2257184,701,1,9,True,True,145.895625,-0.160235
8103,6376661,203,32,0.928967,49,6385321,-1,16000.0,7065695,7065898,689034,203,22,6,True,True,51.51688888888889,-0.928967
8104,6376712,103,5,0.902649,49,6385321,-1,2500.0,6518970,6519073,142258,103,29,11,True,True,5.861701388888889,-0.902649
8105,6376806,18812,256,0.766309,49,6385321,-1,128000.0,7287221,7306033,910415,18812,21,12,True,True,82287.9416888889,-0.7420487360583341
8106,6377084,7,2,0.220376,49,6385321,-1,1000.0,8534715,8534722,2157631,7,6,3,True,True,0.23140833333333333,-0.220376
8107,6377095,11908,32,0.257629,49,6385321,-1,16000.0,8771040,8782948,2393945,11908,1,10,True,True,8777.627733333333,-0.2507972425253626
8108,6377131,47,4,0.476302,49,6385321,-1,2000.0,7041893,7041940,664762,47,27,11,True,True,1.5755444444444446,-0.476302
8109,6378238,10,1,0.897511,49,6385321,-1,500.0,6998693,6998703,620455,10,29,11,True,True,0.13604166666666667,-0.897511
8110,6378720,26,11,0.123098,49,6385321,-1,5500.0,7389372,7389398,1010652,26,21,2,True,True,6.393291666666666,-0.123098
8111,6378935,136,8,0.135756,49,6385321,-1,4000.0,6784770,6784906,405835,136,32,9,True,True,9.164888888888889,-0.135756
8112,6378951,139,64,0.534543,49,6385321,-1,32000.0,8325904,8326043,1946953,139,9,7,True,True,200.5183111111111,-0.534543
8113,6379393,5,2,0.725414,49,6385321,-1,1000.0,8735345,8735350,2355952,5,2,9,True,True,0.08940277777777779,-0.725414
8114,6379472,188,16,0.090442,49,6385321,-1,8000.0,8562115,8562303,2182643,188,8,6,True,True,39.93537777777778,-0.090442
8115,6380095,12873,4,0.691785,49,6385321,-1,2000.0,8403193,8416066,2023098,12873,11,1,True,True,797.8120166666666,-0.6693157617628057
8116,6391925,24763,3,0.871941,97,6433921,-1,1500.0,8531115,8555878,2139190,24763,10,0,True,True,1146.08905,-0.8282051426252343
8117,6393083,6,2,0.93178,97,6433921,-1,1000.0,7308821,7308827,915738,6,29,10,True,True,0.22208333333333335,-0.93178
8118,6402404,10865,16,0.766337,97,6433921,-1,8000.0,6770670,6781535,368266,10865,39,12,True,True,994.1543333333334,-0.7265757020211236
8119,6402494,34078,256,0.600679,97,6433921,-1,128000.0,7467806,7501884,1065312,34078,24,6,True,True,154516.62293333333,-0.5958405599100586
8120,6402669,20,1,0.643987,97,6433921,-1,500.0,8556315,8556335,2153646,20,9,10,True,True,0.24108333333333337,-0.643987
8121,6404470,327,1,0.37701,97,6433921,-1,500.0,8722345,8722672,2317875,327,3,7,True,True,2.6001041666666667,-0.37701
8122,6405043,16695,8,0.717443,97,6433921,-1,4000.0,7852153,7868848,1447110,16695,20,5,True,True,961.8611999999999,-0.7020644744583672
8123,6405474,12420,141,0.736002,97,6433921,-1,70500.0,8603615,8616035,2198141,12420,6,6,True,True,26842.562645833335,-0.7040676874043692
8124,6405788,47,4,0.381651,97,6433921,-1,2000.0,8603837,8603884,2198049,47,6,1,True,True,2.7852722222222224,-0.381651
8125,6406712,10245,128,0.642102,97,6433921,-1,64000.0,8227904,8238149,1821192,10245,19,2,True,True,12657.737955555556,-0.5301655102488225
8126,6406866,2,4,0.5619,97,6433921,-1,2000.0,7837124,7837126,1430258,2,26,1,True,True,0.1092,-0.5619
8127,6409679,62,16,0.856141,97,6433921,-1,8000.0,7806803,7806865,1397124,62,27,6,True,True,15.203777777777777,-0.856141
8128,6411880,3461,4,0.808447,97,6433921,-1,2000.0,6684270,6687731,272390,3461,49,6,True,True,353.6878611111111,-0.7433683365536108
8129,6412361,433,2,0.223551,97,6433921,-1,1000.0,6468570,6469003,56209,433,55,7,True,True,9.9157,-0.223551
8130,6412410,16,2,0.11569,97,6433921,-1,1000.0,6475770,6475786,63360,16,54,0,True,True,0.40577777777777774,-0.11569
8131,6412419,8503,32,0.08768,97,6433921,-1,16000.0,6770670,6779173,358251,8503,48,0,True,True,1535.7494666666666,-0.08063096866972601
8132,6412478,35,4,0.089139,97,6433921,-1,2000.0,6683170,6683205,270692,35,51,6,True,True,2.724555555555556,-0.089139
8133,6413657,15493,8,0.740581,97,6433921,-1,4000.0,6998693,7014186,585036,15493,45,0,True,True,1485.9202333333335,-0.7152334897454323
8134,6413715,7,1,0.937211,97,6433921,-1,500.0,8612137,8612144,2198422,7,6,6,True,True,0.11704583333333334,-0.937211
8135,6413904,35,5,0.744618,97,6433921,-1,2500.0,8342204,8342239,1928300,35,18,7,True,True,3.3789583333333337,-0.744618
8136,6414290,126,1,0.116106,97,6433921,-1,500.0,8782940,8783066,2368650,126,0,6,True,True,2.4339000000000004,-0.116106
8137,6414603,58,4,0.367737,97,6433921,-1,2000.0,6806370,6806428,391767,58,51,10,True,True,1.1783666666666666,-0.367737
8138,6421226,22,8,0.85333,97,6433921,-1,4000.0,8783066,8783088,2361840,22,0,0,True,True,3.3997333333333337,-0.85333
8139,6421316,4,8,0.954069,97,6433921,-1,4000.0,8338904,8338908,1917588,4,21,9,True,True,0.7640888888888888,-0.954069
8140,6421412,60,4,0.576917,97,6433921,-1,2000.0,8578715,8578775,2157303,60,11,0,True,True,1.899,-0.576917
8141,6421880,8849,32,0.001678,97,6433921,-1,16000.0,8740630,8749479,2318750,8849,4,2,True,True,3563.6731111111108,-0.0016484463144259818
8142,6421934,8333,15,0.061885,97,6433921,-1,7500.0,8948533,8956866,2526599,8333,0,10,True,True,1969.1957708333332,-0.061763038750773505
8143,6422009,22,1,0.535603,97,6433921,-1,500.0,6556070,6556092,134061,22,64,8,True,True,0.49295277777777785,-0.535603
8144,6422033,20390,32,0.847119,97,6433921,-1,16000.0,8256704,8277094,1834671,20390,27,10,True,True,9067.048444444445,-0.7797116040995288
8145,6422764,6751,32,0.979849,97,6433921,-1,16000.0,7653858,7660609,1231094,6751,38,6,True,True,6641.533333333334,-0.9793941390941087
8146,6423734,14,1,0.319643,97,6433921,-1,500.0,8783229,8783243,2359495,14,1,2,True,True,0.27043333333333336,-0.319643
8147,6423866,23216,101,0.365024,97,6433921,-1,50500.0,7352021,7375237,928155,23216,49,11,True,True,20406.78529583333,-0.33541712034280224
8148,6423995,349,4,0.679302,97,6433921,-1,2000.0,6435021,6435370,11026,349,78,6,True,True,20.796522222222222,-0.679302
8149,6424009,34,8,0.796565,97,6433921,-1,4000.0,8323704,8323738,1899695,34,27,0,True,True,6.1309555555555555,-0.796565
8150,6424161,8,1,0.519751,97,6433921,-1,500.0,7353121,7353129,928960,8,50,6,True,True,0.04137777777777778,-0.519751
8151,6424189,31,2,0.601618,97,6433921,-1,1000.0,8736445,8736476,2312256,31,7,6,True,True,0.5542972222222222,-0.601618
8152,6424395,7,1,0.222142,97,6433921,-1,500.0,8399863,8399870,1975468,7,25,1,True,True,0.10360972222222221,-0.222142
8153,6424449,25172,64,0.395312,97,6433921,-1,32000.0,6806370,6831542,381921,25172,64,0,True,True,5950.466133333333,-0.3705640522471638
8154,6424472,20451,2,0.538293,97,6433921,-1,1000.0,7385712,7406163,961240,20451,52,6,True,True,794.9044916666667,-0.526306652759673
8155,6424527,15,4,0.460603,97,6433921,-1,2000.0,7352021,7352036,927494,15,54,0,True,True,0.31033333333333335,-0.460603
8156,6425008,71,1,0.144701,97,6433921,-1,500.0,6541670,6541741,116662,71,77,6,True,True,1.3739486111111112,-0.144701
8157,6425300,7485,4,0.94289,97,6433921,-1,2000.0,6919823,6927308,494523,7485,66,1,True,True,85.51682222222222,-0.9262389106986391
8158,6425396,13324,16,0.837217,97,6433921,-1,8000.0,8784329,8797653,2358933,13324,1,6,True,True,3176.465022222222,-0.8103324698387835
8159,6425461,47,1,0.499833,97,6433921,-1,500.0,6472170,6472217,46709,47,83,3,True,True,0.814275,-0.499833
8160,6425543,224,1,0.455785,97,6433921,-1,500.0,6599270,6599494,173727,224,77,11,True,True,7.085244444444444,-0.455785
8161,6425595,2,19,0.601465,97,6433921,-1,9500.0,7175921,7175923,750326,2,60,10,True,True,0.13094166666666665,-0.601465
8162,6425609,443,1,0.145871,97,6433921,-1,500.0,8302104,8302547,1876495,443,32,0,True,True,3.9771555555555556,-0.145871
8163,6426025,8,1,0.665351,97,6433921,-1,500.0,8299904,8299912,1873879,8,33,11,True,True,0.07311111111111111,-0.665351
8164,6426378,7081,128,0.801292,97,6433921,-1,64000.0,8575115,8582196,2148737,7081,17,4,True,True,7607.401244444445,-0.7818127250806516
8165,6426457,11,1,0.702967,97,6433921,-1,500.0,8827529,8827540,2401072,11,1,11,True,True,0.07877222222222223,-0.702967
8166,6455460,21180,4,0.59888,99,6456970,-1,2000.0,7847453,7868633,1391993,21180,43,1,True,True,629.9953666666667,-0.5672878665503229
8167,6455719,12,32,0.308891,99,6456970,-1,16000.0,8622937,8622949,2167218,12,13,8,True,True,4.551466666666667,-0.308891
8168,6455822,29177,128,0.990335,99,6456970,-1,64000.0,7177021,7206198,721199,29177,66,6,True,True,12627.590933333333,-0.9407129356079017
8169,6455887,16,2,0.123464,99,6456970,-1,1000.0,6466370,6466386,10483,16,94,4,True,True,0.3664,-0.123464
8170,6456027,100,1,0.996849,99,6456970,-1,500.0,6462770,6462870,6743,100,95,0,True,True,1.2487499999999998,-0.996849
8171,6456047,127,2,0.706522,99,6456970,-1,1000.0,6462770,6462897,6723,127,96,2,True,True,3.1718249999999997,-0.706522
8172,6462804,16,1,0.478283,95,6466370,-1,500.0,7154314,7154330,691510,16,68,0,True,True,0.0690888888888889,-0.478283
8173,6468167,12202,32,0.828687,95,6468570,-1,16000.0,8323704,8335906,1855537,12202,33,0,True,True,12142.212177777777,-0.8014253614569813
8174,6468858,69,16,0.495026,98,6472170,-1,8000.0,8776440,8776509,2307582,69,7,8,True,True,26.95753333333333,-0.495026
8175,6468963,23944,16,0.70414,98,6472170,-1,8000.0,6682070,6706014,213107,23944,86,2,True,True,8568.963511111111,-0.7034069563696664
8176,6470414,2,40,0.376709,98,6472170,-1,20000.0,7064593,7064595,594179,2,72,6,True,True,0.6344444444444445,-0.376709
8177,6471051,30,4,0.981143,98,6472170,-1,2000.0,7152114,7152144,681063,30,71,1,True,True,0.6241666666666668,-0.981143
8178,6472282,19,8,0.333145,99,6475770,-1,4000.0,7152095,7152114,679813,19,72,12,True,True,0.7906111111111112,-0.333145
8179,6472694,35,2,0.827885,99,6475770,-1,1000.0,8364939,8364974,1892245,35,31,9,True,True,1.1464444444444444,-0.827885
8180,6481475,21285,8,0.210613,131,6518970,-1,4000.0,7831703,7852988,1350228,21285,50,6,True,True,1847.8301333333336,-0.2007269031802976
8181,6482751,3,1,0.732658,131,6518970,-1,500.0,6772870,6772873,290119,3,87,7,True,True,0.016975,-0.732658
8182,6482913,22,4,0.810419,131,6518970,-1,2000.0,8403193,8403215,1920280,22,29,0,True,True,1.4201000000000001,-0.810419
8183,6483235,9208,8,0.700407,131,6518970,-1,4000.0,6540570,6549778,57335,9208,100,10,True,True,1648.1384222222225,-0.6955029624800139
8184,6484147,1,32,0.052566,131,6518970,-1,16000.0,8437815,8437816,1953668,1,29,6,True,True,0.41831111111111113,-0.052566
8185,6485258,9,16,0.865432,131,6518970,-1,8000.0,6944693,6944702,459435,9,85,10,True,True,3.5756,-0.865432
8186,6485563,36,20,0.17902,131,6518970,-1,10000.0,7809003,7809039,1323440,36,53,7,True,True,8.879000000000001,-0.17902
8187,6492039,8,26,0.487505,131,6518970,-1,13000.0,8340004,8340012,1847965,8,35,6,True,True,4.966577777777777,-0.487505
8188,6492231,31,32,0.391808,131,6518970,-1,16000.0,8926933,8926964,2434702,31,1,0,True,True,5.586888888888889,-0.391808
8189,6495591,2,1,0.98439,131,6518970,-1,500.0,8924729,8924731,2429138,2,2,12,True,True,0.011263888888888888,-0.98439
8190,6495648,26,8,0.65925,131,6518970,-1,4000.0,7838224,7838250,1342576,26,54,6,True,True,2.6759777777777773,-0.65925
8191,6495954,8,1,0.848518,131,6518970,-1,500.0,8622937,8622945,2126983,8,16,0,True,True,0.09482222222222222,-0.848518
8192,6496746,14074,4,0.991063,131,6518970,-1,2000.0,8347639,8361713,1850893,14074,37,8,True,True,726.37685,-0.9078074685688381
8193,6498268,835,2,0.547943,131,6518970,-1,1000.0,7928604,7929439,1430336,835,51,9,True,True,29.702805555555557,-0.547943
8194,6498325,12165,64,0.33741,131,6518970,-1,32000.0,8366039,8378204,1867714,12165,36,6,True,True,10986.25528888889,-0.29103438744409155
8195,6498584,9640,64,0.677899,131,6518970,-1,32000.0,7847453,7857093,1348869,9640,56,0,True,True,5203.200177777779,-0.6537167737229942
8196,6498674,14962,32,0.990314,131,6518970,-1,16000.0,8781840,8796802,2283166,14962,9,8,True,True,7270.056444444444,-0.8963110811950862
8197,6501826,1213,32,0.757714,131,6518970,-1,16000.0,7912404,7913617,1410578,1213,54,0,True,True,733.7908444444444,-0.7205071662593803
8198,6502035,6153,1,0.391063,131,6518970,-1,500.0,7177021,7183174,674986,6153,84,0,True,True,19.459198611111113,-0.3672045458703065
8199,6502111,9289,8,0.527844,131,6518970,-1,4000.0,8302104,8311393,1799993,9289,48,7,True,True,663.8729555555556,-0.5196577973224458
8200,6502185,26,1,0.28304,131,6518970,-1,500.0,8155104,8155130,1652919,26,54,7,True,True,0.3016,-0.28304
8201,6502386,77,27,0.696376,131,6518970,-1,13500.0,7929704,7929781,1427318,77,55,6,True,True,36.977325,-0.696376
8202,6504417,98,8,0.195092,131,6518970,-1,4000.0,8633745,8633843,2129328,98,16,0,True,True,6.5268,-0.195092
8203,6506506,16072,16,0.856252,131,6518970,-1,8000.0,8328104,8344176,1821598,16072,44,7,True,True,7309.1216,-0.8166146243001472
8204,6506530,393,2,0.393772,131,6518970,-1,1000.0,8926933,8927326,2420403,393,2,1,True,True,4.426708333333333,-0.393772
8205,6506670,9,10,0.130901,131,6518970,-1,5000.0,6773970,6773979,267300,9,109,6,True,True,0.5092500000000001,-0.130901
8206,6506850,53,32,0.752266,131,6518970,-1,16000.0,6919770,6919823,412920,53,106,10,True,True,4.871288888888889,-0.752266
8207,6506902,10238,16,0.580384,131,6518970,-1,8000.0,7588284,7598522,1081382,10238,76,12,True,True,5187.733155555556,-0.5372091732640137
8208,6514749,11,4,0.805072,131,6518970,-1,2000.0,6547070,6547081,32321,11,123,8,True,True,1.2515555555555558,-0.805072
8209,6515182,17122,16,0.84981,131,6518970,-1,8000.0,6547070,6564192,31888,17122,123,0,True,True,5297.148444444445,-0.7761293797543859
8210,6515205,5924,65,0.709588,131,6518970,-1,32500.0,7378812,7384736,863607,5924,85,1,True,True,7542.880944444444,-0.6431840148745206
8211,6515302,21,4,0.457533,131,6518970,-1,2000.0,6626270,6626291,110968,21,120,8,True,True,1.3911333333333333,-0.457533
8212,6515336,13,4,0.163694,131,6518970,-1,2000.0,6922023,6922036,406687,13,107,7,True,True,0.14935555555555555,-0.163694
8213,6518831,318,1,0.137561,131,6518970,-1,500.0,8399545,8399863,1880714,318,39,9,True,True,4.706841666666667,-0.137561
8214,6519316,9030,256,0.695956,160,6540570,-1,128000.0,7704773,7713803,1185457,9030,74,11,True,True,12661.097244444443,-0.686309823259096
8215,6520167,30595,8,0.291082,160,6540570,-1,4000.0,7928604,7959199,1408437,30595,60,0,True,True,3012.188933333333,-0.28042578913766203
8216,6521012,76,8,0.144823,160,6540570,-1,4000.0,7713803,7713879,1192791,76,75,0,True,True,3.566088888888889,-0.144823
8217,6521112,549,11,0.218136,160,6540570,-1,5500.0,8400963,8401512,1879851,549,38,6,True,True,89.3855875,-0.218136
8218,6521118,54,4,0.748383,160,6540570,-1,2000.0,8403215,8403269,1882097,54,36,1,True,True,3.4857,-0.748383
8219,6523224,6,4,0.735319,160,6540570,-1,2000.0,8388745,8388751,1865521,6,42,2,True,True,0.13303333333333334,-0.735319
8220,6523228,25123,128,0.009133,160,6540570,-1,64000.0,7713803,7738926,1190575,25123,79,0,True,True,20372.876622222222,-0.009013773420451515
8221,6523268,45,32,0.725958,160,6540570,-1,16000.0,8348739,8348784,1825471,45,45,6,True,True,18.669999999999998,-0.725958
8222,6523290,5278,1,0.575682,160,6540570,-1,500.0,7841524,7846802,1318234,5278,72,0,True,True,52.43556944444445,-0.5515352190361885
8223,6523551,26792,8,0.678318,160,6540570,-1,4000.0,8235104,8261896,1711553,26792,59,3,True,True,4114.672533333333,-0.6778729094872548
8224,6523577,26,32,0.988484,160,6540570,-1,16000.0,8838329,8838355,2314752,26,4,9,True,True,4.192355555555555,-0.988484
8225,6523687,13863,2,0.147605,160,6540570,-1,1000.0,8578715,8592578,2055028,13863,27,1,True,True,369.0742416666667,-0.14472243004092533
8226,6523887,47,32,0.950398,160,6540570,-1,16000.0,8738645,8738692,2214758,47,15,7,True,True,15.232177777777778,-0.950398
8227,6525544,23,3,0.427111,160,6540570,-1,1500.0,8724545,8724568,2199001,23,18,0,True,True,0.3187416666666667,-0.427111
8228,6525619,311,2,0.84166,160,6540570,-1,1000.0,7713803,7714114,1188184,311,87,6,True,True,3.6482027777777777,-0.84166
8229,6525992,180,14,0.925985,160,6540570,-1,7000.0,8607437,8607617,2081445,180,26,2,True,True,43.10576666666667,-0.9090044259259259
8230,6526033,15294,16,0.096048,160,6540570,-1,8000.0,7631513,7646807,1105480,15294,92,1,True,True,9636.196711111112,-0.09399898788956053
8231,6526045,205,1,0.974159,160,6540570,-1,500.0,8580915,8581120,2054870,205,29,7,True,True,1.825638888888889,-0.974159
8232,6526122,1222,1,0.179633,160,6540570,-1,500.0,8953933,8955155,2427811,1222,0,8,True,True,18.70508611111111,-0.179633
8233,6526796,10402,8,0.052472,160,6540570,-1,4000.0,7804603,7815005,1277807,10402,87,0,True,True,1094.3339777777778,-0.05246801202856389
8234,6526905,17,2,0.980277,160,6540570,-1,1000.0,7378812,7378829,851907,17,106,0,True,True,0.7870055555555555,-0.980277
8235,6526907,11573,6,0.650098,160,6540570,-1,3000.0,6674870,6686443,147963,11573,143,11,True,True,964.7282916666667,-0.4885667620764131
8236,6526938,14957,64,0.593392,160,6540570,-1,32000.0,8746030,8760987,2219092,14957,15,8,True,True,14796.705955555557,-0.5117185011191931
8237,6527026,8,13,0.969727,160,6540570,-1,6500.0,8408615,8408623,1881589,8,44,8,True,True,1.3080888888888889,-0.969727
8238,6531734,19,16,0.626973,160,6540570,-1,8000.0,8740630,8740649,2208896,19,16,0,True,True,3.0788444444444445,-0.626973
8239,6531754,102,4,0.403994,160,6540570,-1,2000.0,8342239,8342341,1810485,102,57,1,True,True,7.877800000000001,-0.403994
8240,6533797,30,16,0.033993,160,6540570,-1,8000.0,8403163,8403193,1869366,30,49,7,True,True,7.7459999999999996,-0.033993
8241,6537960,162,32,0.240855,160,6540570,-1,16000.0,7661573,7661735,1123613,162,98,8,True,True,163.5624,-0.240855
8242,6537985,38206,4,0.488626,160,6540570,-1,2000.0,7958504,7996710,1420519,38206,76,2,True,True,1472.2155666666665,-0.4676601163056867
8243,6539007,11,16,0.687984,160,6540570,-1,8000.0,7805703,7805714,1266696,11,93,0,True,True,2.6974444444444443,-0.687984
8244,6547958,81,1,0.954555,165,6550670,-1,500.0,7501884,7501965,953926,81,107,7,True,True,1.0145250000000001,-0.954555
8245,6547981,6,8,0.652797,165,6550670,-1,4000.0,8388739,8388745,1840758,6,54,0,True,True,0.2660666666666667,-0.652797
8246,6548054,15766,1,0.375372,165,6550670,-1,500.0,8216704,8232470,1668650,15766,75,10,True,True,103.35808333333333,-0.37303009238750284
8247,6548764,1472,6,0.691795,165,6550670,-1,3000.0,7384612,7386084,835848,1472,117,7,True,True,150.13173333333336,-0.691795
8248,6549100,15973,4,0.795325,165,6550670,-1,2000.0,8367139,8383112,1818039,15973,55,6,True,True,876.8857777777777,-0.7759064754752263
8249,6549404,11,16,0.658519,165,6550670,-1,8000.0,7917804,7917815,1368400,11,83,8,True,True,3.795977777777778,-0.658519
8250,6549461,127,2,0.777731,165,6550670,-1,1000.0,7632613,7632740,1083152,127,107,6,True,True,11.069108333333332,-0.777731
8251,6549590,12228,128,0.864896,165,6550670,-1,64000.0,6674870,6687098,125280,12228,158,0,True,True,22910.341333333334,-0.7121597349210509
8252,6550270,447,16,0.650311,165,6550670,-1,8000.0,8783066,8783513,2232796,447,10,0,True,True,138.1528,-0.650311
8253,6550672,574,8,0.275216,168,6556070,-1,4000.0,7951304,7951878,1400632,574,81,10,True,True,35.30737777777778,-0.275216
8254,6550906,17,1,0.653195,168,6556070,-1,500.0,8044904,8044921,1493998,17,80,12,True,True,0.14199722222222222,-0.653195
8255,6551317,9,4,0.367323,168,6556070,-1,2000.0,8160504,8160513,1609187,9,79,8,True,True,0.7084,-0.367323
8256,6555872,21,16,0.12,168,6556070,-1,8000.0,7837103,7837124,1281231,21,98,8,True,True,4.5864,-0.12
8257,6556914,38837,32,0.082637,188,6599270,-1,16000.0,7718203,7757040,1161289,38837,104,7,True,True,10392.879777777778,-0.08163384953404501
8258,6556980,7,1,0.489218,188,6599270,-1,500.0,8622945,8622952,2065965,7,26,1,True,True,0.08296944444444444,-0.489218
8259,6557207,20,8,0.668792,188,6599270,-1,4000.0,7631484,7631504,1074277,20,117,11,True,True,6.146444444444444,-0.668792
8260,6557226,30122,16,0.509748,188,6599270,-1,8000.0,8561015,8591137,2003789,30122,42,1,True,True,5585.399288888888,-0.48859547913509765
8261,6560365,24923,8,0.023027,188,6599270,-1,4000.0,6898170,6923093,337805,24923,156,12,True,True,2336.4317777777774,-0.022680225794205592
8262,6561375,4,4,0.572982,188,6599270,-1,2000.0,7378808,7378812,817433,4,132,0,True,True,0.37035555555555555,-0.572982
8263,6584225,8636,32,0.572631,188,6599270,-1,16000.0,7041893,7050529,457668,8636,148,0,True,True,2140.1096000000002,-0.5695052563221505
8264,6584326,115,1,0.273725,188,6599270,-1,500.0,7656058,7656173,1071732,115,113,7,True,True,3.5571736111111107,-0.273725
8265,6584470,5285,1,0.745359,188,6599270,-1,500.0,8735345,8740630,2150875,5285,21,0,True,True,51.322493055555555,-0.7424386468971195
8266,6584524,17,8,0.794344,188,6599270,-1,4000.0,7064595,7064612,480071,17,148,1,True,True,1.0785555555555555,-0.794344
8267,6586397,15006,2,0.181097,188,6599270,-1,1000.0,8575115,8590121,1988718,15006,38,0,True,True,353.97480277777777,-0.16186344998145089
8268,6595995,36,1,0.484191,188,6599270,-1,500.0,7830603,7830639,1234608,36,104,10,True,True,0.43479999999999996,-0.484191
8269,6598188,13,2,0.644597,188,6599270,-1,1000.0,7907004,7907017,1308816,13,93,6,True,True,0.35555,-0.644597
8270,6598204,29295,1,0.433656,188,6599270,-1,500.0,8720145,8749440,2121941,29295,25,12,True,True,282.60093750000004,-0.40398521757189254
8271,6598230,8526,1,0.571423,188,6599270,-1,500.0,8436715,8445241,1838485,8526,51,0,True,True,82.35766944444444,-0.5004694218832132
8272,6598245,6341,32,0.099441,188,6599270,-1,16000.0,8527515,8533856,1929270,6341,50,6,True,True,3779.408933333333,-0.09691125375301365
8273,6598319,6,32,0.063498,188,6599270,-1,16000.0,8388739,8388745,1790420,6,63,10,True,True,1.0642666666666667,-0.063498
8274,6598385,98,4,0.908881,188,6599270,-1,2000.0,8436715,8436813,1838330,98,53,6,True,True,5.124311111111111,-0.908881
8275,6598409,63,4,0.795225,188,6599270,-1,2000.0,7804603,7804666,1206194,63,115,12,True,True,2.9169000000000005,-0.795225
8276,6598586,39,1,0.18489,188,6599270,-1,500.0,8611037,8611076,2012451,39,33,2,True,True,0.547625,-0.18489
8277,6598637,103,32,0.812868,188,6599270,-1,16000.0,8435615,8435718,1836978,103,55,8,True,True,43.08604444444445,-0.812868
8278,6601227,155,32,0.019746,227,6620870,-1,16000.0,8184304,8184459,1583077,155,90,7,True,True,74.84088888888888,-0.019746
8279,6601244,6,11,0.55606,227,6620870,-1,5500.0,7382412,7382418,781168,6,144,2,True,True,1.2693083333333333,-0.55606
8280,6601275,10,1,0.536417,227,6620870,-1,500.0,7631504,7631514,1030229,10,131,1,True,True,0.38415277777777773,-0.536417
8281,6601296,8,1,0.812196,227,6620870,-1,500.0,8388739,8388747,1787443,8,65,0,True,True,0.04434444444444444,-0.812196
8282,6601430,4,2,0.488563,227,6620870,-1,1000.0,8926929,8926933,2325499,4,4,7,True,True,0.04505555555555555,-0.488563
8283,6601507,326,2,0.518901,227,6620870,-1,1000.0,8182104,8182430,1580597,326,93,10,True,True,10.052572222222222,-0.518901
8284,6601557,3,8,0.584722,227,6620870,-1,4000.0,7954904,7954907,1353347,3,98,2,True,True,0.18633333333333335,-0.584722
8285,6601724,7,16,0.713749,227,6620870,-1,8000.0,7154314,7154321,552590,7,163,7,True,True,0.48362222222222223,-0.713749
8286,6601793,12,2,0.790068,227,6620870,-1,1000.0,7805703,7805715,1203910,12,121,6,True,True,0.36783333333333335,-0.790068
8287,6602243,16242,8,0.124089,227,6620870,-1,4000.0,8044904,8061146,1442661,16242,96,0,True,True,791.3484222222223,-0.11429072019064432
8288,6602328,45256,3,0.752988,227,6620870,-1,1500.0,8557415,8602671,1955087,45256,48,6,True,True,1689.0893624999999,-0.7390887310390832
8289,6602357,1768,4,0.965681,227,6620870,-1,2000.0,7845124,7846892,1242767,1768,113,1,True,True,58.03951111111112,-0.965681
8290,6602381,3627,16,0.897602,227,6620870,-1,8000.0,7154321,7157948,551940,3627,166,1,True,True,242.01366666666667,-0.8675958717270579
8291,6602432,111,70,0.180664,227,6620870,-1,35000.0,8524215,8524326,1921783,111,54,12,True,True,120.92062499999999,-0.180664
8292,6602439,5630,63,0.599103,227,6620870,-1,31500.0,8231504,8237134,1629065,5630,90,2,True,True,3649.4696000000004,-0.4549903152121314
8293,6602850,587,4,0.179938,227,6620870,-1,2000.0,8430215,8430802,1827365,587,59,10,True,True,26.806333333333335,-0.179938
8294,6602886,1,8,0.554722,227,6620870,-1,4000.0,8066504,8066505,1463618,1,100,10,True,True,0.048388888888888884,-0.554722
8295,6602918,561,8,0.800513,227,6620870,-1,4000.0,7846892,7847453,1243974,561,117,2,True,True,36.832766666666664,-0.800513
8296,6602928,8,1,0.123045,227,6620870,-1,500.0,7385712,7385720,782784,8,156,0,True,True,0.13598888888888888,-0.123045
8297,6602934,6208,3,0.128816,227,6620870,-1,1500.0,7912404,7918612,1309470,6208,111,8,True,True,377.90126666666663,-0.12530804955169775
8298,6603044,9451,256,0.20623,227,6620870,-1,128000.0,7897553,7907004,1294509,9451,113,7,True,True,32502.300444444445,-0.19982107138242983
8299,6603431,3571,256,0.16121,227,6620870,-1,128000.0,7375237,7378808,771806,3571,165,0,True,True,20240.572799999998,-0.1542006058731848
8300,6603479,6939,4,0.562496,227,6620870,-1,2000.0,8354139,8361078,1750660,6939,75,8,True,True,342.79715,-0.5120278292683152
8301,6603637,8,1,0.85145,227,6620870,-1,500.0,8749440,8749448,2145803,8,17,1,True,True,0.10216666666666667,-0.85145
8302,6603653,369,2,0.035005,227,6620870,-1,1000.0,8224304,8224673,1620651,369,95,7,True,True,4.804175,-0.035005
8303,6603719,80,8,0.979928,227,6620870,-1,4000.0,8152904,8152984,1549185,80,103,12,True,True,4.153777777777778,-0.979928
8304,6604464,116,12,0.506148,227,6620870,-1,6000.0,6631670,6631786,27206,116,212,8,True,True,15.770199999999999,-0.506148
8305,6604573,1322,28,0.36356,227,6620870,-1,14000.0,8602515,8603837,1997942,1322,39,10,True,True,548.4023222222222,-0.36356
8306,6604621,9127,32,0.544427,227,6620870,-1,16000.0,6811770,6820897,207149,9127,200,8,True,True,1178.5144,-0.531003609058762
8307,6604631,7934,1,0.423051,227,6620870,-1,500.0,7651658,7659592,1047027,7934,148,6,True,True,243.4010222222222,-0.42262567513447785
8308,6606881,33034,2,0.945228,227,6620870,-1,1000.0,7434772,7467806,827891,33034,160,11,True,True,1481.3512499999997,-0.9409779816361579
8309,6606899,42,16,8.6e-05,227,6620870,-1,8000.0,7840424,7840466,1233525,42,128,7,True,True,8.645466666666668,-8.6e-05
8310,6606945,21,64,0.3006,227,6620870,-1,32000.0,8724545,8724566,2117600,21,26,7,True,True,6.2085333333333335,-0.3006
8311,6606974,17,16,0.946215,227,6620870,-1,8000.0,7200821,7200838,593847,17,180,10,True,True,1.3743555555555558,-0.946215
8312,6607002,13375,128,0.519443,227,6620870,-1,64000.0,7435872,7449247,828870,13375,162,6,True,True,37600.113244444445,-0.5020932657486255
8313,6607032,18378,32,0.782802,227,6620870,-1,16000.0,8526415,8544793,1919383,18378,57,7,True,True,9632.039466666667,-0.7659859003139617
8314,6607069,163,13,0.659158,227,6620870,-1,6500.0,8783066,8783229,2175997,163,12,2,True,True,40.93201666666667,-0.659158
8315,6607310,9106,128,0.44492,227,6620870,-1,64000.0,6923093,6932199,315783,9106,204,2,True,True,3803.8062222222225,-0.4132603015509052
8316,6607654,318,16,0.577071,227,6620870,-1,8000.0,7656173,7656491,1048519,318,150,1,True,True,157.38173333333333,-0.577071
8317,6607660,14,1,0.695101,227,6620870,-1,500.0,7652758,7652772,1045098,14,153,6,True,True,0.4249777777777778,-0.695101
4463,3615840,28,1,0.996973,1,3615840,-1,500.0,3659040,3659068,43200,28,0,11,True,True,0.4525111111111111,-0.996973
4464,3615880,7607,32,0.625132,15,3659040,-1,16000.0,3841674,3849281,225794,7607,0,8,True,True,3121.2223555555556,-0.619769230251396
4465,3615923,14759,32,0.059775,15,3659040,-1,16000.0,4317768,4332527,701845,14759,0,6,True,True,3518.785955555556,-0.05931279392094605
4466,3615992,10,32,0.644575,15,3659040,-1,16000.0,5607751,5607761,1991759,10,0,9,True,True,1.0995555555555556,-0.644575
4467,3627860,12820,256,0.701328,15,3659040,-1,128000.0,6203750,6216570,2575890,12820,0,7,True,True,41550.304000000004,-0.6945251025672836
4468,3628129,6,4,0.791466,15,3659040,-1,2000.0,3661268,3661274,33139,6,4,7,True,True,0.43163333333333337,-0.791466
4469,3628218,19,32,0.125827,15,3659040,-1,16000.0,5209443,5209462,1581225,19,2,0,True,True,5.0793333333333335,-0.125827
4470,3628580,26,4,0.232675,15,3659040,-1,2000.0,4905582,4905608,1277002,26,3,12,True,True,1.2163666666666666,-0.232675
4471,3628688,27,16,0.981676,15,3659040,-1,8000.0,5049987,5050014,1421299,27,3,0,True,True,2.1563999999999997,-0.981676
4472,3628874,34,4,0.788562,15,3659040,-1,2000.0,4316668,4316702,687794,34,6,7,True,True,0.7704777777777778,-0.788562
4473,3628952,22,8,0.756698,15,3659040,-1,4000.0,3747674,3747696,118722,22,8,12,True,True,3.2978,-0.756698
4474,3628991,27,1,0.805525,15,3659040,-1,500.0,4819182,4819209,1190191,27,5,0,True,True,0.20133749999999997,-0.805525
4475,3641283,24,10,0.438719,15,3659040,-1,5000.0,5199643,5199667,1558360,24,3,2,True,True,1.4646666666666666,-0.438719
4476,3641363,6696,4,0.192965,15,3659040,-1,2000.0,4808382,4815078,1167019,6696,7,2,True,True,133.3304333333333,-0.18786990434335377
4477,3643034,67,1,0.68925,15,3659040,-1,500.0,3659068,3659135,16034,67,13,1,True,True,1.0827944444444444,-0.68925
4478,3643821,17,8,0.358167,15,3659040,-1,4000.0,5815558,5815575,2171737,17,1,10,True,True,0.9438777777777778,-0.358167
4479,3659990,2,4,0.134732,27,3661268,-1,2000.0,3661274,3661276,1284,2,13,1,True,True,0.1438777777777778,-0.134732
4480,3660044,204,25,0.898663,27,3661268,-1,12500.0,5988395,5988599,2328351,204,1,9,True,True,68.87833333333332,-0.898663
4481,3660260,7004,128,0.485302,27,3661268,-1,64000.0,4752758,4759762,1092498,7004,10,3,True,True,4077.1523555555555,-0.48503361762280817
4482,3660679,5,16,0.4375,27,3661268,-1,8000.0,6268135,6268140,2607456,5,0,2,True,True,0.7961111111111112,-0.4375
4483,3660746,5,1,0.294715,27,3661268,-1,500.0,4488827,4488832,828081,5,12,6,True,True,0.0189375,-0.294715
4484,3660784,140,34,0.697038,27,3661268,-1,17000.0,4513837,4513977,853053,140,12,8,True,True,61.265166666666666,-0.697038
4485,3660860,9450,32,0.189776,27,3661268,-1,16000.0,4375027,4384477,714167,9450,14,0,True,True,2229.2303111111114,-0.17988995872053132
4486,3661028,773,1,0.186627,27,3661268,-1,500.0,6228903,6229676,2567875,773,1,1,True,True,10.615866666666667,-0.186627
4487,3661037,3,2,0.347665,27,3661268,-1,1000.0,5073840,5073843,1412803,3,8,1,True,True,0.03698333333333334,-0.347665
4488,3661057,9,16,0.732402,27,3661268,-1,8000.0,4475827,4475836,814770,9,16,1,True,True,0.9466,-0.732402
4489,3661097,2714,1,0.275324,27,3661268,-1,500.0,5971510,5974224,2310413,2714,4,7,True,True,52.661036111111116,-0.26933792136492735
4490,3661187,11,16,0.83135,27,3661268,-1,8000.0,5975395,5975406,2314208,11,4,1,True,True,3.3779777777777777,-0.83135
4491,3661202,4,6,0.914474,27,3661268,-1,3000.0,6231235,6231239,2570033,4,1,0,True,True,0.32959999999999995,-0.914474
4492,3661241,8,1,0.55452,27,3661268,-1,500.0,5206143,5206151,1544902,8,10,0,True,True,0.07248888888888888,-0.55452
4493,3661274,20842,1,0.068877,27,3661274,-1,500.0,6041950,6062792,2380676,20842,4,0,True,True,185.75178333333335,-0.06071861567456899
4494,3661337,35594,16,0.155025,215,3747674,-1,8000.0,4801334,4836928,1139997,35594,18,6,True,True,3054.866088888889,-0.15319381487398578
4495,3661440,101,8,0.295673,215,3747674,-1,4000.0,5523151,5523252,1861711,101,10,7,True,True,6.0869333333333335,-0.295673
4496,3661501,63,1,0.263349,215,3747674,-1,500.0,3748774,3748837,87273,63,28,0,True,True,1.1804625000000002,-0.263349
4497,3662111,8148,64,0.367113,215,3747674,-1,32000.0,4800234,4808382,1138123,8148,20,10,True,True,2513.8725333333336,-0.3585500372440988
4498,3662159,5579,4,0.00072,215,3747674,-1,2000.0,4124368,4129947,462209,5579,28,7,True,True,184.20303333333334,-0.0006876786405939624
4499,3662220,11570,1,0.638026,215,3747674,-1,500.0,4221568,4233138,559348,11570,28,9,True,True,108.6781,-0.6279950432775429
4500,3663788,609,1,0.379044,215,3747674,-1,500.0,3983174,3983783,319386,609,30,8,True,True,3.4044791666666665,-0.379044
4501,3663875,76,8,0.185534,215,3747674,-1,4000.0,4508437,4508513,844562,76,23,9,True,True,5.32,-0.185534
4502,3663967,14665,10,0.01872,215,3747674,-1,5000.0,6216570,6231235,2552603,14665,3,0,True,True,1925.9895833333333,-0.018533980894103796
4503,3664153,27,2,0.856829,215,3747674,-1,1000.0,3747674,3747701,83521,27,35,0,True,True,1.011825,-0.856829
4504,3664169,5448,2,0.776017,215,3747674,-1,1000.0,5344451,5349899,1680282,5448,12,8,True,True,53.91628055555555,-0.7755271877445407
4505,3664201,8450,4,0.238787,215,3747674,-1,2000.0,5196043,5204493,1531842,8450,16,7,True,True,199.89448888888887,-0.22074851128166656
4506,3664343,84,16,0.721004,215,3747674,-1,8000.0,6035399,6035483,2371056,84,6,2,True,True,8.162933333333333,-0.721004
4507,3664361,91,1,0.658289,215,3747674,-1,500.0,5219243,5219334,1554882,91,14,7,True,True,0.7444305555555555,-0.658289
4508,3664393,22,2,0.538957,215,3747674,-1,1000.0,4976381,4976403,1311988,22,21,0,True,True,0.5551333333333334,-0.538957
4509,3664433,6,13,0.387491,215,3747674,-1,6500.0,4982981,4982987,1318548,6,21,7,True,True,1.2013083333333334,-0.387491
4510,3664610,111,4,0.52407,215,3747674,-1,2000.0,5975324,5975435,2310714,111,9,6,True,True,8.521716666666666,-0.52407
4511,3664644,4,32,0.497549,215,3747674,-1,16000.0,6036550,6036554,2371906,4,6,0,True,True,0.7774222222222221,-0.497549
4512,3664668,188,32,0.551468,215,3747674,-1,16000.0,6262335,6262523,2597667,188,1,9,True,True,58.10453333333334,-0.551468
4513,3664712,4,8,0.613039,215,3747674,-1,4000.0,5207243,5207247,1542531,4,19,6,True,True,0.2899555555555555,-0.613039
4514,3664784,6124,1,0.3226,215,3747674,-1,500.0,5911358,5917482,2246574,6124,13,6,True,True,40.17153888888889,-0.320302473930156
4515,3664816,16150,121,0.640904,215,3747674,-1,60500.0,5788158,5804308,2123342,16150,15,12,True,True,13503.925019444445,-0.5867800030802012
4516,3665011,232,32,0.110464,215,3747674,-1,16000.0,5566351,5566583,1901340,232,17,0,True,True,121.82577777777779,-0.110464
4517,3665100,33,4,0.523201,215,3747674,-1,2000.0,6225270,6225303,2560170,33,4,7,True,True,1.6597166666666667,-0.523201
4518,3665246,165,101,0.06668,215,3747674,-1,50500.0,3781174,3781339,115928,165,48,9,True,True,109.54922916666666,-0.06667999999999999
4519,3665281,7,64,0.835193,215,3747674,-1,32000.0,5696351,5696358,2031070,7,17,12,True,True,2.156622222222222,-0.835193
4520,3665449,6317,8,0.129774,215,3747674,-1,4000.0,5523151,5529468,1857702,6317,20,0,True,True,369.0289333333334,-0.1288909161370265
4521,3665460,328,4,0.873493,215,3747674,-1,2000.0,4332527,4332855,667067,328,44,2,True,True,6.611022222222223,-0.873493
4522,3665924,9014,74,0.202079,215,3747674,-1,37000.0,6172750,6181764,2506826,9014,7,8,True,True,5958.708372222222,-0.19454715688924154
4523,3665959,15066,4,0.48537,215,3747674,-1,2000.0,5932958,5948024,2266999,15066,15,10,True,True,995.3537000000001,-0.47311061749568334
4524,3665973,7608,3,0.098754,215,3747674,-1,1500.0,6217670,6225278,2551697,7608,5,6,True,True,298.4020166666667,-0.09842972397056503
4525,3666177,10056,113,0.571012,215,3747674,-1,56500.0,4700737,4710793,1034560,10056,42,7,True,True,10050.327820833334,-0.49279484057118106
4526,3666436,7,1,0.8363,215,3747674,-1,500.0,4314468,4314475,648032,7,51,0,True,True,0.03740138888888889,-0.8363
4527,3667058,8,8,0.657921,215,3747674,-1,4000.0,4953182,4953190,1286124,8,36,7,True,True,1.2535111111111112,-0.657921
4528,3667074,37,8,0.525821,215,3747674,-1,4000.0,6036550,6036587,2369476,37,11,2,True,True,1.7977888888888889,-0.525821
4529,3668186,12,8,0.701314,215,3747674,-1,4000.0,4082974,4082986,414788,12,56,8,True,True,1.4092,-0.701314
4530,3668196,39839,1,0.255939,215,3747674,-1,500.0,5193843,5233682,1525647,39839,33,12,True,True,322.44298888888886,-0.25034594273281263
4531,3668426,38,4,0.366354,215,3747674,-1,2000.0,6167350,6167388,2498924,38,9,10,True,True,1.624711111111111,-0.366354
4532,3668615,13,64,0.605954,215,3747674,-1,32000.0,6145750,6145763,2477135,13,10,7,True,True,7.828888888888889,-0.605954
4533,3668830,23991,4,0.070874,215,3747674,-1,2000.0,4385827,4409818,716997,23991,52,9,True,True,499.2591611111111,-0.06744049348543446
4534,3668847,12081,256,0.930211,215,3747674,-1,128000.0,4107887,4119968,439040,12081,60,7,True,True,32625.9136,-0.8934692364355503
4535,3668865,5,1,0.208738,215,3747674,-1,500.0,4496537,4496542,827672,5,50,0,True,True,0.024694444444444446,-0.208738
4536,3669374,4541,184,0.491406,215,3747674,-1,92000.0,6231235,6235776,2561861,4541,3,2,True,True,10577.399466666668,-0.4600515579220006
4537,3669407,7819,4,0.889767,215,3747674,-1,2000.0,5571751,5579570,1902344,7819,26,8,True,True,264.0758055555556,-0.8375370628868837
4538,3669434,2,4,0.079957,215,3747674,-1,2000.0,4773234,4773236,1103800,2,48,6,True,True,0.03585555555555556,-0.079957
4539,3669546,5723,2,0.80102,215,3747674,-1,1000.0,3770374,3776097,100828,5723,69,10,True,True,126.46250555555557,-0.7479233504287375
4540,3669588,33704,64,0.0607,215,3747674,-1,32000.0,3842774,3876478,173186,33704,67,6,True,True,29605.878577777778,-0.06031432249030531
4541,3669597,10,1,0.55802,215,3747674,-1,500.0,4052374,4052384,382777,10,66,7,True,True,0.14491666666666667,-0.55802
4542,3670045,612,43,0.938244,215,3747674,-1,21500.0,5566351,5566963,1896306,612,28,11,True,True,431.8382500000001,-0.938244
4543,3670118,3,16,0.415953,215,3747674,-1,8000.0,4329668,4329671,659550,3,60,6,True,True,0.4736000000000001,-0.415953
4544,3670126,12,8,0.369069,215,3747674,-1,4000.0,6010199,6010211,2340073,12,16,10,True,True,1.2021333333333333,-0.369069
4545,3670158,26577,128,0.708434,215,3747674,-1,64000.0,4343327,4369904,673169,26577,60,9,True,True,26578.65475555555,-0.681071053332244
4546,3670351,9,2,0.823643,215,3747674,-1,1000.0,5073787,5073796,1403436,9,41,7,True,True,0.11095000000000001,-0.823643
4547,3670440,3747,1,0.265816,215,3747674,-1,500.0,5347751,5351498,1677311,3747,32,6,True,True,18.44477361111111,-0.26438676419731894
4548,3672786,28250,128,0.040653,215,3747674,-1,64000.0,5520951,5549201,1848165,28250,32,0,True,True,31369.034488888894,-0.039000290302370635
4549,3672822,13457,128,0.070388,215,3747674,-1,64000.0,4741250,4754707,1068428,13457,55,10,True,True,8434.637866666666,-0.07037383470510673
4550,3673201,21313,16,0.303905,215,3747674,-1,8000.0,4086574,4107887,413373,21313,73,3,True,True,5128.076266666666,-0.3030498084183828
4551,3673565,89,1,0.944603,215,3747674,-1,500.0,4698537,4698626,1024972,89,57,11,True,True,0.9684930555555554,-0.944603
4552,3673625,16711,4,0.960587,215,3747674,-1,2000.0,6041950,6058661,2368325,16711,13,8,True,True,531.3833277777778,-0.9519097319907219
4553,3673741,75,2,0.097119,215,3747674,-1,1000.0,4226968,4227043,553227,75,72,8,True,True,1.3410416666666667,-0.097119
4554,3673762,201,1,0.725172,215,3747674,-1,500.0,5988395,5988596,2314633,201,18,0,True,True,2.7146166666666667,-0.725172
4555,3673920,5,1,0.531661,215,3747674,-1,500.0,5107443,5107448,1433523,5,44,7,True,True,0.03241666666666667,-0.531661
4556,3674946,25,1,0.18946,215,3747674,-1,500.0,6243935,6243960,2568989,25,2,5,True,True,0.2619444444444444,-0.18946
4557,3674980,12598,32,0.526192,215,3747674,-1,16000.0,5901958,5914556,2226978,12598,26,12,True,True,2206.4211555555557,-0.5201438093478963
4558,3675045,21116,45,0.248763,215,3747674,-1,22500.0,5434151,5455267,1759106,21116,37,12,True,True,4354.830875000001,-0.23481148177661185
4559,3675284,288,3,0.625325,215,3747674,-1,1500.0,5905558,5905846,2230274,288,26,1,True,True,4.3572,-0.625325
4560,3675406,1649,5,0.178898,215,3747674,-1,2500.0,5206143,5207792,1530737,1649,45,8,True,True,74.7088611111111,-0.178898
4561,3675425,101,1,0.749194,215,3747674,-1,500.0,4819182,4819283,1143757,101,58,9,True,True,0.7531513888888889,-0.749194
4562,3675572,12,2,0.415185,215,3747674,-1,1000.0,5339051,5339063,1663479,12,41,8,True,True,0.12593333333333334,-0.415185
4563,3675590,8667,16,0.105514,215,3747674,-1,8000.0,6263435,6272102,2587845,8667,1,6,True,True,1316.4030222222223,-0.1031276564383815
4564,3675622,29,12,0.638624,215,3747674,-1,6000.0,4524637,4524666,849015,29,69,9,True,True,4.100116666666667,-0.638624
4565,3675637,7754,128,0.357963,215,3747674,-1,64000.0,6251535,6259289,2575898,7754,3,0,True,True,9144.559111111112,-0.34512297600561626
4566,3675654,189,32,0.458721,215,3747674,-1,16000.0,3748774,3748963,73120,189,97,6,True,True,113.3244,-0.458721
4567,3675688,10761,1,0.665242,215,3747674,-1,500.0,4077574,4088335,401886,10761,90,0,True,True,156.22826805555556,-0.6479841840745143
4568,3675741,8744,4,0.882824,215,3747674,-1,2000.0,5333651,5342395,1657910,8744,44,12,True,True,194.50746111111113,-0.836793993459824
4569,3675872,9308,1,0.166809,215,3747674,-1,500.0,4743450,4752758,1067578,9308,68,7,True,True,46.38794722222222,-0.16608904407922706
4570,3675903,11829,72,0.180397,215,3747674,-1,36000.0,5790358,5802187,2114455,11829,31,7,True,True,5905.3046,-0.1798655149197649
4571,3676012,238,1,0.401557,215,3747674,-1,500.0,5974224,5974462,2298212,238,25,2,True,True,4.567947222222222,-0.401557
4572,3676024,33,8,0.337513,215,3747674,-1,4000.0,5095443,5095476,1419419,33,56,10,True,True,2.066533333333333,-0.337513
4573,3676082,23,5,0.158176,215,3747674,-1,2500.0,4493237,4493260,817155,23,79,2,True,True,0.45872222222222225,-0.158176
4574,3676130,45,1,0.998434,215,3747674,-1,500.0,5477351,5477396,1801221,45,42,11,True,True,0.5038125,-0.998434
4575,3676133,2356,2,0.443012,215,3747674,-1,1000.0,6216570,6218926,2540437,2356,11,8,True,True,62.29416666666666,-0.44132587809474055
4576,3676184,230,8,0.352324,215,3747674,-1,4000.0,3836274,3836504,160090,230,103,11,True,True,35.52733333333333,-0.352324
4577,3677867,53,45,0.315155,215,3747674,-1,22500.0,6251535,6251588,2573668,53,4,8,True,True,24.111687500000002,-0.315155
4578,3677893,32,1,0.991463,215,3747674,-1,500.0,5097643,5097675,1419750,32,59,7,True,True,0.22097777777777777,-0.991463
4579,3677973,1043,1,0.324654,215,3747674,-1,500.0,6240335,6241378,2562362,1043,6,7,True,True,12.166884722222221,-0.324654
4580,3677995,13208,38,0.37172,215,3747674,-1,19000.0,6172750,6185958,2494755,13208,15,0,True,True,4573.411888888889,-0.34065318345006323
4581,3678079,1889,4,0.764184,215,3747674,-1,2000.0,5242551,5244440,1564472,1889,52,1,True,True,39.1023,-0.764184
4582,3678090,14913,128,0.430588,215,3747674,-1,64000.0,6268135,6283048,2590045,14913,0,0,True,True,18668.823644444445,-0.4173664214719294
4583,3678108,13165,16,0.725868,215,3747674,-1,8000.0,5593351,5606516,1915243,13165,41,10,True,True,862.7553555555556,-0.6359859939375598
4584,3678125,7,4,0.608413,215,3747674,-1,2000.0,5242551,5242558,1564426,7,54,0,True,True,0.1449,-0.608413
4585,3678176,6,37,0.563145,215,3747674,-1,18500.0,4122168,4122174,443992,6,103,7,True,True,1.9573,-0.563145
4586,3678377,8869,256,0.213928,215,3747674,-1,128000.0,5233682,5242551,1555305,8869,56,2,True,True,14988.222577777778,-0.18253839639188565
4587,3678440,12027,210,0.765708,215,3747674,-1,105000.0,4760107,4772134,1081667,12027,81,8,True,True,11311.430958333332,-0.7640115623602681
4588,3679211,14,64,0.926147,215,3747674,-1,32000.0,5105243,5105257,1426032,14,66,7,True,True,5.809066666666666,-0.926147
4589,3679280,44,128,0.254089,215,3747674,-1,64000.0,4487727,4487771,808447,44,94,6,True,True,21.3312,-0.254089
4590,3679312,4,1,0.961652,215,3747674,-1,500.0,5211643,5211647,1532331,4,58,7,True,True,0.033416666666666664,-0.961652
4591,3679372,7906,32,0.4475,215,3747674,-1,16000.0,4702937,4710843,1023565,7906,87,7,True,True,2267.797466666667,-0.4178312575887148
4592,3680172,1984,32,0.397091,215,3747674,-1,16000.0,4313368,4315352,633196,1984,106,12,True,True,339.2199111111111,-0.397091
4593,3680281,13,14,0.726313,215,3747674,-1,7000.0,4496537,4496550,816256,13,94,7,True,True,0.8988777777777778,-0.726313
4594,3680922,11742,86,0.982956,215,3747674,-1,43000.0,4772134,4783876,1091212,11742,83,6,True,True,4324.95935,-0.9567333047987069
4595,3681024,1300,8,0.595763,215,3747674,-1,4000.0,4089874,4091174,408850,1300,114,7,True,True,156.37555555555556,-0.595763
4596,3681070,19,1,0.517609,215,3747674,-1,500.0,3891374,3891393,210304,19,120,8,True,True,0.2460763888888889,-0.517609
4597,3681095,23,32,0.993412,215,3747674,-1,16000.0,5972610,5972633,2291515,23,31,6,True,True,14.126088888888889,-0.993412
4598,3681213,5,32,0.301842,215,3747674,-1,16000.0,3885974,3885979,204761,5,122,0,True,True,0.9375555555555556,-0.301842
4599,3681391,13,8,0.300334,215,3747674,-1,4000.0,6041950,6041963,2360559,13,20,0,True,True,0.7265555555555555,-0.300334
4600,3681904,3459,4,0.221887,215,3747674,-1,2000.0,4119968,4123427,438064,3459,115,0,True,True,144.96028888888887,-0.19966566140818934
4601,3682096,13849,4,0.85572,215,3747674,-1,2000.0,6235935,6249784,2553839,13849,8,3,True,True,628.0219222222222,-0.8464937350578496
4602,3682167,19827,32,0.021701,215,3747674,-1,16000.0,5988599,6008426,2306432,19827,28,2,True,True,7567.650666666666,-0.020749577709203937
4603,3682283,6,1,0.82194,215,3747674,-1,500.0,4493227,4493233,810944,6,101,7,True,True,0.023933333333333334,-0.82194
4604,3682525,22,32,0.689719,215,3747674,-1,16000.0,4119968,4119990,437443,22,119,1,True,True,8.196711111111112,-0.689719
4605,3682574,13,1,0.275957,215,3747674,-1,500.0,4087674,4087687,405100,13,122,6,True,True,0.1587986111111111,-0.275957
4606,3682589,3,4,0.553663,215,3747674,-1,2000.0,4976381,4976384,1293792,3,79,6,True,True,0.1514,-0.553663
4607,3683826,2914,1,0.556323,215,3747674,-1,500.0,5609951,5612865,1926125,2914,44,7,True,True,10.441144444444445,-0.5203838458025397
4608,3685104,2,1,0.925922,215,3747674,-1,500.0,4331868,4331870,646764,2,111,7,True,True,0.010077777777777778,-0.925922
4609,3688341,561,1,0.154715,215,3747674,-1,500.0,4978581,4979142,1290240,561,79,7,True,True,7.262725,-0.1522348626126266
4610,3688365,19295,64,0.037736,215,3747674,-1,32000.0,5490351,5509646,1801986,19295,53,6,True,True,11759.890666666666,-0.03767479142135557
4611,3688398,12603,8,0.355656,215,3747674,-1,4000.0,5242551,5255154,1554153,12603,61,0,True,True,481.84380000000004,-0.35077897983910256
4612,3688772,56,1,0.138408,215,3747674,-1,500.0,5049987,5050043,1361215,56,80,11,True,True,0.2795333333333333,-0.138408
4613,3688871,53,8,0.367083,215,3747674,-1,4000.0,4980781,4980834,1291910,53,82,7,True,True,5.578544444444445,-0.367083
4614,3688977,11,8,0.582156,215,3747674,-1,4000.0,5243651,5243662,1554674,11,60,0,True,True,0.4554,-0.582156
4615,3689104,7367,16,0.232994,215,3747674,-1,8000.0,5495751,5503118,1806647,7367,53,8,True,True,1302.9422888888887,-0.22782048004808628
4616,3689453,19,1,0.811074,215,3747674,-1,500.0,4494337,4494356,804884,19,109,6,True,True,0.07578888888888889,-0.811074
4617,3690701,14513,16,0.091905,215,3747674,-1,8000.0,4705137,4719650,1014436,14513,101,0,True,True,1643.7446888888887,-0.08211174359892183
4618,3690792,149,32,0.399798,215,3747674,-1,16000.0,5004587,5004736,1313795,149,83,10,True,True,74.32782222222222,-0.399798
4619,3690846,16952,256,0.917882,215,3747674,-1,128000.0,5954558,5971510,2263712,16952,36,10,True,True,73782.39075555555,-0.9016822382564755
4620,3690876,21615,64,0.734266,215,3747674,-1,32000.0,4050174,4071789,359298,21615,141,7,True,True,15395.9424,-0.7206885072696945
4621,3690903,30,8,0.723581,215,3747674,-1,4000.0,4486627,4486657,795724,30,117,9,True,True,0.9089999999999999,-0.723581
4622,3691207,140,16,0.792904,215,3747674,-1,8000.0,4047974,4048114,356767,140,143,11,True,True,27.001333333333335,-0.792904
4623,3691710,20607,32,0.172902,215,3747674,-1,16000.0,4754707,4775314,1062997,20607,100,0,True,True,2951.236711111111,-0.1716693014153993
4624,3691896,6844,35,0.825705,215,3747674,-1,17500.0,5346651,5353495,1654755,6844,59,7,True,True,1178.450486111111,-0.8236959118249295
4625,3692532,17,8,0.689595,215,3747674,-1,4000.0,5499351,5499368,1806819,17,54,2,True,True,1.7611999999999999,-0.689595
4626,3692654,1207,32,0.576232,215,3747674,-1,16000.0,3786574,3787781,93920,1207,153,8,True,True,355.9092888888889,-0.5392957115944361
4627,3692800,10,1,0.907656,215,3747674,-1,500.0,4547337,4547347,854537,10,110,10,True,True,0.099875,-0.907656
4628,3692903,3,12,0.595231,215,3747674,-1,6000.0,4004774,4004777,311871,3,148,10,True,True,0.50745,-0.595231
4629,3693006,11,21,0.300393,215,3747674,-1,10500.0,5243651,5243662,1550645,11,65,6,True,True,1.195425,-0.300393
4630,3699045,8653,32,0.730789,215,3747674,-1,16000.0,3977774,3986427,278729,8653,151,12,True,True,1558.2165777777777,-0.701149967600147
4631,3699066,22116,32,0.576284,215,3747674,-1,16000.0,5596951,5619067,1897885,22116,47,1,True,True,2654.4087999999997,-0.5633613130872163
4632,3699271,21,1,0.078477,215,3747674,-1,500.0,5788158,5788179,2088887,21,43,0,True,True,0.18307916666666668,-0.078477
4633,3699282,111,18,0.055923,215,3747674,-1,9000.0,6264535,6264646,2565253,111,2,6,True,True,18.500925000000002,-0.055923
4634,3699352,13,4,0.770902,215,3747674,-1,2000.0,3885974,3885987,186622,13,157,11,True,True,0.3047055555555555,-0.770902
4635,3699478,11,4,0.34793,215,3747674,-1,2000.0,4803534,4803545,1104056,11,101,7,True,True,0.21107777777777778,-0.34793
4636,3699527,13020,12,0.817142,215,3747674,-1,6000.0,5006787,5019807,1307260,13020,90,7,True,True,2643.9294,-0.8154202576832262
4637,3700163,6,11,0.416522,215,3747674,-1,5500.0,5217043,5217049,1516880,6,74,8,True,True,0.5399166666666667,-0.416522
4638,3701086,44,32,0.867831,215,3747674,-1,16000.0,5073796,5073840,1372710,44,88,1,True,True,8.678755555555556,-0.867831
4639,3701224,130,1,0.869787,215,3747674,-1,500.0,6031799,6031929,2330575,130,28,10,True,True,0.8410277777777777,-0.869787
4640,3701346,187,32,0.226718,215,3747674,-1,16000.0,6049950,6050137,2348604,187,22,2,True,True,38.98742222222222,-0.226718
4641,3712058,24,36,0.652779,215,3747674,-1,18000.0,4719650,4719674,1007592,24,116,0,True,True,2.958,-0.652779
4642,3712151,13959,64,0.602302,215,3747674,-1,32000.0,4073974,4087933,361823,13959,156,10,True,True,12509.781955555556,-0.5900529271048415
4643,3714914,7407,9,0.011434,215,3747674,-1,4500.0,4210768,4218175,495854,7407,146,12,True,True,453.29222500000003,-0.009869245914907718
4644,3715223,18,16,0.777419,215,3747674,-1,8000.0,6044150,6044168,2328927,18,23,7,True,True,2.012,-0.777419
4645,3715324,18,16,0.382487,215,3747674,-1,8000.0,4525737,4525755,810413,18,123,6,True,True,2.314,-0.382487
4646,3715542,5,8,0.304783,215,3747674,-1,4000.0,4314468,4314473,598926,5,145,6,True,True,0.21372222222222223,-0.304783
4647,3720730,18,16,0.041182,215,3747674,-1,8000.0,5701758,5701776,1981028,18,49,8,True,True,1.5992,-0.041182
4648,3720939,56,4,0.53993,215,3747674,-1,2000.0,4718137,4718193,997198,56,119,7,True,True,1.1707111111111113,-0.53993
4649,3721655,12,1,0.14958,215,3747674,-1,500.0,5523151,5523163,1801496,12,58,0,True,True,0.09040000000000001,-0.14958
4650,3723113,108,2,0.502402,215,3747674,-1,1000.0,6240335,6240443,2517222,108,8,0,True,True,2.5197,-0.502402
4651,3723509,38,1,0.220797,215,3747674,-1,500.0,4655337,4655375,931828,38,126,12,True,True,0.2014,-0.220797
4652,3723658,819,1,0.05052,215,3747674,-1,500.0,4122168,4122987,398510,819,156,0,True,True,7.2208499999999995,-0.05052
4653,3723949,12732,20,0.731579,215,3747674,-1,10000.0,5049987,5062719,1326038,12732,96,0,True,True,1457.2198333333333,-0.7068604822840318
4654,3724018,394,4,0.392883,215,3747674,-1,2000.0,5200743,5201137,1476725,394,86,6,True,True,9.617977777777776,-0.392883
4655,3733006,4,16,0.445616,215,3747674,-1,8000.0,5571751,5571755,1838745,4,56,0,True,True,0.6146666666666667,-0.445616
4656,3733414,122,4,0.595132,215,3747674,-1,2000.0,5974224,5974346,2240810,122,38,0,True,True,9.366211111111111,-0.595132
4657,3736777,71,3,0.504729,215,3747674,-1,1500.0,5975324,5975395,2238547,71,37,0,True,True,4.088120833333333,-0.504729
4658,3736867,291,2,0.222086,215,3747674,-1,1000.0,4719650,4719941,982783,291,126,2,True,True,1.9925416666666664,-0.222086
4659,3737473,40,1,0.289783,215,3747674,-1,500.0,5489251,5489291,1751778,40,69,6,True,True,0.3791111111111111,-0.289783
4660,3737586,14,4,0.394322,215,3747674,-1,2000.0,4329668,4329682,592082,14,153,0,True,True,0.5525333333333333,-0.394322
4661,3737606,16503,3,0.132189,215,3747674,-1,1500.0,4493227,4509730,755621,16503,143,0,True,True,246.82273333333336,-0.12445451907429579
4662,3737796,274,12,0.082545,215,3747674,-1,6000.0,4715937,4716211,978141,274,129,9,True,True,15.808866666666667,-0.07593779417726576
4663,3740770,18193,1,0.571441,215,3747674,-1,500.0,4982987,5001180,1242217,18193,106,1,True,True,203.38971805555556,-0.5567975317571131
4664,3740870,2,4,0.049311,215,3747674,-1,2000.0,3787674,3787676,46804,2,190,6,True,True,0.06827777777777778,-0.049311
4665,3740946,4650,1,0.399191,215,3747674,-1,500.0,4364927,4369577,623981,4650,153,10,True,True,27.744665277777777,-0.3679236168723989
4666,3741105,22,1,0.085079,215,3747674,-1,500.0,5520951,5520973,1779846,22,66,10,True,True,0.15329722222222222,-0.085079
4667,3741132,20,4,0.501823,215,3747674,-1,2000.0,6235935,6235955,2494803,20,10,0,True,True,1.0171111111111113,-0.501823
4668,3741765,21010,1,0.773825,215,3747674,-1,500.0,4472227,4493237,730462,21010,153,12,True,True,127.21819722222223,-0.6994102925533859
4669,3741794,1379,32,0.130375,215,3747674,-1,16000.0,6238135,6239514,2496341,1379,10,7,True,True,537.0798222222222,-0.12480744763322238
4670,3741818,8052,16,0.134871,215,3747674,-1,8000.0,6194350,6202402,2452532,8052,21,10,True,True,1872.1329777777778,-0.13140349801859816
4671,3742130,11773,256,0.559296,215,3747674,-1,128000.0,4964608,4976381,1222478,11773,116,7,True,True,33144.25031111111,-0.5124840959927603
4672,3742226,27737,2,0.487861,215,3747674,-1,1000.0,6232335,6260072,2490109,27737,13,6,True,True,596.5328611111111,-0.48332844188806967
4673,3744910,24,1,0.652248,215,3747674,-1,500.0,6231235,6231259,2486325,24,15,0,True,True,0.3296,-0.652248
4674,3745166,37,4,0.196099,215,3747674,-1,2000.0,4763707,4763744,1018541,37,129,2,True,True,0.6598333333333334,-0.196099
4675,3745225,5,16,0.615997,215,3747674,-1,8000.0,5977595,5977600,2232370,5,41,7,True,True,1.397,-0.615997
4676,3745556,5180,2,0.735668,215,3747674,-1,1000.0,3793074,3798254,47518,5180,201,8,True,True,93.18092777777778,-0.7279429599822071
4677,3745892,345,7,0.246246,215,3747674,-1,3500.0,4373927,4374272,628035,345,163,8,True,True,18.429493055555554,-0.2417367217065042
4678,3745926,7556,18,0.071644,215,3747674,-1,9000.0,5434151,5441707,1688225,7556,78,0,True,True,608.698825,-0.07116801693147787
4679,3746126,1346,1,0.776772,215,3747674,-1,500.0,4497637,4498983,751511,1346,151,6,True,True,6.647744444444445,-0.776772
4680,3746157,12869,5,0.323412,215,3747674,-1,2500.0,5910258,5923127,2164101,12869,52,2,True,True,430.1103125,-0.30270156117613084
4681,3746241,9785,64,0.924138,215,3747674,-1,32000.0,6053550,6063335,2307309,9785,28,4,True,True,7251.861777777778,-0.8312772112225525
4682,3746249,7103,1,0.089595,215,3747674,-1,500.0,6046350,6053453,2300101,7103,30,7,True,True,49.4339375,-0.08449185811642197
4683,3755003,82,3,0.671748,247,3770374,-1,1500.0,5230043,5230125,1475040,82,94,9,True,True,2.4036249999999995,-0.671748
4684,3755163,75,16,0.423541,247,3770374,-1,8000.0,6197950,6198025,2442787,75,23,1,True,True,18.736666666666665,-0.423541
4685,3755216,149,15,0.348308,247,3770374,-1,7500.0,4568937,4569086,813721,149,151,10,True,True,10.867687499999999,-0.348308
4686,3755303,664,1,0.320738,247,3770374,-1,500.0,5209443,5210107,1454140,664,100,7,True,True,5.547166666666667,-0.320738
4687,3755563,12,7,0.593877,247,3770374,-1,3500.0,6057150,6057162,2301587,12,29,2,True,True,0.9518833333333334,-0.593877
4688,3755616,5197,2,0.024207,247,3770374,-1,1000.0,5247251,5252448,1491635,5197,90,4,True,True,49.05298333333333,-0.023261937526763105
4689,3755685,162,1,0.304819,247,3770374,-1,500.0,4491027,4491189,735342,162,167,7,True,True,0.6277499999999999,-0.304819
4690,3755779,25,4,0.987652,247,3770374,-1,2000.0,4807134,4807159,1051355,25,134,2,True,True,0.4527777777777778,-0.987652
4691,3755886,133,1,0.616221,247,3770374,-1,500.0,4210768,4210901,454882,133,190,0,True,True,1.0628916666666668,-0.616221
4692,3756006,65,1,0.990159,247,3770374,-1,500.0,6223070,6223135,2467064,65,19,8,True,True,0.846625,-0.990159
4693,3756031,311,16,0.44221,247,3770374,-1,8000.0,6201550,6201861,2445519,311,24,2,True,True,66.1186,-0.44221
4694,3756055,4751,128,0.145818,247,3770374,-1,64000.0,6031799,6036550,2275744,4751,42,0,True,True,3784.7836444444442,-0.1423888350572098
4695,3756222,13626,35,0.044878,247,3770374,-1,17500.0,4950982,4964608,1194760,13626,133,7,True,True,9983.294805555555,-0.044705852199799216
4696,3756261,33,32,0.818172,247,3770374,-1,16000.0,5906658,5906691,2150397,33,60,6,True,True,5.325466666666667,-0.818172
4697,3756506,69,2,0.199685,247,3770374,-1,1000.0,4778634,4778703,1022128,69,143,8,True,True,0.5498916666666667,-0.199685
4698,3756759,40,8,0.373821,247,3770374,-1,4000.0,6143550,6143590,2386791,40,31,12,True,True,2.02,-0.373821
4699,3756843,17162,1,0.757734,247,3770374,-1,500.0,4368527,4385689,611684,17162,184,0,True,True,125.50940138888889,-0.6657718922055246
4700,3756862,6542,32,0.852764,247,3770374,-1,16000.0,5209443,5215985,1452581,6542,107,0,True,True,1766.7306666666666,-0.8516437273632396
4701,3756895,3,1,0.112372,247,3770374,-1,500.0,6041950,6041953,2285055,3,39,0,True,True,0.020958333333333332,-0.112372
4702,3756915,8,32,0.054538,247,3770374,-1,16000.0,5488151,5488159,1731236,8,88,9,True,True,2.426311111111111,-0.054538
4703,3757054,179,8,0.948941,247,3770374,-1,4000.0,4077574,4077753,320520,179,214,1,True,True,20.04402222222222,-0.948941
4704,3757085,210,1,0.92673,247,3770374,-1,500.0,4375027,4375237,617942,210,186,6,True,True,1.5945416666666667,-0.92673
4705,3762278,398,1,0.868752,247,3770374,-1,500.0,4705137,4705535,942859,398,161,7,True,True,3.660029166666667,-0.8293172589417677
4706,3762315,1072,16,0.820134,247,3770374,-1,8000.0,5793958,5795030,2031643,1072,66,2,True,True,131.1175111111111,-0.820134
4707,3762596,873,2,0.013733,247,3770374,-1,1000.0,4328568,4329441,565972,873,197,9,True,True,17.2272,-0.013733
4708,3762738,3561,13,0.693795,247,3770374,-1,6500.0,5073843,5077404,1311105,3561,123,1,True,True,258.29645833333336,-0.628028698167735
4709,3763357,38,8,0.111278,247,3770374,-1,4000.0,5071587,5071625,1308230,38,127,10,True,True,1.506488888888889,-0.111278
4710,3763829,30,16,0.450062,247,3770374,-1,8000.0,5103043,5103073,1339214,30,121,8,True,True,3.342,-0.450062
4711,3763901,3,1,0.022748,247,3770374,-1,500.0,4948782,4948785,1184881,3,143,11,True,True,0.055641666666666666,-0.022748
4712,3764374,127,1,0.20901,247,3770374,-1,500.0,6246135,6246262,2481761,127,7,7,True,True,1.3760097222222223,-0.20901
4713,3764568,25,1,0.538005,247,3770374,-1,500.0,4368527,4368552,603959,25,196,2,True,True,0.13541666666666666,-0.538005
4714,3765006,404,1,0.203801,247,3770374,-1,500.0,4747050,4747454,982044,404,160,2,True,True,1.9925055555555555,-0.203801
4715,3765081,180,8,0.523266,247,3770374,-1,4000.0,5696358,5696538,1931277,180,72,1,True,True,6.9319999999999995,-0.523266
4716,3765135,8,64,0.258658,247,3770374,-1,32000.0,6235935,6235943,2470800,8,12,0,True,True,6.509511111111111,-0.258658
4717,3765185,10,13,0.483026,247,3770374,-1,6500.0,4953182,4953192,1187997,10,144,0,True,True,2.546194444444445,-0.483026
4718,3766817,15506,16,0.729924,247,3770374,-1,8000.0,6225303,6240809,2458486,15506,20,2,True,True,3163.3051555555553,-0.7269082765748652
2412,2106290,17,16,0.418239,1,2106290,-1,8000.0,2149490,2149507,43200,17,0,11,True,True,9.601222222222223,-0.418239
2413,2106514,39,2,0.137867,91,2149490,-1,1000.0,2598562,2598601,492048,39,0,7,True,True,1.943066666666667,-0.137867
2414,2107603,2989,8,0.38371,91,2149490,-1,4000.0,4107053,4110042,1999450,2989,0,7,True,True,110.9878888888889,-0.3709333853964392
2415,2108333,8303,4,0.185754,91,2149490,-1,2000.0,4283696,4291999,2175363,8303,0,11,True,True,276.21583888888887,-0.17910625920692108
2416,2108437,24111,8,0.635502,91,2149490,-1,4000.0,4781083,4805194,2672646,24111,0,11,True,True,3150.8996666666667,-0.6264849946265164
2417,2108484,12,32,0.693433,91,2149490,-1,16000.0,2316124,2316136,207640,12,4,0,True,True,4.0389333333333335,-0.693433
2418,2108758,197,16,0.64526,91,2149490,-1,8000.0,3848056,3848253,1739298,197,3,12,True,True,30.46933333333333,-0.64526
2419,2108788,39,8,0.9999,91,2149490,-1,4000.0,2476062,2476101,367274,39,5,1,True,True,6.912966666666667,-0.9999
2420,2108947,3,8,0.554913,91,2149490,-1,4000.0,4677112,4677115,2568165,3,1,2,True,True,0.5559333333333334,-0.554913
2421,2108974,32,32,0.489642,91,2149490,-1,16000.0,2215390,2215422,106416,32,8,11,True,True,26.766222222222222,-0.489642
2422,2109516,18,16,0.140297,91,2149490,-1,8000.0,4342509,4342527,2232993,18,2,10,True,True,6.6272,-0.140297
2423,2111377,14909,1,0.31458,91,2149490,-1,500.0,4671312,4686221,2559935,14909,2,12,True,True,353.9424111111111,-0.3078391251809451
2424,2112022,3,1,0.451001,91,2149490,-1,500.0,3606168,3606171,1494146,3,7,1,True,True,0.033875,-0.451001
2425,2112643,18751,1,0.053611,91,2149490,-1,500.0,2882139,2900890,769496,18751,8,6,True,True,162.9145736111111,-0.05092941340161825
2426,2113179,13130,1,0.359039,91,2149490,-1,500.0,4104853,4117983,1991674,13130,6,7,True,True,64.58079305555556,-0.35472213642664335
2427,2113265,28,16,0.009583,91,2149490,-1,8000.0,2446519,2446547,333254,28,12,7,True,True,12.384088888888888,-0.009583
2428,2113530,9,2,0.136535,91,2149490,-1,1000.0,4581312,4581321,2467782,9,3,2,True,True,0.1393,-0.136535
2429,2113630,12319,142,0.815216,91,2149490,-1,71000.0,3094145,3106464,980515,12319,10,3,True,True,12281.573294444444,-0.7882457010536669
2430,2113724,4,14,0.963829,91,2149490,-1,7000.0,3430612,3430616,1316888,4,10,9,True,True,0.8264666666666667,-0.963829
2431,2113880,30,1,0.505438,91,2149490,-1,500.0,4233453,4233483,2119573,30,6,7,True,True,0.19383333333333336,-0.505438
2432,2113923,63,1,0.49497,91,2149490,-1,500.0,4317609,4317672,2203686,63,5,7,True,True,0.5945625000000001,-0.49497
2433,2114019,3743,64,0.684697,91,2149490,-1,32000.0,4235653,4239396,2121634,3743,7,7,True,True,1481.1434666666667,-0.67084833565875
2434,2114322,7782,32,0.41563,91,2149490,-1,16000.0,4099053,4106835,1984731,7782,11,0,True,True,933.5966666666666,-0.4119649579050511
2435,2114423,162,1,0.839892,91,2149490,-1,500.0,2837677,2837839,723254,162,17,2,True,True,1.6343999999999999,-0.839892
2436,2114439,8491,1,0.4887,91,2149490,-1,500.0,2150590,2159081,36151,8491,23,6,True,True,279.18461527777777,-0.4778550982465987
2437,2114630,20986,16,0.082671,91,2149490,-1,8000.0,3057660,3078646,943030,20986,16,2,True,True,3341.4702222222218,-0.08171451631744965
2438,2114633,6696,8,0.030861,91,2149490,-1,4000.0,4320909,4327605,2206276,6696,5,6,True,True,495.7075000000001,-0.030685857408119122
2439,2115210,34,1,0.761057,91,2149490,-1,500.0,3200807,3200841,1085597,34,16,6,True,True,0.5715305555555555,-0.761057
2440,2115263,60,1,0.29209,91,2149490,-1,500.0,3059860,3059920,944597,60,18,7,True,True,0.6153333333333334,-0.29209
2441,2115285,85,1,0.274853,91,2149490,-1,500.0,4575818,4575903,2460533,85,4,4,True,True,0.7326527777777778,-0.274853
2442,2117492,9,14,0.537609,91,2149490,-1,7000.0,2627777,2627786,510285,9,23,7,True,True,3.8689000000000004,-0.5376089999999999
2443,2117508,17722,1,0.168209,91,2149490,-1,500.0,3750856,3768578,1633348,17722,15,6,True,True,450.46945277777775,-0.15141779243013553
2444,2117559,200,4,0.457321,91,2149490,-1,2000.0,3020558,3020758,902999,200,22,12,True,True,5.536666666666666,-0.457321
2445,2117770,10177,85,0.742518,91,2149490,-1,42500.0,3086930,3097107,969160,10177,20,4,True,True,7055.669729166667,-0.7388775930093064
2446,2117824,8,32,0.76592,91,2149490,-1,16000.0,4684312,4684320,2566488,8,1,2,True,True,7.148088888888888,-0.76592
2447,2117897,13108,8,0.549726,91,2149490,-1,4000.0,3651593,3664701,1533696,13108,17,7,True,True,3474.687733333333,-0.5490786768261294
2448,2117914,7364,8,0.113211,91,2149490,-1,4000.0,2172190,2179554,54276,7364,34,10,True,True,1401.9843333333333,-0.10531623549668302
2449,2117989,8629,5,0.114207,91,2149490,-1,2500.0,4737883,4746512,2619894,8629,1,11,True,True,565.8572430555556,-0.11279939419708755
2450,2118041,4874,32,0.775113,91,2149490,-1,16000.0,3079460,3084334,961419,4874,24,6,True,True,1227.7322666666666,-0.765563950479496
2451,2118061,719,4,0.823283,91,2149490,-1,2000.0,4782183,4782902,2664122,719,0,0,True,True,31.212588888888888,-0.823283
2452,2118189,8698,1,0.366862,91,2149490,-1,500.0,4166453,4175151,2048264,8698,14,0,True,True,72.41122222222222,-0.354764755427943
2453,2119686,8688,2,0.822611,91,2149490,-1,1000.0,3562916,3571604,1443230,8688,22,2,True,True,95.89732222222221,-0.768489769833667
2454,2119735,139,1,0.041611,91,2149490,-1,500.0,3872956,3873095,1753221,139,18,10,True,True,0.8542708333333333,-0.041611
2455,2119857,8904,106,0.71898,91,2149490,-1,53000.0,4005845,4014749,1885988,8904,18,0,True,True,9124.486183333333,-0.5703169081153723
2456,2120189,19141,1,0.546353,91,2149490,-1,500.0,3081130,3100271,960941,19141,29,2,True,True,151.16110277777778,-0.5374327156287187
2457,2120488,210,59,0.989776,91,2149490,-1,29500.0,2437719,2437929,317231,210,40,6,True,True,267.91654166666666,-0.989776
2458,2120501,11,4,0.102416,91,2149490,-1,2000.0,3203007,3203018,1082506,11,26,7,True,True,0.7396277777777778,-0.102416
2459,2120528,857,1,0.830071,91,2149490,-1,500.0,4315409,4316266,2194881,857,11,1,True,True,8.637845833333332,-0.830071
2460,2120571,19559,9,0.751345,91,2149490,-1,4500.0,4572218,4591777,2451647,19559,8,0,True,True,1465.8062874999998,-0.748675486370091
2461,2120598,31,4,0.297709,91,2149490,-1,2000.0,4516318,4516349,2395720,31,9,9,True,True,1.11135,-0.297709
2462,2121350,12,1,0.999313,91,2149490,-1,500.0,2172190,2172202,50840,12,47,0,True,True,0.2122,-0.999313
2463,2121572,14650,128,0.449732,91,2149490,-1,64000.0,4497409,4512059,2375837,14650,10,10,True,True,20520.50808888889,-0.43978291468598346
2464,2121578,235,1,0.348577,91,2149490,-1,500.0,3113307,3113542,991729,235,32,8,True,True,1.6782916666666667,-0.348577
2465,2124500,112,2,0.816729,91,2149490,-1,1000.0,2672077,2672189,547577,112,42,10,True,True,4.802622222222222,-0.816729
2466,2124543,239,4,0.43907,91,2149490,-1,2000.0,2436619,2436858,312076,239,48,8,True,True,25.672583333333332,-0.43907
2467,2124689,6917,15,0.993958,91,2149490,-1,7500.0,3749756,3756673,1625067,6917,26,0,True,True,3339.636958333333,-0.9841607784432419
2468,2124740,12,1,0.775632,91,2149490,-1,500.0,4568618,4568630,2443878,12,9,3,True,True,0.11073333333333334,-0.775632
2469,2124925,6261,128,0.236946,91,2149490,-1,64000.0,3749756,3756017,1624831,6261,28,10,True,True,26030.7424,-0.23527988150802578
2470,2124997,143,4,0.810703,91,2149490,-1,2000.0,2329619,2329762,204622,143,52,1,True,True,11.012588888888889,-0.810703
2471,2125054,13211,4,0.587924,91,2149490,-1,2000.0,2490162,2503373,365108,13211,48,9,True,True,1546.3038000000001,-0.5866824517577157
2472,2125176,104,4,0.350631,91,2149490,-1,2000.0,4235653,4235757,2110477,104,17,0,True,True,2.4890666666666665,-0.350631
2473,2125179,31,1,0.710754,91,2149490,-1,500.0,4356609,4356640,2231430,31,12,7,True,True,0.34788888888888886,-0.710754
2474,2125414,19212,16,0.632771,91,2149490,-1,8000.0,2923361,2942573,797947,19212,45,8,True,True,1496.3831555555555,-0.5819241464028285
2475,2132350,15615,1,0.165982,91,2149490,-1,500.0,4095040,4110655,1962690,15615,25,8,True,True,61.522131944444446,-0.1642400980207404
2476,2132729,25,64,0.139235,91,2149490,-1,32000.0,3649368,3649393,1516639,25,33,11,True,True,45.86666666666667,-0.139235
2477,2132819,14871,256,0.20662,91,2149490,-1,128000.0,2900890,2915761,768071,14871,48,0,True,True,20351.981866666665,-0.17989323455731698
2478,2134008,14246,1,0.206943,91,2149490,-1,500.0,3076160,3090406,942152,14246,44,7,True,True,114.72130833333334,-0.20124336249795588
2479,2134043,15,2,0.059358,91,2149490,-1,1000.0,3073960,3073975,939917,15,45,0,True,True,0.306,-0.059358
2480,2134317,25475,128,0.350815,91,2149490,-1,64000.0,2917961,2943436,783644,25475,50,7,True,True,16262.28888888889,-0.3305842144256305
2481,2134804,225,8,0.281085,91,2149490,-1,4000.0,4049640,4049865,1914836,225,26,0,True,True,21.0125,-0.281085
2482,2134927,18621,64,0.538769,91,2149490,-1,32000.0,3237607,3256228,1102680,18621,38,9,True,True,19317.340355555556,-0.4983089065083005
2483,2134934,7127,2,0.323654,91,2149490,-1,1000.0,2585562,2592689,450628,7127,59,8,True,True,292.10734444444444,-0.3225831854800992
2484,2134970,77,1,0.704054,91,2149490,-1,500.0,4288396,4288473,2153426,77,17,2,True,True,0.6635902777777777,-0.704054
2485,2135214,3631,41,0.289333,91,2149490,-1,20500.0,2326924,2330555,191710,3631,67,8,True,True,2992.9345138888893,-0.2823762069230795
2486,2135239,16457,1,0.267343,91,2149490,-1,500.0,2447619,2464076,312380,16457,63,6,True,True,449.3743986111112,-0.2618732587529822
2487,2135398,391,8,0.858017,91,2149490,-1,4000.0,3553816,3554207,1418418,391,38,10,True,True,19.241544444444447,-0.858017
2488,2135495,20,64,0.985488,91,2149490,-1,32000.0,2649377,2649397,513882,20,59,10,True,True,14.199111111111112,-0.985488
2489,2135551,18,1,0.679299,91,2149490,-1,500.0,4089640,4089658,1954089,18,27,6,True,True,0.05695,-0.679299
2490,2135886,4,32,0.095225,91,2149490,-1,16000.0,3224607,3224611,1088721,4,42,10,True,True,3.584711111111111,-0.095225
2491,2136844,10695,140,0.962772,91,2149490,-1,70000.0,3324007,3334702,1187163,10695,41,0,True,True,27484.999888888884,-0.9601819328551373
2492,2139597,62,2,0.785691,91,2149490,-1,1000.0,4782183,4782245,2642586,62,1,6,True,True,1.3457444444444444,-0.785691
2493,2139648,15967,16,0.918769,91,2149490,-1,8000.0,4680712,4696679,2541064,15967,5,4,True,True,5677.0666,-0.8709918985181179
2494,2139768,17844,2,0.992486,91,2149490,-1,1000.0,4475809,4493653,2336041,17844,14,8,True,True,584.2564972222223,-0.9730200376479301
2495,2139994,19,10,0.867048,91,2149490,-1,5000.0,2930261,2930280,790267,19,59,6,True,True,0.8531527777777778,-0.867048
2496,2140004,18,1,0.126888,91,2149490,-1,500.0,4237853,4237871,2097849,18,22,7,True,True,0.11382500000000001,-0.126888
2497,2140073,70,32,0.866079,91,2149490,-1,16000.0,3199707,3199777,1059634,70,50,12,True,True,38.14533333333333,-0.866079
2498,2140389,2,16,0.249677,91,2149490,-1,8000.0,3027058,3027060,886669,2,60,6,True,True,0.24982222222222222,-0.249677
2499,2140483,10688,1,0.711395,91,2149490,-1,500.0,3758056,3768744,1617573,10688,36,4,True,True,223.24405555555552,-0.5871799510817003
2500,2147589,73,8,0.828482,91,2149490,-1,4000.0,4049640,4049713,1902051,73,33,7,True,True,6.817388888888888,-0.828482
2501,2148088,63,16,0.761474,91,2149490,-1,8000.0,3982756,3982819,1834668,63,35,8,True,True,5.1492,-0.761474
2502,2148106,8109,128,0.676235,91,2149490,-1,64000.0,4497409,4505518,2349303,8109,13,0,True,True,12568.059911111111,-0.6644099501983639
2503,2148766,53,2,0.489459,91,2149490,-1,1000.0,2889569,2889622,740803,53,70,8,True,True,0.9236722222222222,-0.489459
2504,2150347,22243,64,0.577426,92,2150590,-1,32000.0,4671312,4693555,2520965,22243,7,0,True,True,31620.4944,-0.5648763981424426
2505,2150391,9,1,0.268717,92,2150590,-1,500.0,3327607,3327616,1177216,9,50,1,True,True,0.2006,-0.268717
2506,2150734,417,32,0.414225,107,2172190,-1,16000.0,2446519,2446936,295785,417,83,0,True,True,368.8689333333333,-0.414225
2507,2150755,1489,1,0.451992,107,2172190,-1,500.0,4004356,4005845,1853601,1489,37,10,True,True,12.338019444444443,-0.451992
2508,2151909,206,1,0.633628,107,2172190,-1,500.0,2431219,2431425,279310,206,88,7,True,True,4.187236111111111,-0.633628
2509,2155978,12334,64,0.880125,107,2172190,-1,32000.0,4584912,4597246,2428934,12334,9,3,True,True,5741.093866666666,-0.8372635622016235
2510,2156228,71,1,0.093095,107,2172190,-1,500.0,4082040,4082111,1925812,71,35,10,True,True,0.7617708333333333,-0.093095
2511,2156396,10,2,0.515613,107,2172190,-1,1000.0,4102653,4102663,1946257,10,32,1,True,True,0.07283333333333333,-0.515613
2512,2156730,10,2,0.278226,107,2172190,-1,1000.0,4578018,4578028,2421288,10,11,7,True,True,0.1723888888888889,-0.278226
2513,2159566,9504,4,0.936336,107,2172190,-1,2000.0,2493762,2503266,334196,9504,85,1,True,True,1108.9176333333335,-0.901018671835777
2514,2159629,64,2,0.369071,107,2172190,-1,1000.0,3712593,3712657,1552964,64,49,7,True,True,3.1308444444444445,-0.369071
2515,2160021,9,16,0.950254,107,2172190,-1,8000.0,3970156,3970165,1810135,9,43,0,True,True,0.664,-0.950254
2516,2160104,10,1,0.327289,107,2172190,-1,500.0,3048660,3048670,888556,10,73,0,True,True,0.14894444444444443,-0.327289
2517,2160248,10513,32,0.002473,107,2172190,-1,16000.0,4088540,4099053,1928292,10513,37,6,True,True,1198.3793333333333,-0.0022524268537788316
2518,2168533,11303,32,0.774135,107,2172190,-1,16000.0,3754456,3765759,1585923,11303,48,2,True,True,9183.885377777779,-0.6733106239439856
2519,2170528,45,1,0.732724,107,2172190,-1,500.0,3700293,3700338,1529765,45,53,7,True,True,1.89375,-0.732724
2520,2171776,42,1,0.730932,107,2172190,-1,500.0,2447619,2447661,275843,42,94,0,True,True,1.1610083333333334,-0.730932
2521,2172033,50,32,0.458449,107,2172190,-1,16000.0,3850256,3850306,1678223,50,46,0,True,True,15.795555555555554,-0.458449
2522,2177531,42,1,0.664144,215,2215390,-1,500.0,3606116,3606158,1428585,42,58,11,True,True,0.47425,-0.664144
2523,2177773,9989,34,0.358223,215,2215390,-1,17000.0,3970156,3980145,1792383,9989,45,0,True,True,1667.8130972222225,-0.3412140771519856
2524,2178120,19,1,0.063331,215,2215390,-1,500.0,2837677,2837696,659557,19,88,0,True,True,0.1916888888888889,-0.063331
2525,2179651,3,2,0.534424,215,2215390,-1,1000.0,2321524,2321527,141873,3,107,8,True,True,0.07125000000000001,-0.534424
2526,2179836,44885,1,0.21783,215,2215390,-1,500.0,2834077,2878962,654241,44885,90,0,True,True,445.7609222222222,-0.21672482702748455
2527,2180791,11359,1,0.429643,215,2215390,-1,500.0,3970156,3981515,1789365,11359,46,12,True,True,57.47692361111111,-0.42753986806716515
2528,2180801,34,4,0.211851,215,2215390,-1,2000.0,4284796,4284830,2103995,34,25,6,True,True,1.0783666666666667,-0.211851
2529,2180879,7170,1,0.268537,215,2215390,-1,500.0,3073960,3081130,893081,7170,79,6,True,True,60.62188888888889,-0.24159478265651566
2530,2181396,263,8,0.828344,215,2215390,-1,4000.0,4004356,4004619,1822960,263,43,0,True,True,17.433977777777777,-0.828344
2531,2181471,25629,33,0.337755,215,2215390,-1,16500.0,2303990,2329619,122519,25629,114,7,True,True,11764.670408333333,-0.3120707538639478
2532,2181633,26487,1,0.577934,215,2215390,-1,500.0,3977356,4003843,1795723,26487,46,3,True,True,151.715325,-0.5267888228557576
2533,2181686,17746,1,0.566142,215,2215390,-1,500.0,3559316,3577062,1377630,17746,65,7,True,True,101.89534722222223,-0.515883389925717
2534,2181740,275,8,0.485338,215,2215390,-1,4000.0,2429019,2429294,247279,275,112,12,True,True,40.62361111111111,-0.485338
2535,2183780,63,32,0.34374,215,2215390,-1,16000.0,3723393,3723456,1539613,63,58,9,True,True,39.58080000000001,-0.34374
2536,2186989,42441,32,0.682552,215,2215390,-1,16000.0,4047440,4089881,1860451,42441,42,6,True,True,12261.071911111112,-0.6687430155696319
2537,2187170,35360,128,0.048409,215,2215390,-1,64000.0,4694683,4730043,2507513,35360,4,6,True,True,98621.30559999999,-0.048031982791597615
2538,2187180,3613,4,0.099575,215,2215390,-1,2000.0,4099053,4102666,1911873,3613,37,2,True,True,52.72665,-0.09926865274904029
2539,2187316,13,42,0.78389,215,2215390,-1,21000.0,2682877,2682890,495561,13,101,9,True,True,9.225125,-0.78389
2540,2187337,81,16,0.459582,215,2215390,-1,8000.0,3430616,3430697,1243279,81,71,1,True,True,19.1268,-0.459582
2541,2187483,4,1,0.124237,215,2215390,-1,500.0,3419812,3419816,1232329,4,73,1,True,True,0.07395555555555555,-0.124237
2542,2187802,222,4,0.857652,215,2215390,-1,2000.0,3557116,3557338,1369314,222,70,6,True,True,5.358833333333334,-0.857652
2543,2187819,142,16,0.441286,215,2215390,-1,8000.0,3649368,3649510,1461549,142,65,0,True,True,65.13066666666667,-0.441286
2544,2187867,9,1,0.000676,215,2215390,-1,500.0,3443616,3443625,1255749,9,73,9,True,True,0.13746250000000002,-0.000676
2545,2188238,603,1,0.958032,215,2215390,-1,500.0,2479362,2479965,291124,603,114,6,True,True,12.8614875,-0.958032
2546,2189734,3130,32,0.202318,215,2215390,-1,16000.0,2881039,2884169,691305,3130,103,11,True,True,1109.2094222222222,-0.20157350008986247
2547,2189831,55185,1,0.688592,215,2215390,-1,500.0,4572218,4627403,2382387,55185,15,2,True,True,421.5639666666666,-0.6767850238075469
2548,2190353,4,32,0.131913,215,2215390,-1,16000.0,3417607,3417611,1227254,4,78,12,True,True,2.3665777777777777,-0.131913
2549,2190388,645,6,0.649997,215,2215390,-1,3000.0,3025958,3026603,835570,645,98,8,True,True,30.212875,-0.649997
2550,2190559,1,8,0.158977,215,2215390,-1,4000.0,2307590,2307591,117031,1,132,1,True,True,0.11226666666666667,-0.158977
2551,2190639,2713,2,0.932726,215,2215390,-1,1000.0,3754456,3757169,1563817,2713,58,0,True,True,162.82597222222222,-0.8161579243989602
2552,2190992,4281,32,0.274019,215,2215390,-1,16000.0,4161053,4165334,1970061,4281,34,10,True,True,1656.8838666666668,-0.24454820216311532
2553,2191522,74,1,0.654588,215,2215390,-1,500.0,3973756,3973830,1782234,74,52,3,True,True,0.3386527777777778,-0.654588
2554,2191699,664,1,0.250389,215,2215390,-1,500.0,2933861,2934525,742162,664,103,4,True,True,3.3231263888888893,-0.2482116186502544
2555,2192292,119,8,0.371844,215,2215390,-1,4000.0,2895369,2895488,703077,119,108,7,True,True,7.118844444444444,-0.371844
2556,2192359,69,1,0.9038,215,2215390,-1,500.0,4005845,4005914,1813486,69,48,2,True,True,0.5717416666666666,-0.9038
2557,2192404,5243,16,0.165525,215,2215390,-1,8000.0,4099053,4104296,1906649,5243,38,0,True,True,307.23628888888885,-0.15771683956284255
2558,2192462,6613,128,0.396342,215,2215390,-1,64000.0,3225707,3232320,1033245,6613,87,0,True,True,27081.772622222226,-0.39395121594218685
2559,2193211,15,4,0.305509,215,2215390,-1,2000.0,3097107,3097122,903896,15,93,0,True,True,0.44908333333333333,-0.305509
2560,2193371,9234,32,0.699441,215,2215390,-1,16000.0,2470319,2479553,276948,9234,129,6,True,True,6681.491244444445,-0.6921090210551724
2561,2193805,9,1,0.234144,215,2215390,-1,500.0,4027445,4027454,1833640,9,48,10,True,True,0.0907625,-0.234144
2562,2193848,46,8,0.655485,215,2215390,-1,4000.0,2478262,2478308,284414,46,129,7,True,True,7.8491333333333335,-0.655485
2563,2193938,41,1,0.703698,215,2215390,-1,500.0,3027060,3027101,833122,41,105,1,True,True,0.32008472222222223,-0.703698
2564,2193984,79,1,0.001086,215,2215390,-1,500.0,2620162,2620241,426178,79,125,10,True,True,2.3773513888888886,-0.001086
2565,2193987,10037,32,0.476807,215,2215390,-1,16000.0,4117853,4127890,1923866,10037,35,9,True,True,1963.1388888888887,-0.47608771568788716
2566,2193998,237,32,0.1327,215,2215390,-1,16000.0,4095040,4095277,1901042,237,42,0,True,True,27.702666666666666,-0.1327
2567,2194621,25,1,0.226191,215,2215390,-1,500.0,3097107,3097132,902486,25,97,1,True,True,0.18711805555555555,-0.226191
2568,2194663,77,1,0.679983,215,2215390,-1,500.0,2580162,2580239,385499,77,131,12,True,True,2.0761125,-0.679983
2569,2194709,10,32,0.009287,215,2215390,-1,16000.0,3710393,3710403,1515684,10,72,1,True,True,9.234222222222224,-0.009287
2570,2194764,859,1,0.695597,215,2215390,-1,500.0,3696993,3697852,1502229,859,74,7,True,True,34.95070833333333,-0.6725280244689311
2571,2194836,28342,1,0.817109,215,2215390,-1,500.0,3706793,3735135,1511957,28342,73,6,True,True,664.6218944444444,-0.7580421400141102
2572,2194945,9,8,0.988155,215,2215390,-1,4000.0,4098640,4098649,1903695,9,42,2,True,True,0.2635,-0.988155
2573,2194955,18693,16,0.422314,215,2215390,-1,8000.0,2726077,2744770,531122,18693,128,11,True,True,3730.1232888888894,-0.4154333030417336
2574,2195011,19,1,0.132175,215,2215390,-1,500.0,4005845,4005864,1810834,19,53,0,True,True,0.1574361111111111,-0.132175
2575,2195223,77,16,0.070828,215,2215390,-1,8000.0,2442119,2442196,246896,77,148,7,True,True,29.605644444444444,-0.070828
2576,2195238,15430,32,0.38307,215,2215390,-1,16000.0,3072860,3088290,877622,15430,110,9,True,True,4086.956,-0.36820197953647194
2577,2195505,32,4,0.730763,215,2215390,-1,2000.0,2930261,2930293,734756,32,119,0,True,True,0.5747555555555556,-0.730763
2578,2195658,10815,128,0.102427,215,2215390,-1,64000.0,3083330,3094145,887672,10815,105,7,True,True,11237.392,-0.10169285574129378
2579,2195893,78,4,0.313351,215,2215390,-1,2000.0,2337219,2337297,141326,78,156,8,True,True,3.803366666666667,-0.313351
2580,2206570,9594,128,0.880989,215,2215390,-1,64000.0,3532216,3541810,1325646,9594,87,7,True,True,7806.421333333334,-0.8792523656878689
2581,2206573,16617,3,0.137129,215,2215390,-1,1500.0,4209653,4226270,2003080,16617,33,10,True,True,353.99216666666666,-0.13688163767803818
2582,2206646,72,32,0.77346,215,2215390,-1,16000.0,4045240,4045312,1838594,72,52,9,True,True,27.5136,-0.77346
2583,2206689,13325,2,0.753158,215,2215390,-1,1000.0,4319809,4333134,2113120,13325,24,7,True,True,245.00372500000003,-0.7442496360638975
2584,2206734,10,1,0.133146,215,2215390,-1,500.0,3606158,3606168,1399424,10,85,1,True,True,0.11291666666666667,-0.133146
2585,2206764,18494,1,0.99294,215,2215390,-1,500.0,4562818,4581312,2356054,18494,17,6,True,True,164.02014166666666,-0.991079721377386
2586,2206779,1110,4,0.142853,215,2215390,-1,2000.0,2884169,2885279,677390,1110,133,1,True,True,48.352833333333336,-0.142853
2587,2206857,26637,32,0.530508,215,2215390,-1,16000.0,4240496,4267133,2033639,26637,31,6,True,True,6245.148933333334,-0.49564866864209944
2588,2207013,25,32,0.008475,215,2215390,-1,16000.0,4671312,4671337,2464299,25,9,0,True,True,16.00444444444444,-0.008475
2589,2207065,18862,128,0.65002,215,2215390,-1,64000.0,3432816,3451678,1225751,18862,96,7,True,True,33369.509333333335,-0.6334362586539304
2590,2207184,21992,4,0.440099,215,2215390,-1,2000.0,3883756,3905748,1676572,21992,69,9,True,True,703.2615333333333,-0.43800225666819426
2591,2207357,15,2,0.722432,215,2215390,-1,1000.0,2620162,2620177,412805,15,148,0,True,True,0.9027916666666665,-0.722432
2592,2208090,232,1,0.62808,215,2215390,-1,500.0,3698093,3698325,1490003,232,84,6,True,True,9.763333333333334,-0.62808
2593,2208115,17,13,0.151374,215,2215390,-1,6500.0,4188053,4188070,1979938,17,38,10,True,True,1.4398763888888888,-0.151374
2594,2208129,286,16,0.41171,215,2215390,-1,8000.0,4687912,4688198,2479783,286,5,3,True,True,91.51364444444445,-0.41171
2595,2208414,12148,4,0.686566,215,2215390,-1,2000.0,3324007,3336155,1115593,12148,107,12,True,True,876.2596555555556,-0.6847529409313616
2596,2208490,9,1,0.859963,215,2215390,-1,500.0,4239396,4239405,2030906,9,34,2,True,True,0.056912500000000005,-0.859963
2597,2208498,3658,1,0.086688,215,2215390,-1,500.0,4237853,4241511,2029355,3658,35,0,True,True,22.495819444444443,-0.08449422658324146
2598,2208577,29,29,0.100465,215,2215390,-1,14500.0,2834077,2834106,625500,29,149,12,True,True,7.781586111111111,-0.100465
2599,2208764,14,2,0.752446,215,2215390,-1,1000.0,3970156,3970170,1761392,14,70,0,True,True,0.12911111111111112,-0.752446
2600,2208837,20,45,0.589574,215,2215390,-1,22500.0,3705693,3705713,1496856,20,88,8,True,True,31.03375,-0.589574
2601,2208985,23370,128,0.384032,215,2215390,-1,64000.0,4354409,4377779,2145424,23370,25,6,True,True,33103.47146666666,-0.3615399696966635
2602,2208989,13,16,0.963249,215,2215390,-1,8000.0,2331819,2331832,122830,13,179,7,True,True,4.004577777777778,-0.963249
2603,2209089,77,2,0.314504,215,2215390,-1,1000.0,4060440,4060517,1851351,77,58,9,True,True,1.4326277777777778,-0.314504
2604,2209115,20024,16,0.13983,215,2215390,-1,8000.0,2625577,2645601,416462,20024,159,8,True,True,6974.91091111111,-0.1334251792926679
2605,2209312,12,8,0.276968,215,2215390,-1,4000.0,4309996,4310008,2100684,12,31,10,True,True,1.0633333333333335,-0.276968
2606,2209681,7,8,0.084249,215,2215390,-1,4000.0,3048660,3048667,838979,7,136,0,True,True,0.8340888888888889,-0.084249
2607,2209843,7,4,0.553397,215,2215390,-1,2000.0,4565018,4565025,2355175,7,19,7,True,True,0.26331666666666664,-0.553397
2608,2209869,14334,200,0.600008,215,2215390,-1,100000.0,2301790,2316124,91921,14334,191,12,True,True,35797.83111111111,-0.5941938884118343
2609,2210022,15128,16,0.607593,215,2215390,-1,8000.0,2934158,2949286,724136,15128,142,1,True,True,1844.7884444444444,-0.5137794613526184
2610,2210067,27,1,0.77897,215,2215390,-1,500.0,4353309,4353336,2143242,27,27,9,True,True,0.4733625,-0.77897
2611,2210090,13392,4,0.690476,215,2215390,-1,2000.0,4561718,4575110,2351628,13392,21,7,True,True,483.0386,-0.6863680672541865
2612,2210114,5508,64,0.847892,215,2215390,-1,32000.0,2837839,2843347,627725,5508,156,2,True,True,3206.2198222222223,-0.8164485661358373
2613,2210138,12475,95,0.658405,215,2215390,-1,47500.0,3048660,3061135,838522,12475,140,10,True,True,14433.74517361111,-0.6014452421991257
2614,2210185,85,1,0.301649,215,2215390,-1,500.0,2650477,2650562,440292,85,165,6,True,True,0.9057222222222222,-0.301649
2615,2210269,8658,16,0.517749,215,2215390,-1,8000.0,2596362,2605020,386093,8658,172,9,True,True,3435.6623999999997,-0.5157813918803719
2616,2210293,1166,14,0.509523,215,2215390,-1,7000.0,3724556,3725722,1514263,1166,90,6,True,True,320.4945333333334,-0.509523
2617,2210526,487,5,0.747844,215,2215390,-1,2500.0,2439919,2440406,229393,487,187,7,True,True,52.65349305555556,-0.747844
2618,2210579,16,2,0.295542,215,2215390,-1,1000.0,4405609,4405625,2195030,16,26,7,True,True,0.5462222222222223,-0.295542
2619,2210710,57968,83,0.054569,215,2215390,-1,41500.0,4399809,4457777,2189099,57968,27,0,True,True,93299.0566138889,-0.05421130199571852
2620,2210889,7752,64,0.897913,215,2215390,-1,32000.0,3761656,3769408,1550767,7752,86,3,True,True,9058.98311111111,-0.7251934979733463
2621,2210918,5,2,0.954672,215,2215390,-1,1000.0,4403409,4403414,2192491,5,27,2,True,True,0.17069444444444445,-0.954672
2622,2211017,122,4,0.494888,215,2215390,-1,2000.0,2444319,2444441,233302,122,190,7,True,True,12.31936111111111,-0.45194880279190125
2623,2211488,280,3,0.112744,215,2215390,-1,1500.0,3694793,3695073,1483305,280,103,11,True,True,30.485000000000003,-0.112744
2624,2211789,27,2,0.499583,215,2215390,-1,1000.0,4427209,4427236,2215420,27,26,10,True,True,1.205925,-0.499583
2625,2211797,10983,64,0.59393,215,2215390,-1,32000.0,3556016,3566999,1344219,10983,114,7,True,True,3619.1568,-0.5353413351067529
2626,2211812,15454,1,0.528287,215,2215390,-1,500.0,3225707,3241161,1013895,15454,128,6,True,True,472.5204069444444,-0.5264714251743035
2627,2211845,4,4,0.977697,215,2215390,-1,2000.0,2620177,2620181,408332,4,178,1,True,True,0.48148888888888886,-0.977697
2628,2211964,343,32,0.986883,215,2215390,-1,16000.0,2475719,2476062,263755,343,190,8,True,True,243.19462222222222,-0.986883
2629,2211969,76,4,0.933924,215,2215390,-1,2000.0,4031140,4031216,1819171,76,71,1,True,True,5.925888888888889,-0.933924
2630,2211985,12454,1,0.131983,215,2215390,-1,500.0,4034440,4046894,1822455,12454,71,7,True,True,187.44715277777777,-0.11840272793126778
2631,2212785,6,32,0.860814,215,2215390,-1,16000.0,2929161,2929167,716376,6,160,7,True,True,0.8621333333333333,-0.860814
2632,2217450,13,4,0.56838,250,2301790,-1,2000.0,4315396,4315409,2097946,13,38,8,True,True,0.5241166666666666,-0.56838
2633,2217922,28,64,0.365412,250,2301790,-1,32000.0,2726077,2726105,508155,28,175,0,True,True,24.829155555555555,-0.365412
2634,2218080,3,8,0.682942,250,2301790,-1,4000.0,3107907,3107910,889827,3,137,9,True,True,0.18200000000000002,-0.682942
2635,2218177,21171,128,0.762726,250,2301790,-1,64000.0,4673512,4694683,2455335,21171,9,7,True,True,60024.60888888889,-0.7165231478461332
2636,2218200,4916,16,0.954453,250,2301790,-1,8000.0,2747677,2752593,529477,4916,177,10,True,True,1118.2989333333333,-0.9231700291884083
2637,2218257,19,32,0.770367,250,2301790,-1,16000.0,2469219,2469238,250962,19,200,10,True,True,14.837733333333334,-0.770367
2638,2218294,549,1,0.016689,250,2301790,-1,500.0,2926961,2927510,708667,549,164,2,True,True,2.4651625,-0.016689
2639,2218364,346,27,0.067533,250,2301790,-1,13500.0,3649393,3649739,1431029,346,110,1,True,True,267.804,-0.067533
2640,2218378,6,1,0.262185,250,2301790,-1,500.0,3728156,3728162,1509778,6,99,2,True,True,0.09984166666666668,-0.262185
2641,2218446,1149,8,0.039827,250,2301790,-1,4000.0,3078360,3079509,859914,1149,148,7,True,True,74.04666666666667,-0.039827
2642,2220087,297,16,0.060469,250,2301790,-1,8000.0,2933861,2934158,713774,297,163,0,True,True,23.52457777777778,-0.05929338892269786
2643,2220171,31,13,0.78929,250,2301790,-1,6500.0,4032240,4032271,1812069,31,74,6,True,True,8.341540277777778,-0.78929
2644,2220465,52,4,0.506611,250,2301790,-1,2000.0,2889569,2889621,669104,52,174,0,True,True,1.8124888888888888,-0.506611
2645,2223616,112,7,0.628571,250,2301790,-1,3500.0,4139453,4139565,1915837,112,55,10,True,True,4.818333333333333,-0.628571
2646,2223755,4483,1,0.501049,250,2301790,-1,500.0,4087440,4091923,1863685,4483,68,8,True,True,16.85371388888889,-0.45318590489624766
2647,2223976,4,6,0.415432,250,2301790,-1,3000.0,2915761,2915765,691785,4,174,1,True,True,0.11396666666666665,-0.415432
2648,2224069,34,3,0.701811,250,2301790,-1,1500.0,4354409,4354443,2130340,34,32,0,True,True,1.7882583333333335,-0.7018110000000001
2649,2224162,9841,64,0.082428,250,2301790,-1,32000.0,4399809,4409650,2175647,9841,31,11,True,True,11642.690044444444,-0.08132894563593043
2650,2224894,3827,1,0.536565,250,2301790,-1,500.0,3850256,3854083,1625362,3827,96,7,True,True,33.765433333333334,-0.4851554793381544
2651,2224911,713,4,0.616047,250,2301790,-1,2000.0,4166453,4167166,1941542,713,56,8,True,True,20.229394444444445,-0.616047
2652,2224927,116,8,0.277468,250,2301790,-1,4000.0,2342619,2342735,117692,116,226,8,True,True,8.3752,-0.277468
2653,2226269,118,8,0.309907,250,2301790,-1,4000.0,4470409,4470527,2244140,118,27,11,True,True,7.770955555555557,-0.309907
2654,2226296,4979,17,0.511305,250,2301790,-1,8500.0,3062060,3067039,835764,4979,161,7,True,True,864.1569625,-0.5110127700168586
2655,2226375,73,4,0.203197,250,2301790,-1,2000.0,4505518,4505591,2279143,73,24,0,True,True,2.9362222222222223,-0.203197
2656,2226742,2595,16,0.80806,250,2301790,-1,8000.0,4028545,4031140,1801803,2595,83,6,True,True,809.3516666666666,-0.80806
2657,2226774,23165,1,0.53639,250,2301790,-1,500.0,3331207,3354372,1104433,23165,139,3,True,True,465.2291958333333,-0.5209403607233881
2658,2227829,24,4,0.390732,250,2301790,-1,2000.0,2893169,2893193,665340,24,186,3,True,True,0.7014666666666667,-0.390732
2659,2228113,10,8,0.634294,250,2301790,-1,4000.0,3851356,3851366,1623243,10,99,6,True,True,0.7897777777777778,-0.634294
2660,2228175,6,16,0.834526,250,2301790,-1,8000.0,3054060,3054066,825885,6,168,8,True,True,1.2752000000000001,-0.834526
2661,2228383,432,32,0.681056,250,2301790,-1,16000.0,3530016,3530448,1301633,432,134,12,True,True,76.0128,-0.681056
2662,2228637,7092,1,0.066115,250,2301790,-1,500.0,4559518,4566610,2330881,7092,23,11,True,True,59.545830555555554,-0.06261188578377215
2663,2229278,185,1,0.698676,250,2301790,-1,500.0,3226807,3226992,997529,185,147,6,True,True,5.685409722222222,-0.698676
2664,2229642,11216,1,0.729958,250,2301790,-1,500.0,3723456,3734672,1493814,11216,113,1,True,True,211.02864444444447,-0.6783382846857465
2665,2229695,804,2,0.846468,250,2301790,-1,1000.0,4231253,4232057,2001558,804,56,10,True,True,10.389466666666667,-0.846468
2666,2229769,19826,32,0.057906,250,2301790,-1,16000.0,4046340,4066166,1816571,19826,81,6,True,True,6244.197422222222,-0.054808574327097126
2667,2229799,5,1,0.086213,250,2301790,-1,500.0,3419807,3419812,1190008,5,144,7,True,True,0.09244444444444445,-0.086213
5518,4447222,5,1,0.647793,1,4447222,-1,500.0,4468822,4468827,21600,5,0,10,True,True,0.111375,-0.647793
5519,4447274,9180,256,0.176618,72,4468822,-1,128000.0,4899062,4908242,451788,9180,0,0,True,True,45240.41031111111,-0.16028570868692263
5520,4447328,14,32,0.039331,72,4468822,-1,16000.0,5998113,5998127,1550785,14,0,4,True,True,8.012977777777778,-0.039331
5521,4447560,21273,4,0.384164,72,4468822,-1,2000.0,5162883,5184156,715323,21273,1,6,True,True,1467.8301833333335,-0.36839931974305296
5522,4447584,229,4,0.191003,72,4468822,-1,2000.0,6116313,6116542,1668729,229,0,7,True,True,12.92446111111111,-0.1858257809237803
5523,4447982,25979,118,0.695882,72,4468822,-1,59000.0,5970492,5996471,1522510,25979,2,0,True,True,55591.301550000004,-0.6680463565147016
5524,4448069,22,1,0.896461,72,4468822,-1,500.0,6838543,6838565,2390474,22,0,8,True,True,0.36431388888888894,-0.896461
5525,4448097,102,16,0.630617,72,4468822,-1,8000.0,5107783,5107885,659686,102,5,9,True,True,25.2756,-0.630617
5526,4448179,5,15,0.359261,72,4468822,-1,7500.0,4696927,4696932,248748,5,7,7,True,True,1.1877083333333334,-0.359261
5527,4448207,22666,32,0.084862,72,4468822,-1,16000.0,4540127,4562793,91920,22666,8,0,True,True,11823.375644444444,-0.0826120444494664
5528,4448248,31,4,0.632791,72,4468822,-1,2000.0,4942262,4942293,494014,31,6,11,True,True,1.7849111111111111,-0.632791
5529,4448319,7814,128,0.735324,72,4468822,-1,64000.0,4700527,4708341,252208,7814,8,0,True,True,14216.516622222221,-0.7121013889612412
5530,4448730,31,16,0.139943,72,4468822,-1,8000.0,4727927,4727958,279197,31,8,10,True,True,8.609733333333333,-0.139943
5531,4448774,16,4,0.193093,72,4468822,-1,2000.0,5723092,5723108,1274318,16,4,0,True,True,1.1872,-0.193093
5532,4448838,33,2,0.719739,72,4468822,-1,1000.0,6782326,6782359,2333488,33,1,8,True,True,0.9556250000000001,-0.719739
5533,4449247,7918,1,0.592945,72,4468822,-1,500.0,4694727,4702645,245480,7918,13,0,True,True,120.65711944444445,-0.5911692695375238
5534,4449408,16395,12,0.489233,72,4468822,-1,6000.0,6378541,6394936,1929133,16395,2,0,True,True,2345.2201333333333,-0.4396276256813406
5535,4449879,56,1,0.062993,72,4468822,-1,500.0,5596692,5596748,1146813,56,7,1,True,True,0.9330222222222222,-0.062993
5536,4449895,2398,16,0.540552,72,4468822,-1,8000.0,6154232,6156630,1704337,2398,3,0,True,True,429.33088888888886,-0.536997291170509
5537,4450351,3163,1,0.307731,72,4468822,-1,500.0,6078413,6081576,1628062,3163,5,0,True,True,31.865077777777778,-0.30163922463860005
5538,4450360,14342,4,0.53394,72,4468822,-1,2000.0,4630927,4645269,180567,14342,18,6,True,True,1137.1858055555556,-0.5108793482491468
5539,4450400,39,8,0.83425,72,4468822,-1,4000.0,6538817,6538856,2088417,39,2,8,True,True,7.5933,-0.83425
5540,4450560,13230,1,0.449307,72,4468822,-1,500.0,4950962,4964192,500402,13230,13,7,True,True,198.16880833333335,-0.44756469726877796
5541,4450635,25896,1,0.995834,72,4468822,-1,500.0,6639726,6665622,2189091,25896,2,1,True,True,444.2031083333334,-0.981239018513815
5542,4450670,16527,32,0.037043,72,4468822,-1,16000.0,4468827,4485354,18157,16527,23,1,True,True,11642.813333333334,-0.03689468371875989
5543,4450960,155,9,0.056054,72,4468822,-1,4500.0,5241883,5242038,790923,155,12,10,True,True,27.442749999999997,-0.056054
5544,4451396,7764,4,0.787779,72,4468822,-1,2000.0,6685126,6692890,2233730,7764,2,11,True,True,636.1091444444444,-0.7784625624086237
5545,4451584,107,82,0.042815,72,4468822,-1,41000.0,4746727,4746834,295143,107,19,7,True,True,138.6413861111111,-0.042815
5546,4451620,44,32,0.118187,72,4468822,-1,16000.0,4858405,4858449,406785,44,19,9,True,True,15.74808888888889,-0.118187
5547,4451634,8215,9,0.807104,72,4468822,-1,4500.0,4798927,4807142,347293,8215,20,0,True,True,1246.9912,-0.7958676826966861
5548,4452803,26155,4,0.667316,72,4468822,-1,2000.0,5242983,5269138,790180,26155,13,0,True,True,1857.132466666667,-0.6605509320381375
5549,4452848,156,2,0.45837,72,4468822,-1,1000.0,5998113,5998269,1545265,156,9,0,True,True,5.580466666666667,-0.45837
5550,4453339,29,8,0.678078,72,4468822,-1,4000.0,5410883,5410912,957544,29,14,7,True,True,4.702188888888889,-0.678078
5551,4453369,15,7,0.874255,72,4468822,-1,3500.0,6042413,6042428,1589044,15,9,0,True,True,1.2707916666666668,-0.874255
5552,4453378,6,32,0.148954,72,4468822,-1,16000.0,6870243,6870249,2416865,6,0,8,True,True,2.8392,-0.148954
5553,4453717,113,1,0.579346,72,4468822,-1,500.0,6825526,6825639,2371809,113,2,11,True,True,1.4246055555555557,-0.5620778694245707
5554,4453925,74,8,0.924816,72,4468822,-1,4000.0,5421683,5421757,967758,74,17,9,True,True,10.35671111111111,-0.924816
5555,4453933,9,1,0.036878,72,4468822,-1,500.0,5176983,5176992,723050,9,21,9,True,True,0.18221250000000003,-0.036878
5556,4453955,12221,8,0.14159,72,4468822,-1,4000.0,4750327,4762548,296372,12221,29,3,True,True,1586.6499777777776,-0.14080059728938973
5557,4454014,19588,16,0.653832,72,4468822,-1,8000.0,6874643,6894231,2420629,19588,0,7,True,True,3359.4454666666675,-0.6219622094123985
5558,4454143,24945,32,0.47122,72,4468822,-1,16000.0,4863805,4888750,409662,24945,28,0,True,True,13769.238,-0.470356391083628
5559,4454163,5965,16,0.918019,72,4468822,-1,8000.0,4982362,4988327,528199,5965,25,8,True,True,1813.8914444444445,-0.8180478327950981
5560,4454391,10287,188,0.045802,72,4468822,-1,94000.0,6020813,6031100,1566422,10287,13,0,True,True,35475.3415,-0.042598234439954814
5561,4454436,55,16,0.701297,72,4468822,-1,8000.0,6633917,6633972,2179481,55,7,7,True,True,12.00711111111111,-0.701297
5562,4454459,501,64,0.130538,72,4468822,-1,32000.0,6078413,6078914,1623954,501,12,0,True,True,329.5466666666666,-0.130538
5563,4454483,14827,128,0.172249,72,4468822,-1,64000.0,6782326,6797153,2327843,14827,4,0,True,True,33485.50311111111,-0.16755764718400945
5564,4454632,15,32,0.049958,72,4468822,-1,16000.0,4740927,4740942,286295,15,38,2,True,True,7.162,-0.049958
5565,4454811,9,1,0.307337,72,4468822,-1,500.0,5165083,5165092,710272,9,27,7,True,True,0.13746250000000002,-0.307337
5566,4454844,13049,16,0.793697,72,4468822,-1,8000.0,6381841,6394890,1926997,13049,10,7,True,True,2536.7889777777777,-0.7009350546887724
5567,4455102,16479,32,0.456185,72,4468822,-1,16000.0,5056983,5073462,601881,16479,31,1,True,True,9635.0952,-0.4276250422296894
5568,4455208,4,32,0.170689,72,4468822,-1,16000.0,5994513,5994517,1539305,4,20,0,True,True,2.3712,-0.170689
5569,4455263,5,16,0.591042,72,4468822,-1,8000.0,5994513,5994518,1539250,5,21,1,True,True,1.482,-0.591042
5570,4455308,375,2,0.8178,72,4468822,-1,1000.0,4643927,4644302,188619,375,48,9,True,True,13.764083333333334,-0.8055174547894148
5571,4455339,34906,1,0.106331,72,4468822,-1,500.0,4733727,4768633,278388,34906,44,0,True,True,576.2751791666666,-0.10387113581089699
5572,4455394,18,4,0.497143,72,4468822,-1,2000.0,6512541,6512559,2057147,18,10,9,True,True,1.5063,-0.497143
5573,4455785,17910,1,0.799175,72,4468822,-1,500.0,6631717,6649627,2175932,17910,9,12,True,True,269.21936388888884,-0.7662894407079839
5574,4455800,37228,37,0.220573,72,4468822,-1,18500.0,6993220,7030448,2537420,37228,0,11,True,True,24521.178761111114,-0.2170029092840074
5575,4455844,11896,34,0.804454,72,4468822,-1,17000.0,5594483,5606379,1138639,11896,28,0,True,True,7153.181469444444,-0.7549930087725235
5576,4455958,137,1,0.426211,72,4468822,-1,500.0,6113013,6113150,1657055,137,17,10,True,True,1.8451236111111111,-0.426211
5577,4457648,36,1,0.811521,72,4468822,-1,500.0,4956762,4956798,499114,36,40,7,True,True,0.5223,-0.811521
5578,4463451,4177,64,0.982193,72,4468822,-1,32000.0,5744692,5748869,1281241,4177,27,0,True,True,6561.192444444444,-0.9808251304906723
5579,4463634,4,1,0.678398,72,4468822,-1,500.0,5810592,5810596,1346958,4,27,6,True,True,0.06946111111111111,-0.678398
5580,4463694,276,4,0.324235,72,4468822,-1,2000.0,6776926,6777202,2313232,276,7,12,True,True,16.503266666666665,-0.324235
5581,4463947,536,24,0.975853,72,4468822,-1,12000.0,4976962,4977498,513015,536,43,0,True,True,247.5784,-0.975853
5582,4464265,6,8,0.575967,72,4468822,-1,4000.0,5161783,5161789,697518,6,40,11,True,True,0.7839333333333334,-0.575967
5583,4464805,14525,1,0.137329,72,4468822,-1,500.0,5252083,5266608,787278,14525,35,4,True,True,251.40656666666666,-0.13548361685110905
5584,4464867,73,1,0.836427,72,4468822,-1,500.0,6208241,6208314,1743374,73,16,10,True,True,0.8505513888888888,-0.836427
5585,4464895,499,4,0.793102,72,4468822,-1,2000.0,6637517,6638016,2172622,499,10,0,True,True,27.65568888888889,-0.793102
5586,4465011,103,8,0.764228,72,4468822,-1,4000.0,6373141,6373244,1908130,103,17,11,True,True,9.398177777777779,-0.764228
5587,4465046,13,2,0.593085,72,4468822,-1,1000.0,4490427,4490440,25381,13,67,10,True,True,0.5311944444444444,-0.593085
5588,4465557,56,8,0.335504,72,4468822,-1,4000.0,6078413,6078469,1612856,56,24,9,True,True,4.604444444444444,-0.335504
5589,4465601,18274,1,0.120745,72,4468822,-1,500.0,6854043,6872317,2388442,18274,3,6,True,True,310.52025416666663,-0.11706859928369949
5590,4465636,78,2,0.141237,72,4468822,-1,1000.0,4798927,4799005,333291,78,58,0,True,True,2.5614333333333335,-0.141237
5591,4476701,15193,1,0.415154,91,4490427,-1,500.0,6436941,6452134,1960240,15193,16,6,True,True,215.1791472222222,-0.4080609285795415
5592,4476870,237,1,0.696296,91,4490427,-1,500.0,6501741,6501978,2024871,237,16,11,True,True,4.080020833333333,-0.696296
5593,4476890,59,2,0.553408,91,4490427,-1,1000.0,6020813,6020872,1543923,59,30,10,True,True,2.774638888888889,-0.553408
5594,4477000,18387,1,0.438661,91,4490427,-1,500.0,5053383,5071770,576383,18387,52,0,True,True,350.62497499999995,-0.4244259200674945
5595,4477331,7032,32,0.925676,91,4490427,-1,16000.0,6238841,6245873,1761510,7032,21,0,True,True,2909.290933333333,-0.9200531368528958
5596,4477589,2634,1,0.040699,91,4490427,-1,500.0,6833143,6835777,2355554,2634,5,7,True,True,44.4268,-0.040699
5597,4479098,38,36,0.099968,91,4490427,-1,18000.0,5408683,5408721,929585,38,45,8,True,True,28.7052,-0.099968
5598,4479574,116,32,0.847367,91,4490427,-1,16000.0,5944192,5944308,1464618,116,38,7,True,True,75.59075555555556,-0.847367
5599,4479759,23,1,0.612442,91,4490427,-1,500.0,6842143,6842166,2362384,23,4,3,True,True,0.4200055555555555,-0.612442
5600,4479965,23122,85,0.777662,91,4490427,-1,42500.0,4629827,4652949,149862,23122,78,7,True,True,39895.33602777778,-0.7545085645042957
5601,4479974,874,1,0.01563,91,4490427,-1,500.0,6864843,6865717,2384869,874,3,8,True,True,14.526102777777776,-0.015344794526257213
5602,4480013,903,2,0.486967,91,4490427,-1,1000.0,5242983,5243886,762970,903,51,0,True,True,35.52803333333333,-0.486967
5603,4480707,9507,16,0.00635,91,4490427,-1,8000.0,5244083,5253590,763376,9507,50,6,True,True,2772.3850666666667,-0.006129406219111535
5604,4480767,60,1,0.179413,91,4490427,-1,500.0,4534727,4534787,53960,60,83,11,True,True,0.7795833333333333,-0.179413
5605,4480810,29,1,0.089141,91,4490427,-1,500.0,4629827,4629856,149017,29,81,0,True,True,0.7076805555555555,-0.089141
5606,4480861,9072,3,0.651756,91,4490427,-1,1500.0,6159641,6168713,1678780,9072,26,1,True,True,347.37041666666664,-0.6277234157938457
5607,4482498,10,121,0.886915,91,4490427,-1,60500.0,4954562,4954572,472064,10,65,2,True,True,17.555083333333332,-0.8869149999999998
5608,4483981,53,28,0.416222,91,4490427,-1,14000.0,5086183,5086236,602202,53,60,7,True,True,30.026266666666668,-0.416222
5609,4485144,20673,1,0.807412,91,4490427,-1,500.0,6859443,6880116,2374299,20673,4,0,True,True,313.7583916666666,-0.7844436763543924
5610,4487909,4,1,0.772563,91,4490427,-1,500.0,4491527,4491531,3618,4,89,6,True,True,0.08172222222222222,-0.772563
5611,4487985,15,64,0.692358,91,4490427,-1,32000.0,6907599,6907614,2419614,15,1,10,True,True,23.269333333333336,-0.692358
5612,4510866,85,16,0.20616,170,4534727,-1,8000.0,4541227,4541312,30361,85,88,6,True,True,17.69322222222222,-0.20616
5613,4510882,3,3,0.639826,170,4534727,-1,1500.0,6053213,6053216,1542331,3,35,9,True,True,0.10830000000000001,-0.639826
5614,4511154,16606,8,0.523087,170,4534727,-1,4000.0,4649327,4665933,138173,16606,85,8,True,True,3057.5267444444444,-0.5210183324855238
5615,4511179,215,32,0.412031,170,4534727,-1,16000.0,4540127,4540342,28948,215,92,8,True,True,89.5068888888889,-0.412031
5616,4511310,19035,8,0.93809,170,4534727,-1,4000.0,6995420,7014455,2484110,19035,0,7,True,True,2679.2683333333334,-0.922054714714814
5617,4511499,4827,1,0.610538,170,4534727,-1,500.0,6641926,6646753,2130427,4827,16,7,True,True,74.54465138888888,-0.5833341122570209
5618,4511753,13257,16,0.037621,170,4534727,-1,8000.0,5965792,5979049,1454039,13257,46,10,True,True,4196.951466666667,-0.03721089578095156
5619,4511871,26313,256,0.18,170,4534727,-1,128000.0,6919307,6945620,2407436,26313,2,6,True,True,115023.53457777777,-0.17949260931199434
5620,4511897,9,1,0.499888,170,4534727,-1,500.0,4798927,4798936,287030,9,81,0,True,True,0.147775,-0.499888
5621,4512052,29,1,0.950298,170,4534727,-1,500.0,6186641,6186670,1674589,29,31,9,True,True,0.4954972222222222,-0.950298
5622,4512336,7,4,0.627192,170,4534727,-1,2000.0,6993220,6993227,2480884,7,1,0,True,True,0.5655611111111111,-0.627192
5623,4512344,10183,128,0.782583,170,4534727,-1,64000.0,6118527,6128710,1606183,10183,35,3,True,True,15463.101511111112,-0.7253008728958064
5624,4512484,6867,1,0.347854,170,4534727,-1,500.0,6880176,6887043,2367692,6867,5,1,True,True,70.2269375,-0.3453523850283388
5625,4512523,10641,4,0.00457,170,4534727,-1,2000.0,6378541,6389182,1866018,10641,29,0,True,True,432.8255111111111,-0.004238321696235926
5626,4512568,9408,20,0.235639,170,4534727,-1,10000.0,4730127,4739535,217559,9408,91,7,True,True,2704.41275,-0.21529643907424215
5627,4513133,10312,256,0.117508,170,4534727,-1,128000.0,4888750,4899062,375617,10312,82,8,True,True,56684.73742222223,-0.11677645031910079
5628,4513172,278,8,0.530199,170,4534727,-1,4000.0,5966892,5967170,1453720,278,52,6,True,True,44.17111111111111,-0.530199
5629,4513229,131,1,0.095684,170,4534727,-1,500.0,4799005,4799136,285776,131,86,2,True,True,2.150947222222222,-0.095684
5630,4513502,29923,8,0.361901,170,4534727,-1,4000.0,6830943,6860866,2317441,29923,14,1,True,True,3960.674944444444,-0.3563871890145336
5631,4513893,115,4,0.761128,170,4534727,-1,2000.0,5403283,5403398,889390,115,64,12,True,True,7.600861111111111,-0.761128
5632,4513961,12531,206,0.539723,170,4534727,-1,103000.0,5723092,5735623,1209131,12531,59,8,True,True,47730.38940555555,-0.5243256498984564
5633,4514005,12786,1,0.219276,170,4534727,-1,500.0,5247383,5260169,733378,12786,67,7,True,True,222.31106527777777,-0.21240184940700507
5634,4516809,8,128,0.770331,170,4534727,-1,64000.0,6165041,6165049,1648232,8,36,8,True,True,14.250666666666667,-0.770331
5635,4516825,14,2,0.659327,170,4534727,-1,1000.0,6782326,6782340,2265501,14,16,0,True,True,0.40541666666666665,-0.659327
5636,4516932,25708,1,0.276427,170,4534727,-1,500.0,6175841,6201549,1658909,25708,37,0,True,True,438.4360791666667,-0.27343944126625175
5637,4517075,17,1,0.193719,170,4534727,-1,500.0,6830926,6830943,2313851,17,15,8,True,True,0.26569583333333335,-0.193719
5638,4517257,2,1,0.796613,170,4534727,-1,500.0,6392641,6392643,1875384,2,31,9,True,True,0.031169444444444444,-0.796613
5639,4517345,1051,16,0.685244,170,4534727,-1,8000.0,6113013,6114064,1595668,1051,45,0,True,True,226.47882222222222,-0.685244
5640,4517516,8846,64,0.968574,170,4534727,-1,32000.0,6042413,6051259,1524897,8846,52,10,True,True,7024.774044444444,-0.9534101039920806
5641,4517639,67,16,0.474413,170,4534727,-1,8000.0,6134145,6134212,1616506,67,43,8,True,True,14.675977777777776,-0.474413
5642,4518334,13,4,0.176324,170,4534727,-1,2000.0,6877943,6877956,2359609,13,6,7,True,True,0.6520944444444444,-0.176324
5643,4518433,41,4,0.670143,170,4534727,-1,2000.0,5242983,5243024,724550,41,80,6,True,True,3.2262444444444442,-0.670143
5644,4519280,15706,216,0.043116,170,4534727,-1,108000.0,5815992,5831698,1296712,15706,65,8,True,True,51440.5686,-0.04002259507705264
5645,4520412,26,4,0.644861,170,4534727,-1,2000.0,5704692,5704718,1184280,26,70,10,True,True,1.4136777777777778,-0.644861
5646,4521523,8,1,0.285065,170,4534727,-1,500.0,4799005,4799013,277482,8,102,0,True,True,0.13135555555555556,-0.285065
5647,4521690,260,24,0.434672,170,4534727,-1,12000.0,5211583,5211843,689893,260,84,9,True,True,122.26933333333334,-0.434672
5648,4521909,11,2,0.334295,170,4534727,-1,1000.0,5248483,5248494,726574,11,78,0,True,True,0.41561666666666675,-0.334295
5649,4522729,3,1,0.805154,170,4534727,-1,500.0,5787892,5787895,1265163,3,67,0,True,True,0.03490416666666667,-0.805154
5650,4522899,35,3,0.758408,170,4534727,-1,1500.0,6128710,6128745,1605811,35,45,7,True,True,0.9928333333333333,-0.758408
5651,4522924,5,1,0.043317,170,4534727,-1,500.0,6875743,6875748,2352819,5,7,6,True,True,0.07029166666666667,-0.043317
5652,4522944,39,8,0.740417,170,4534727,-1,4000.0,5970492,5970531,1447548,39,64,2,True,True,7.5543000000000005,-0.740417
5653,4522957,35,16,0.924861,170,4534727,-1,8000.0,4744527,4744562,221570,35,115,2,True,True,8.111444444444444,-0.924861
5654,4523140,9578,16,0.175888,170,4534727,-1,8000.0,6378541,6388119,1855401,9578,37,8,True,True,1548.844,-0.16173967951604962
5655,4523250,9,1,0.785492,170,4534727,-1,500.0,6872443,6872452,2349193,9,9,7,True,True,0.126525,-0.785492
5656,4523363,12532,2,0.485061,170,4534727,-1,1000.0,5744692,5757224,1221329,12532,74,10,True,True,606.1315111111111,-0.47898615847616727
5657,4524246,9,3,0.116065,170,4534727,-1,1500.0,6852943,6852952,2328697,9,14,9,True,True,0.48045,-0.116065
5658,4524794,22,8,0.895079,170,4534727,-1,4000.0,4943362,4943384,418568,22,107,6,True,True,2.9714666666666667,-0.895079
5659,4526009,18052,32,0.721403,170,4534727,-1,16000.0,5247383,5265435,721374,18052,87,0,True,True,10092.705733333334,-0.7074323118719428
5660,4526106,312,1,0.592707,170,4534727,-1,500.0,6091413,6091725,1565307,312,54,7,True,True,3.644766666666667,-0.592707
5661,4526425,95,4,0.325972,170,4534727,-1,2000.0,6458541,6458636,1932116,95,34,9,True,True,5.514749999999999,-0.325972
5662,4528509,10985,7,0.198751,170,4534727,-1,3500.0,6136345,6147330,1607836,10985,49,7,True,True,973.1639652777777,-0.18596329169406853
5663,4528532,13,2,0.676853,170,4534727,-1,1000.0,6447741,6447754,1919209,13,35,9,True,True,0.3945861111111111,-0.676853
5664,4528542,6902,256,0.325685,170,4534727,-1,128000.0,6147330,6154232,1618788,6902,50,0,True,True,23151.33511111111,-0.3180518490172135
5665,4528627,58,1,0.778975,170,4534727,-1,500.0,6838543,6838601,2309916,58,16,0,True,True,0.9604638888888889,-0.778975
5666,4528643,5,16,0.326132,170,4534727,-1,8000.0,5594483,5594488,1065840,5,87,0,True,True,1.3328888888888888,-0.326132
5667,4528671,7501,2,0.098064,170,4534727,-1,1000.0,5833992,5841493,1305321,7501,77,4,True,True,315.3702861111111,-0.0934355476579182
5668,4529621,14,2,0.737748,170,4534727,-1,1000.0,6882399,6882413,2352778,14,5,7,True,True,0.2968777777777778,-0.737748
5669,4529931,4,6,0.869886,170,4534727,-1,3000.0,6639722,6639726,2109791,4,30,0,True,True,0.3772333333333333,-0.8698860000000003
5670,4530007,7692,8,0.375532,170,4534727,-1,4000.0,5826792,5834484,1296785,7692,80,9,True,True,1001.3688,-0.3736015284938959
5671,4530554,17,10,0.220663,170,4534727,-1,5000.0,6639722,6639739,2109168,17,31,1,True,True,2.6720694444444444,-0.22066300000000005
5672,4530578,845,1,0.47099,170,4534727,-1,500.0,4706327,4707172,175749,845,138,0,True,True,11.331215277777778,-0.47099
5673,4530844,8764,4,0.484408,170,4534727,-1,2000.0,5704692,5713456,1173848,8764,89,0,True,True,616.3858,-0.43967064744265105
5674,4531169,3,32,0.890489,170,4534727,-1,16000.0,6118513,6118516,1587344,3,59,0,True,True,1.3922666666666668,-0.890489
5675,4531344,21,1,0.144941,170,4534727,-1,500.0,5594488,5594509,1063144,21,93,1,True,True,0.3498833333333333,-0.144941
5676,4531526,20,16,0.927887,170,4534727,-1,8000.0,6880156,6880176,2348630,20,7,1,True,True,3.3928888888888893,-0.927887
5677,4531638,26,1,0.454991,170,4534727,-1,500.0,5999213,5999239,1467575,26,73,6,True,True,0.4650388888888889,-0.454991
5678,4531659,557,1,0.38733,170,4534727,-1,500.0,5717692,5718249,1186033,557,92,7,True,True,9.64925138888889,-0.38733
5679,4531671,7658,4,0.136405,170,4534727,-1,2000.0,5594483,5602141,1062812,7658,99,12,True,True,516.7812166666666,-0.1324373876411572
5680,4531782,62,1,0.719821,170,4534727,-1,500.0,5715492,5715554,1183710,62,93,9,True,True,1.2815916666666667,-0.719821
5681,4531933,1006,32,0.632021,170,4534727,-1,16000.0,4704127,4705133,172194,1006,147,3,True,True,474.11662222222225,-0.632021
5682,4532622,14,1,0.975556,170,4534727,-1,500.0,6118513,6118527,1585891,14,61,0,True,True,0.20303888888888888,-0.975556
5683,4532680,5732,128,0.202211,170,4534727,-1,64000.0,6064013,6069745,1531333,5732,69,9,True,True,15292.192355555557,-0.19474634159233037
5684,4532800,98,8,0.127212,170,4534727,-1,4000.0,5118583,5118681,585783,98,121,9,True,True,9.531044444444444,-0.127212
5685,4534150,9493,16,0.692211,170,4534727,-1,8000.0,4700527,4710020,166377,9493,152,3,True,True,2196.5411333333336,-0.6490820343789236
5686,4534165,11917,32,0.059652,170,4534727,-1,16000.0,4948762,4960679,414597,11917,131,8,True,True,5705.409377777778,-0.05783962096289095
5687,4534238,47,1,0.136501,170,4534727,-1,500.0,4847605,4847652,313367,47,138,8,True,True,0.9248555555555557,-0.136501
5688,4534246,13,16,0.851651,170,4534727,-1,8000.0,6880143,6880156,2345897,13,8,7,True,True,2.2053777777777777,-0.851651
5689,4534395,78,41,0.458579,170,4534727,-1,20500.0,6545317,6545395,2010922,78,37,8,True,True,70.48036666666668,-0.458579
5690,4534431,2356,32,0.171201,170,4534727,-1,16000.0,5214883,5217239,680452,2356,118,6,True,True,1527.5224888888888,-0.16689888773395706
5691,4534672,3,4,0.343576,170,4534727,-1,2000.0,5242983,5242986,708311,3,115,0,True,True,0.23606666666666665,-0.343576
5692,4534701,127,1,0.886409,170,4534727,-1,500.0,4627627,4627754,92926,127,166,12,True,True,2.980972222222222,-0.886409
5693,4534756,8,1,0.603636,206,4540127,-1,500.0,6947820,6947828,2413064,8,3,7,True,True,0.11402222222222223,-0.603636
5694,4534783,7493,13,0.789547,206,4540127,-1,6500.0,5031783,5039276,497000,7493,131,7,True,True,1649.8500777777776,-0.7136435413641795
5695,4535473,14324,32,0.637999,206,4540127,-1,16000.0,4798927,4813251,263454,14324,150,8,True,True,8433.127244444444,-0.5719587892298181
5696,4536952,7,2,0.611528,206,4540127,-1,1000.0,5787892,5787899,1250940,7,93,11,True,True,0.1628861111111111,-0.611528
5697,4537101,22782,64,0.169935,206,4540127,-1,32000.0,4960362,4983144,423261,22782,135,4,True,True,27092.7568,-0.16464346048539652
5698,4537167,10152,2,0.970136,206,4540127,-1,1000.0,4976962,4987114,439795,10152,135,9,True,True,413.05589999999995,-0.9578651584840732
5699,4537238,12,4,0.855004,206,4540127,-1,2000.0,4842205,4842217,304967,12,148,11,True,True,1.1638,-0.855004
5700,4537337,23,4,0.086474,206,4540127,-1,2000.0,6880176,6880199,2342839,23,7,0,True,True,0.9754555555555556,-0.086474
5701,4537344,189,1,0.856974,206,4540127,-1,500.0,5214883,5215072,677539,189,122,0,True,True,3.77475,-0.856974
5702,4537367,11498,256,0.489213,206,4540127,-1,128000.0,5020285,5031783,482918,11498,135,8,True,True,61208.07573333333,-0.48583401411366317
5703,4537480,15,12,0.995664,206,4540127,-1,6000.0,6637517,6637532,2100037,15,37,2,True,True,2.494,-0.995664
5704,4537510,203,32,0.591581,206,4540127,-1,16000.0,5941992,5942195,1404482,203,90,0,True,True,135.70324444444444,-0.591581
5705,4537875,9,1,0.836989,206,4540127,-1,500.0,6159632,6159641,1621757,9,59,8,True,True,0.09977499999999999,-0.836989
5706,4537929,4,4,0.279171,206,4540127,-1,2000.0,5596688,5596692,1058759,4,107,7,True,True,0.26657777777777775,-0.279171
5707,4537994,9,2,0.730018,206,4540127,-1,1000.0,5809492,5809501,1271498,9,96,10,True,True,0.35365,-0.730018
5708,4538286,7597,2,0.736179,206,4540127,-1,1000.0,6859443,6867040,2321157,7597,18,8,True,True,260.8422722222222,-0.7217495533777674
5709,4538325,12320,1,0.246654,206,4540127,-1,500.0,6885999,6898319,2347674,12320,6,3,True,True,119.79920833333333,-0.19952522298942804
5710,4538828,2,16,0.327296,206,4540127,-1,8000.0,6945620,6945622,2406792,2,4,7,True,True,0.45608888888888893,-0.327296
5711,4538836,3,4,0.579467,206,4540127,-1,2000.0,5083983,5083986,545147,3,140,8,True,True,0.24280000000000002,-0.579467
5712,4539024,19,4,0.891823,206,4540127,-1,2000.0,6435841,6435860,1896817,19,50,11,True,True,0.9750166666666668,-0.891823
5713,4539041,7308,2,0.591772,206,4540127,-1,1000.0,6911999,6919307,2372958,7308,6,7,True,True,245.59485833333335,-0.4632536812990359
5714,4539072,11767,4,0.14897,206,4540127,-1,2000.0,5198583,5210350,659511,11767,135,10,True,True,874.5126611111111,-0.14566336366753296
5715,4539154,266,4,0.573701,206,4540127,-1,2000.0,6238841,6239107,1699687,266,59,1,True,True,11.457211111111112,-0.573701
5716,4539197,12,32,0.005078,206,4540127,-1,16000.0,6118513,6118525,1579316,12,74,7,True,True,5.569066666666667,-0.005078
5717,4539250,24,1,0.980184,206,4540127,-1,500.0,6378541,6378565,1839291,24,54,0,True,True,0.2712,-0.980184
5718,4539326,9,1,0.040059,206,4540127,-1,500.0,5248483,5248492,709157,9,127,6,True,True,0.170025,-0.040059
5719,4539362,12486,128,0.470653,206,4540127,-1,64000.0,5200783,5213269,661421,12486,139,7,True,True,30287.94648888889,-0.4560115090582636
5720,4539386,549,16,0.768606,206,4540127,-1,8000.0,5683092,5683641,1143706,549,115,12,True,True,109.2022,-0.768606
5721,4539400,38,11,0.033621,206,4540127,-1,5500.0,6880199,6880237,2340799,38,10,1,True,True,4.431961111111112,-0.033621
5722,4539428,6673,11,0.531122,206,4540127,-1,5500.0,6326341,6333014,1786913,6673,60,6,True,True,1108.4372444444446,-0.5286847625172663
5723,4539570,29,1,0.479269,206,4540127,-1,500.0,5941992,5942021,1402422,29,102,12,True,True,0.6058180555555556,-0.479269
5724,4539617,41,4,0.798018,206,4540127,-1,2000.0,4956762,4956803,417145,41,161,0,True,True,2.3793666666666664,-0.798018
5725,4539651,11,4,0.821291,206,4540127,-1,2000.0,5220283,5220294,680632,11,140,8,True,True,0.9085388888888889,-0.821291
5726,4539700,12,8,0.452441,206,4540127,-1,4000.0,6379641,6379653,1839941,12,55,6,True,True,1.0421333333333334,-0.452441
5727,4539973,16323,2,0.240511,206,4540127,-1,1000.0,5003962,5020285,463989,16323,159,10,True,True,709.659263888889,-0.2385423625856833
5728,4540032,20468,8,0.558487,206,4540127,-1,4000.0,5972692,5993160,1432660,20468,97,7,True,True,2855.4110666666666,-0.5503780096755145
5729,4540119,7,1,0.012423,206,4540127,-1,500.0,6637517,6637524,2097398,7,41,0,True,True,0.09698888888888889,-0.012423
5730,4540204,452,2,0.731786,207,4541227,-1,1000.0,4966162,4966614,425958,452,165,7,True,True,15.280111111111111,-0.731786
5731,4540698,84,4,0.949934,207,4541227,-1,2000.0,6690526,6690610,2149828,84,36,8,True,True,6.881466666666667,-0.949934
5732,4540838,16624,128,0.132712,207,4541227,-1,64000.0,4633127,4649751,92289,16624,202,7,True,True,40633.57155555555,-0.12203550373511185
5733,4541331,1361,16,0.29579,247,4627627,-1,8000.0,4863805,4865166,322474,1361,178,8,True,True,395.56708888888886,-0.29579
5734,4542711,39803,32,0.64764,247,4627627,-1,16000.0,6447741,6487544,1905030,39803,52,0,True,True,19167.901733333336,-0.6271504331200286
5735,4542733,93,16,0.09073,247,4627627,-1,8000.0,6325241,6325334,1782508,93,65,12,True,True,22.588666666666665,-0.09073
5736,4542757,20619,20,0.479783,247,4627627,-1,10000.0,5053383,5074002,510626,20619,162,10,True,True,7688.492,-0.4641236474276928
5737,4542826,24541,128,0.304837,247,4627627,-1,64000.0,6114113,6138654,1571287,24541,84,6,True,True,39695.97457777778,-0.2869138664371871
5738,4542922,7192,32,0.703304,247,4627627,-1,16000.0,6128745,6135937,1585823,7192,78,1,True,True,2868.7077777777777,-0.6420417414075091
5739,4545593,10098,1,0.857922,247,4627627,-1,500.0,6950020,6960118,2404427,10098,3,7,True,True,150.3140361111111,-0.8473254240464819
5740,4545652,134,1,0.747287,247,4627627,-1,500.0,6089213,6089347,1543561,134,90,9,True,True,1.3489333333333333,-0.747287
5741,4545678,8,3,0.024413,247,4627627,-1,1500.0,6175841,6175849,1630163,8,72,9,True,True,0.34659999999999996,-0.024413
5742,4546241,62,1,0.454841,247,4627627,-1,500.0,6512541,6512603,1966300,62,50,0,True,True,1.2970916666666665,-0.454841
5743,4546266,5,8,0.771835,247,4627627,-1,4000.0,6639717,6639722,2093451,5,43,7,True,True,0.6287222222222223,-0.771835
5744,4546278,312,1,0.874199,247,4627627,-1,500.0,5078583,5078895,532305,312,167,10,True,True,5.450466666666667,-0.874199
5745,4546309,18,2,0.40536,247,4627627,-1,1000.0,4706327,4706345,160018,18,207,7,True,True,0.48275,-0.40536
5746,4546313,22560,16,0.789859,247,4627627,-1,8000.0,4737327,4759887,191014,22560,203,2,True,True,5482.3624,-0.7610514199651217
5747,4546388,15476,256,0.37042,247,4627627,-1,128000.0,6523341,6538817,1976953,15476,51,9,True,True,88971.31306666667,-0.34892124990782986
5748,4547692,5567,32,0.464296,247,4627627,-1,16000.0,6235241,6240808,1687549,5567,72,8,True,True,2082.6112000000003,-0.463874294763748
5749,4547799,23,32,0.633402,247,4627627,-1,16000.0,6329941,6329964,1782142,23,68,1,True,True,11.156533333333334,-0.633402
5750,4548559,15,2,0.860383,247,4627627,-1,1000.0,5245183,5245198,696624,15,150,6,True,True,0.5901666666666666,-0.860383
5751,4548601,49,1,0.070699,247,4627627,-1,500.0,6539917,6539966,1991316,49,50,6,True,True,1.1925374999999998,-0.070699
5752,4548870,23,4,0.893434,247,4627627,-1,2000.0,4670927,4670950,122057,23,219,10,True,True,1.5436833333333335,-0.893434
5753,4548920,25,8,0.332906,247,4627627,-1,4000.0,6378541,6378566,1829621,25,64,0,True,True,2.26,-0.332906
5754,4548991,127,32,0.032714,247,4627627,-1,16000.0,6229841,6229968,1680850,127,76,10,True,True,58.61755555555555,-0.032714
5755,4549079,9,1,0.425902,247,4627627,-1,500.0,5830392,5830401,1281313,9,123,0,True,True,0.1456625,-0.425902
5756,4549091,7,8,0.269789,247,4627627,-1,4000.0,4733727,4733734,184636,7,213,1,True,True,0.8063222222222222,-0.269789
5757,4550800,140,2,0.946095,247,4627627,-1,1000.0,5508083,5508223,957283,140,145,12,True,True,5.830222222222222,-0.946095
5758,4550857,10170,8,0.542435,247,4627627,-1,4000.0,5166183,5176353,615326,10170,169,6,True,True,1280.7187333333334,-0.5304181353737984
5759,4551076,11945,4,0.794479,247,4627627,-1,2000.0,5994513,6006458,1443437,11945,113,0,True,True,773.1355555555556,-0.7802559544410304
5760,4551090,221,8,0.787692,247,4627627,-1,4000.0,5994292,5994513,1443202,221,115,10,True,True,32.7522,-0.787692
5761,4551512,47,1,0.080959,247,4627627,-1,500.0,6909799,6909846,2358287,47,8,7,True,True,1.1619444444444444,-0.080959
5762,4551543,9,2,0.880847,247,4627627,-1,1000.0,5830392,5830401,1278849,9,127,2,True,True,0.291325,-0.880847
5763,4551700,51326,1,0.735761,247,4627627,-1,500.0,5096983,5148309,545283,51326,179,9,True,True,695.5674583333332,-0.6954904400957198
5764,4551709,72,4,0.054812,247,4627627,-1,2000.0,5295283,5295355,743574,72,154,11,True,True,5.6852,-0.054812
5765,4551801,1050,2,0.945322,247,4627627,-1,1000.0,6134145,6135195,1582344,1050,88,0,True,True,28.634749999999997,-0.9415461374048898
5766,4551830,14819,1,0.674653,247,4627627,-1,500.0,5213783,5228602,661953,14819,171,7,True,True,306.70199444444444,-0.669931907473774
5767,4553656,7380,16,0.887978,247,4627627,-1,8000.0,4963962,4971342,410306,7380,196,2,True,True,2083.728266666667,-0.8828380038638717
5768,4554141,18,6,0.110967,247,4627627,-1,3000.0,6067613,6067631,1513472,18,105,1,True,True,2.1501,-0.110967
5769,4554431,72,1,0.365591,247,4627627,-1,500.0,5316883,5316955,762452,72,156,10,True,True,1.227,-0.365591
5770,4554453,5978,128,0.619133,247,4627627,-1,64000.0,4793527,4799505,239074,5978,220,11,True,True,8510.68711111111,-0.4815711652895738
5771,4554771,52873,10,0.365571,247,4627627,-1,5000.0,4673127,4726000,118356,52873,237,7,True,True,8676.775138888888,-0.3633995386482608
5772,4554882,283,32,0.175267,247,4627627,-1,16000.0,4694727,4695010,139845,283,237,10,True,True,143.41182222222224,-0.175267
5773,4554941,70,8,0.55879,247,4627627,-1,4000.0,5855592,5855662,1300651,70,127,10,True,True,8.477777777777778,-0.55879
862,803344,420,32,0.443679,1,803344,-1,16000.0,808744,809164,5400,420,0,8,True,True,276.584,-0.443679
863,803495,6902,4,0.694001,10,808744,-1,2000.0,812044,818946,8549,6902,0,7,True,True,629.2024888888889,-0.6908498548377365
864,803568,20120,2,0.903424,10,808744,-1,1000.0,809844,829964,6276,20120,1,6,True,True,922.5358555555556,-0.8891977846573458
865,803679,7452,128,0.045991,10,808744,-1,64000.0,3162191,3169643,2358512,7452,0,1,True,True,19805.499022222222,-0.04551764820201357
866,804449,15046,128,0.796143,10,808744,-1,64000.0,812044,827090,7595,15046,1,0,True,True,43596.1952,-0.7880939384535537
867,804482,33606,16,0.293368,10,808744,-1,8000.0,1906633,1940239,1102151,33606,1,0,True,True,12191.19428888889,-0.29328167174430986
868,805102,62,32,0.374841,10,808744,-1,16000.0,913944,914006,108842,62,2,9,True,True,40.56453333333334,-0.374841
869,805220,10332,32,0.14557,10,808744,-1,16000.0,898444,908776,93224,10332,3,12,True,True,6550.100266666666,-0.1425738161248761
870,805230,29,1,0.531166,10,808744,-1,500.0,3082901,3082930,2277671,29,1,11,True,True,1.1817902777777778,-0.531166
871,805243,4,1,0.565928,10,808744,-1,500.0,2910101,2910105,2104858,4,2,0,True,True,0.06632777777777778,-0.565928
872,805292,77,5,0.792519,10,808744,-1,2500.0,2626124,2626201,1820832,77,3,0,True,True,11.355361111111112,-0.792519
873,811926,8,12,0.169984,10,812044,-1,6000.0,812044,812052,118,8,7,0,True,True,2.1050666666666666,-0.169984
874,812010,19832,32,0.078968,10,812044,-1,16000.0,812044,831876,34,19832,7,0,True,True,14817.053511111111,-0.07576204267987022
875,812082,21614,3,0.87084,81,898444,-1,1500.0,2233049,2254663,1420967,21614,4,9,True,True,529.5181541666666,-0.8378175081657009
876,812749,20,16,0.61971,81,898444,-1,8000.0,2873880,2873900,2061131,20,3,10,True,True,5.213333333333334,-0.61971
877,812915,14297,64,0.24083,81,898444,-1,32000.0,2846791,2861088,2033876,14297,4,0,True,True,14211.803466666668,-0.24016400714347572
878,813568,1417,1,0.912829,81,898444,-1,500.0,2090449,2091866,1276881,1417,7,7,True,True,18.2961,-0.9054788705412689
879,813725,9665,1,0.143118,81,898444,-1,500.0,3425146,3434811,2611421,9665,0,10,True,True,173.09863472222224,-0.1414849390549161
880,813919,40458,1,0.46115,81,898444,-1,500.0,2670882,2711340,1856963,40458,6,0,True,True,962.8578250000002,-0.44461242021527997
881,822832,22853,1,0.253977,81,898444,-1,500.0,2623321,2646174,1800489,22853,8,6,True,True,718.1328805555555,-0.25004896036857543
882,822838,110,64,0.255327,81,898444,-1,32000.0,2077449,2077559,1254611,110,11,0,True,True,87.13955555555556,-0.255327
883,822900,33,32,0.009397,81,898444,-1,16000.0,2247849,2247882,1424949,33,9,2,True,True,7.443333333333333,-0.009397
884,822952,4,8,0.804633,81,898444,-1,4000.0,930544,930548,107592,4,14,2,True,True,0.6412,-0.804633
885,822990,16,1,0.901209,81,898444,-1,500.0,2034233,2034249,1211243,16,13,7,True,True,0.3476444444444444,-0.901209
886,823196,6103,1,0.677611,81,898444,-1,500.0,2620021,2626124,1796825,6103,9,6,True,True,183.1150597222222,-0.5593517810109407
887,823236,17,8,0.157976,81,898444,-1,4000.0,2720483,2720500,1897247,17,6,7,True,True,3.350511111111111,-0.157976
888,825223,23,6,0.44173,81,898444,-1,3000.0,2032033,2032056,1206810,23,16,0,True,True,2.668766666666667,-0.44173
889,825864,1998,1,0.345566,81,898444,-1,500.0,2468814,2470812,1642950,1998,11,6,True,True,22.968641666666667,-0.33359524504980836
890,825996,5,1,0.587572,81,898444,-1,500.0,2655992,2655997,1829996,5,8,7,True,True,0.11070833333333333,-0.587572
891,826016,18972,12,0.638939,81,898444,-1,6000.0,2761983,2780955,1935967,18972,6,7,True,True,3597.3276000000005,-0.6104629617160712
892,826170,219,16,0.424309,81,898444,-1,8000.0,899544,899763,73374,219,23,6,True,True,64.93106666666667,-0.424309
893,826200,20,1,0.250098,81,898444,-1,500.0,2526114,2526134,1699914,20,13,7,True,True,0.2750277777777778,-0.250098
894,826364,216,7,0.845304,81,898444,-1,3500.0,903144,903360,76780,216,24,2,True,True,29.2152,-0.8453039999999998
895,826367,752,1,0.199217,81,898444,-1,500.0,1288547,1289299,462180,752,22,6,True,True,8.299602777777777,-0.18543558451727019
896,849581,23,1,0.384693,81,898444,-1,500.0,1142560,1142583,292979,23,23,6,True,True,0.3418375,-0.384693
897,855437,12693,16,0.483208,81,898444,-1,8000.0,899544,912237,44107,12693,27,0,True,True,4093.8495333333335,-0.47799332229378705
898,855480,6,16,0.237206,81,898444,-1,8000.0,2931701,2931707,2076221,6,3,10,True,True,1.2118666666666666,-0.237206
899,855897,7,2,0.571923,81,898444,-1,1000.0,3105679,3105686,2249782,7,2,1,True,True,0.4032583333333333,-0.571923
900,855953,8,6,0.574812,81,898444,-1,3000.0,2512014,2512022,1656061,8,16,0,True,True,0.6052666666666666,-0.574812
901,856547,12,3,0.992692,81,898444,-1,1500.0,2661082,2661094,1804535,12,11,6,True,True,0.7260500000000001,-0.992692
902,856672,8973,256,0.295231,81,898444,-1,128000.0,973962,982935,117290,8973,28,0,True,True,36639.8656,-0.2870351756017483
903,856901,5276,1,0.977944,81,898444,-1,500.0,2761983,2767259,1905082,5276,8,0,True,True,74.6470375,-0.9765355548333415
904,857055,2147,1,0.65823,81,898444,-1,500.0,1713621,1715768,856566,2147,27,10,True,True,52.261558333333326,-0.65823
905,857294,280,4,0.27448,81,898444,-1,2000.0,3161911,3162191,2304617,280,2,7,True,True,22.731333333333332,-0.27448
906,857423,10533,256,0.565929,81,898444,-1,128000.0,2457181,2467714,1599758,10533,21,9,True,True,34331.9456,-0.5272021727341557
907,857764,2,16,0.685799,81,898444,-1,8000.0,1805421,1805423,947657,2,29,11,True,True,0.6690666666666666,-0.685799
908,857872,23,32,0.744669,81,898444,-1,16000.0,1287447,1287470,429575,23,32,7,True,True,8.726711111111111,-0.744669
909,857926,13543,41,0.049044,81,898444,-1,20500.0,2731683,2745226,1873757,13543,11,2,True,True,10297.754123611112,-0.044372560556572654
910,858044,130,2,0.606406,81,898444,-1,1000.0,2548513,2548643,1690469,130,19,6,True,True,4.8598333333333334,-0.606406
911,858080,14815,32,0.496727,81,898444,-1,16000.0,1136060,1150875,277980,14815,36,6,True,True,7265.931333333334,-0.47490945602015583
912,858233,4292,256,0.904155,81,898444,-1,128000.0,1827021,1831313,968788,4292,31,10,True,True,35844.53866666667,-0.8882469346061
913,858316,633,8,0.286194,81,898444,-1,4000.0,2428876,2429509,1570560,633,24,10,True,True,73.31546666666667,-0.286194
914,858633,5104,16,0.79886,81,898444,-1,8000.0,1285247,1290351,426614,5104,37,9,True,True,937.6101777777778,-0.7980687870926106
915,869045,28,4,0.607065,81,898444,-1,2000.0,3159711,3159739,2290666,28,3,11,True,True,2.384044444444444,-0.607065
916,872125,2,4,0.352321,81,898444,-1,2000.0,2276366,2276368,1404241,2,26,7,True,True,0.1519111111111111,-0.352321
917,872597,2,8,0.636618,81,898444,-1,4000.0,2394166,2394168,1521569,2,26,7,True,True,0.20384444444444447,-0.636618
918,872822,7,1,0.620891,81,898444,-1,500.0,2222249,2222256,1349427,7,30,11,True,True,0.09067916666666666,-0.620891
919,874005,8,3,0.677764,81,898444,-1,1500.0,2407276,2407284,1533271,8,26,1,True,True,0.23073333333333332,-0.677764
920,874367,121,4,0.720928,81,898444,-1,2000.0,2874980,2875101,2000613,121,8,6,True,True,7.885166666666667,-0.720928
921,874462,30081,118,0.659182,81,898444,-1,59000.0,2643902,2673983,1769440,30081,18,8,True,True,79125.73960277777,-0.6224482893341317
922,874661,25,8,0.838337,81,898444,-1,4000.0,938544,938569,63883,25,48,7,True,True,4.17,-0.838337
923,875287,124,1,0.628248,81,898444,-1,500.0,1488380,1488504,613093,124,42,11,True,True,2.077,-0.628248
924,875915,116,1,0.903404,81,898444,-1,500.0,2764183,2764299,1888268,116,11,7,True,True,1.64865,-0.903404
925,876833,31818,22,0.646341,81,898444,-1,11000.0,942144,973962,65311,31818,50,2,True,True,10283.371266666667,-0.6244080811555788
926,879025,6633,4,0.308933,81,898444,-1,2000.0,1331747,1338380,452722,6633,44,0,True,True,1110.1916333333334,-0.3086188561427053
927,879294,29,1,0.440823,81,898444,-1,500.0,2297966,2297995,1418672,29,31,0,True,True,0.5394,-0.440823
928,879729,170,1,0.579574,81,898444,-1,500.0,2668682,2668852,1788953,170,17,6,True,True,2.7702916666666666,-0.579574
929,880101,14947,8,0.73236,81,898444,-1,4000.0,3295546,3310493,2415445,14947,1,9,True,True,3202.068488888889,-0.6822556270593298
930,880390,8887,73,0.090133,81,898444,-1,36500.0,2718283,2727170,1837893,8887,17,10,True,True,17211.49044166667,-0.08986722658085226
931,880414,11490,32,0.29511,81,898444,-1,16000.0,926944,938434,46530,11490,58,7,True,True,7421.199288888889,-0.2934888989002872
932,880813,36514,15,0.747481,81,898444,-1,7500.0,913944,950458,33131,36514,59,0,True,True,10489.042,-0.7249421220090978
933,881078,5,8,0.17564,81,898444,-1,4000.0,2825191,2825196,1944113,5,12,6,True,True,0.7807777777777778,-0.17564
934,881223,28,16,0.13216,81,898444,-1,8000.0,2662182,2662210,1780959,28,21,0,True,True,9.03528888888889,-0.13216
935,881791,19419,2,0.539408,81,898444,-1,1000.0,3271500,3290919,2389709,19419,2,6,True,True,709.6996083333333,-0.4887928429860379
936,882069,133,32,0.97149,81,898444,-1,16000.0,3403546,3403679,2521477,133,1,12,True,True,82.50137777777778,-0.97149
937,883386,108,31,0.530852,81,898444,-1,15500.0,2407168,2407276,1523782,108,37,7,True,True,32.1873,-0.530852
938,883775,287,2,0.913487,81,898444,-1,1000.0,1906633,1906920,1022858,287,49,6,True,True,11.21771388888889,-0.913487
939,883852,219,2,0.830473,81,898444,-1,1000.0,2512014,2512233,1628162,219,33,11,True,True,5.523058333333334,-0.830473
940,883929,246,8,0.25697,81,898444,-1,4000.0,3273700,3273946,2389771,246,3,6,True,True,40.631,-0.25697
941,884401,10356,1,0.82469,81,898444,-1,500.0,1832421,1842777,948020,10356,52,8,True,True,273.50309166666665,-0.8237217990055554
942,886266,17,42,0.481848,81,898444,-1,21000.0,2670882,2670899,1784616,17,23,7,True,True,11.635225,-0.481848
943,886308,10,16,0.806488,81,898444,-1,8000.0,3163291,3163301,2276983,10,5,6,True,True,3.247333333333333,-0.806488
944,887364,49,8,0.746559,81,898444,-1,4000.0,2818691,2818740,1931327,49,17,2,True,True,7.642366666666667,-0.746559
945,887483,4,16,0.338715,81,898444,-1,8000.0,3428446,3428450,2540963,4,0,6,True,True,1.2016888888888888,-0.338715
946,888404,19181,64,0.11517,81,898444,-1,32000.0,2029833,2049014,1141429,19181,54,11,True,True,23622.952266666667,-0.11263731580138299
947,888428,7,4,0.962893,81,898444,-1,2000.0,2274166,2274173,1385738,7,47,10,True,True,0.48696666666666666,-0.962893
948,890340,32,8,0.140757,81,898444,-1,4000.0,3116479,3116511,2226139,32,10,8,True,True,5.025777777777778,-0.140757
949,890943,933,1,0.9665,81,898444,-1,500.0,1583088,1584021,692145,933,63,0,True,True,31.441162500000004,-0.9641664650795824
950,898449,8685,8,0.860141,82,899544,-1,4000.0,1986633,1995318,1088184,8685,57,7,True,True,789.9526999999999,-0.8552788276708161
951,898487,4,31,0.724217,82,899544,-1,15500.0,982935,982939,84448,4,72,0,True,True,2.0615,-0.724217
952,899563,16,16,0.979942,104,903144,-1,8000.0,2662182,2662198,1762619,16,30,6,True,True,5.163022222222223,-0.979942
953,899573,6726,4,0.96727,104,903144,-1,2000.0,2523914,2530640,1624341,6726,39,9,True,True,443.56425555555563,-0.9598624692030197
954,899742,37,1,0.804588,104,903144,-1,500.0,1231160,1231197,331418,37,72,12,True,True,0.4781222222222223,-0.804588
955,900455,21812,4,0.365775,104,903144,-1,2000.0,2531209,2553021,1630754,21812,38,6,True,True,1778.2440166666668,-0.36186653993199364
956,900532,88,64,0.790682,104,903144,-1,32000.0,2547413,2547501,1646881,88,38,8,True,True,105.27146666666668,-0.790682
957,900557,1004,1,0.013919,104,903144,-1,500.0,3295546,3296550,2394989,1004,3,0,True,True,26.8319,-0.013919
958,900601,3,2,0.536572,104,903144,-1,1000.0,2542009,2542012,1641408,3,40,0,True,True,0.11902500000000002,-0.536572
959,900967,2394,2,0.454786,104,903144,-1,1000.0,1065042,1067436,164075,2394,79,6,True,True,134.26735000000002,-0.4538324834259821
960,900973,1191,16,0.672828,104,903144,-1,8000.0,3039701,3040892,2138728,1191,14,10,True,True,405.3105333333333,-0.672828
961,901023,7663,1,0.672341,104,903144,-1,500.0,2910101,2917764,2009078,7663,17,6,True,True,129.6436402777778,-0.6648090338592754
962,901302,88,4,0.58456,104,903144,-1,2000.0,1670421,1670509,769119,88,72,12,True,True,9.116311111111111,-0.58456
963,901346,11,2,0.822417,104,903144,-1,1000.0,934144,934155,32798,11,87,3,True,True,0.44226111111111116,-0.822417
964,901612,8,1,0.940292,104,903144,-1,500.0,2906801,2906809,2005189,8,18,2,True,True,0.1292222222222222,-0.940292
965,901663,23878,7,0.108346,104,903144,-1,3500.0,2631924,2655802,1730261,23878,38,2,True,True,4944.715766666667,-0.10746027935917983
966,902461,19,2,0.233822,104,903144,-1,1000.0,1493080,1493099,590619,19,76,2,True,True,0.6365527777777777,-0.233822
967,902471,1293,1,0.025025,104,903144,-1,500.0,2622221,2623514,1719750,1293,41,7,True,True,36.00286666666667,-0.025025
968,902499,7017,42,0.884235,104,903144,-1,21000.0,2077449,2084466,1174950,7017,65,11,True,True,3547.5454,-0.882475072448385
969,902511,126,8,0.561407,104,903144,-1,4000.0,2240649,2240775,1338138,126,61,8,True,True,7.249200000000001,-0.561407
970,902522,52,1,0.915256,104,903144,-1,500.0,1489480,1489532,586958,52,80,0,True,True,0.8709999999999999,-0.915256
971,902557,23,32,0.221367,104,903144,-1,16000.0,2818183,2818206,1915626,23,24,9,True,True,14.348933333333335,-0.221367
972,902661,93,1,0.063217,104,903144,-1,500.0,2667582,2667675,1764921,93,34,0,True,True,1.5374375,-0.05967134313524852
973,903095,8782,32,0.823855,104,903144,-1,16000.0,1489480,1498262,586385,8782,83,6,True,True,4744.166133333334,-0.816254297590179
974,903110,860,16,0.909388,104,903144,-1,8000.0,2754383,2755243,1851273,860,28,6,True,True,203.03644444444444,-0.909388
975,903135,6,16,0.30219,104,903144,-1,8000.0,2759783,2759789,1856648,6,28,8,True,True,1.4402666666666668,-0.30219
976,903148,44954,1,0.408296,152,913944,-1,500.0,2852280,2897234,1949132,44954,21,0,True,True,707.5126749999998,-0.4069535088711938
977,903524,11752,256,0.139777,152,913944,-1,128000.0,1081075,1092827,177551,11752,95,2,True,True,73939.9704888889,-0.13823139022571723
978,903601,92,1,0.946262,152,913944,-1,500.0,1067242,1067334,163641,92,96,7,True,True,2.585327777777778,-0.946262
979,903638,68,1,0.304365,152,913944,-1,500.0,1881021,1881089,977383,68,78,11,True,True,1.4032555555555557,-0.304365
980,903680,4122,32,0.492625,152,913944,-1,16000.0,2548513,2552635,1644833,4122,48,0,True,True,2713.572488888889,-0.49077251912644027
981,903718,45,8,0.097192,152,913944,-1,4000.0,3116511,3116556,2212793,45,11,1,True,True,7.0675,-0.097192
982,904017,60,2,0.887259,152,913944,-1,1000.0,3273946,3274006,2369929,60,5,2,True,True,2.4775,-0.887259
983,904225,19,1,0.135664,152,913944,-1,500.0,2885901,2885920,1981676,19,21,9,True,True,0.2918611111111111,-0.135664
984,904339,39,33,0.453644,152,913944,-1,16500.0,2633024,2633063,1728685,39,46,6,True,True,37.1388875,-0.4536439999999999
985,905570,22716,12,0.670486,152,913944,-1,6000.0,3220700,3243416,2315130,22716,8,0,True,True,7082.617266666668,-0.6655455925431509
986,905590,9,4,0.74314,152,913944,-1,2000.0,2034249,2034258,1128659,9,78,2,True,True,0.7822,-0.74314
987,905623,13136,1,0.945974,152,913944,-1,500.0,924744,937880,19121,13136,113,9,True,True,264.20096666666666,-0.9312002091023869
988,906078,9022,64,0.419127,152,913944,-1,32000.0,1919633,1928655,1013555,9022,83,7,True,True,14778.022755555558,-0.41896745983606254
989,906231,66,8,0.742269,152,913944,-1,4000.0,2467714,2467780,1561483,66,63,8,True,True,5.733933333333333,-0.742269
990,906267,19,2,0.154523,152,913944,-1,1000.0,2542013,2542032,1635746,19,56,2,True,True,0.7538250000000001,-0.154523
991,906314,10719,32,0.414885,152,913944,-1,16000.0,2910101,2920820,2003787,10719,19,0,True,True,5877.257822222222,-0.4068302271596272
992,906561,65,1,0.099022,152,913944,-1,500.0,3018101,3018166,2111540,65,18,12,True,True,0.8960972222222222,-0.099022
993,906605,6836,4,0.489347,152,913944,-1,2000.0,2389766,2396602,1483161,6836,72,8,True,True,380.5644666666667,-0.4178119082493469
994,906648,38,16,0.408116,152,913944,-1,8000.0,1434380,1434418,527732,38,102,8,True,True,22.060266666666667,-0.408116
995,907346,10685,256,0.951522,152,913944,-1,128000.0,1125375,1136060,218029,10685,110,6,True,True,25622.229333333336,-0.8716710288576335
996,907418,22137,186,0.032716,152,913944,-1,93000.0,2673983,2696120,1766565,22137,40,7,True,True,89524.07514166666,-0.03199660481287014
997,907611,11406,130,0.37053,152,913944,-1,65000.0,3085101,3096507,2177490,11406,16,7,True,True,57831.372625,-0.3597427230715946
998,907659,13541,8,0.443383,152,913944,-1,4000.0,1584021,1597562,676362,13541,99,2,True,True,2715.242566666667,-0.4402419458032457
999,908719,13369,32,0.950555,152,913944,-1,16000.0,1917433,1930802,1008714,13369,91,9,True,True,10634.690844444443,-0.9467149338667373
1000,908991,87,16,0.85545,152,913944,-1,8000.0,1274360,1274447,365369,87,111,11,True,True,24.45371111111111,-0.8459178127670589
1001,909120,27,4,0.099355,152,913944,-1,2000.0,1883221,1883248,974101,27,94,7,True,True,1.9320000000000002,-0.099355
1002,909179,43100,1,0.68568,152,913944,-1,500.0,2852280,2895380,1943101,43100,29,8,True,True,682.6922499999998,-0.6833691277455864
1003,909201,123,2,0.544466,152,913944,-1,1000.0,2530109,2530232,1620908,123,64,7,True,True,4.6986,-0.544466
1004,909536,33,1,0.977843,152,913944,-1,500.0,1428947,1428980,519411,33,110,9,True,True,1.2987333333333333,-0.977843
1005,909593,16765,128,0.358674,152,913944,-1,64000.0,913944,930709,4351,16765,132,0,True,True,43800.94560000001,-0.3562650624860513
1006,909608,12,4,0.39814,152,913944,-1,2000.0,3218500,3218512,2308892,12,9,7,True,True,1.2152666666666667,-0.39814
1007,909629,54,39,0.189809,152,913944,-1,19500.0,2785783,2785837,1876154,54,35,10,True,True,38.794275,-0.189809
1008,909664,402,8,0.12216,152,913944,-1,4000.0,1063942,1064344,154278,402,125,8,True,True,89.56113333333333,-0.12216
1009,909671,508,32,0.848033,152,913944,-1,16000.0,2818183,2818691,1908512,508,34,0,True,True,316.92426666666665,-0.848033
1010,909734,7262,128,0.454717,152,913944,-1,64000.0,2179049,2186311,1269315,7262,87,0,True,True,12199.373866666665,-0.4523543137327232
1011,910051,9,1,0.662769,152,913944,-1,500.0,2244249,2244258,1334198,9,84,3,True,True,0.0630125,-0.662769
1012,910264,145,32,0.641704,152,913944,-1,16000.0,2575721,2575866,1665457,145,61,10,True,True,105.83711111111111,-0.641704
1013,912627,17,11,0.597146,152,913944,-1,5500.0,1719021,1719038,806394,17,107,8,True,True,4.2737291666666675,-0.597146
1014,913063,10,8,0.021357,152,913944,-1,4000.0,2251449,2251459,1338386,10,84,2,True,True,0.5602222222222223,-0.021357
1015,913159,10,2,0.786795,152,913944,-1,1000.0,1004542,1004552,91383,10,132,1,True,True,0.46094444444444443,-0.786795
1016,913181,4,32,0.243569,152,913944,-1,16000.0,2668682,2668686,1755501,4,48,0,True,True,2.0858666666666665,-0.243569
1017,913189,52,2,0.125924,152,913944,-1,1000.0,3208700,3208752,2295511,52,10,7,True,True,1.8199999999999998,-0.125924
1018,913206,10652,32,0.564578,152,913944,-1,16000.0,2437576,2448228,1524370,10652,78,6,True,True,3041.6755555555555,-0.5133008516971213
1019,913376,10586,4,0.06861,152,913944,-1,2000.0,3317146,3327732,2403770,10586,3,10,True,True,1085.2330444444444,-0.06769862424410279
1020,913679,13,1,0.765157,152,913944,-1,500.0,1428980,1428993,515301,13,122,1,True,True,0.5116222222222222,-0.765157
1021,913776,5090,128,0.207157,152,913944,-1,64000.0,2653792,2658882,1740016,5090,57,8,True,True,14307.666133333332,-0.20667204348378637
1022,913837,8334,86,0.215951,152,913944,-1,43000.0,3221800,3230134,2307963,8334,9,6,True,True,17842.34283888889,-0.21272406217307174
1023,913856,34,1,0.869695,152,913944,-1,500.0,2891301,2891335,1977445,34,29,8,True,True,0.46381666666666665,-0.869695
1024,913878,12987,102,0.32856,152,913944,-1,51000.0,1141460,1154447,227582,12987,134,8,True,True,23223.967041666667,-0.32213898465867113
1025,914416,1453,8,0.147554,177,924744,-1,4000.0,3273946,3275399,2359530,1453,6,0,True,True,239.98716666666667,-0.147554
1026,914447,10233,26,0.900531,177,924744,-1,13000.0,1070842,1081075,156395,10233,139,3,True,True,7270.512347222222,-0.8921635584319013
1027,917303,12378,32,0.002836,177,924744,-1,16000.0,2626124,2638502,1708821,12378,65,2,True,True,11178.658933333334,-0.0028003721208009744
1028,917615,29897,224,0.858406,177,924744,-1,112000.0,3272600,3302497,2354985,29897,9,6,True,True,143058.47204444444,-0.8426763283445564
1029,917671,30,8,0.144688,177,924744,-1,4000.0,3427346,3427376,2509675,30,1,7,True,True,4.506333333333333,-0.144688
1030,917677,24,1,0.129992,177,924744,-1,500.0,1058542,1058566,140865,24,146,11,True,True,0.6172333333333333,-0.129992
1031,918317,103,8,0.250654,177,924744,-1,4000.0,2394168,2394271,1475851,103,90,1,True,True,10.497988888888889,-0.250654
1032,918364,38,2,0.174497,177,924744,-1,1000.0,2553021,2553059,1634657,38,72,3,True,True,1.505327777777778,-0.174497
1033,918775,3,9,0.661058,177,924744,-1,4500.0,2552113,2552116,1633338,3,73,3,True,True,0.5608500000000001,-0.661058
1034,919307,9385,1,0.02578,177,924744,-1,500.0,936344,945729,17037,9385,155,7,True,True,176.72671250000002,-0.025531308420011372
1035,919364,89,32,0.01486,177,924744,-1,16000.0,2846791,2846880,1927427,89,39,10,True,True,44.6068,-0.01486
1036,919452,3,64,0.789985,177,924744,-1,32000.0,2824091,2824094,1904639,3,41,8,True,True,3.7477333333333336,-0.789985
1037,920324,34,8,0.237932,177,924744,-1,4000.0,2638502,2638536,1718178,34,66,2,True,True,7.6292222222222215,-0.237932
1038,920891,48,2,0.323771,177,924744,-1,1000.0,1124275,1124323,203384,48,147,11,True,True,0.9808000000000001,-0.323771
1039,920971,97,16,0.174246,177,924744,-1,8000.0,3265000,3265097,2344029,97,12,11,True,True,34.09226666666667,-0.174246
1040,921010,137,32,0.052399,177,924744,-1,16000.0,2753283,2753420,1832273,137,52,10,True,True,70.49715555555557,-0.052399
1041,921138,19,32,0.741718,177,924744,-1,16000.0,2297966,2297985,1376828,19,101,0,True,True,11.3088,-0.741718
1042,921155,4,16,0.526086,177,924744,-1,8000.0,2542009,2542013,1620854,4,84,9,True,True,1.2696,-0.526086
1043,921476,16,2,0.745665,177,924744,-1,1000.0,3273700,3273716,2352224,16,9,0,True,True,0.6606666666666667,-0.745665
1044,922091,7318,1,0.476246,177,924744,-1,500.0,2892401,2899719,1970310,7318,34,6,True,True,100.25887916666666,-0.4653122655409186
1045,922453,8,32,0.778017,177,924744,-1,16000.0,1418147,1418155,495694,8,143,12,True,True,8.455111111111112,-0.778017
1046,923100,8145,4,0.513238,177,924744,-1,2000.0,3284746,3292891,2361646,8145,7,9,True,True,621.58645,-0.4874105583259583
1047,923295,14,4,0.109054,177,924744,-1,2000.0,1331747,1331761,408452,14,146,11,True,True,2.2771777777777773,-0.109054
1048,924235,1805,4,0.503839,177,924744,-1,2000.0,1144760,1146565,220525,1805,152,7,True,True,122.9471111111111,-0.5023906570846182
1049,924270,4,4,0.945416,177,924744,-1,2000.0,2909001,2909005,1984731,4,34,7,True,True,0.2653111111111111,-0.945416
1050,924347,478,32,0.043365,177,924744,-1,16000.0,3216300,3216778,2291953,478,18,8,True,True,317.0520888888889,-0.043365
1051,924458,5852,24,0.783227,177,924744,-1,12000.0,1905533,1911385,981075,5852,129,1,True,True,2764.8674,-0.7828657979391327
1052,924597,126,1,0.866981,177,924744,-1,500.0,2903201,2903327,1978604,126,37,0,True,True,1.9747000000000003,-0.866981
1053,924998,6,8,0.521451,178,926944,-1,4000.0,2034233,2034239,1109235,6,122,0,True,True,1.0429333333333335,-0.521451
1054,925011,39,16,0.458043,178,926944,-1,8000.0,2875101,2875140,1950090,39,41,0,True,True,10.166,-0.458043
1055,936420,9172,256,0.964026,175,938544,-1,128000.0,3096507,3105679,2160087,9172,27,7,True,True,72069.94026666666,-0.9619975569929986
1056,940082,17,1,0.060825,175,942144,-1,500.0,2252549,2252566,1312467,17,113,6,True,True,0.11904722222222222,-0.060825
1057,946443,136,4,0.478982,205,973962,-1,2000.0,2513114,2513250,1566671,136,97,6,True,True,6.939777777777778,-0.478982
1058,947436,101,4,0.401617,205,973962,-1,2000.0,1015342,1015443,67906,101,173,9,True,True,9.299855555555556,-0.401617
1059,948335,228,2,0.686097,205,973962,-1,1000.0,1434380,1434608,486045,228,150,0,True,True,16.5452,-0.686097
1060,948427,60,128,0.490269,205,973962,-1,64000.0,1837821,1837881,889394,60,138,8,True,True,212.40533333333332,-0.490269
1061,950872,20,1,0.909701,205,973962,-1,500.0,2875101,2875121,1924229,20,43,1,True,True,0.32583333333333336,-0.909701
1062,951596,93,6,0.073491,205,973962,-1,3000.0,2662182,2662275,1710586,93,71,0,True,True,11.253775000000001,-0.073491
1063,952049,4,1,0.08079,205,973962,-1,500.0,1434380,1434384,482331,4,154,0,True,True,0.14513333333333334,-0.08079
1064,954290,6001,1,0.608297,205,973962,-1,500.0,2179049,2185050,1224759,6001,124,12,True,True,78.82782916666667,-0.6076802835028675
1065,954364,14892,1,0.065682,205,973962,-1,500.0,2088249,2103141,1133885,14892,126,9,True,True,195.7441125,-0.06542450962766105
1066,958951,49,2,0.275016,205,973962,-1,1000.0,2628324,2628373,1669373,49,81,7,True,True,2.6541666666666663,-0.275016
1067,959062,1,16,0.633077,205,973962,-1,8000.0,2431076,2431077,1472014,1,107,7,True,True,0.19993333333333332,-0.633077
1068,960718,5,1,0.548356,205,973962,-1,500.0,2728083,2728088,1767365,5,63,8,True,True,0.12531944444444446,-0.548356
1069,961037,26,1,0.325185,205,973962,-1,500.0,2092649,2092675,1131612,26,128,7,True,True,0.3239166666666667,-0.325185
1070,961492,11010,4,0.994628,205,973962,-1,2000.0,1004542,1015552,43050,11010,185,0,True,True,1044.2805555555556,-0.9946129726375028
1071,962758,3023,14,0.530557,205,973962,-1,7000.0,2635224,2638247,1672466,3023,80,7,True,True,1187.0733194444445,-0.530557
1072,964846,8,16,0.453715,205,973962,-1,8000.0,1583080,1583088,618234,8,156,12,True,True,4.323911111111111,-0.453715
1073,965817,8624,1,0.605427,205,973962,-1,500.0,1065042,1073666,99225,8624,183,0,True,True,241.13646944444446,-0.5999904486544159
1074,967377,34871,32,0.099178,205,973962,-1,16000.0,2618921,2653792,1651544,34871,89,11,True,True,33676.90413333334,-0.09532142481001993
1075,967509,1078,4,0.701779,205,973962,-1,2000.0,3210900,3211978,2243391,1078,19,7,True,True,60.11611111111111,-0.5590806299952882
1076,968389,9,5,0.852793,205,973962,-1,2500.0,3206491,3206500,2238102,9,21,11,True,True,0.8863125000000001,-0.852793
1077,968414,72,16,0.650917,205,973962,-1,8000.0,2554121,2554193,1585707,72,93,6,True,True,22.817600000000002,-0.650917
1078,969769,154,39,0.768963,205,973962,-1,19500.0,2527909,2528063,1558140,154,104,2,True,True,114.7146,-0.768963
1079,971202,34,2,0.72084,205,973962,-1,1000.0,1496680,1496714,525478,34,162,0,True,True,1.1548666666666667,-0.72084
1080,971335,38,5,0.215023,205,973962,-1,2500.0,2807383,2807421,1836048,38,57,10,True,True,3.9744305555555557,-0.215023
1081,971395,4,1,0.451555,205,973962,-1,500.0,1941233,1941237,969838,4,146,10,True,True,0.08112222222222223,-0.451555
1082,971409,19,16,0.228494,205,973962,-1,8000.0,1274447,1274466,303038,19,180,1,True,True,5.400644444444445,-0.228494
1083,972347,8440,4,0.338932,205,973962,-1,2000.0,2658882,2667322,1686535,8440,79,2,True,True,654.8985222222223,-0.3218070655994613
1084,972419,46,64,0.453499,205,973962,-1,32000.0,1762221,1762267,789802,46,159,11,True,True,77.91377777777778,-0.453499
1085,972472,202,7,0.41599,205,973962,-1,3500.0,2436476,2436678,1464004,202,116,8,True,True,14.984472222222221,-0.41599
1086,972562,9,16,0.095086,205,973962,-1,8000.0,2384366,2384375,1411804,9,124,12,True,True,2.7242,-0.095086
1087,973330,8268,1,0.426764,205,973962,-1,500.0,2235249,2243517,1261919,8268,134,7,True,True,71.12674583333333,-0.34899787594485204
1088,976350,1795,8,0.665108,230,982935,-1,4000.0,2526114,2527909,1549764,1795,107,0,True,True,227.8072666666667,-0.5524232361494749
1089,977243,39,1,0.374301,230,982935,-1,500.0,2659982,2660021,1682739,39,79,0,True,True,0.8462458333333333,-0.374301
1090,977252,11,1,0.152639,230,982935,-1,500.0,2659982,2659993,1682730,11,80,6,True,True,0.23868472222222223,-0.152639
1091,977766,685,12,0.922985,230,982935,-1,6000.0,1904848,1905533,927082,685,159,10,True,True,160.64391666666666,-0.922985
1092,977881,13472,8,0.067133,230,982935,-1,4000.0,3206500,3219972,2228619,13472,21,1,True,True,1954.6832,-0.057873084741205935
1093,977908,132,1,0.831772,230,982935,-1,500.0,2404968,2405100,1427060,132,125,9,True,True,1.2690333333333332,-0.831772
1094,978328,59,16,0.09323,230,982935,-1,8000.0,3270400,3270459,2292072,59,14,8,True,True,18.984888888888893,-0.09323
1095,978363,3,8,0.096564,230,982935,-1,4000.0,2667582,2667585,1689219,3,77,8,True,True,0.42033333333333334,-0.096564
1096,978418,13818,1,0.738796,230,982935,-1,500.0,2903201,2917019,1924783,13818,43,9,True,True,227.74597361111114,-0.7256273912301037
1097,978486,10996,1,0.811769,230,982935,-1,500.0,1445180,1456176,466694,10996,183,9,True,True,233.4728333333333,-0.7526353186424929
1098,978991,526,1,0.556371,230,982935,-1,500.0,3220700,3221226,2241709,526,18,7,True,True,13.317297222222221,-0.556371
1099,980530,24,4,0.586465,230,982935,-1,2000.0,2846880,2846904,1866350,24,54,1,True,True,1.5036,-0.586465
1100,980556,14205,5,0.561586,230,982935,-1,2500.0,2442976,2457181,1462420,14205,124,8,True,True,790.1482291666666,-0.5267122341600582
1101,980782,174,1,0.329646,230,982935,-1,500.0,1692021,1692195,711239,174,177,10,True,True,4.5421249999999995,-0.329646
1102,981035,110,1,0.122231,230,982935,-1,500.0,1883248,1883358,902213,110,168,1,True,True,1.9677777777777778,-0.122231
1103,981285,15835,1,0.353598,230,982935,-1,500.0,3111079,3126914,2129794,15835,31,8,True,True,307.6357263888889,-0.340199977731624
1104,981445,6,1,0.665341,230,982935,-1,500.0,2032033,2032039,1050588,6,160,7,True,True,0.11603333333333335,-0.665341
1105,982056,602,32,0.750284,230,982935,-1,16000.0,2875101,2875703,1893045,602,49,0,True,True,313.8426666666667,-0.750284
1106,982101,37,4,0.868092,230,982935,-1,2000.0,2696683,2696720,1714582,37,76,10,True,True,4.138038888888889,-0.868092
1107,982123,110,8,0.721061,230,982935,-1,4000.0,1984433,1984543,1002310,110,165,11,True,True,10.057666666666668,-0.721061
1108,982164,7,8,0.968399,230,982935,-1,4000.0,1004535,1004542,22371,7,224,10,True,True,1.2906444444444445,-0.968399
1109,982252,5,1,0.60041,230,982935,-1,500.0,1583088,1583093,600836,5,187,1,True,True,0.1689027777777778,-0.60041
1110,982290,4761,32,0.351646,230,982935,-1,16000.0,2575721,2580482,1593431,4761,105,0,True,True,3118.2511555555557,-0.32915208824295245
1111,982603,17270,32,0.577919,230,982935,-1,16000.0,3430646,3447916,2448043,17270,0,7,True,True,8742.493244444444,-0.5456782597023907
1112,982610,6,1,0.212739,230,982935,-1,500.0,2252566,2252572,1269956,6,145,1,True,True,0.04201666666666667,-0.212739
1113,982622,638,32,0.656736,230,982935,-1,16000.0,2391966,2392604,1409344,638,139,7,True,True,285.4553777777778,-0.656736
1114,982989,235,32,0.224245,233,1004535,-1,16000.0,1496680,1496915,513691,235,194,2,True,True,127.71466666666667,-0.224245
1115,983056,39,1,0.108218,233,1004535,-1,500.0,2675083,2675122,1692027,39,78,6,True,True,0.7731208333333333,-0.108218
1116,983155,9737,1,0.845373,233,1004535,-1,500.0,2722683,2732420,1739528,9737,75,7,True,True,253.98507222222224,-0.8307644022967127
1117,983164,29666,2,0.367561,233,1004535,-1,1000.0,2297966,2327632,1314802,29666,146,10,True,True,1131.5752444444445,-0.3658468036882804
8108,6377131,47,4,0.476302,1,6377131,-1,2000.0,6379331,6379378,2200,47,0,7,True,True,2.040061111111111,-0.476302
8109,6378238,10,1,0.897511,4,6379331,-1,500.0,6400931,6400941,22693,10,0,0,True,True,0.18220833333333333,-0.897511
8110,6378720,26,11,0.123098,4,6379331,-1,5500.0,6384731,6384757,6011,26,1,8,True,True,3.607175,-0.12309800000000003
8111,6378935,136,8,0.135756,4,6379331,-1,4000.0,6379331,6379467,396,136,2,0,True,True,11.80631111111111,-0.135756
8112,6378951,139,64,0.534543,4,6379331,-1,32000.0,6390131,6390270,11180,139,1,8,True,True,112.83093333333332,-0.534543
8113,6379393,5,2,0.725414,5,6384731,-1,1000.0,6395531,6395536,16138,5,1,0,True,True,0.15225000000000002,-0.725414
8114,6379472,188,16,0.090442,5,6384731,-1,8000.0,6395531,6395719,16059,188,1,0,True,True,45.796800000000005,-0.090442
8115,6380095,12873,4,0.691785,5,6384731,-1,2000.0,6395531,6408404,15436,12873,3,8,True,True,891.4881444444444,-0.6917130560576183
8116,6391925,24763,3,0.871941,5,6395531,-1,1500.0,6406331,6431094,14406,24763,0,8,True,True,1161.0599541666666,-0.8351686092965624
8117,6393083,6,2,0.93178,5,6395531,-1,1000.0,6400931,6400937,7848,6,2,8,True,True,0.21865,-0.93178
8118,6402404,10865,16,0.766337,7,6406331,-1,8000.0,7089027,7099892,686623,10865,0,1,True,True,4096.853066666667,-0.750004122056002
8119,6402494,34078,256,0.600679,7,6406331,-1,128000.0,6431094,6465172,28600,34078,1,0,True,True,137952.9415111111,-0.5872259406078748
8120,6402669,20,1,0.643987,7,6406331,-1,500.0,6874866,6874886,472197,20,1,2,True,True,0.43325,-0.643987
8121,6404470,327,1,0.37701,7,6406331,-1,500.0,6484243,6484570,79773,327,2,1,True,True,4.842325000000001,-0.37701
8122,6405043,16695,8,0.717443,7,6406331,-1,4000.0,6471806,6488501,66763,16695,3,6,True,True,1906.1419777777778,-0.6921191632626599
8123,6405474,12420,141,0.736002,7,6406331,-1,70500.0,8509795,8522215,2104321,12420,0,6,True,True,43849.88375,-0.6365951091384554
8124,6405788,47,4,0.381651,7,6406331,-1,2000.0,7466297,7466344,1060509,47,1,7,True,True,8.316650000000001,-0.381651
8125,6406712,10245,128,0.642102,47,6431094,-1,64000.0,6467406,6477651,60694,10245,6,7,True,True,18526.03093333333,-0.6414782373818182
8126,6406866,2,4,0.5619,47,6431094,-1,2000.0,6499743,6499745,92877,2,4,6,True,True,0.1592888888888889,-0.5619
8127,6409679,62,16,0.856141,47,6431094,-1,8000.0,6593657,6593719,183978,62,4,0,True,True,42.803422222222224,-0.856141
8128,6411880,3461,4,0.808447,47,6431094,-1,2000.0,6880666,6884127,468786,3461,3,7,True,True,198.66476666666668,-0.6854600326720007
8129,6412361,433,2,0.223551,47,6431094,-1,1000.0,6550357,6550790,137996,433,6,10,True,True,12.000113888888889,-0.223551
8130,6412410,16,2,0.11569,47,6431094,-1,1000.0,7245680,7245696,833270,16,2,1,True,True,1.5155555555555555,-0.11569
8131,6412419,8503,32,0.08768,47,6431094,-1,16000.0,7066323,7074826,653904,8503,4,12,True,True,8778.142711111112,-0.08763785127387688
8132,6412478,35,4,0.089139,47,6431094,-1,2000.0,6484208,6484243,71730,35,11,7,True,True,2.073166666666667,-0.089139
8133,6413657,15493,8,0.740581,47,6431094,-1,4000.0,8035841,8051334,1622184,15493,1,2,True,True,6024.046844444445,-0.7395029716556193
8134,6413715,7,1,0.937211,47,6431094,-1,500.0,7364680,7364687,950965,7,3,8,True,True,0.20911527777777777,-0.937211
8135,6413904,35,5,0.744618,47,6431094,-1,2500.0,6818649,6818684,404745,35,9,1,True,True,6.058888888888889,-0.744618
8136,6414290,126,1,0.116106,47,6431094,-1,500.0,6482008,6482134,67718,126,15,7,True,True,1.817375,-0.116106
8137,6414603,58,4,0.367737,47,6431094,-1,2000.0,6470706,6470764,56103,58,17,6,True,True,3.4416555555555557,-0.367737
8138,6421226,22,8,0.85333,47,6431094,-1,4000.0,6740322,6740344,319096,22,10,6,True,True,8.149533333333334,-0.85333
8139,6421316,4,8,0.954069,47,6431094,-1,4000.0,6851049,6851053,429733,4,9,10,True,True,1.3344444444444445,-0.954069
8140,6421412,60,4,0.576917,47,6431094,-1,2000.0,6465206,6465266,43794,60,21,1,True,True,3.247666666666667,-0.576917
8141,6421880,8849,32,0.001678,47,6431094,-1,16000.0,7812441,7821290,1390561,8849,2,8,True,True,6133.779111111111,-0.0016656058483255185
8142,6421934,8333,15,0.061885,47,6431094,-1,7500.0,6469606,6477939,47672,8333,21,7,True,True,1785.9236666666668,-0.06148228842940778
8143,6422009,22,1,0.535603,47,6431094,-1,500.0,6475406,6475428,53397,22,19,3,True,True,0.3165861111111111,-0.535603
8144,6422033,20390,32,0.847119,47,6431094,-1,16000.0,6561257,6581647,139224,20390,14,6,True,True,22607.12524444444,-0.7985396051944864
8145,6422764,6751,32,0.979849,47,6431094,-1,16000.0,6465172,6471923,42408,6751,26,1,True,True,2978.611866666667,-0.9496250057635238
8146,6423734,14,1,0.319643,47,6431094,-1,500.0,6514543,6514557,90809,14,16,8,True,True,0.5582888888888888,-0.319643
8147,6423866,23216,101,0.365024,47,6431094,-1,50500.0,6717622,6740838,293756,23216,13,7,True,True,59910.48899166666,-0.3306648187997294
8148,6423995,349,4,0.679302,47,6431094,-1,2000.0,8128041,8128390,1704046,349,1,11,True,True,63.853427777777775,-0.679302
8149,6424009,34,8,0.796565,47,6431094,-1,4000.0,6465172,6465206,41163,34,29,0,True,True,3.680688888888889,-0.796565
8150,6424161,8,1,0.519751,47,6431094,-1,500.0,8657924,8657932,2233763,8,0,9,True,True,0.23528888888888888,-0.519751
8151,6424189,31,2,0.601618,47,6431094,-1,1000.0,7456497,7456528,1032308,31,6,0,True,True,2.5080722222222223,-0.601618
8152,6424395,7,1,0.222142,47,6431094,-1,500.0,7834041,7834048,1409646,7,4,10,True,True,0.13359305555555556,-0.222142
8153,6424449,25172,64,0.395312,47,6431094,-1,32000.0,6706419,6731591,281970,25172,18,6,True,True,26214.162844444443,-0.3904754008638093
8154,6424472,20451,2,0.538293,47,6431094,-1,1000.0,6489643,6510094,65171,20451,24,8,True,True,765.4679722222223,-0.5165378322570615
8155,6424527,15,4,0.460603,47,6431094,-1,2000.0,7347380,7347395,922853,15,9,2,True,True,2.0435,-0.460603
8156,6425008,71,1,0.144701,47,6431094,-1,500.0,6477606,6477677,52598,71,29,7,True,True,0.9168861111111111,-0.144701
8157,6425300,7485,4,0.94289,47,6431094,-1,2000.0,6797038,6804523,371738,7485,17,7,True,True,704.4780388888889,-0.8682255599806218
8158,6425396,13324,16,0.837217,47,6431094,-1,8000.0,8584829,8598153,2159433,13324,1,7,True,True,8000.452933333334,-0.8163592452265621
8159,6425461,47,1,0.499833,47,6431094,-1,500.0,7701741,7701788,1276280,47,7,8,True,True,1.002601388888889,-0.499833
8160,6425543,224,1,0.455785,47,6431094,-1,500.0,7477197,7477421,1051654,224,8,6,True,True,9.757380555555555,-0.4504849686281649
8161,6425595,2,19,0.601465,47,6431094,-1,9500.0,7747141,7747143,1321546,2,7,7,True,True,0.8554222222222223,-0.601465
8162,6425609,443,1,0.145871,47,6431094,-1,500.0,6479808,6480251,54199,443,34,1,True,True,6.099793055555557,-0.13925356771541697
8163,6426025,8,1,0.665351,47,6431094,-1,500.0,6498643,6498651,72618,8,30,8,True,True,0.1592888888888889,-0.665351
8164,6426378,7081,128,0.801292,47,6431094,-1,64000.0,8576829,8583910,2150451,7081,2,0,True,True,29610.352,-0.7880742466662337
8165,6426457,11,1,0.702967,47,6431094,-1,500.0,7456480,7456491,1030023,11,13,0,True,True,0.44498055555555555,-0.702967
8166,6455460,21180,4,0.59888,53,6465172,-1,2000.0,6505543,6526723,50083,21180,31,2,True,True,2212.133261111111,-0.5988557966501664
8167,6455719,12,32,0.308891,53,6465172,-1,16000.0,7282880,7282892,827161,12,16,10,True,True,18.853333333333335,-0.308891
8168,6455822,29177,128,0.990335,53,6465172,-1,64000.0,8235795,8264972,1779973,29177,4,2,True,True,127966.28533333332,-0.9242733148646614
8169,6455887,16,2,0.123464,53,6465172,-1,1000.0,7468497,7468513,1012610,16,12,7,True,True,1.4576444444444445,-0.123464
8170,6456027,100,1,0.996849,53,6465172,-1,500.0,7973441,7973541,1517414,100,7,8,True,True,3.239583333333333,-0.996849
8171,6456047,127,2,0.706522,53,6465172,-1,1000.0,7973441,7973568,1517394,127,7,0,True,True,8.228541666666667,-0.706522
8172,6462804,16,1,0.478283,53,6465172,-1,500.0,6572057,6572073,109253,16,33,9,True,True,0.7084888888888888,-0.478283
8173,6468167,12202,32,0.828687,52,6469606,-1,16000.0,8334795,8346997,1866628,12202,4,12,True,True,14709.7384,-0.8234454423672019
8174,6468858,69,16,0.495026,52,6469606,-1,8000.0,6501943,6502012,33085,69,39,7,True,True,21.8822,-0.495026
8175,6468963,23944,16,0.70414,52,6469606,-1,8000.0,7563597,7587541,1094634,23944,14,12,True,True,8722.656377777777,-0.6602228263376857
8176,6470414,2,40,0.376709,52,6470706,-1,20000.0,6479806,6479808,9392,2,48,7,True,True,1.033111111111111,-0.376709
8177,6471051,30,4,0.981143,52,6471806,-1,2000.0,7701741,7701771,1230690,30,13,0,True,True,2.559833333333333,-0.981143
8178,6472282,19,8,0.333145,53,6475406,-1,4000.0,8241195,8241214,1768913,19,5,8,True,True,6.752811111111112,-0.333145
8179,6472694,35,2,0.827885,53,6475406,-1,1000.0,7106003,7106038,633309,35,26,2,True,True,1.404763888888889,-0.827885
8180,6481475,21285,8,0.210613,50,6482008,-1,4000.0,7591141,7612426,1109666,21285,16,2,True,True,3953.479677777778,-0.20828183188923682
8181,6482751,3,1,0.732658,53,6484208,-1,500.0,6711819,6711822,229068,3,37,8,True,True,0.04682083333333334,-0.732658
8182,6482913,22,4,0.810419,53,6484208,-1,2000.0,6711822,6711844,228909,22,37,1,True,True,1.3734111111111111,-0.810419
8183,6483235,9208,8,0.700407,53,6484208,-1,4000.0,6560157,6569365,76922,9208,43,7,True,True,2205.052422222222,-0.6755614646743834
8184,6484147,1,32,0.052566,53,6484208,-1,16000.0,6519943,6519944,35796,1,45,8,True,True,0.7353777777777778,-0.052566
8185,6485258,9,16,0.865432,53,6489643,-1,8000.0,6493243,6493252,7985,9,51,1,True,True,2.1636,-0.865432
8186,6485563,36,20,0.17902,53,6489643,-1,10000.0,7091227,7091263,605664,36,28,7,True,True,20.464,-0.17902
8187,6492039,8,26,0.487505,54,6493243,-1,13000.0,6874849,6874857,382810,8,33,0,True,True,4.5058,-0.487505
8188,6492231,31,32,0.391808,54,6493243,-1,16000.0,7309180,7309211,816949,31,25,10,True,True,37.61333333333333,-0.391808
8189,6495591,2,1,0.98439,60,6498643,-1,500.0,8244795,8244797,1749204,2,5,4,True,True,0.10271388888888888,-0.98439
8190,6495648,26,8,0.65925,60,6498643,-1,4000.0,6557957,6557983,62309,26,48,7,True,True,2.827644444444444,-0.65925
8191,6495954,8,1,0.848518,60,6498643,-1,500.0,7986841,7986849,1490887,8,10,7,True,True,0.3481444444444444,-0.848518
8192,6496746,14074,4,0.991063,60,6498643,-1,2000.0,7868641,7882715,1371895,14074,13,9,True,True,1364.7849999999999,-0.8951471199424248
8193,6498268,835,2,0.547943,60,6498643,-1,1000.0,7341580,7342415,843312,835,28,0,True,True,54.6925,-0.547943
8194,6498325,12165,64,0.33741,60,6498643,-1,32000.0,7795841,7808006,1297516,12165,16,0,True,True,17384.860355555556,-0.3373902892536448
8195,6498584,9640,64,0.677899,60,6498643,-1,32000.0,6509143,6518783,10559,9640,56,2,True,True,20283.038844444447,-0.6527761529079052
8196,6498674,14962,32,0.990314,60,6499743,-1,16000.0,6521157,6536119,22483,14962,54,2,True,True,8187.469555555555,-0.9356423577004402
8197,6501826,1213,32,0.757714,60,6501943,-1,16000.0,6519944,6521157,18118,1213,55,0,True,True,892.0132444444445,-0.757714
8198,6502035,6153,1,0.391063,64,6505543,-1,500.0,6874849,6881002,372814,6153,40,7,True,True,140.69702083333334,-0.36134254557049084
8199,6502111,9289,8,0.527844,64,6505543,-1,4000.0,7242080,7251369,739969,9289,33,12,True,True,3557.934255555556,-0.5214474837642257
8200,6502185,26,1,0.28304,64,6505543,-1,500.0,7795841,7795867,1293656,26,17,7,True,True,0.5718916666666667,-0.28304
8201,6502386,77,27,0.696376,64,6505543,-1,13500.0,6807838,6807915,305452,77,45,9,True,True,46.0296375,-0.696376
8202,6504417,98,8,0.195092,64,6505543,-1,4000.0,6523357,6523455,18940,98,58,7,True,True,13.507666666666665,-0.195092
8203,6506506,16072,16,0.856252,68,6509143,-1,8000.0,6923723,6939795,417217,16072,39,8,True,True,9502.514355555555,-0.8500976452772713
8204,6506530,393,2,0.393772,68,6509143,-1,1000.0,7857841,7858234,1351311,393,14,7,True,True,14.251708333333333,-0.393772
8205,6506670,9,10,0.130901,68,6509143,-1,5000.0,6521044,6521053,14374,9,62,6,True,True,2.0682500000000004,-0.130901
8206,6506850,53,32,0.752266,68,6509143,-1,16000.0,8579029,8579082,2072179,53,2,7,True,True,55.35791111111111,-0.752266
8207,6506902,10238,16,0.580384,68,6509143,-1,8000.0,8138841,8149079,1631939,10238,9,9,True,True,7101.867133333333,-0.5739914859918641
8208,6514749,11,4,0.805072,73,6519943,-1,2000.0,6519944,6519955,5195,11,66,1,True,True,1.0111444444444446,-0.805072
8209,6515182,17122,16,0.84981,73,6519943,-1,8000.0,6914968,6932090,399786,17122,43,10,True,True,10809.277111111112,-0.8326970703350681
8210,6515205,5924,65,0.709588,73,6519943,-1,32500.0,8681724,8687648,2166519,5924,0,10,True,True,7925.606,-0.6846693451831779
8211,6515302,21,4,0.457533,73,6519943,-1,2000.0,6597319,6597340,82017,21,58,4,True,True,3.6223833333333335,-0.457533
8212,6515336,13,4,0.163694,73,6519943,-1,2000.0,7587397,7587410,1072061,13,26,7,True,True,1.2247444444444444,-0.163694
8213,6518831,318,1,0.137561,73,6519943,-1,500.0,8579029,8579347,2060198,318,3,0,True,True,10.379608333333334,-0.137561
8214,6519316,9030,256,0.695956,73,6519943,-1,128000.0,7155680,7164710,636364,9030,41,2,True,True,98768.75377777779,-0.6912435804933109
8215,6520167,30595,8,0.291082,72,6521044,-1,4000.0,8231095,8261690,1710928,30595,11,12,True,True,9183.878944444446,-0.2808888862366907
8216,6521012,76,8,0.144823,72,6521044,-1,4000.0,7804841,7804917,1283829,76,22,2,True,True,13.397955555555555,-0.144823
8217,6521112,549,11,0.218136,73,6521157,-1,5500.0,7102403,7102952,581291,549,45,1,True,True,126.18877638888888,-0.2148776221218272
8218,6521118,54,4,0.748383,73,6521157,-1,2000.0,8144641,8144695,1623523,54,12,2,True,True,9.2223,-0.748383
8219,6523224,6,4,0.735319,76,6523357,-1,2000.0,6528757,6528763,5533,6,72,8,True,True,0.42106666666666664,-0.735319
8220,6523228,25123,128,0.009133,76,6523357,-1,64000.0,7253280,7278403,730052,25123,42,8,True,True,161140.09457777778,-0.009059154163219786
8221,6523268,45,32,0.725958,76,6523357,-1,16000.0,8139941,8139986,1616673,45,13,6,True,True,62.148,-0.725958
8222,6523290,5278,1,0.575682,76,6523357,-1,500.0,6884268,6889546,360978,5278,54,0,True,True,131.35539166666666,-0.5235856399349421
8223,6523551,26792,8,0.678318,90,6528757,-1,4000.0,7874041,7900833,1350490,26792,20,8,True,True,5025.715766666666,-0.648156033869816
8224,6523577,26,32,0.988484,90,6528757,-1,16000.0,7968041,7968067,1444464,26,20,8,True,True,26.74071111111111,-0.988484
8225,6523687,13863,2,0.147605,90,6528757,-1,1000.0,7099892,7113755,576205,13863,51,2,True,True,759.5959416666666,-0.12638273141101922
8226,6523887,47,32,0.950398,90,6528757,-1,16000.0,8084841,8084888,1560954,47,16,10,True,True,54.82288888888889,-0.950398
8227,6525544,23,3,0.427111,90,6528757,-1,1500.0,7336180,7336203,810636,23,44,0,True,True,2.206466666666667,-0.427111
8228,6525619,311,2,0.84166,90,6528757,-1,1000.0,7102092,7102403,576473,311,53,0,True,True,13.194175,-0.84166
8229,6525992,180,14,0.925985,90,6528757,-1,7000.0,8755017,8755197,2229025,180,0,1,True,True,69.1075,-0.925985
8230,6526033,15294,16,0.096048,90,6528757,-1,8000.0,6593657,6608951,67624,15294,76,0,True,True,11014.374022222222,-0.0958775075587307
8231,6526045,205,1,0.974159,90,6528757,-1,500.0,6715422,6715627,189377,205,72,3,True,True,3.2671875,-0.974159
8232,6526122,1222,1,0.179633,90,6528757,-1,500.0,6918323,6919545,392201,1222,60,1,True,True,50.28853055555555,-0.178392158603585
8233,6526796,10402,8,0.052472,90,6528757,-1,4000.0,7102092,7112494,575296,10402,55,7,True,True,2306.6167777777778,-0.04914958743951693
8234,6526905,17,2,0.980277,90,6528757,-1,1000.0,7111403,7111420,584498,17,52,8,True,True,1.1937305555555555,-0.980277
8235,6526907,11573,6,0.650098,90,6528757,-1,3000.0,6593657,6605230,66750,11573,82,10,True,True,3121.932008333333,-0.6471966838517517
8236,6526938,14957,64,0.593392,90,6528757,-1,32000.0,7140723,7155680,613785,14957,52,1,True,True,39298.12746666667,-0.5839959442059117
8237,6527026,8,13,0.969727,90,6528757,-1,6500.0,7801241,7801249,1274215,8,29,8,True,True,2.312266666666667,-0.969727
8238,6531734,19,16,0.626973,104,6550357,-1,8000.0,6878466,6878485,346732,19,68,2,True,True,8.188155555555555,-0.626973
8239,6531754,102,4,0.403994,104,6550357,-1,2000.0,6711819,6711921,180065,102,80,0,True,True,6.367633333333333,-0.403994
8240,6533797,30,16,0.033993,104,6550357,-1,8000.0,7283980,7284010,750183,30,48,6,True,True,23.566666666666666,-0.033993
8241,6537960,162,32,0.240855,104,6550357,-1,16000.0,8032241,8032403,1494281,162,19,7,True,True,251.7192,-0.240855
8242,6537985,38206,4,0.488626,104,6550357,-1,2000.0,6555757,6593963,17772,38206,93,8,True,True,5336.043361111111,-0.4755924123677139
8243,6539007,11,16,0.687984,104,6550357,-1,8000.0,6593719,6593730,54712,11,86,1,True,True,7.594155555555556,-0.687984
8244,6547958,81,1,0.954555,104,6550357,-1,500.0,8730848,8730929,2182890,81,1,11,True,True,1.8849375000000002,-0.954555
8245,6547981,6,8,0.652797,104,6550357,-1,4000.0,7464097,7464103,916116,6,43,7,True,True,2.1234,-0.652797
8246,6548054,15766,1,0.375372,104,6550357,-1,500.0,6618919,6634685,70865,15766,87,10,True,True,268.78723611111116,-0.3594426322029066
8247,6548764,1472,6,0.691795,104,6550357,-1,3000.0,8683924,8685396,2135160,1472,2,7,True,True,177.376,-0.691795
8248,6549100,15973,4,0.795325,104,6550357,-1,2000.0,8660124,8676097,2111024,15973,4,7,True,True,1741.53615,-0.7750226153077705
8249,6549404,11,16,0.658519,104,6550357,-1,8000.0,6818638,6818649,269234,11,80,0,True,True,6.093511111111112,-0.658519
8250,6549461,127,2,0.777731,104,6550357,-1,1000.0,8008441,8008568,1458980,127,23,10,True,True,5.849408333333333,-0.777731
8251,6549590,12228,128,0.864896,104,6550357,-1,64000.0,6890068,6902296,340478,12228,73,7,True,True,58188.36408888889,-0.8576130469833994
8252,6550270,447,16,0.650311,104,6550357,-1,8000.0,7247880,7248327,697610,447,57,7,True,True,344.73633333333333,-0.650311
8253,6550672,574,8,0.275216,106,6555757,-1,4000.0,6872649,6873223,321977,574,81,9,True,True,99.4742,-0.275216
8254,6550906,17,1,0.653195,106,6555757,-1,500.0,7653141,7653158,1102235,17,40,2,True,True,0.38254722222222226,-0.653195
8255,6551317,9,4,0.367323,106,6555757,-1,2000.0,8508695,8508704,1957378,9,11,12,True,True,1.2757,-0.367323
8256,6555872,21,16,0.12,110,6557957,-1,8000.0,8030041,8030062,1474169,21,24,0,True,True,13.4288,-0.12
8257,6556914,38837,32,0.082637,110,6557957,-1,16000.0,6892268,6931105,335354,38837,77,0,True,True,48045.87622222222,-0.08243037509214084
8258,6556980,7,1,0.489218,110,6557957,-1,500.0,7341580,7341587,784600,7,55,8,True,True,0.22925,-0.489218
8259,6557207,20,8,0.668792,110,6557957,-1,4000.0,7473897,7473917,916690,20,47,8,True,True,7.051555555555556,-0.668792
8260,6557226,30122,16,0.509748,110,6557957,-1,8000.0,8232195,8262317,1674969,30122,16,6,True,True,17802.26033333333,-0.47978755338990065
8261,6560365,24923,8,0.023027,109,6561257,-1,4000.0,7359280,7384203,798915,24923,55,0,True,True,5281.009666666667,-0.022711327414228773
8262,6561375,4,4,0.572982,109,6572057,-1,2000.0,7358180,7358184,796805,4,56,0,True,True,0.4702222222222222,-0.572982
8263,6584225,8636,32,0.572631,113,6593657,-1,16000.0,8063241,8071877,1479016,8636,23,10,True,True,12634.699377777777,-0.5640494077029954
8264,6584326,115,1,0.273725,113,6593657,-1,500.0,7255480,7255595,671154,115,65,7,True,True,6.187159722222222,-0.273725
8265,6584470,5285,1,0.745359,113,6593657,-1,500.0,7138420,7143705,553950,5285,72,0,True,True,188.60298611111114,-0.67593282977217
8266,6584524,17,8,0.794344,113,6593657,-1,4000.0,7456480,7456497,871956,17,55,8,True,True,5.5015777777777775,-0.794344
8267,6586397,15006,2,0.181097,113,6593657,-1,1000.0,6893368,6908374,306971,15006,86,6,True,True,1112.7651444444446,-0.17923908569457261
8268,6595995,36,1,0.484191,110,6597319,-1,500.0,7336180,7336216,740185,36,63,8,True,True,1.1512,-0.484191
8269,6598188,13,2,0.644597,188,6618919,-1,1000.0,7979241,7979254,1381053,13,29,3,True,True,0.9219527777777777,-0.644597
8270,6598204,29295,1,0.433656,188,6618919,-1,500.0,8144695,8173990,1546491,29295,18,0,True,True,1374.403326388889,-0.4333679260810384
8271,6598230,8526,1,0.571423,188,6618919,-1,500.0,7696341,7704867,1098111,8526,46,11,True,True,179.55807083333335,-0.5630631836990486
8272,6598245,6341,32,0.099441,188,6618919,-1,16000.0,7793641,7799982,1195396,6341,43,6,True,True,4581.7936,-0.08978937177721014
8273,6598319,6,32,0.063498,188,6618919,-1,16000.0,7476097,7476103,877778,6,53,0,True,True,8.461866666666667,-0.063498
8274,6598385,98,4,0.908881,188,6618919,-1,2000.0,7096627,7096725,498242,98,86,8,True,True,8.198244444444445,-0.908881
8275,6598409,63,4,0.795225,188,6618919,-1,2000.0,7476097,7476160,877688,63,54,7,True,True,11.106200000000001,-0.795225
8276,6598586,39,1,0.18489,188,6618919,-1,500.0,6818638,6818677,220052,39,107,9,True,True,1.3502666666666667,-0.18489
8277,6598637,103,32,0.812868,188,6618919,-1,16000.0,7140620,7140723,541983,103,80,7,True,True,113.6296,-0.812868
8278,6601227,155,32,0.019746,188,6618919,-1,16000.0,7593341,7593496,992114,155,49,7,True,True,112.48866666666666,-0.019746
8279,6601244,6,11,0.55606,188,6618919,-1,5500.0,8422295,8422301,1821051,6,12,6,True,True,2.2108166666666667,-0.55606
8280,6601275,10,1,0.536417,188,6618919,-1,500.0,8235795,8235805,1634520,10,16,0,True,True,0.44654166666666667,-0.536417
8281,6601296,8,1,0.812196,188,6618919,-1,500.0,8144695,8144703,1543399,8,21,0,True,True,0.3415666666666667,-0.812196
8282,6601430,4,2,0.488563,188,6618919,-1,1000.0,7089023,7089027,487593,4,95,6,True,True,0.22737777777777776,-0.488563
8283,6601507,326,2,0.518901,188,6618919,-1,1000.0,7358180,7358506,756673,326,69,9,True,True,19.183344444444444,-0.5176806356982753
8284,6601557,3,8,0.584722,188,6618919,-1,4000.0,8647124,8647127,2045567,3,6,11,True,True,0.7675666666666667,-0.584722
8285,6601724,7,16,0.713749,188,6618919,-1,8000.0,8039441,8039448,1437717,7,29,2,True,True,5.523311111111111,-0.713749
8286,6601793,12,2,0.790068,188,6618919,-1,1000.0,7649541,7649553,1047748,12,54,7,True,True,0.5469333333333334,-0.790068
8287,6602243,16242,8,0.124089,188,6618919,-1,4000.0,6979923,6996165,377680,16242,101,11,True,True,4559.6068,-0.11990077135969143
8288,6602328,45256,3,0.752988,188,6618919,-1,1500.0,7960441,8005697,1358113,45256,39,12,True,True,4764.767629166667,-0.7457218725698843
8289,6602357,1768,4,0.965681,188,6618919,-1,2000.0,7456497,7458265,854140,1768,67,0,True,True,286.0820444444444,-0.965681
8290,6602381,3627,16,0.897602,188,6618919,-1,8000.0,7282880,7286507,680499,3627,82,0,True,True,2850.2253111111113,-0.8872839558238991
8291,6602432,111,70,0.180664,188,6618919,-1,35000.0,7792541,7792652,1190109,111,50,7,True,True,207.07049999999998,-0.180664
8292,6602439,5630,63,0.599103,188,6618919,-1,31500.0,8579029,8584659,1976590,5630,9,0,True,True,11738.670387499998,-0.5942500124323566
8293,6602850,587,4,0.179938,188,6618919,-1,2000.0,6861849,6862436,258999,587,120,9,True,True,97.08327777777778,-0.179938
8294,6602886,1,8,0.554722,188,6618919,-1,4000.0,8421195,8421196,1818309,1,15,12,True,True,0.26797777777777776,-0.554722
8295,6602918,561,8,0.800513,188,6618919,-1,4000.0,6829449,6830010,226531,561,123,9,True,True,184.12019999999998,-0.800513
8296,6602928,8,1,0.123045,188,6618919,-1,500.0,8752448,8752456,2149520,8,1,10,True,True,0.21938888888888888,-0.123045
8297,6602934,6208,3,0.128816,188,6618919,-1,1500.0,6887868,6894076,284934,6208,115,2,True,True,668.1831666666667,-0.12286063923605249
8298,6603044,9451,256,0.20623,188,6618919,-1,128000.0,8687648,8697099,2084604,9451,3,6,True,True,50301.850666666665,-0.2048883727703064
8299,6603431,3571,256,0.16121,188,6618919,-1,128000.0,8598153,8601724,1994722,3571,9,1,True,True,35241.11217777778,-0.15499852601012412
8300,6603479,6939,4,0.562496,188,6618919,-1,2000.0,7282880,7289819,679401,6939,89,0,True,True,1370.853127777778,-0.5623198727924327
8301,6603637,8,1,0.85145,188,6618919,-1,500.0,7604141,7604149,1000504,8,62,9,True,True,0.18384444444444445,-0.85145
8302,6603653,369,2,0.035005,188,6618919,-1,1000.0,8754648,8755017,2150995,369,1,7,True,True,20.238625,-0.035005
8303,6603719,80,8,0.979928,188,6618919,-1,4000.0,6887868,6887948,284149,80,120,0,True,True,20.62666666666667,-0.979928
8304,6604464,116,12,0.506148,188,6618919,-1,6000.0,6794838,6794954,190374,116,137,8,True,True,27.5848,-0.506148
8305,6604573,1322,28,0.36356,188,6618919,-1,14000.0,6789438,6790760,184865,1322,138,8,True,True,1145.4317777777778,-0.33834844605209446
8306,6604621,9127,32,0.544427,188,6618919,-1,16000.0,6925923,6935050,321302,9127,114,7,True,True,10861.308488888888,-0.530102393630086
8307,6604631,7934,1,0.423051,188,6618919,-1,500.0,6739222,6747156,134591,7934,141,10,True,True,349.4832583333333,-0.42267110857921064
8308,6606881,33034,2,0.945228,188,6618919,-1,1000.0,7330780,7363814,723899,33034,88,10,True,True,2070.768294444444,-0.9406551066777995
8309,6606899,42,16,8.6e-05,188,6618919,-1,8000.0,7087923,7087965,481024,42,113,10,True,True,21.936133333333334,-8.6e-05
8310,6606945,21,64,0.3006,188,6618919,-1,32000.0,8603924,8603945,1996979,21,10,7,True,True,48.28693333333334,-0.3006
8311,6606974,17,16,0.946215,188,6618919,-1,8000.0,6874849,6874866,267875,17,130,0,True,True,5.8922,-0.946215
8312,6607002,13375,128,0.519443,188,6618919,-1,64000.0,7111420,7124795,504418,13375,104,1,True,True,65782.616,-0.5145726706187289
8313,6607032,18378,32,0.782802,188,6618919,-1,16000.0,6872649,6891027,265617,18378,134,0,True,True,13404.063866666667,-0.6619872656767039
8314,6607069,163,13,0.659158,188,6618919,-1,6500.0,8144695,8144858,1537626,163,30,1,True,True,90.47247083333333,-0.659158
8315,6607310,9106,128,0.44492,188,6618919,-1,64000.0,8555229,8564335,1947919,9106,17,1,True,True,35458.667911111115,-0.44479200703743715
8316,6607654,318,16,0.577071,188,6618919,-1,8000.0,6740344,6740662,132690,318,148,1,True,True,235.5956,-0.577071
8317,6607660,14,1,0.695101,188,6618919,-1,500.0,7116820,7116834,509160,14,106,8,True,True,0.5394083333333334,-0.695101
8318,6607677,12718,2,0.522666,188,6618919,-1,1000.0,8030041,8042759,1422364,12718,42,10,True,True,1214.3474833333332,-0.5094317158120837
8319,6607681,77,32,0.98602,188,6618919,-1,16000.0,7343780,7343857,736099,77,88,7,True,True,80.696,-0.98602
8320,6608094,151,1,0.352117,188,6618919,-1,500.0,6784038,6784189,175944,151,151,11,True,True,3.5224944444444444,-0.352117
8321,6608243,24,4,0.538209,188,6618919,-1,2000.0,7359280,7359304,751037,24,85,6,True,True,2.8312000000000004,-0.538209
8322,6608269,17286,72,0.20984,188,6618919,-1,36000.0,7587541,7604827,979272,17286,70,0,True,True,28450.246400000004,-0.20800820567590383
8323,6608636,12173,33,0.099009,188,6618919,-1,16500.0,6892268,6904441,283632,12173,131,7,True,True,14931.846324999999,-0.09814791259642593
8324,6608641,7850,2,0.819763,188,6618919,-1,1000.0,7984641,7992491,1376000,7850,45,8,True,True,646.8481499999999,-0.8030066091021816
8325,6608689,14,16,0.2371,188,6618919,-1,8000.0,7138420,7138434,529731,14,111,10,True,True,8.983644444444444,-0.2371
8326,6609037,2902,32,0.188074,188,6618919,-1,16000.0,6884268,6887170,275231,2902,138,1,True,True,1752.9245333333333,-0.11015279412392852
8327,6609647,18,32,0.299709,188,6618919,-1,16000.0,8552995,8553013,1943348,18,18,10,True,True,16.6504,-0.299709
8328,6609672,8,1,0.832628,188,6618919,-1,500.0,6705319,6705327,95647,8,168,12,True,True,0.127,-0.832628
8329,6609718,136,8,0.957423,188,6618919,-1,4000.0,6936723,6936859,327005,136,128,9,True,True,39.41582222222222,-0.957423
8330,6609805,11572,2,0.602144,188,6618919,-1,1000.0,8531395,8542967,1921590,11572,19,10,True,True,559.7090694444445,-0.5603038130521384
8331,6609811,28668,16,0.21604,188,6618919,-1,8000.0,7855641,7884309,1245830,28668,56,10,True,True,11062.965466666668,-0.21523015001577372
8332,6610311,17,16,0.359065,188,6618919,-1,8000.0,8601724,8601741,1991413,17,11,6,True,True,9.772355555555556,-0.359065
8333,6610437,18881,16,0.128492,188,6618919,-1,8000.0,7975641,7994522,1365204,18881,50,0,True,True,11524.348266666668,-0.12582557774661215
8334,6610602,61,2,0.622313,188,6618919,-1,1000.0,8585929,8585990,1975327,61,13,6,True,True,4.120550000000001,-0.622313
8335,6610813,6518,1,0.07436,188,6618919,-1,500.0,7456497,7463015,845684,6518,89,2,True,True,273.1299208333333,-0.07143754434866617
8336,6611122,34,5,0.254967,188,6618919,-1,2500.0,8555195,8555229,1944073,34,20,7,True,True,5.056791666666666,-0.25496699999999994
8337,6615704,17343,3,0.381782,188,6618919,-1,1500.0,7587541,7604884,971837,17343,78,0,True,True,1189.3566083333333,-0.37847641450594155
8338,6615735,16,22,0.90366,188,6618919,-1,11000.0,7585197,7585213,969462,16,81,10,True,True,8.263169444444443,-0.9006725345707038
8339,6616571,166,1,0.400059,188,6618919,-1,500.0,6916068,6916234,299497,166,141,6,True,True,6.878855555555556,-0.400059
8340,6616591,14827,128,0.083254,188,6618919,-1,64000.0,8041641,8056468,1425050,14827,43,7,True,True,90401.71324444444,-0.08208954530344564
8341,6617362,14120,2,0.254179,188,6618919,-1,1000.0,7744941,7759061,1127579,14120,71,11,True,True,633.0722499999999,-0.253666260400992
8342,6617493,51,13,0.425343,188,6618919,-1,6500.0,7962641,7962692,1345148,51,57,7,True,True,25.865287499999997,-0.425343
8343,6618406,2,4,0.694515,188,6618919,-1,2000.0,6884266,6884268,265860,2,154,3,True,True,0.1354,-0.694515
8344,6618418,23,16,0.535904,188,6618919,-1,8000.0,6936723,6936746,318305,23,140,0,True,True,13.331822222222222,-0.535904
8345,6618438,11672,2,0.070558,188,6618919,-1,1000.0,7287580,7299252,669142,11672,111,3,True,True,1070.1068444444445,-0.06891364699503182
8346,6618468,4,1,0.732675,188,6618919,-1,500.0,8576829,8576833,1958361,4,19,10,True,True,0.1275,-0.732675
8347,6618580,26,32,0.995359,188,6618919,-1,16000.0,8582629,8582655,1964049,26,15,4,True,True,28.1008,-0.995359
8348,6619963,33909,64,0.696803,203,6705319,-1,32000.0,8141041,8174950,1521078,33909,40,6,True,True,100596.08142222223,-0.696117838972701
8349,6619988,15803,16,0.192627,203,6705319,-1,8000.0,7647341,7663144,1027353,15803,81,11,True,True,5490.697244444444,-0.1907980294491952
8350,6620056,9,1,0.372142,203,6705319,-1,500.0,7261280,7261289,641224,9,120,2,True,True,0.4696,-0.372142
8351,6622312,5,1,0.657318,203,6705319,-1,500.0,7975641,7975646,1353329,5,57,7,True,True,0.18490277777777778,-0.657318
8352,6622397,12,8,0.820508,203,6705319,-1,4000.0,7790341,7790353,1167944,12,75,11,True,True,2.6268000000000002,-0.820508
8353,6622983,8,1,0.604945,203,6705319,-1,500.0,7451080,7451088,828097,8,104,12,True,True,0.3084555555555556,-0.604945
8354,6622999,19984,1,0.419686,203,6705319,-1,500.0,7807041,7827025,1184042,19984,69,7,True,True,432.2477694444445,-0.4159449751701868
8355,6630985,28,1,0.153491,203,6705319,-1,500.0,6893368,6893396,262383,28,157,0,True,True,1.0760555555555555,-0.153491
8356,6632064,10,2,0.992449,203,6705319,-1,1000.0,6740838,6740848,108774,10,186,2,True,True,0.9260833333333334,-0.992449
8357,6632105,2358,32,0.433627,203,6705319,-1,16000.0,8008441,8010799,1376336,2358,52,0,True,True,1733.9246222222223,-0.432687678116102
8358,6632456,13,1,0.02591,203,6705319,-1,500.0,7834041,7834054,1201585,13,68,0,True,True,0.24810138888888889,-0.02591
8359,6632537,232,1,0.603607,203,6705319,-1,500.0,8248395,8248627,1615858,232,30,4,True,True,9.5091,-0.603607
8360,6633392,16,64,0.077525,203,6705319,-1,32000.0,7257680,7257696,624288,16,128,7,True,True,54.44977777777778,-0.077525
8361,6633783,55,8,0.124621,203,6705319,-1,4000.0,6918268,6918323,284485,55,159,7,True,True,18.23311111111111,-0.124621
8362,6635342,7653,128,0.10999,203,6705319,-1,64000.0,7461897,7469550,826555,7653,103,8,True,True,43704.216,-0.10960039189252536
8363,6635459,66,1,0.548369,203,6705319,-1,500.0,7587541,7587607,952082,66,93,2,True,True,1.5544833333333334,-0.548369
6249,4878338,11,32,0.304912,1,4878338,-1,16000.0,4921538,4921549,43200,11,0,11,True,True,2.013733333333333,-0.304912
6250,4879071,26,2,0.337594,65,4921538,-1,1000.0,7735381,7735407,2856310,26,0,7,True,True,1.7063944444444445,-0.337594
6251,4879130,60,2,0.019712,65,4921538,-1,1000.0,7666666,7666726,2787536,60,1,1,True,True,3.9185000000000003,-0.019712
6252,4879180,6680,256,0.326117,65,4921538,-1,128000.0,7233455,7240135,2354275,6680,2,8,True,True,21350.43377777778,-0.30323791996236216
6253,4879208,137,1,0.460909,65,4921538,-1,500.0,7295155,7295292,2415947,137,2,8,True,True,3.1772583333333335,-0.460909
6254,4879296,7,1,0.863369,65,4921538,-1,500.0,5638129,5638136,758833,7,4,5,True,True,0.20124027777777778,-0.863369
6255,4879534,312,1,0.568049,65,4921538,-1,500.0,5860511,5860823,980977,312,4,11,True,True,7.091733333333333,-0.565785877763889
6256,4879804,7273,2,0.90141,65,4921538,-1,1000.0,7289755,7297028,2409951,7273,3,0,True,True,349.9281361111111,-0.8389597611405497
6257,4879828,53,5,0.266619,65,4921538,-1,2500.0,5930805,5930858,1050977,53,5,8,True,True,4.069958333333333,-0.266619
6258,4879844,274,4,0.695958,65,4921538,-1,2000.0,7468962,7469236,2589118,274,2,8,True,True,24.34337777777778,-0.695958
6259,4879850,72,16,0.587989,65,4921538,-1,8000.0,5795611,5795683,915761,72,8,6,True,True,27.3664,-0.587989
6260,4880161,38027,32,0.985765,65,4921538,-1,16000.0,4944238,4982265,64077,38027,10,10,True,True,17915.043733333336,-0.9505676416764136
6261,4880191,17280,16,0.377738,65,4921538,-1,8000.0,7388128,7405408,2507937,17280,3,6,True,True,5185.93208888889,-0.3664147519192561
6262,4880221,16,8,0.390301,65,4921538,-1,4000.0,4971282,4971298,91061,16,11,1,True,True,1.2750222222222223,-0.390301
6263,4880293,160,16,0.572539,65,4921538,-1,8000.0,7655862,7656022,2775569,160,2,0,True,True,70.19377777777778,-0.572539
6264,4887016,13116,4,0.808327,65,4921538,-1,2000.0,6811437,6824553,1924421,13116,8,0,True,True,1141.4565666666665,-0.789463915672539
6265,4887503,7015,8,0.100057,65,4921538,-1,4000.0,7420620,7427635,2533117,7015,4,2,True,True,1508.8346666666666,-0.09690164627640568
6266,4887513,78,16,0.675111,65,4921538,-1,8000.0,5304081,5304159,416568,78,14,10,True,True,20.734133333333336,-0.675111
6267,4887636,911,32,0.335967,65,4921538,-1,16000.0,5210382,5211293,322746,911,15,2,True,True,558.2203111111111,-0.335967
6268,4887999,37,1,0.502769,65,4921538,-1,500.0,4988582,4988619,100583,37,16,0,True,True,0.7951402777777777,-0.502769
6269,4888110,373,16,0.764904,65,4921538,-1,8000.0,6713137,6713510,1825027,373,10,11,True,True,62.52308888888889,-0.764904
6270,4888363,310,8,0.339539,65,4921538,-1,4000.0,7199250,7199560,2310887,310,9,11,True,True,28.699111111111108,-0.339539
6271,4888651,28881,256,0.614828,65,4921538,-1,128000.0,5223515,5252396,334864,28881,17,0,True,True,90254.3864888889,-0.5715592071691618
6272,4888977,17,4,0.363334,65,4921538,-1,2000.0,7261997,7262014,2373020,17,8,1,True,True,0.55505,-0.363334
6273,4889116,13,16,0.435991,65,4921538,-1,8000.0,5628729,5628742,739613,13,17,7,True,True,3.4952666666666663,-0.435991
6274,4890037,71,32,0.496952,65,4921538,-1,16000.0,7205050,7205121,2315013,71,10,3,True,True,22.76102222222222,-0.496952
6275,4890192,3313,1,0.847334,65,4921538,-1,500.0,6393296,6396609,1503104,3313,14,6,True,True,31.592066666666664,-0.8079997650749573
6276,4890349,18465,16,0.78715,65,4921538,-1,8000.0,5750529,5768994,860180,18465,18,7,True,True,6326.5232000000005,-0.7744454444297226
6277,4890532,7,16,0.84038,65,4921538,-1,8000.0,5798911,5798918,908379,7,17,7,True,True,2.6024444444444446,-0.84038
6278,4890539,85,1,0.535834,65,4921538,-1,500.0,7156050,7156135,2265511,85,12,12,True,True,0.8004166666666667,-0.535834
6279,4890755,96,32,0.287356,65,4921538,-1,16000.0,6557496,6557592,1666741,96,15,0,True,True,22.886400000000002,-0.287356
6280,4890793,21669,4,0.047531,65,4921538,-1,2000.0,5317081,5338750,426288,21669,24,7,True,True,1895.7618944444441,-0.046821377549398156
6281,4891211,34,16,0.996228,65,4921538,-1,8000.0,6202924,6202958,1311713,34,17,0,True,True,14.431866666666666,-0.996228
6282,4891255,335,1,0.402027,65,4921538,-1,500.0,5593781,5594116,702526,335,25,8,True,True,3.686861111111111,-0.402027
6283,4891280,34,1,0.225886,65,4921538,-1,500.0,5053382,5053416,162102,34,30,10,True,True,0.43888333333333335,-0.225886
6284,4891308,16879,123,0.742888,65,4921538,-1,61500.0,4922638,4939517,31330,16879,34,6,True,True,13410.87313333333,-0.5779756472227151
6285,4891483,14135,2,0.091958,65,4921538,-1,1000.0,6982064,6996199,2090581,14135,13,12,True,True,499.69584999999995,-0.08092861199731682
6286,4891580,37,14,0.844187,65,4921538,-1,7000.0,4987482,4987519,95902,37,33,9,True,True,11.131963888888889,-0.844187
6287,4891601,32005,16,0.094734,65,4921538,-1,8000.0,7201450,7233455,2309849,32005,11,0,True,True,6291.523222222223,-0.0905456214459447
6288,4891744,15533,256,0.336838,65,4921538,-1,128000.0,7447620,7463153,2555876,15533,4,8,True,True,94471.49795555556,-0.3282223878369092
6289,4891751,25,1,0.06727,65,4921538,-1,500.0,5903711,5903736,1011960,25,22,11,True,True,0.4868055555555555,-0.06727
6290,4891772,333,1,0.801186,65,4921538,-1,500.0,6840564,6840897,1948792,333,16,2,True,True,12.888025,-0.801186
6291,4892703,136,1,0.475268,65,4921538,-1,500.0,6107424,6107560,1214721,136,22,10,True,True,4.0380666666666665,-0.475268
6292,4892784,23,1,0.209739,65,4921538,-1,500.0,7295155,7295178,2402371,23,7,0,True,True,0.5334083333333334,-0.209739
6293,4892987,5403,13,0.795652,65,4921538,-1,6500.0,7409728,7415131,2516741,5403,6,10,True,True,1337.9056347222222,-0.7436121289674615
6294,4893037,9824,2,0.651537,65,4921538,-1,1000.0,6810337,6820161,1917300,9824,20,12,True,True,537.3460027777778,-0.5805588504106972
6295,4893058,119,4,0.301847,65,4921538,-1,2000.0,7042550,7042669,2149492,119,17,7,True,True,14.916649999999999,-0.301847
6296,4893092,3,4,0.804127,65,4921538,-1,2000.0,7016550,7016553,2123458,3,18,2,True,True,0.37373333333333336,-0.804127
6297,4893139,107,2,0.43291,65,4921538,-1,1000.0,7676981,7677088,2783842,107,1,2,True,True,6.84265,-0.43291
6298,4893163,21,32,0.539948,65,4921538,-1,16000.0,5252403,5252424,359240,21,40,0,True,True,7.421866666666666,-0.539948
6299,4893256,25,16,0.200077,65,4921538,-1,8000.0,7821781,7821806,2928525,25,0,12,True,True,3.61,-0.200077
6300,4893306,12864,64,0.402301,65,4921538,-1,32000.0,6250556,6263420,1357250,12864,28,11,True,True,28654.838044444445,-0.3961972453289318
6301,4893349,211,8,0.624964,65,4921538,-1,4000.0,5119282,5119493,225933,211,45,6,True,True,41.604511111111115,-0.624964
6302,4894139,371,1,0.453229,65,4921538,-1,500.0,6840564,6840935,1946425,371,22,0,True,True,14.358730555555557,-0.453229
6303,4894205,48,32,0.763442,65,4921538,-1,16000.0,6507796,6507844,1613591,48,28,0,True,True,23.182933333333335,-0.763442
6304,4894231,44,8,0.180601,65,4921538,-1,4000.0,4971238,4971282,77007,44,52,10,True,True,3.506311111111111,-0.180601
6305,4895612,10,32,0.018603,65,4921538,-1,16000.0,5925405,5925415,1029793,10,34,0,True,True,2.3764444444444446,-0.018603
6306,4895622,11994,8,0.703332,65,4921538,-1,4000.0,5860511,5872505,964889,11994,36,0,True,True,2149.067211111111,-0.680432590427235
6307,4895882,3,1,0.86271,65,4921538,-1,500.0,5373281,5373284,477399,3,44,8,True,True,0.07795416666666667,-0.86271
6308,4895968,23,2,0.576843,65,4921538,-1,1000.0,6421396,6421419,1525428,23,29,8,True,True,0.46313055555555555,-0.576843
6309,4895984,8,16,0.212953,65,4921538,-1,8000.0,6557507,6557515,1661523,8,27,1,True,True,0.9536,-0.212953
6310,4895993,11,8,0.962117,65,4921538,-1,4000.0,5542981,5542992,646988,11,46,7,True,True,1.0343666666666667,-0.962117
6311,4896003,16,41,0.742208,65,4921538,-1,20500.0,5806511,5806527,910508,16,40,7,True,True,16.218688888888888,-0.742208
6312,4896291,3098,16,0.467295,65,4921538,-1,8000.0,5314881,5317979,418590,3098,50,9,True,True,1120.068822222222,-0.4638894415950038
6313,4896671,17362,128,0.937163,65,4921538,-1,64000.0,4949638,4967000,52967,17362,61,8,True,True,37321.041066666665,-0.8819336283607009
6314,4896798,333,2,0.532719,65,4921538,-1,1000.0,6415996,6416329,1519198,333,31,10,True,True,5.93295,-0.532719
6315,4964811,8,1,0.614422,83,4971238,-1,500.0,7016538,7016546,2051727,8,21,6,True,True,0.24915555555555557,-0.614422
6316,4964818,13609,128,0.769119,83,4971238,-1,64000.0,5443581,5457190,478763,13609,50,7,True,True,24398.482844444443,-0.7622794864857487
6317,4964905,4,16,0.433724,83,4971238,-1,8000.0,5952405,5952409,987500,4,37,10,True,True,0.6833777777777778,-0.433724
6318,4965079,16,7,0.566116,83,4971238,-1,3500.0,4988582,4988598,23503,16,62,6,True,True,2.406911111111111,-0.566116
6319,4965091,8164,1,0.626758,83,4971238,-1,500.0,7199250,7207414,2234159,8164,17,0,True,True,76.81175,-0.5528279700575882
6320,4965152,13,1,0.52227,83,4971238,-1,500.0,5748329,5748342,783177,13,48,12,True,True,0.2255861111111111,-0.52227
6321,4965209,19140,13,0.364275,83,4971238,-1,6500.0,5031782,5050922,66573,19140,63,11,True,True,4511.330308333333,-0.33144977851978213
6322,4965225,5348,8,0.147744,83,4971238,-1,4000.0,6150624,6155972,1185399,5348,37,11,True,True,1152.4254666666666,-0.14769559514707162
6323,4965337,26,32,0.150473,83,4971238,-1,16000.0,6818337,6818363,1853000,26,26,6,True,True,18.468088888888886,-0.150473
6324,4965341,44,16,0.685307,83,4971238,-1,8000.0,6193824,6193868,1228483,44,38,11,True,True,23.997600000000002,-0.685307
6325,4965528,13,1,0.300276,83,4971238,-1,500.0,5594116,5594129,628588,13,54,1,True,True,0.1430722222222222,-0.300276
6326,4965570,9,1,0.435389,83,4971238,-1,500.0,7733181,7733190,2767611,9,2,11,True,True,0.29533750000000003,-0.435389
6327,4966013,54,4,0.318653,83,4971238,-1,2000.0,4976682,4976736,10669,54,72,8,True,True,1.8126,-0.318653
6328,4966019,111,29,0.830214,83,4971238,-1,14500.0,7201450,7201561,2235431,111,18,7,True,True,26.81605833333333,-0.830214
6329,4966028,14475,1,0.064428,83,4971238,-1,500.0,6982064,6996539,2016036,14475,25,0,True,True,254.69386944444443,-0.05688780118803587
6330,4967530,350,16,0.203558,83,4971238,-1,8000.0,7512162,7512512,2544632,350,6,11,True,True,159.96555555555554,-0.203558
6331,4967600,6113,1,0.412438,83,4971238,-1,500.0,5162482,5168595,194882,6113,69,0,True,True,49.843488888888885,-0.41228633068195064
6332,4968036,187,16,0.823711,83,4971238,-1,8000.0,6982064,6982251,2014028,187,26,0,True,True,91.37235555555556,-0.823711
6333,4968040,16106,16,0.646043,83,4971238,-1,8000.0,5269222,5285328,301182,16106,67,6,True,True,4606.340400000001,-0.644592368533605
6334,4968931,5,1,0.256447,83,4971238,-1,500.0,6084724,6084729,1115793,5,46,2,True,True,0.13377777777777777,-0.256447
6335,4969066,8270,24,0.601232,83,4971238,-1,12000.0,6421396,6429666,1452330,8270,38,0,True,True,4624.189666666666,-0.5648105427782089
6336,4969076,22,1,0.405866,83,4971238,-1,500.0,5796711,5796733,827635,22,56,6,True,True,0.5111944444444445,-0.405866
6337,4972025,54,16,0.113559,87,4976682,-1,8000.0,6386796,6386850,1414771,54,42,11,True,True,8.568,-0.113559
6338,4972673,518,8,0.191916,87,4976682,-1,4000.0,5766029,5766547,793356,518,59,9,True,True,91.63995555555556,-0.191916
6339,4972718,376,1,0.245587,87,4976682,-1,500.0,6415996,6416372,1443278,376,40,0,True,True,3.3495333333333335,-0.245587
6340,4975919,5657,2,0.827229,87,4976682,-1,1000.0,5630929,5636586,655010,5657,64,6,True,True,376.2621861111111,-0.821164648438948
6341,4976027,259,4,0.46416,87,4976682,-1,2000.0,5271422,5271681,295395,259,74,7,True,True,17.843661111111114,-0.46416
6342,4976257,34,8,0.559825,87,4976682,-1,4000.0,5640329,5640363,664072,34,63,7,True,True,7.819622222222223,-0.559825
6343,4976907,30,2,0.436133,97,4987482,-1,1000.0,6669907,6669937,1693000,30,35,8,True,True,0.41583333333333333,-0.436133
6344,4977065,26811,64,0.646922,97,4987482,-1,32000.0,5794511,5821322,817446,26811,61,0,True,True,33314.071288888896,-0.6037767584667284
6345,4978639,12,2,0.037004,97,4987482,-1,1000.0,6535896,6535908,1557257,12,38,9,True,True,0.44093333333333334,-0.037004
6346,4978779,16654,94,0.159358,97,4987482,-1,47000.0,6895664,6912318,1916885,16654,29,9,True,True,24831.89383333333,-0.1559929768602306
6347,4978840,91,32,0.136431,97,4987482,-1,16000.0,7420228,7420319,2441388,91,10,2,True,True,85.5683111111111,-0.136431
6348,4986046,13928,256,0.258397,97,4987482,-1,128000.0,5254194,5268122,268148,13928,82,6,True,True,52807.97226666667,-0.24578338461614427
6349,4986058,7,8,0.803538,97,4987482,-1,4000.0,5252396,5252403,266338,7,84,8,True,True,0.5676,-0.7374233830123599
6350,4986134,20,4,0.658671,97,4987482,-1,2000.0,6202956,6202976,1216822,20,49,1,True,True,2.122333333333333,-0.658671
6351,4986480,6,53,0.175985,97,4987482,-1,26500.0,7676466,7676472,2689986,6,4,0,True,True,10.16805,-0.175985
6352,4987189,67,64,0.852521,97,4987482,-1,32000.0,7069650,7069717,2082461,67,25,6,True,True,92.81733333333332,-0.852521
6353,4987212,14787,128,0.963787,97,4987482,-1,64000.0,6513196,6527983,1525984,14787,43,8,True,True,32209.01422222222,-0.9437881304990121
6354,4987740,78,1,0.485842,98,4988582,-1,500.0,5374381,5374459,386641,78,80,0,True,True,2.0268083333333333,-0.485842
6355,4987840,365,4,0.019909,98,4988582,-1,2000.0,7068550,7068915,2080710,365,26,10,True,True,31.602916666666665,-0.019909
6356,4989169,109,8,0.859584,134,5031782,-1,4000.0,7420320,7420429,2431151,109,11,2,True,True,25.623477777777776,-0.859584
6357,4989371,31,8,0.08393,134,5031782,-1,4000.0,7046950,7046981,2057579,31,28,6,True,True,7.288788888888889,-0.08393
6358,4989557,10336,8,0.6016,134,5031782,-1,4000.0,6205156,6215492,1215599,10336,55,7,True,True,1534.7963555555557,-0.5259447147463685
6359,4989575,14084,1,0.867172,134,5031782,-1,500.0,7018750,7032834,2029175,14084,30,7,True,True,480.9668555555555,-0.8471602038748667
6360,4990729,108,2,0.900575,134,5031782,-1,1000.0,5441381,5441489,450652,108,85,11,True,True,3.6534,-0.900575
6361,4990830,666,2,0.407007,134,5031782,-1,1000.0,7689981,7690647,2699151,666,3,9,True,True,33.995599999999996,-0.407007
6362,4991259,16734,1,0.363434,134,5031782,-1,500.0,7410828,7427562,2419569,16734,14,6,True,True,371.84525,-0.3256484650627727
6363,4991313,1000,3,0.657431,134,5031782,-1,1500.0,5771429,5772429,780116,1000,76,8,True,True,69.04166666666667,-0.657431
6364,4991342,21,8,0.090306,134,5031782,-1,4000.0,5252403,5252424,261061,21,98,1,True,True,1.8554666666666666,-0.090306
6365,4996152,288,8,0.943162,134,5031782,-1,4000.0,7255055,7255343,2258903,288,21,10,True,True,14.4672,-0.943162
6366,4996383,9,1,0.724234,134,5031782,-1,500.0,7289755,7289764,2293372,9,20,0,True,True,0.2436625,-0.724234
6367,4996738,11299,256,0.14056,134,5031782,-1,128000.0,6996539,7007838,1999801,11299,37,8,True,True,50884.34631111111,-0.1360326994618933
6368,4996862,19,8,0.111932,134,5031782,-1,4000.0,7676472,7676491,2679610,19,5,2,True,True,4.8602,-0.111932
6369,4997024,11651,2,0.73448,134,5031782,-1,1000.0,5628729,5640380,631705,11651,87,0,True,True,693.2718027777778,-0.7142970283769291
6370,4998240,68,32,0.932935,134,5031782,-1,16000.0,6835796,6835864,1837556,68,45,8,True,True,32.35893333333333,-0.932935
6371,4998380,9,2,0.521958,134,5031782,-1,1000.0,6811437,6811446,1813057,9,48,6,True,True,0.6866,-0.521958
6372,5001282,11,1,0.828982,134,5031782,-1,500.0,6651507,6651518,1650225,11,52,8,True,True,0.05675694444444444,-0.828982
6373,5001393,8013,2,0.949675,134,5031782,-1,1000.0,6835864,6843877,1834471,8013,45,1,True,True,463.9232416666666,-0.6851030782802816
6374,5003634,1429,2,0.931556,134,5031782,-1,1000.0,6836964,6838393,1833330,1429,45,6,True,True,57.072672222222224,-0.931556
6375,5003672,396,11,0.251808,134,5031782,-1,5500.0,5755229,5755625,751557,396,87,6,True,True,94.07145,-0.25180800000000003
6376,5003800,518,4,0.884565,134,5031782,-1,2000.0,5604929,5605447,601129,518,95,9,True,True,17.680211111111113,-0.8220396885820929
6377,5003985,4,16,0.238077,134,5031782,-1,8000.0,6200724,6200728,1196739,4,70,6,True,True,1.963111111111111,-0.238077
6378,5004083,382,8,0.122277,134,5031782,-1,4000.0,5794129,5794511,790046,382,86,6,True,True,72.59697777777778,-0.122277
6379,5004332,179,1,0.806687,134,5031782,-1,500.0,6669937,6670116,1665605,179,53,1,True,True,1.2405694444444444,-0.806687
6380,5004346,342,1,0.329286,134,5031782,-1,500.0,7261655,7261997,2257309,342,23,7,True,True,2.7915750000000004,-0.329286
6381,5004375,7617,128,0.584326,134,5031782,-1,64000.0,5963205,5970822,958830,7617,77,9,True,True,19771.963733333334,-0.5225510181538257
6382,5004770,7207,53,0.389951,134,5031782,-1,26500.0,7634262,7641469,2629492,7207,9,0,True,True,11055.879131944444,-0.3543012232032731
6383,5008217,92,1,0.748374,134,5031782,-1,500.0,7420228,7420320,2412011,92,15,0,True,True,2.7033944444444447,-0.748374
6384,5008449,72,16,0.235938,134,5031782,-1,8000.0,6207356,6207428,1198907,72,71,7,True,True,23.4112,-0.235938
6385,5008526,6200,16,0.422869,134,5031782,-1,8000.0,7257255,7263455,2248729,6200,26,7,True,True,697.564,-0.40066219341326037
6386,5008573,5,8,0.144278,134,5031782,-1,4000.0,6285156,6285161,1276583,5,71,7,True,True,1.007111111111111,-0.144278
6387,5009035,112,4,0.175154,134,5031782,-1,2000.0,7627762,7627874,2618727,112,10,8,True,True,13.396444444444445,-0.175154
6388,5009187,92,16,0.969923,134,5031782,-1,8000.0,6507796,6507888,1498609,92,66,0,True,True,22.216977777777778,-0.969923
6389,5011695,36736,16,0.439475,134,5031782,-1,8000.0,5925405,5962141,913710,36736,88,1,True,True,8244.899577777778,-0.4171719144402733
6390,5012350,143,32,0.254306,134,5031782,-1,16000.0,7015438,7015581,2003088,143,43,6,True,True,114.48897777777776,-0.254306
6391,5012445,12,8,0.589481,134,5031782,-1,4000.0,7016538,7016550,2004093,12,42,0,True,True,2.989866666666667,-0.589481
6392,5013079,28,4,0.490359,134,5031782,-1,2000.0,6083522,6083550,1070443,28,86,9,True,True,3.106444444444444,-0.490359
6393,5013666,39,64,0.374705,134,5031782,-1,32000.0,5374381,5374420,360715,39,118,6,True,True,64.85786666666667,-0.374705
6394,5035595,4,1,0.948711,202,5053382,-1,500.0,5971922,5971926,936327,4,87,6,True,True,0.1106,-0.948711
6395,5035616,49,1,0.31649,202,5053382,-1,500.0,6664507,6664556,1628891,49,62,9,True,True,0.27412777777777775,-0.31649
6396,5035632,6541,32,0.423781,202,5053382,-1,16000.0,5629829,5636370,594197,6541,111,6,True,True,6690.515066666667,-0.4070756239966467
6397,5035672,13689,1,0.682738,202,5053382,-1,500.0,5604929,5618618,569257,13689,114,0,True,True,102.3116736111111,-0.6320300824557941
6398,5035701,48,4,0.963315,202,5053382,-1,2000.0,7600762,7600810,2565061,48,11,7,True,True,3.4664000000000006,-0.963315
6399,5038555,27,25,0.879434,202,5053382,-1,12500.0,7674266,7674293,2635711,27,7,8,True,True,22.271250000000002,-0.879434
6400,5039384,9,8,0.936972,202,5053382,-1,4000.0,5793029,5793038,753645,9,105,10,True,True,1.7104,-0.936972
6401,5039437,4609,128,0.362998,202,5053382,-1,64000.0,6308956,6313565,1269519,4609,78,7,True,True,6116.1088,-0.35634698128153086
6402,5039447,15719,8,0.715671,202,5053382,-1,4000.0,7661262,7676981,2621815,15719,9,8,True,True,4143.661933333333,-0.7148191044031186
6403,5039464,2,1,0.821365,202,5053382,-1,500.0,7014338,7014340,1974874,2,48,8,True,True,0.05003888888888888,-0.821365
6404,5039486,489,1,0.021074,202,5053382,-1,500.0,5817311,5817800,777825,489,102,9,True,True,6.60345,-0.020175244874437302
6405,5039769,60,1,0.966805,202,5053382,-1,500.0,6653707,6653767,1613938,60,67,7,True,True,0.26958333333333334,-0.966805
6406,5039891,10,4,0.605815,202,5053382,-1,2000.0,5269222,5269232,229331,10,136,0,True,True,0.6475,-0.605815
6407,5039964,11,2,0.841473,202,5053382,-1,1000.0,6884864,6884875,1844900,11,54,11,True,True,0.4685083333333334,-0.841473
6408,5040154,8196,8,0.662223,202,5053382,-1,4000.0,5540781,5548977,500627,8196,128,12,True,True,777.9884999999999,-0.5970703312393583
6409,5040184,9272,1,0.940848,202,5053382,-1,500.0,7655862,7665134,2615678,9272,11,10,True,True,267.35037500000004,-0.8547273067275576
6410,5040190,24297,78,0.690682,202,5053382,-1,39000.0,6199624,6223921,1159434,24297,91,1,True,True,39254.514325000004,-0.6795108722544387
6411,5040213,572,8,0.788803,202,5053382,-1,4000.0,7679181,7679753,2638968,572,4,7,True,True,147.50608888888888,-0.788803
6412,5040272,2900,64,0.239676,202,5053382,-1,32000.0,6306756,6309656,1266484,2900,85,0,True,True,1837.8961777777777,-0.21821410699439447
6413,5040327,32,2,0.552728,202,5053382,-1,1000.0,6202924,6202956,1162597,32,92,7,True,True,1.6978666666666666,-0.552728
6414,5040396,7193,1,0.309269,202,5053382,-1,500.0,6514296,6521489,1473900,7193,75,6,True,True,130.3083513888889,-0.2947365146183825
6415,5040423,9,8,0.958484,202,5053382,-1,4000.0,5794511,5794520,754088,9,116,0,True,True,1.7104,-0.958484
6416,5040900,48,4,0.362855,202,5053382,-1,2000.0,6343556,6343604,1302656,48,85,9,True,True,5.544533333333334,-0.362855
6417,5040909,7,64,0.81225,202,5053382,-1,32000.0,6272156,6272163,1231247,7,89,10,True,True,16.06951111111111,-0.81225
6418,5041154,752,8,0.122054,202,5053382,-1,4000.0,6085824,6086576,1044670,752,101,6,True,True,160.9614222222222,-0.122054
6419,5041162,10,1,0.866953,202,5053382,-1,500.0,7289755,7289765,2248593,10,30,6,True,True,0.2707361111111111,-0.866953
6420,5041194,39,32,0.857647,202,5053382,-1,16000.0,6646107,6646146,1604913,39,73,7,True,True,8.9232,-0.857647
6421,5046220,1,16,0.388471,202,5053382,-1,8000.0,7676466,7676467,2630246,1,8,7,True,True,0.5115999999999999,-0.388471
6422,5046284,15625,4,0.909789,202,5053382,-1,2000.0,6392196,6407821,1345912,15625,87,8,True,True,606.3904722222222,-0.8951118285746285
6423,5046317,3,1,0.392976,202,5053382,-1,500.0,7416628,7416631,2370311,3,24,0,True,True,0.05358750000000001,-0.392976
6424,5046332,6729,4,0.977993,202,5053382,-1,2000.0,6282956,6289685,1236624,6729,94,8,True,True,647.6352055555556,-0.9544080131681383
6425,5046363,260,1,0.255534,202,5053382,-1,500.0,5588381,5588641,542018,260,143,11,True,True,2.50575,-0.255534
6426,5046749,11,9,0.09025,202,5053382,-1,4500.0,7199250,7199261,2152501,11,42,0,True,True,1.1456499999999998,-0.09025
6427,5046809,257,1,0.822708,202,5053382,-1,500.0,6343596,6343853,1296787,257,91,1,True,True,7.421588888888889,-0.822708
6428,5046913,11,32,0.23546,202,5053382,-1,16000.0,7263455,7263466,2216542,11,33,2,True,True,2.8732,-0.23546
6429,5047043,14,4,0.210386,202,5053382,-1,2000.0,6810337,6810351,1763294,14,70,0,True,True,1.648188888888889,-0.210386
6430,5047140,22571,16,0.890247,202,5053382,-1,8000.0,7258355,7280926,2211215,22571,36,6,True,True,6213.639444444444,-0.7928935437285595
6431,5047202,6,8,0.915891,202,5053382,-1,4000.0,5634529,5634535,587327,6,140,4,True,True,1.5278666666666667,-0.915891
6432,5047254,11,12,0.631353,202,5053382,-1,6000.0,5074982,5074993,27728,11,171,10,True,True,1.937466666666667,-0.631353
6433,5048161,10364,23,0.879467,202,5053382,-1,11500.0,5975522,5985886,927361,10364,115,2,True,True,6946.121133333334,-0.8735003861746574
6434,5048205,473,2,0.766741,202,5053382,-1,1000.0,7689981,7690454,2641776,473,3,0,True,True,24.144022222222222,-0.766741
6435,5048623,20,54,0.406289,202,5053382,-1,27000.0,5118182,5118202,69559,20,173,11,True,True,28.083,-0.406289
6436,5048678,9806,32,0.033882,202,5053382,-1,16000.0,5376581,5386387,327903,9806,156,7,True,True,7692.711111111111,-0.033090933107798495
6437,5049119,1583,2,0.866445,202,5053382,-1,1000.0,6830396,6831979,1781277,1583,69,1,True,True,40.63473055555556,-0.866445
6438,5049130,11094,128,0.823198,202,5053382,-1,64000.0,7666662,7677756,2617532,11094,12,8,True,True,46636.079999999994,-0.8197415217537466
6439,5049135,11,80,0.940495,202,5053382,-1,40000.0,7415528,7415539,2366393,11,27,3,True,True,13.384555555555558,-0.940495
6440,5049317,7704,256,0.471091,202,5053382,-1,128000.0,5661929,5669633,612612,7704,143,10,True,True,39872.35697777778,-0.45339323220042993
6441,5049589,6,8,0.412961,202,5053382,-1,4000.0,5268122,5268128,218533,6,170,6,True,True,0.777,-0.412961
6442,5049619,15133,8,0.841163,202,5053382,-1,4000.0,5626529,5641662,576910,15133,151,10,True,True,3332.569766666667,-0.7788277354510053
6443,5049809,7295,16,0.717386,202,5053382,-1,8000.0,6394396,6401691,1344587,7295,95,6,True,True,1163.998711111111,-0.705634862901767
6444,5050464,16097,1,0.876761,202,5053382,-1,500.0,5367881,5383978,317417,16097,166,8,True,True,410.11533333333335,-0.8752650614924119
6445,5050620,3608,128,0.820241,202,5053382,-1,64000.0,5205682,5209290,155062,3608,180,11,True,True,12193.675022222222,-0.8150212788418023
6446,5050703,99,4,0.824401,202,5053382,-1,2000.0,5754129,5754228,703426,99,142,1,True,True,8.55195,-0.824401
6447,5050777,49,2,0.698482,202,5053382,-1,1000.0,7622362,7622411,2571585,49,18,10,True,True,3.1967055555555555,-0.698482
6448,5050915,24920,64,0.506335,202,5053382,-1,32000.0,7007838,7032758,1956923,24920,61,7,True,True,47478.75466666666,-0.4899771495783778
6449,5051602,7919,2,0.351856,202,5053382,-1,1000.0,6196024,6203943,1144422,7919,116,7,True,True,506.7181861111111,-0.34667639073575474
6450,5051620,4940,16,0.602116,202,5053382,-1,8000.0,7044750,7049690,1993130,4940,54,7,True,True,2342.7631111111114,-0.5772212773591326
6451,5051644,11891,128,0.813428,202,5053382,-1,64000.0,5594129,5606020,542485,11891,160,1,True,True,13760.715377777778,-0.7506426359147662
6452,5051662,10,32,0.737786,202,5053382,-1,16000.0,5454381,5454391,402719,10,166,9,True,True,3.716444444444445,-0.737786
6453,5051696,12002,128,0.453262,202,5053382,-1,64000.0,6072722,6084724,1021026,12002,124,9,True,True,42072.59768888888,-0.4483743597794913
6454,5051826,9,28,0.027351,202,5053382,-1,14000.0,6306756,6306765,1254930,9,106,10,True,True,2.7408500000000005,-0.027351
6455,5051887,12955,4,0.052099,202,5053382,-1,2000.0,6982064,6995019,1930177,12955,64,0,True,True,932.1185888888889,-0.04534298956278313
6456,5051994,549,1,0.641593,202,5053382,-1,500.0,7040350,7040899,1988356,549,56,10,True,True,17.487937499999997,-0.641593
6457,5052030,7192,8,0.630156,202,5053382,-1,4000.0,5540781,5547973,488751,7192,169,0,True,True,655.4558777777777,-0.5314949350028773
6458,5052093,9,1,0.791019,202,5053382,-1,500.0,7411928,7411937,2359835,9,29,6,True,True,0.2067375,-0.791019
6459,5053167,300,16,0.136092,202,5053382,-1,8000.0,7420320,7420620,2367153,300,24,0,True,True,141.04666666666665,-0.136092
6460,5053192,11523,32,0.400662,202,5053382,-1,16000.0,5794511,5806034,741319,11523,147,1,True,True,8676.119555555557,-0.3955231790256886
6461,5053311,60,4,0.628296,202,5053382,-1,2000.0,6829137,6829197,1775826,60,79,9,True,True,2.417333333333333,-0.628296
6462,5053321,42,1,0.313722,202,5053382,-1,500.0,5162482,5162524,109161,42,198,11,True,True,0.3464416666666667,-0.313722
6463,5053390,9387,32,0.082232,243,5074982,-1,16000.0,7463562,7472949,2410172,9387,22,1,True,True,6649.8677333333335,-0.0812177826391272
6464,5053409,409,1,0.157822,243,5074982,-1,500.0,7463153,7463562,2409744,409,23,1,True,True,9.745561111111112,-0.157822
6465,5053471,669,40,0.516366,243,5074982,-1,20000.0,5804311,5804980,750840,669,145,8,True,True,661.6038333333332,-0.516366
6466,5053478,1370,4,0.969665,243,5074982,-1,2000.0,7207250,7208620,2153772,1370,48,7,True,True,53.20166666666667,-0.969665
6467,5053524,4,1,0.830621,243,5074982,-1,500.0,7666662,7666666,2613138,4,12,0,True,True,0.1306166666666667,-0.830621
6468,5053546,607,1,0.763163,243,5074982,-1,500.0,6330556,6331163,1277010,607,113,10,True,True,6.470451388888889,-0.763163
6469,5053558,18448,160,0.84696,243,5074982,-1,80000.0,7634262,7652710,2580704,18448,18,6,True,True,72248.95466666667,-0.7866471195505288
6470,5053616,14,16,0.685753,243,5074982,-1,8000.0,6841664,6841678,1788048,14,78,6,True,True,8.669422222222222,-0.685753
6471,5053649,94,1,0.792642,243,5074982,-1,500.0,5925311,5925405,871662,94,145,10,True,True,0.6980805555555556,-0.792642
6472,5053681,194,8,0.319399,243,5074982,-1,4000.0,7300628,7300822,2246947,194,38,2,True,True,36.07964444444445,-0.31629948387490286
6473,5053696,1791,8,0.478365,243,5074982,-1,4000.0,5252403,5254194,198707,1791,201,0,True,True,158.2448,-0.478365
6474,5054011,14447,128,0.735172,243,5074982,-1,64000.0,7259455,7273902,2205444,14447,47,6,True,True,24098.197866666666,-0.6449747796715702
6475,5054052,7887,29,0.26068,243,5074982,-1,14500.0,6277556,6285443,1223504,7887,123,8,True,True,6595.058038888889,-0.22648862870364875
6476,5054099,10840,32,0.687467,243,5074982,-1,16000.0,6332756,6343596,1278657,10840,117,7,True,True,8291.605511111113,-0.5769892127950863
6477,5054492,21,8,0.826769,243,5074982,-1,4000.0,5319281,5319302,264789,21,196,7,True,True,3.7132666666666667,-0.826769
6478,5055358,13301,128,0.799529,243,5074982,-1,64000.0,7288655,7301956,2233297,13301,44,10,True,True,40890.38168888888,-0.7766345808679512
6479,5055377,15508,140,0.198664,243,5074982,-1,70000.0,5970822,5986330,915445,15508,145,7,True,True,61169.83522222222,-0.19558988104813937
6480,5055439,17,16,0.414496,243,5074982,-1,8000.0,7633162,7633179,2577723,17,19,8,True,True,8.972977777777778,-0.414496
6481,5055712,8,16,0.181889,243,5074982,-1,8000.0,7267055,7267063,2211343,8,46,2,True,True,0.9440000000000001,-0.181889
6482,5055757,3,8,0.87639,243,5074982,-1,4000.0,5398181,5398184,342424,3,195,10,True,True,0.44373333333333337,-0.87639
6483,5055783,1034,4,0.944757,243,5074982,-1,2000.0,6723937,6724971,1668154,1034,96,9,True,True,66.35749444444444,-0.8941786175555885
6484,5056411,109,2,0.884341,243,5074982,-1,1000.0,7442220,7442329,2385809,109,28,10,True,True,3.770188888888889,-0.884341
6485,5056458,266,9,0.224487,243,5074982,-1,4500.0,5282481,5282747,226023,266,207,9,True,True,45.615675,-0.224487
6486,5056472,345,8,0.948109,243,5074982,-1,4000.0,5362481,5362826,306009,345,203,11,True,True,60.26383333333334,-0.948109
6487,5056902,18,10,0.923112,243,5074982,-1,5000.0,6643907,6643925,1587005,18,105,12,True,True,1.6524999999999999,-0.923112
6488,5057043,9038,32,0.647107,243,5074982,-1,16000.0,6507796,6516834,1450753,9038,113,12,True,True,4929.880622222222,-0.6056614859434444
6489,5058075,16,1,0.626627,243,5074982,-1,500.0,7668866,7668882,2610791,16,11,7,True,True,0.5339777777777778,-0.626627
6490,5058146,12,7,0.906845,243,5074982,-1,3500.0,6817237,6817249,1759091,12,94,2,True,True,1.8645666666666667,-0.906845
6491,5058434,553,4,0.974128,243,5074982,-1,2000.0,7598562,7599115,2540128,553,24,12,True,True,42.62093888888889,-0.974128
6492,5058632,386,1,0.198266,243,5074982,-1,500.0,7297028,7297414,2238396,386,43,3,True,True,8.957630555555555,-0.19816558822470132
6493,5058801,18,16,0.701261,243,5074982,-1,8000.0,6061922,6061940,1003121,18,153,12,True,True,5.710800000000001,-0.701261
6494,5058827,10593,1,0.168756,243,5074982,-1,500.0,7416628,7427221,2357801,10593,37,6,True,True,260.87940000000003,-0.15427316526532903
6495,5058866,27,16,0.401035,243,5074982,-1,8000.0,5271681,5271708,212815,27,217,1,True,True,7.4406,-0.401035
6496,5058919,16733,1,0.428903,243,5074982,-1,500.0,5206782,5223515,147863,16733,229,6,True,True,317.29291944444446,-0.4131100034521906
6497,5058961,39,1,0.260158,243,5074982,-1,500.0,6525096,6525135,1466135,39,114,9,True,True,0.574925,-0.260158
6498,5059497,36,30,0.089061,243,5074982,-1,15000.0,5545181,5545217,485684,36,200,7,True,True,11.5215,-0.089061
6499,5059573,159,16,0.36792,243,5074982,-1,8000.0,6830237,6830396,1770664,159,95,6,True,True,32.65153333333333,-0.36792
6500,5059943,270,8,0.947244,243,5074982,-1,4000.0,6813637,6813907,1753694,270,99,7,True,True,82.392,-0.947244
6501,5059974,12,1,0.117351,243,5074982,-1,500.0,7045850,7045862,1985876,12,71,6,True,True,0.3526833333333334,-0.117351
6502,5060092,437,64,0.718583,243,5074982,-1,32000.0,7387028,7387465,2326936,437,43,12,True,True,571.1241777777777,-0.7083620925444029
6503,5060119,11,3,0.435159,243,5074982,-1,1500.0,6557496,6557507,1497377,11,117,10,True,True,0.24585,-0.435159
6504,5060145,147,4,0.919989,243,5074982,-1,2000.0,7008938,7009085,1948793,147,82,6,True,True,11.236516666666667,-0.919989
